,TIME,SRC,PACKET_SIZE,CUMULATIVE_PACKET_SIZE,PAGE_NUMBER,TOTAL_PACKET_SIZE
0,0.0,74.125.24.0-255,153,153,77,320036
1,2.3e-05,172.31.40.0-255,66,219,77,320036
2,3.1e-05,74.125.24.0-255,1484,1703,77,320036
3,3.5e-05,172.31.40.0-255,66,1769,77,320036
4,4.1e-05,74.125.24.0-255,2902,4671,77,320036
5,4.4e-05,172.31.40.0-255,66,4737,77,320036
6,5.2e-05,74.125.24.0-255,7156,11893,77,320036
7,5.6e-05,172.31.40.0-255,66,11959,77,320036
8,6e-05,74.125.24.0-255,2140,14099,77,320036
9,6.4e-05,172.31.40.0-255,66,14165,77,320036
10,0.000111,74.125.24.0-255,11410,25575,77,320036
11,0.000115,172.31.40.0-255,66,25641,77,320036
12,0.00012,74.125.24.0-255,2902,28543,77,320036
13,0.000122,172.31.40.0-255,66,28609,77,320036
14,0.000161,74.125.24.0-255,2543,31152,77,320036
15,0.000164,172.31.40.0-255,66,31218,77,320036
16,0.000254,74.125.24.0-255,1484,32702,77,320036
17,0.000258,172.31.40.0-255,66,32768,77,320036
18,0.000275,74.125.24.0-255,2902,35670,77,320036
19,0.000278,172.31.40.0-255,66,35736,77,320036
20,0.000303,74.125.24.0-255,5738,41474,77,320036
21,0.000305,172.31.40.0-255,66,41540,77,320036
22,0.000317,74.125.24.0-255,1484,43024,77,320036
23,0.000319,172.31.40.0-255,66,43090,77,320036
24,0.000343,74.125.24.0-255,7156,50246,77,320036
25,0.000345,172.31.40.0-255,66,50312,77,320036
26,0.000378,74.125.24.0-255,9992,60304,77,320036
27,0.000381,172.31.40.0-255,66,60370,77,320036
28,0.000384,74.125.24.0-255,1484,61854,77,320036
29,0.000386,172.31.40.0-255,66,61920,77,320036
30,0.000438,74.125.24.0-255,3897,65817,77,320036
31,0.000443,172.31.40.0-255,66,65883,77,320036
32,0.000446,74.125.24.0-255,131,66014,77,320036
33,0.000557,74.125.24.0-255,1484,67498,77,320036
34,0.000561,172.31.40.0-255,66,67564,77,320036
35,0.000577,74.125.24.0-255,2902,70466,77,320036
36,0.000581,172.31.40.0-255,66,70532,77,320036
37,0.000587,74.125.24.0-255,5738,76270,77,320036
38,0.000589,172.31.40.0-255,66,76336,77,320036
39,0.000635,74.125.24.0-255,12828,89164,77,320036
40,0.000638,172.31.40.0-255,66,89230,77,320036
41,0.000645,74.125.24.0-255,7156,96386,77,320036
42,0.000647,172.31.40.0-255,66,96452,77,320036
43,0.000662,74.125.24.0-255,3602,100054,77,320036
44,0.000665,172.31.40.0-255,66,100120,77,320036
45,0.000954,74.125.24.0-255,1484,101604,77,320036
46,0.00096,74.125.24.0-255,2902,104506,77,320036
47,0.000964,172.31.40.0-255,66,104572,77,320036
48,0.000971,74.125.24.0-255,5738,110310,77,320036
49,0.000973,172.31.40.0-255,66,110376,77,320036
50,0.000998,74.125.24.0-255,12828,123204,77,320036
51,0.001001,172.31.40.0-255,66,123270,77,320036
52,0.001014,74.125.24.0-255,1484,124754,77,320036
53,0.001036,74.125.24.0-255,9274,134028,77,320036
54,0.001038,172.31.40.0-255,66,134094,77,320036
55,0.001124,74.125.24.0-255,1484,135578,77,320036
56,0.001128,74.125.24.0-255,1484,137062,77,320036
57,0.001131,172.31.40.0-255,66,137128,77,320036
58,0.001152,74.125.24.0-255,1484,138612,77,320036
59,0.00116,74.125.24.0-255,5738,144350,77,320036
60,0.001163,172.31.40.0-255,66,144416,77,320036
61,0.001168,74.125.24.0-255,4320,148736,77,320036
62,0.001171,172.31.40.0-255,66,148802,77,320036
63,0.001188,74.125.24.0-255,8574,157376,77,320036
64,0.001191,172.31.40.0-255,66,157442,77,320036
65,0.001217,74.125.24.0-255,1484,158926,77,320036
66,0.001242,74.125.24.0-255,9274,168200,77,320036
67,0.001245,172.31.40.0-255,66,168266,77,320036
68,0.001272,172.31.40.0-255,101,168367,77,320036
69,0.001301,74.125.24.0-255,1484,169851,77,320036
70,0.001307,74.125.24.0-255,2902,172753,77,320036
71,0.001311,172.31.40.0-255,66,172819,77,320036
72,0.001314,74.125.24.0-255,1484,174303,77,320036
73,0.001336,74.125.24.0-255,4320,178623,77,320036
74,0.001341,172.31.40.0-255,66,178689,77,320036
75,0.001348,74.125.24.0-255,1484,180173,77,320036
76,0.001369,74.125.24.0-255,11410,191583,77,320036
77,0.001372,172.31.40.0-255,66,191649,77,320036
78,0.001375,74.125.24.0-255,1484,193133,77,320036
79,0.0014,74.125.24.0-255,9274,202407,77,320036
80,0.001403,172.31.40.0-255,66,202473,77,320036
81,0.001632,74.125.24.0-255,1484,203957,77,320036
82,0.001638,74.125.24.0-255,2902,206859,77,320036
83,0.001641,172.31.40.0-255,66,206925,77,320036
84,0.001648,74.125.24.0-255,5738,212663,77,320036
85,0.00165,172.31.40.0-255,66,212729,77,320036
86,0.001669,74.125.24.0-255,1484,214213,77,320036
87,0.001689,74.125.24.0-255,11410,225623,77,320036
88,0.001692,172.31.40.0-255,66,225689,77,320036
89,0.001719,74.125.24.0-255,13528,239217,77,320036
90,0.001722,172.31.40.0-255,66,239283,77,320036
91,0.001726,74.125.24.0-255,2902,242185,77,320036
92,0.001728,172.31.40.0-255,66,242251,77,320036
93,0.001746,74.125.24.0-255,4320,246571,77,320036
94,0.00175,172.31.40.0-255,66,246637,77,320036
95,0.001778,74.125.24.0-255,7156,253793,77,320036
96,0.001781,172.31.40.0-255,66,253859,77,320036
97,0.001821,172.31.40.0-255,66,253925,77,320036
98,0.001824,74.125.24.0-255,766,254691,77,320036
99,0.001866,74.125.24.0-255,2902,257593,77,320036
100,0.001869,172.31.40.0-255,66,257659,77,320036
101,0.001883,74.125.24.0-255,2902,260561,77,320036
102,0.001887,172.31.40.0-255,66,260627,77,320036
103,0.001893,74.125.24.0-255,7156,267783,77,320036
104,0.001895,172.31.40.0-255,66,267849,77,320036
105,0.001905,74.125.24.0-255,12828,280677,77,320036
106,0.001909,172.31.40.0-255,66,280743,77,320036
107,0.001933,74.125.24.0-255,1484,282227,77,320036
108,0.001941,74.125.24.0-255,6438,288665,77,320036
109,0.001944,172.31.40.0-255,66,288731,77,320036
110,0.001959,172.31.40.0-255,66,288797,77,320036
111,0.001984,74.125.24.0-255,7156,295953,77,320036
112,0.001987,172.31.40.0-255,66,296019,77,320036
113,0.002005,172.31.40.0-255,66,296085,77,320036
114,0.002033,74.125.24.0-255,3602,299687,77,320036
115,0.002036,172.31.40.0-255,66,299753,77,320036
116,0.002045,74.125.24.0-255,9992,309745,77,320036
117,0.002047,172.31.40.0-255,66,309811,77,320036
118,0.002054,74.125.24.0-255,7156,316967,77,320036
119,0.002058,172.31.40.0-255,66,317033,77,320036
120,0.002108,172.31.40.0-255,66,317099,77,320036
121,0.002125,172.31.40.0-255,66,317165,77,320036
122,0.002146,74.125.24.0-255,2634,319799,77,320036
123,0.002149,172.31.40.0-255,66,319865,77,320036
124,0.002152,74.125.24.0-255,105,319970,77,320036
125,0.003739,74.125.24.0-255,66,320036,77,320036
126,0.0,74.125.24.0-255,149,149,77,414799
127,2.1e-05,172.31.40.0-255,66,215,77,414799
128,2.8e-05,74.125.24.0-255,1484,1699,77,414799
129,3.3e-05,172.31.40.0-255,66,1765,77,414799
130,4.5e-05,74.125.24.0-255,2902,4667,77,414799
131,5e-05,172.31.40.0-255,66,4733,77,414799
132,5.6e-05,74.125.24.0-255,5738,10471,77,414799
133,6e-05,172.31.40.0-255,66,10537,77,414799
134,6.7e-05,74.125.24.0-255,5738,16275,77,414799
135,6.9e-05,172.31.40.0-255,66,16341,77,414799
136,9.6e-05,74.125.24.0-255,7701,24042,77,414799
137,0.000103,172.31.40.0-255,66,24108,77,414799
138,0.000111,74.125.24.0-255,6797,30905,77,414799
139,0.000114,172.31.40.0-255,66,30971,77,414799
140,0.000319,74.125.24.0-255,1484,32455,77,414799
141,0.000326,172.31.40.0-255,66,32521,77,414799
142,0.000331,74.125.24.0-255,2902,35423,77,414799
143,0.000333,172.31.40.0-255,66,35489,77,414799
144,0.000365,74.125.24.0-255,5738,41227,77,414799
145,0.000368,172.31.40.0-255,66,41293,77,414799
146,0.000403,74.125.24.0-255,12469,53762,77,414799
147,0.000406,172.31.40.0-255,66,53828,77,414799
148,0.000441,74.125.24.0-255,11051,64879,77,414799
149,0.000444,172.31.40.0-255,66,64945,77,414799
150,0.000487,74.125.24.0-255,1484,66429,77,414799
151,0.000489,172.31.40.0-255,66,66495,77,414799
152,0.000494,74.125.24.0-255,2902,69397,77,414799
153,0.000496,172.31.40.0-255,66,69463,77,414799
154,0.00053,74.125.24.0-255,5738,75201,77,414799
155,0.000533,172.31.40.0-255,66,75267,77,414799
156,0.00054,74.125.24.0-255,7072,82339,77,414799
157,0.000542,172.31.40.0-255,66,82405,77,414799
158,0.000714,74.125.24.0-255,1484,83889,77,414799
159,0.00072,74.125.24.0-255,2902,86791,77,414799
160,0.000723,172.31.40.0-255,66,86857,77,414799
161,0.000731,74.125.24.0-255,5738,92595,77,414799
162,0.000733,172.31.40.0-255,66,92661,77,414799
163,0.000771,74.125.24.0-255,12828,105489,77,414799
164,0.000774,172.31.40.0-255,66,105555,77,414799
165,0.000777,74.125.24.0-255,1484,107039,77,414799
166,0.000805,74.125.24.0-255,13144,120183,77,414799
167,0.000808,172.31.40.0-255,66,120249,77,414799
168,0.000813,74.125.24.0-255,4320,124569,77,414799
169,0.000815,172.31.40.0-255,66,124635,77,414799
170,0.000858,74.125.24.0-255,11410,136045,77,414799
171,0.000861,172.31.40.0-255,66,136111,77,414799
172,0.000871,74.125.24.0-255,11410,147521,77,414799
173,0.000873,172.31.40.0-255,66,147587,77,414799
174,0.000882,74.125.24.0-255,2319,149906,77,414799
175,0.000884,172.31.40.0-255,66,149972,77,414799
176,0.001171,74.125.24.0-255,1484,151456,77,414799
177,0.00119,74.125.24.0-255,2902,154358,77,414799
178,0.001194,172.31.40.0-255,66,154424,77,414799
179,0.001199,74.125.24.0-255,2902,157326,77,414799
180,0.0012,172.31.40.0-255,66,157392,77,414799
181,0.001233,74.125.24.0-255,2902,160294,77,414799
182,0.001236,172.31.40.0-255,66,160360,77,414799
183,0.001247,74.125.24.0-255,11410,171770,77,414799
184,0.001249,172.31.40.0-255,66,171836,77,414799
185,0.001265,74.125.24.0-255,1484,173320,77,414799
186,0.001277,74.125.24.0-255,4320,177640,77,414799
187,0.00128,172.31.40.0-255,66,177706,77,414799
188,0.00131,74.125.24.0-255,6438,184144,77,414799
189,0.001314,172.31.40.0-255,66,184210,77,414799
190,0.001353,74.125.24.0-255,1484,185694,77,414799
191,0.001364,74.125.24.0-255,2902,188596,77,414799
192,0.001367,172.31.40.0-255,66,188662,77,414799
193,0.001371,74.125.24.0-255,1484,190146,77,414799
194,0.001401,74.125.24.0-255,4320,194466,77,414799
195,0.001404,172.31.40.0-255,66,194532,77,414799
196,0.001415,74.125.24.0-255,11410,205942,77,414799
197,0.001418,172.31.40.0-255,66,206008,77,414799
198,0.001448,74.125.24.0-255,1484,207492,77,414799
199,0.001483,74.125.24.0-255,10692,218184,77,414799
200,0.001486,172.31.40.0-255,66,218250,77,414799
201,0.001548,74.125.24.0-255,4320,222570,77,414799
202,0.001552,172.31.40.0-255,66,222636,77,414799
203,0.001558,74.125.24.0-255,5738,228374,77,414799
204,0.00156,172.31.40.0-255,66,228440,77,414799
205,0.001575,74.125.24.0-255,11410,239850,77,414799
206,0.001578,172.31.40.0-255,66,239916,77,414799
207,0.001584,74.125.24.0-255,7156,247072,77,414799
208,0.001587,172.31.40.0-255,66,247138,77,414799
209,0.001649,74.125.24.0-255,6438,253576,77,414799
210,0.001652,172.31.40.0-255,66,253642,77,414799
211,0.001688,74.125.24.0-255,7156,260798,77,414799
212,0.001691,172.31.40.0-255,66,260864,77,414799
213,0.001697,74.125.24.0-255,4320,265184,77,414799
214,0.001699,172.31.40.0-255,66,265250,77,414799
215,0.001743,74.125.24.0-255,11410,276660,77,414799
216,0.001746,172.31.40.0-255,66,276726,77,414799
217,0.001754,74.125.24.0-255,9274,286000,77,414799
218,0.001757,172.31.40.0-255,66,286066,77,414799
219,0.001915,74.125.24.0-255,1484,287550,77,414799
220,0.001931,74.125.24.0-255,2902,290452,77,414799
221,0.001934,172.31.40.0-255,66,290518,77,414799
222,0.001941,74.125.24.0-255,5738,296256,77,414799
223,0.001943,172.31.40.0-255,66,296322,77,414799
224,0.001976,74.125.24.0-255,12828,309150,77,414799
225,0.001978,172.31.40.0-255,66,309216,77,414799
226,0.001987,74.125.24.0-255,8574,317790,77,414799
227,0.00199,172.31.40.0-255,66,317856,77,414799
228,0.002024,74.125.24.0-255,2184,320040,77,414799
229,0.002027,172.31.40.0-255,66,320106,77,414799
230,0.002104,74.125.24.0-255,1484,321590,77,414799
231,0.002108,74.125.24.0-255,1484,323074,77,414799
232,0.002111,172.31.40.0-255,66,323140,77,414799
233,0.002138,74.125.24.0-255,1484,324624,77,414799
234,0.002146,74.125.24.0-255,5738,330362,77,414799
235,0.002148,172.31.40.0-255,66,330428,77,414799
236,0.002187,74.125.24.0-255,12828,343256,77,414799
237,0.002191,172.31.40.0-255,66,343322,77,414799
238,0.002201,74.125.24.0-255,10692,354014,77,414799
239,0.002204,172.31.40.0-255,66,354080,77,414799
240,0.00225,74.125.24.0-255,1484,355564,77,414799
241,0.002254,74.125.24.0-255,1484,357048,77,414799
242,0.002257,172.31.40.0-255,66,357114,77,414799
243,0.002284,74.125.24.0-255,1484,358598,77,414799
244,0.002291,74.125.24.0-255,5738,364336,77,414799
245,0.002294,172.31.40.0-255,66,364402,77,414799
246,0.0023,74.125.24.0-255,5738,370140,77,414799
247,0.002303,172.31.40.0-255,66,370206,77,414799
248,0.002318,74.125.24.0-255,11410,381616,77,414799
249,0.002321,172.31.40.0-255,66,381682,77,414799
250,0.004599,74.125.24.0-255,5738,387420,77,414799
251,0.004606,172.31.40.0-255,66,387486,77,414799
252,0.006876,74.125.24.0-255,5738,393224,77,414799
253,0.006884,172.31.40.0-255,66,393290,77,414799
254,0.009172,74.125.24.0-255,5738,399028,77,414799
255,0.009177,172.31.40.0-255,66,399094,77,414799
256,0.011497,74.125.24.0-255,5738,404832,77,414799
257,0.011505,172.31.40.0-255,66,404898,77,414799
258,0.013789,74.125.24.0-255,5738,410636,77,414799
259,0.013801,172.31.40.0-255,66,410702,77,414799
260,0.016108,74.125.24.0-255,3860,414562,77,414799
261,0.01612,172.31.40.0-255,66,414628,77,414799
262,0.016369,172.31.40.0-255,105,414733,77,414799
263,0.018614,74.125.24.0-255,66,414799,77,414799
264,0.0,172.217.26.0-255,153,153,77,202041
265,2.4e-05,172.31.40.0-255,66,219,77,202041
266,3.1e-05,172.217.26.0-255,1484,1703,77,202041
267,3.5e-05,172.31.40.0-255,66,1769,77,202041
268,4.8e-05,172.217.26.0-255,2902,4671,77,202041
269,5.2e-05,172.31.40.0-255,66,4737,77,202041
270,6e-05,172.217.26.0-255,7156,11893,77,202041
271,6.3e-05,172.31.40.0-255,66,11959,77,202041
272,6.7e-05,172.217.26.0-255,2031,13990,77,202041
273,7.1e-05,172.31.40.0-255,66,14056,77,202041
274,0.000179,172.217.26.0-255,1484,15540,77,202041
275,0.000184,172.31.40.0-255,66,15606,77,202041
276,0.000189,172.217.26.0-255,2902,18508,77,202041
277,0.000192,172.31.40.0-255,66,18574,77,202041
278,0.000198,172.217.26.0-255,4320,22894,77,202041
279,0.000205,172.31.40.0-255,66,22960,77,202041
280,0.000211,172.217.26.0-255,5738,28698,77,202041
281,0.000214,172.31.40.0-255,66,28764,77,202041
282,0.000253,172.217.26.0-255,2543,31307,77,202041
283,0.000256,172.31.40.0-255,66,31373,77,202041
284,0.000559,172.217.26.0-255,1484,32857,77,202041
285,0.000564,172.31.40.0-255,66,32923,77,202041
286,0.00057,172.217.26.0-255,2902,35825,77,202041
287,0.000573,172.31.40.0-255,66,35891,77,202041
288,0.000576,172.217.26.0-255,1484,37375,77,202041
289,0.000578,172.31.40.0-255,66,37441,77,202041
290,0.000619,172.217.26.0-255,4320,41761,77,202041
291,0.000623,172.31.40.0-255,66,41827,77,202041
292,0.00063,172.217.26.0-255,6797,48624,77,202041
293,0.000632,172.31.40.0-255,66,48690,77,202041
294,0.00072,172.217.26.0-255,1484,50174,77,202041
295,0.000724,172.31.40.0-255,66,50240,77,202041
296,0.000729,172.217.26.0-255,2902,53142,77,202041
297,0.000731,172.31.40.0-255,66,53208,77,202041
298,0.000734,172.217.26.0-255,1484,54692,77,202041
299,0.000774,172.217.26.0-255,4320,59012,77,202041
300,0.000777,172.31.40.0-255,66,59078,77,202041
301,0.000784,172.217.26.0-255,5738,64816,77,202041
302,0.000786,172.31.40.0-255,66,64882,77,202041
303,0.000809,172.217.26.0-255,1459,66341,77,202041
304,0.001126,172.31.40.0-255,66,66407,77,202041
305,0.001418,172.217.26.0-255,346,66753,77,202041
306,0.001596,172.217.26.0-255,1484,68237,77,202041
307,0.001603,172.31.40.0-255,66,68303,77,202041
308,0.001611,172.217.26.0-255,2902,71205,77,202041
309,0.001613,172.31.40.0-255,66,71271,77,202041
310,0.001625,172.217.26.0-255,5738,77009,77,202041
311,0.001627,172.31.40.0-255,66,77075,77,202041
312,0.001637,172.217.26.0-255,6797,83872,77,202041
313,0.001639,172.31.40.0-255,66,83938,77,202041
314,0.001678,172.31.40.0-255,66,84004,77,202041
315,0.001683,172.217.26.0-255,2543,86547,77,202041
316,0.001685,172.31.40.0-255,66,86613,77,202041
317,0.001817,172.217.26.0-255,1484,88097,77,202041
318,0.001825,172.217.26.0-255,2902,90999,77,202041
319,0.001828,172.31.40.0-255,66,91065,77,202041
320,0.001836,172.217.26.0-255,5738,96803,77,202041
321,0.001838,172.31.40.0-255,66,96869,77,202041
322,0.001859,172.217.26.0-255,2902,99771,77,202041
323,0.001861,172.31.40.0-255,66,99837,77,202041
324,0.001892,172.217.26.0-255,9992,109829,77,202041
325,0.001895,172.31.40.0-255,66,109895,77,202041
326,0.001905,172.217.26.0-255,9992,119887,77,202041
327,0.001908,172.31.40.0-255,66,119953,77,202041
328,0.001937,172.217.26.0-255,766,120719,77,202041
329,0.001941,172.217.26.0-255,1484,122203,77,202041
330,0.001943,172.31.40.0-255,66,122269,77,202041
331,0.001949,172.217.26.0-255,4320,126589,77,202041
332,0.001951,172.31.40.0-255,66,126655,77,202041
333,0.001977,172.217.26.0-255,9992,136647,77,202041
334,0.001979,172.31.40.0-255,66,136713,77,202041
335,0.001986,172.217.26.0-255,7156,143869,77,202041
336,0.001989,172.31.40.0-255,66,143935,77,202041
337,0.002011,172.217.26.0-255,7156,151091,77,202041
338,0.002014,172.31.40.0-255,66,151157,77,202041
339,0.003979,172.217.26.0-255,4320,155477,77,202041
340,0.003982,172.31.40.0-255,66,155543,77,202041
341,0.004032,172.217.26.0-255,1484,157027,77,202041
342,0.005945,172.217.26.0-255,4320,161347,77,202041
343,0.005949,172.31.40.0-255,66,161413,77,202041
344,0.007923,172.217.26.0-255,5738,167151,77,202041
345,0.007931,172.31.40.0-255,66,167217,77,202041
346,0.009903,172.217.26.0-255,5738,172955,77,202041
347,0.009911,172.31.40.0-255,66,173021,77,202041
348,0.011878,172.217.26.0-255,5738,178759,77,202041
349,0.011884,172.31.40.0-255,66,178825,77,202041
350,0.013874,172.217.26.0-255,5738,184563,77,202041
351,0.013882,172.31.40.0-255,66,184629,77,202041
352,0.015868,172.217.26.0-255,5738,190367,77,202041
353,0.015876,172.31.40.0-255,66,190433,77,202041
354,0.017853,172.217.26.0-255,5738,196171,77,202041
355,0.017861,172.31.40.0-255,66,196237,77,202041
356,0.019846,172.217.26.0-255,5738,201975,77,202041
357,0.019854,172.31.40.0-255,66,202041,77,202041
358,0.0,74.125.24.0-255,153,153,77,175826
359,1.9e-05,172.31.40.0-255,66,219,77,175826
360,2.6e-05,74.125.24.0-255,1484,1703,77,175826
361,3e-05,172.31.40.0-255,66,1769,77,175826
362,3.6e-05,74.125.24.0-255,2902,4671,77,175826
363,3.9e-05,172.31.40.0-255,66,4737,77,175826
364,4.4e-05,74.125.24.0-255,4320,9057,77,175826
365,4.7e-05,172.31.40.0-255,66,9123,77,175826
366,9.8e-05,74.125.24.0-255,4935,14058,77,175826
367,0.000101,172.31.40.0-255,66,14124,77,175826
368,0.000115,74.125.24.0-255,2902,17026,77,175826
369,0.000117,172.31.40.0-255,66,17092,77,175826
370,0.000134,74.125.24.0-255,2902,19994,77,175826
371,0.000136,172.31.40.0-255,66,20060,77,175826
372,0.000147,74.125.24.0-255,9992,30052,77,175826
373,0.000149,172.31.40.0-255,66,30118,77,175826
374,0.000174,74.125.24.0-255,1125,31243,77,175826
375,0.000176,172.31.40.0-255,66,31309,77,175826
376,0.000245,74.125.24.0-255,1484,32793,77,175826
377,0.000249,172.31.40.0-255,66,32859,77,175826
378,0.000254,74.125.24.0-255,2902,35761,77,175826
379,0.000256,172.31.40.0-255,66,35827,77,175826
380,0.000286,74.125.24.0-255,5738,41565,77,175826
381,0.000289,172.31.40.0-255,66,41631,77,175826
382,0.000293,74.125.24.0-255,4320,45951,77,175826
383,0.000296,172.31.40.0-255,66,46017,77,175826
384,0.00033,74.125.24.0-255,2543,48560,77,175826
385,0.000334,172.31.40.0-255,66,48626,77,175826
386,0.000434,74.125.24.0-255,1484,50110,77,175826
387,0.000438,172.31.40.0-255,66,50176,77,175826
388,0.000443,74.125.24.0-255,2902,53078,77,175826
389,0.000446,172.31.40.0-255,66,53144,77,175826
390,0.000472,74.125.24.0-255,5738,58882,77,175826
391,0.000476,172.31.40.0-255,66,58948,77,175826
392,0.00048,74.125.24.0-255,2902,61850,77,175826
393,0.000482,172.31.40.0-255,66,61916,77,175826
394,0.000498,74.125.24.0-255,3961,65877,77,175826
395,0.000501,172.31.40.0-255,66,65943,77,175826
396,0.000651,74.125.24.0-255,647,66590,77,175826
397,0.001045,172.31.40.0-255,66,66656,77,175826
398,0.001162,74.125.24.0-255,1484,68140,77,175826
399,0.001171,74.125.24.0-255,2902,71042,77,175826
400,0.001175,172.31.40.0-255,66,71108,77,175826
401,0.001183,74.125.24.0-255,5738,76846,77,175826
402,0.001185,172.31.40.0-255,66,76912,77,175826
403,0.001189,74.125.24.0-255,1484,78396,77,175826
404,0.001205,74.125.24.0-255,2902,81298,77,175826
405,0.001207,172.31.40.0-255,66,81364,77,175826
406,0.00124,74.125.24.0-255,2543,83907,77,175826
407,0.001243,172.31.40.0-255,66,83973,77,175826
408,0.001345,74.125.24.0-255,1484,85457,77,175826
409,0.00135,74.125.24.0-255,1484,86941,77,175826
410,0.001354,172.31.40.0-255,66,87007,77,175826
411,0.001377,74.125.24.0-255,1484,88491,77,175826
412,0.001383,74.125.24.0-255,5738,94229,77,175826
413,0.001386,172.31.40.0-255,66,94295,77,175826
414,0.001393,74.125.24.0-255,6797,101092,77,175826
415,0.001395,172.31.40.0-255,66,101158,77,175826
416,0.002032,74.125.24.0-255,1484,102642,77,175826
417,0.00204,74.125.24.0-255,2902,105544,77,175826
418,0.002045,172.31.40.0-255,66,105610,77,175826
419,0.002052,74.125.24.0-255,5738,111348,77,175826
420,0.002054,172.31.40.0-255,66,111414,77,175826
421,0.002075,74.125.24.0-255,9992,121406,77,175826
422,0.002077,172.31.40.0-255,66,121472,77,175826
423,0.002104,74.125.24.0-255,5738,127210,77,175826
424,0.002107,172.31.40.0-255,66,127276,77,175826
425,0.00213,74.125.24.0-255,7856,135132,77,175826
426,0.002133,172.31.40.0-255,66,135198,77,175826
427,0.004384,74.125.24.0-255,5738,140936,77,175826
428,0.00439,172.31.40.0-255,66,141002,77,175826
429,0.006646,74.125.24.0-255,5738,146740,77,175826
430,0.006651,172.31.40.0-255,66,146806,77,175826
431,0.008962,74.125.24.0-255,5738,152544,77,175826
432,0.00897,172.31.40.0-255,66,152610,77,175826
433,0.011259,74.125.24.0-255,5738,158348,77,175826
434,0.011269,172.31.40.0-255,66,158414,77,175826
435,0.013572,74.125.24.0-255,5738,164152,77,175826
436,0.013582,172.31.40.0-255,66,164218,77,175826
437,0.01588,74.125.24.0-255,5738,169956,77,175826
438,0.015892,172.31.40.0-255,66,170022,77,175826
439,0.018212,74.125.24.0-255,5738,175760,77,175826
440,0.018226,172.31.40.0-255,66,175826,77,175826
441,0.0,74.125.200.0-255,150,150,77,399016
442,2.2e-05,172.31.40.0-255,66,216,77,399016
443,2.9e-05,74.125.200.0-255,1484,1700,77,399016
444,3.3e-05,172.31.40.0-255,66,1766,77,399016
445,3.9e-05,74.125.200.0-255,2902,4668,77,399016
446,4.3e-05,172.31.40.0-255,66,4734,77,399016
447,4.9e-05,74.125.200.0-255,4320,9054,77,399016
448,5.2e-05,172.31.40.0-255,66,9120,77,399016
449,7.3e-05,74.125.200.0-255,1484,10604,77,399016
450,7.5e-05,172.31.40.0-255,66,10670,77,399016
451,9.7e-05,74.125.200.0-255,3402,14072,77,399016
452,9.9e-05,172.31.40.0-255,66,14138,77,399016
453,0.000129,74.125.200.0-255,1484,15622,77,399016
454,0.000131,172.31.40.0-255,66,15688,77,399016
455,0.000135,74.125.200.0-255,1484,17172,77,399016
456,0.000137,172.31.40.0-255,66,17238,77,399016
457,0.000152,74.125.200.0-255,1484,18722,77,399016
458,0.000154,172.31.40.0-255,66,18788,77,399016
459,0.000161,74.125.200.0-255,5738,24526,77,399016
460,0.000163,172.31.40.0-255,66,24592,77,399016
461,0.000192,74.125.200.0-255,5738,30330,77,399016
462,0.000195,172.31.40.0-255,66,30396,77,399016
463,0.00021,74.125.200.0-255,1125,31521,77,399016
464,0.000212,172.31.40.0-255,66,31587,77,399016
465,0.00026,74.125.200.0-255,1484,33071,77,399016
466,0.000263,172.31.40.0-255,66,33137,77,399016
467,0.000286,74.125.200.0-255,1484,34621,77,399016
468,0.000289,172.31.40.0-255,66,34687,77,399016
469,0.000294,74.125.200.0-255,2902,37589,77,399016
470,0.000296,172.31.40.0-255,66,37655,77,399016
471,0.000302,74.125.200.0-255,4320,41975,77,399016
472,0.000304,172.31.40.0-255,66,42041,77,399016
473,0.00033,74.125.200.0-255,1484,43525,77,399016
474,0.000338,74.125.200.0-255,5379,48904,77,399016
475,0.00034,172.31.40.0-255,66,48970,77,399016
476,0.000345,74.125.200.0-255,2902,51872,77,399016
477,0.000346,172.31.40.0-255,66,51938,77,399016
478,0.000363,74.125.200.0-255,2902,54840,77,399016
479,0.000365,172.31.40.0-255,66,54906,77,399016
480,0.000388,74.125.200.0-255,2902,57808,77,399016
481,0.00039,172.31.40.0-255,66,57874,77,399016
482,0.00041,74.125.200.0-255,5738,63612,77,399016
483,0.000412,172.31.40.0-255,66,63678,77,399016
484,0.000427,74.125.200.0-255,2543,66221,77,399016
485,0.00043,172.31.40.0-255,66,66287,77,399016
486,0.000505,74.125.200.0-255,645,66932,77,399016
487,0.000641,74.125.200.0-255,1484,68416,77,399016
488,0.000645,172.31.40.0-255,66,68482,77,399016
489,0.000652,74.125.200.0-255,2902,71384,77,399016
490,0.000655,172.31.40.0-255,66,71450,77,399016
491,0.000658,74.125.200.0-255,1484,72934,77,399016
492,0.000696,74.125.200.0-255,2902,75836,77,399016
493,0.000699,172.31.40.0-255,66,75902,77,399016
494,0.000712,74.125.200.0-255,2902,78804,77,399016
495,0.000714,172.31.40.0-255,66,78870,77,399016
496,0.000719,74.125.200.0-255,4320,83190,77,399016
497,0.000721,172.31.40.0-255,66,83256,77,399016
498,0.000753,74.125.200.0-255,8574,91830,77,399016
499,0.000755,172.31.40.0-255,66,91896,77,399016
500,0.000758,74.125.200.0-255,1484,93380,77,399016
501,0.000793,74.125.200.0-255,1484,94864,77,399016
502,0.000795,172.31.40.0-255,66,94930,77,399016
503,0.000814,74.125.200.0-255,1484,96414,77,399016
504,0.000818,74.125.200.0-255,2902,99316,77,399016
505,0.00082,172.31.40.0-255,66,99382,77,399016
506,0.000862,74.125.200.0-255,2184,101566,77,399016
507,0.000865,172.31.40.0-255,66,101632,77,399016
508,0.000896,74.125.200.0-255,2902,104534,77,399016
509,0.000898,172.31.40.0-255,66,104600,77,399016
510,0.000913,74.125.200.0-255,2902,107502,77,399016
511,0.000915,172.31.40.0-255,66,107568,77,399016
512,0.00092,74.125.200.0-255,4320,111888,77,399016
513,0.000922,172.31.40.0-255,66,111954,77,399016
514,0.000943,74.125.200.0-255,1484,113438,77,399016
515,0.000967,74.125.200.0-255,7156,120594,77,399016
516,0.00097,172.31.40.0-255,66,120660,77,399016
517,0.000976,74.125.200.0-255,5738,126398,77,399016
518,0.000978,172.31.40.0-255,66,126464,77,399016
519,0.00098,74.125.200.0-255,1484,127948,77,399016
520,0.001,74.125.200.0-255,5738,133686,77,399016
521,0.001002,172.31.40.0-255,66,133752,77,399016
522,0.001006,74.125.200.0-255,2184,135936,77,399016
523,0.001007,172.31.40.0-255,66,136002,77,399016
524,0.001045,74.125.200.0-255,1484,137486,77,399016
525,0.00106,74.125.200.0-255,1484,138970,77,399016
526,0.001063,172.31.40.0-255,66,139036,77,399016
527,0.001091,74.125.200.0-255,2902,141938,77,399016
528,0.001094,172.31.40.0-255,66,142004,77,399016
529,0.001124,74.125.200.0-255,4320,146324,77,399016
530,0.001127,172.31.40.0-255,66,146390,77,399016
531,0.001131,74.125.200.0-255,2902,149292,77,399016
532,0.001133,172.31.40.0-255,66,149358,77,399016
533,0.001138,74.125.200.0-255,4320,153678,77,399016
534,0.00114,172.31.40.0-255,66,153744,77,399016
535,0.001173,74.125.200.0-255,8574,162318,77,399016
536,0.001176,172.31.40.0-255,66,162384,77,399016
537,0.001182,74.125.200.0-255,5738,168122,77,399016
538,0.001184,172.31.40.0-255,66,168188,77,399016
539,0.001219,74.125.200.0-255,2184,170372,77,399016
540,0.001221,172.31.40.0-255,66,170438,77,399016
541,0.001243,74.125.200.0-255,2902,173340,77,399016
542,0.001246,172.31.40.0-255,66,173406,77,399016
543,0.001249,74.125.200.0-255,1484,174890,77,399016
544,0.001276,74.125.200.0-255,5738,180628,77,399016
545,0.001279,172.31.40.0-255,66,180694,77,399016
546,0.001284,74.125.200.0-255,4320,185014,77,399016
547,0.001285,172.31.40.0-255,66,185080,77,399016
548,0.001291,74.125.200.0-255,5738,190818,77,399016
549,0.001292,172.31.40.0-255,66,190884,77,399016
550,0.001346,74.125.200.0-255,11410,202294,77,399016
551,0.001349,172.31.40.0-255,66,202360,77,399016
552,0.001365,74.125.200.0-255,2184,204544,77,399016
553,0.001367,172.31.40.0-255,66,204610,77,399016
554,0.001426,74.125.200.0-255,1484,206094,77,399016
555,0.001451,74.125.200.0-255,2902,208996,77,399016
556,0.001454,172.31.40.0-255,66,209062,77,399016
557,0.001469,74.125.200.0-255,2902,211964,77,399016
558,0.001471,172.31.40.0-255,66,212030,77,399016
559,0.001483,74.125.200.0-255,2902,214932,77,399016
560,0.001486,172.31.40.0-255,66,214998,77,399016
561,0.001501,74.125.200.0-255,1484,216482,77,399016
562,0.001505,74.125.200.0-255,2902,219384,77,399016
563,0.001508,172.31.40.0-255,66,219450,77,399016
564,0.001512,74.125.200.0-255,2902,222352,77,399016
565,0.001514,172.31.40.0-255,66,222418,77,399016
566,0.001535,74.125.200.0-255,2902,225320,77,399016
567,0.001537,172.31.40.0-255,66,225386,77,399016
568,0.001543,74.125.200.0-255,5738,231124,77,399016
569,0.001545,172.31.40.0-255,66,231190,77,399016
570,0.001551,74.125.200.0-255,7156,238346,77,399016
571,0.001553,172.31.40.0-255,66,238412,77,399016
572,0.001567,74.125.200.0-255,766,239178,77,399016
573,0.001969,74.125.200.0-255,1484,240662,77,399016
574,0.001973,172.31.40.0-255,66,240728,77,399016
575,0.001979,74.125.200.0-255,2902,243630,77,399016
576,0.001981,172.31.40.0-255,66,243696,77,399016
577,0.002029,74.125.200.0-255,5738,249434,77,399016
578,0.002032,172.31.40.0-255,66,249500,77,399016
579,0.00204,74.125.200.0-255,1484,250984,77,399016
580,0.002055,74.125.200.0-255,2902,253886,77,399016
581,0.002057,172.31.40.0-255,66,253952,77,399016
582,0.002092,74.125.200.0-255,5738,259690,77,399016
583,0.002094,172.31.40.0-255,66,259756,77,399016
584,0.002101,74.125.200.0-255,7156,266912,77,399016
585,0.002103,172.31.40.0-255,66,266978,77,399016
586,0.002143,74.125.200.0-255,5738,272716,77,399016
587,0.002146,172.31.40.0-255,66,272782,77,399016
588,0.002157,74.125.200.0-255,766,273548,77,399016
589,0.002171,74.125.200.0-255,4320,277868,77,399016
590,0.002174,172.31.40.0-255,66,277934,77,399016
591,0.002187,74.125.200.0-255,2902,280836,77,399016
592,0.002189,172.31.40.0-255,66,280902,77,399016
593,0.002192,74.125.200.0-255,1484,282386,77,399016
594,0.002197,74.125.200.0-255,2902,285288,77,399016
595,0.002198,172.31.40.0-255,66,285354,77,399016
596,0.002203,74.125.200.0-255,2902,288256,77,399016
597,0.002205,172.31.40.0-255,66,288322,77,399016
598,0.002226,74.125.200.0-255,2902,291224,77,399016
599,0.002229,172.31.40.0-255,66,291290,77,399016
600,0.002243,74.125.200.0-255,4320,295610,77,399016
601,0.002246,172.31.40.0-255,66,295676,77,399016
602,0.002265,74.125.200.0-255,8574,304250,77,399016
603,0.002268,172.31.40.0-255,66,304316,77,399016
604,0.002317,74.125.200.0-255,13528,317844,77,399016
605,0.002321,172.31.40.0-255,66,317910,77,399016
606,0.002327,74.125.200.0-255,5738,323648,77,399016
607,0.002329,172.31.40.0-255,66,323714,77,399016
608,0.002364,74.125.200.0-255,4320,328034,77,399016
609,0.002366,172.31.40.0-255,66,328100,77,399016
610,0.002396,74.125.200.0-255,9992,338092,77,399016
611,0.0024,172.31.40.0-255,66,338158,77,399016
612,0.002404,74.125.200.0-255,3602,341760,77,399016
613,0.002406,172.31.40.0-255,66,341826,77,399016
614,0.002409,74.125.200.0-255,1484,343310,77,399016
615,0.002427,74.125.200.0-255,2902,346212,77,399016
616,0.00243,172.31.40.0-255,66,346278,77,399016
617,0.002447,74.125.200.0-255,2902,349180,77,399016
618,0.00245,172.31.40.0-255,66,349246,77,399016
619,0.002472,74.125.200.0-255,5738,354984,77,399016
620,0.002503,74.125.200.0-255,9992,364976,77,399016
621,0.002509,74.125.200.0-255,7156,372132,77,399016
622,0.002547,74.125.200.0-255,3602,375734,77,399016
623,0.008012,172.31.40.0-255,66,375800,77,399016
624,0.010557,74.125.200.0-255,5738,381538,77,399016
625,0.010566,172.31.40.0-255,66,381604,77,399016
626,0.013106,74.125.200.0-255,5738,387342,77,399016
627,0.013113,172.31.40.0-255,66,387408,77,399016
628,0.015653,74.125.200.0-255,5738,393146,77,399016
629,0.015661,172.31.40.0-255,66,393212,77,399016
630,0.018196,74.125.200.0-255,5738,398950,77,399016
631,0.018207,172.31.40.0-255,66,399016,77,399016
632,0.0,172.217.194.0-255,152,152,77,331009
633,1.2e-05,172.31.40.0-255,66,218,77,331009
634,3.4e-05,172.217.194.0-255,1484,1702,77,331009
635,3.9e-05,172.31.40.0-255,66,1768,77,331009
636,4.4e-05,172.217.194.0-255,2902,4670,77,331009
637,4.7e-05,172.31.40.0-255,66,4736,77,331009
638,5.2e-05,172.217.194.0-255,2902,7638,77,331009
639,5.5e-05,172.31.40.0-255,66,7704,77,331009
640,8.9e-05,172.217.194.0-255,4320,12024,77,331009
641,9.1e-05,172.31.40.0-255,66,12090,77,331009
642,9.6e-05,172.217.194.0-255,2028,14118,77,331009
643,9.8e-05,172.31.40.0-255,66,14184,77,331009
644,0.000512,172.217.194.0-255,1484,15668,77,331009
645,0.000519,172.31.40.0-255,66,15734,77,331009
646,0.000527,172.217.194.0-255,2902,18636,77,331009
647,0.000529,172.31.40.0-255,66,18702,77,331009
648,0.00054,172.217.194.0-255,2902,21604,77,331009
649,0.000542,172.31.40.0-255,66,21670,77,331009
650,0.000551,172.217.194.0-255,7156,28826,77,331009
651,0.000552,172.31.40.0-255,66,28892,77,331009
652,0.000583,172.217.194.0-255,9992,38884,77,331009
653,0.000586,172.31.40.0-255,66,38950,77,331009
654,0.000623,172.217.194.0-255,6797,45747,77,331009
655,0.000626,172.31.40.0-255,66,45813,77,331009
656,0.000641,172.31.40.0-255,66,45879,77,331009
657,0.00066,172.217.194.0-255,5020,50899,77,331009
658,0.000663,172.31.40.0-255,66,50965,77,331009
659,0.000665,172.217.194.0-255,340,51305,77,331009
660,0.000668,172.31.40.0-255,66,51371,77,331009
661,0.000985,172.217.194.0-255,120,51491,77,331009
662,0.000992,172.31.40.0-255,66,51557,77,331009
663,0.001142,172.217.194.0-255,1484,53041,77,331009
664,0.001151,172.217.194.0-255,2902,55943,77,331009
665,0.001155,172.31.40.0-255,66,56009,77,331009
666,0.001162,172.217.194.0-255,5738,61747,77,331009
667,0.001166,172.31.40.0-255,66,61813,77,331009
668,0.001197,172.217.194.0-255,12828,74641,77,331009
669,0.0012,172.31.40.0-255,66,74707,77,331009
670,0.001203,172.217.194.0-255,1484,76191,77,331009
671,0.00125,172.217.194.0-255,9274,85465,77,331009
672,0.001253,172.31.40.0-255,66,85531,77,331009
673,0.002274,172.217.194.0-255,1484,87015,77,331009
674,0.002281,172.217.194.0-255,2902,89917,77,331009
675,0.002284,172.31.40.0-255,66,89983,77,331009
676,0.002288,172.217.194.0-255,1484,91467,77,331009
677,0.002315,172.217.194.0-255,4320,95787,77,331009
678,0.002318,172.31.40.0-255,66,95853,77,331009
679,0.002324,172.217.194.0-255,7156,103009,77,331009
680,0.002326,172.31.40.0-255,66,103075,77,331009
681,0.002333,172.217.194.0-255,7156,110231,77,331009
682,0.002339,172.31.40.0-255,66,110297,77,331009
683,0.00236,172.217.194.0-255,1484,111781,77,331009
684,0.002362,172.217.194.0-255,1484,113265,77,331009
685,0.002364,172.31.40.0-255,66,113331,77,331009
686,0.002391,172.217.194.0-255,6438,119769,77,331009
687,0.002397,172.31.40.0-255,66,119835,77,331009
688,0.002773,172.217.194.0-255,1484,121319,77,331009
689,0.002784,172.217.194.0-255,1484,122803,77,331009
690,0.002786,172.31.40.0-255,66,122869,77,331009
691,0.002807,172.217.194.0-255,1484,124353,77,331009
692,0.002813,172.217.194.0-255,5738,130091,77,331009
693,0.002815,172.31.40.0-255,66,130157,77,331009
694,0.00282,172.217.194.0-255,5738,135895,77,331009
695,0.002823,172.31.40.0-255,66,135961,77,331009
696,0.002854,172.217.194.0-255,7156,143117,77,331009
697,0.002856,172.31.40.0-255,66,143183,77,331009
698,0.002864,172.217.194.0-255,9992,153175,77,331009
699,0.002866,172.31.40.0-255,66,153241,77,331009
700,0.002891,172.217.194.0-255,5020,158261,77,331009
701,0.002893,172.31.40.0-255,66,158327,77,331009
702,0.002898,172.217.194.0-255,4320,162647,77,331009
703,0.0029,172.31.40.0-255,66,162713,77,331009
704,0.002914,172.217.194.0-255,1484,164197,77,331009
705,0.002923,172.217.194.0-255,11410,175607,77,331009
706,0.002925,172.31.40.0-255,66,175673,77,331009
707,0.002937,172.217.194.0-255,1484,177157,77,331009
708,0.002942,172.217.194.0-255,4320,181477,77,331009
709,0.002944,172.31.40.0-255,66,181543,77,331009
710,0.002972,172.217.194.0-255,6438,187981,77,331009
711,0.002974,172.31.40.0-255,66,188047,77,331009
712,0.00301,172.217.194.0-255,8574,196621,77,331009
713,0.003012,172.31.40.0-255,66,196687,77,331009
714,0.003021,172.217.194.0-255,9992,206679,77,331009
715,0.003022,172.31.40.0-255,66,206745,77,331009
716,0.003044,172.217.194.0-255,9992,216737,77,331009
717,0.003046,172.31.40.0-255,66,216803,77,331009
718,0.003075,172.217.194.0-255,5020,221823,77,331009
719,0.003077,172.31.40.0-255,66,221889,77,331009
720,0.00308,172.217.194.0-255,1484,223373,77,331009
721,0.003103,172.217.194.0-255,2902,226275,77,331009
722,0.003105,172.31.40.0-255,66,226341,77,331009
723,0.003111,172.217.194.0-255,5738,232079,77,331009
724,0.003113,172.31.40.0-255,66,232145,77,331009
725,0.003117,172.217.194.0-255,2902,235047,77,331009
726,0.003119,172.31.40.0-255,66,235113,77,331009
727,0.003152,172.217.194.0-255,8574,243687,77,331009
728,0.003155,172.31.40.0-255,66,243753,77,331009
729,0.003157,172.217.194.0-255,1484,245237,77,331009
730,0.00316,172.217.194.0-255,1484,246721,77,331009
731,0.003161,172.31.40.0-255,66,246787,77,331009
732,0.003181,172.217.194.0-255,5738,252525,77,331009
733,0.003183,172.31.40.0-255,66,252591,77,331009
734,0.003213,172.217.194.0-255,3602,256193,77,331009
735,0.003215,172.31.40.0-255,66,256259,77,331009
736,0.003238,172.217.194.0-255,1484,257743,77,331009
737,0.003275,172.217.194.0-255,1484,259227,77,331009
738,0.003277,172.31.40.0-255,66,259293,77,331009
739,0.003303,172.217.194.0-255,1484,260777,77,331009
740,0.003309,172.217.194.0-255,5738,266515,77,331009
741,0.003311,172.31.40.0-255,66,266581,77,331009
742,0.003315,172.217.194.0-255,2902,269483,77,331009
743,0.003317,172.31.40.0-255,66,269549,77,331009
744,0.003321,172.217.194.0-255,4320,273869,77,331009
745,0.003324,172.31.40.0-255,66,273935,77,331009
746,0.003334,172.217.194.0-255,8574,282509,77,331009
747,0.003336,172.31.40.0-255,66,282575,77,331009
748,0.00334,172.217.194.0-255,2902,285477,77,331009
749,0.003342,172.31.40.0-255,66,285543,77,331009
750,0.003367,172.217.194.0-255,5020,290563,77,331009
751,0.003369,172.31.40.0-255,66,290629,77,331009
752,0.003402,172.217.194.0-255,1484,292113,77,331009
753,0.003407,172.217.194.0-255,2902,295015,77,331009
754,0.003409,172.31.40.0-255,66,295081,77,331009
755,0.003416,172.217.194.0-255,5738,300819,77,331009
756,0.003418,172.31.40.0-255,66,300885,77,331009
757,0.003456,172.217.194.0-255,12828,313713,77,331009
758,0.00346,172.31.40.0-255,66,313779,77,331009
759,0.003463,172.217.194.0-255,1484,315263,77,331009
760,0.003497,172.217.194.0-255,5738,321001,77,331009
761,0.0035,172.31.40.0-255,66,321067,77,331009
762,0.003546,172.31.40.0-255,66,321133,77,331009
763,0.00357,172.31.40.0-255,66,321199,77,331009
764,0.003602,172.217.194.0-255,2184,323383,77,331009
765,0.003605,172.31.40.0-255,66,323449,77,331009
766,0.003621,172.31.40.0-255,66,323515,77,331009
767,0.003644,172.31.40.0-255,66,323581,77,331009
768,0.003648,172.217.194.0-255,2902,326483,77,331009
769,0.003651,172.31.40.0-255,66,326549,77,331009
770,0.003656,172.217.194.0-255,4052,330601,77,331009
771,0.003658,172.31.40.0-255,66,330667,77,331009
772,0.003681,172.217.194.0-255,105,330772,77,331009
773,0.007094,172.31.40.0-255,66,330838,77,331009
774,0.007131,172.31.40.0-255,105,330943,77,331009
775,0.009714,172.217.194.0-255,66,331009,77,331009
776,0.0,172.217.194.0-255,153,153,77,312021
777,2e-05,172.31.40.0-255,66,219,77,312021
778,2.7e-05,172.217.194.0-255,1484,1703,77,312021
779,3.2e-05,172.31.40.0-255,66,1769,77,312021
780,3.8e-05,172.217.194.0-255,2902,4671,77,312021
781,4.2e-05,172.31.40.0-255,66,4737,77,312021
782,4.9e-05,172.217.194.0-255,7156,11893,77,312021
783,5.2e-05,172.31.40.0-255,66,11959,77,312021
784,5.6e-05,172.217.194.0-255,2065,14024,77,312021
785,5.9e-05,172.31.40.0-255,66,14090,77,312021
786,0.000183,172.217.194.0-255,1484,15574,77,312021
787,0.000187,172.31.40.0-255,66,15640,77,312021
788,0.000227,172.217.194.0-255,2902,18542,77,312021
789,0.000231,172.31.40.0-255,66,18608,77,312021
790,0.000245,172.217.194.0-255,5738,24346,77,312021
791,0.000249,172.31.40.0-255,66,24412,77,312021
792,0.000268,172.217.194.0-255,2902,27314,77,312021
793,0.000271,172.31.40.0-255,66,27380,77,312021
794,0.000285,172.217.194.0-255,3961,31341,77,312021
795,0.000288,172.31.40.0-255,66,31407,77,312021
796,0.000308,172.217.194.0-255,2902,34309,77,312021
797,0.00031,172.31.40.0-255,66,34375,77,312021
798,0.00033,172.217.194.0-255,4320,38695,77,312021
799,0.000332,172.31.40.0-255,66,38761,77,312021
800,0.000339,172.217.194.0-255,5738,44499,77,312021
801,0.000341,172.31.40.0-255,66,44565,77,312021
802,0.000361,172.217.194.0-255,2902,47467,77,312021
803,0.000363,172.31.40.0-255,66,47533,77,312021
804,0.000375,172.217.194.0-255,12828,60361,77,312021
805,0.000377,172.31.40.0-255,66,60427,77,312021
806,0.000413,172.217.194.0-255,5320,65747,77,312021
807,0.000415,172.31.40.0-255,66,65813,77,312021
808,0.000427,172.217.194.0-255,377,66190,77,312021
809,0.000564,172.217.194.0-255,1484,67674,77,312021
810,0.00057,172.217.194.0-255,2902,70576,77,312021
811,0.000576,172.31.40.0-255,66,70642,77,312021
812,0.000596,172.217.194.0-255,5738,76380,77,312021
813,0.0006,172.217.194.0-255,1484,77864,77,312021
814,0.000618,172.217.194.0-255,7156,85020,77,312021
815,0.000622,172.217.194.0-255,2902,87922,77,312021
816,0.000625,172.31.40.0-255,66,87988,77,312021
817,0.00063,172.31.40.0-255,66,88054,77,312021
818,0.000648,172.217.194.0-255,7156,95210,77,312021
819,0.000653,172.217.194.0-255,2902,98112,77,312021
820,0.000663,172.31.40.0-255,66,98178,77,312021
821,0.000666,172.217.194.0-255,2184,100362,77,312021
822,0.000671,172.31.40.0-255,66,100428,77,312021
823,0.000981,172.217.194.0-255,1484,101912,77,312021
824,0.000993,172.217.194.0-255,2902,104814,77,312021
825,0.000996,172.31.40.0-255,66,104880,77,312021
826,0.001018,172.217.194.0-255,4320,109200,77,312021
827,0.001026,172.31.40.0-255,66,109266,77,312021
828,0.001048,172.217.194.0-255,8574,117840,77,312021
829,0.001067,172.31.40.0-255,66,117906,77,312021
830,0.001087,172.31.40.0-255,66,117972,77,312021
831,0.001704,172.217.194.0-255,1484,119456,77,312021
832,0.001714,172.217.194.0-255,2902,122358,77,312021
833,0.001719,172.31.40.0-255,66,122424,77,312021
834,0.001726,172.217.194.0-255,5738,128162,77,312021
835,0.001739,172.217.194.0-255,1484,129646,77,312021
836,0.001771,172.217.194.0-255,11410,141056,77,312021
837,0.001795,172.217.194.0-255,10692,151748,77,312021
838,0.00198,172.217.194.0-255,1484,153232,77,312021
839,0.001988,172.217.194.0-255,2902,156134,77,312021
840,0.002005,172.217.194.0-255,5738,161872,77,312021
841,0.002038,172.217.194.0-255,4320,166192,77,312021
842,0.002054,172.217.194.0-255,5738,171930,77,312021
843,0.002061,172.217.194.0-255,5738,177668,77,312021
844,0.002079,172.217.194.0-255,5738,183406,77,312021
845,0.002086,172.217.194.0-255,6438,189844,77,312021
846,0.002138,172.217.194.0-255,9992,199836,77,312021
847,0.002156,172.217.194.0-255,5738,205574,77,312021
848,0.00218,172.217.194.0-255,4320,209894,77,312021
849,0.002189,172.217.194.0-255,9274,219168,77,312021
850,0.002218,172.217.194.0-255,2902,222070,77,312021
851,0.002226,172.217.194.0-255,1484,223554,77,312021
852,0.00227,172.217.194.0-255,766,224320,77,312021
853,0.002282,172.217.194.0-255,12828,237148,77,312021
854,0.002307,172.217.194.0-255,5738,242886,77,312021
855,0.00233,172.217.194.0-255,12828,255714,77,312021
856,0.00236,172.217.194.0-255,8574,264288,77,312021
857,0.002403,172.217.194.0-255,3602,267890,77,312021
858,0.002409,172.217.194.0-255,5738,273628,77,312021
859,0.002428,172.217.194.0-255,8574,282202,77,312021
860,0.002458,172.217.194.0-255,13528,295730,77,312021
861,0.002467,172.217.194.0-255,9992,305722,77,312021
862,0.002544,172.217.194.0-255,766,306488,77,312021
863,0.00255,172.217.194.0-255,5008,311496,77,312021
864,0.002553,172.217.194.0-255,105,311601,77,312021
865,0.01126,172.31.40.0-255,66,311667,77,312021
866,0.012462,172.217.194.0-255,105,311772,77,312021
867,0.012473,172.31.40.0-255,78,311850,77,312021
868,0.013413,172.31.40.0-255,105,311955,77,312021
869,0.016,172.217.194.0-255,66,312021,77,312021
870,0.0,172.217.194.0-255,150,150,77,164287
871,2.7e-05,172.31.40.0-255,66,216,77,164287
872,3.2e-05,172.217.194.0-255,1484,1700,77,164287
873,3.6e-05,172.31.40.0-255,66,1766,77,164287
874,6.2e-05,172.217.194.0-255,2902,4668,77,164287
875,6.8e-05,172.31.40.0-255,66,4734,77,164287
876,9.5e-05,172.217.194.0-255,5738,10472,77,164287
877,9.8e-05,172.31.40.0-255,66,10538,77,164287
878,0.000128,172.217.194.0-255,3367,13905,77,164287
879,0.000131,172.31.40.0-255,66,13971,77,164287
880,0.000158,172.217.194.0-255,4320,18291,77,164287
881,0.000162,172.31.40.0-255,66,18357,77,164287
882,0.000195,172.217.194.0-255,8574,26931,77,164287
883,0.000198,172.31.40.0-255,66,26997,77,164287
884,0.000223,172.217.194.0-255,3961,30958,77,164287
885,0.000225,172.31.40.0-255,66,31024,77,164287
886,0.000492,172.217.194.0-255,1484,32508,77,164287
887,0.000497,172.31.40.0-255,66,32574,77,164287
888,0.000507,172.217.194.0-255,2902,35476,77,164287
889,0.00051,172.31.40.0-255,66,35542,77,164287
890,0.000545,172.217.194.0-255,5738,41280,77,164287
891,0.000548,172.31.40.0-255,66,41346,77,164287
892,0.000556,172.217.194.0-255,7156,48502,77,164287
893,0.000559,172.31.40.0-255,66,48568,77,164287
894,0.000588,172.217.194.0-255,2902,51470,77,164287
895,0.000592,172.31.40.0-255,66,51536,77,164287
896,0.000633,172.217.194.0-255,7156,58692,77,164287
897,0.000637,172.31.40.0-255,66,58758,77,164287
898,0.000659,172.217.194.0-255,6438,65196,77,164287
899,0.000662,172.31.40.0-255,66,65262,77,164287
900,0.000858,172.217.194.0-255,379,65641,77,164287
901,0.000864,172.31.40.0-255,66,65707,77,164287
902,0.000898,172.217.194.0-255,366,66073,77,164287
903,0.001028,172.31.40.0-255,66,66139,77,164287
904,0.001584,172.217.194.0-255,1484,67623,77,164287
905,0.001594,172.217.194.0-255,2902,70525,77,164287
906,0.001599,172.31.40.0-255,66,70591,77,164287
907,0.00163,172.217.194.0-255,5738,76329,77,164287
908,0.001632,172.31.40.0-255,66,76395,77,164287
909,0.001637,172.217.194.0-255,2902,79297,77,164287
910,0.001639,172.31.40.0-255,66,79363,77,164287
911,0.001671,172.217.194.0-255,9992,89355,77,164287
912,0.001674,172.31.40.0-255,66,89421,77,164287
913,0.001679,172.217.194.0-255,4320,93741,77,164287
914,0.001681,172.31.40.0-255,66,93807,77,164287
915,0.001733,172.217.194.0-255,6438,100245,77,164287
916,0.001736,172.31.40.0-255,66,100311,77,164287
917,0.002031,172.217.194.0-255,1484,101795,77,164287
918,0.002037,172.217.194.0-255,1484,103279,77,164287
919,0.002042,172.31.40.0-255,66,103345,77,164287
920,0.002073,172.217.194.0-255,1484,104829,77,164287
921,0.002081,172.217.194.0-255,5738,110567,77,164287
922,0.002084,172.31.40.0-255,66,110633,77,164287
923,0.002119,172.217.194.0-255,7156,117789,77,164287
924,0.002123,172.31.40.0-255,66,117855,77,164287
925,0.004198,172.217.194.0-255,5738,123593,77,164287
926,0.004204,172.31.40.0-255,66,123659,77,164287
927,0.006266,172.217.194.0-255,5738,129397,77,164287
928,0.006272,172.31.40.0-255,66,129463,77,164287
929,0.00835,172.217.194.0-255,5738,135201,77,164287
930,0.008358,172.31.40.0-255,66,135267,77,164287
931,0.010468,172.217.194.0-255,5738,141005,77,164287
932,0.010476,172.31.40.0-255,66,141071,77,164287
933,0.012561,172.217.194.0-255,5738,146809,77,164287
934,0.012569,172.31.40.0-255,66,146875,77,164287
935,0.014662,172.217.194.0-255,5738,152613,77,164287
936,0.01467,172.31.40.0-255,66,152679,77,164287
937,0.016757,172.217.194.0-255,5738,158417,77,164287
938,0.016765,172.31.40.0-255,66,158483,77,164287
939,0.018864,172.217.194.0-255,5738,164221,77,164287
940,0.018874,172.31.40.0-255,66,164287,77,164287
941,0.0,74.125.130.0-255,155,155,77,353060
942,2.1e-05,172.31.40.0-255,66,221,77,353060
943,2.8e-05,74.125.130.0-255,1484,1705,77,353060
944,3.3e-05,172.31.40.0-255,66,1771,77,353060
945,4.5e-05,74.125.130.0-255,2902,4673,77,353060
946,4.9e-05,172.31.40.0-255,66,4739,77,353060
947,5.5e-05,74.125.130.0-255,4320,9059,77,353060
948,5.8e-05,172.31.40.0-255,66,9125,77,353060
949,9.3e-05,74.125.130.0-255,9090,18215,77,353060
950,9.6e-05,172.31.40.0-255,66,18281,77,353060
951,0.000102,74.125.130.0-255,4320,22601,77,353060
952,0.000104,172.31.40.0-255,66,22667,77,353060
953,0.000158,74.125.130.0-255,7156,29823,77,353060
954,0.000162,172.31.40.0-255,66,29889,77,353060
955,0.000186,74.125.130.0-255,1125,31014,77,353060
956,0.000189,172.31.40.0-255,66,31080,77,353060
957,0.000311,74.125.130.0-255,1484,32564,77,353060
958,0.000315,172.31.40.0-255,66,32630,77,353060
959,0.000319,74.125.130.0-255,1484,34114,77,353060
960,0.000322,172.31.40.0-255,66,34180,77,353060
961,0.000343,74.125.130.0-255,1484,35664,77,353060
962,0.000346,172.31.40.0-255,66,35730,77,353060
963,0.000352,74.125.130.0-255,5738,41468,77,353060
964,0.000355,172.31.40.0-255,66,41534,77,353060
965,0.000388,74.125.130.0-255,6797,48331,77,353060
966,0.000391,172.31.40.0-255,66,48397,77,353060
967,0.000411,74.125.130.0-255,8574,56971,77,353060
968,0.000418,172.31.40.0-255,66,57037,77,353060
969,0.000457,74.125.130.0-255,4320,61357,77,353060
970,0.00046,172.31.40.0-255,66,61423,77,353060
971,0.000488,74.125.130.0-255,4252,65675,77,353060
972,0.000491,172.31.40.0-255,66,65741,77,353060
973,0.000494,74.125.130.0-255,101,65842,77,353060
974,0.000827,74.125.130.0-255,1484,67326,77,353060
975,0.000833,74.125.130.0-255,1484,68810,77,353060
976,0.000842,74.125.130.0-255,1484,70294,77,353060
977,0.000852,74.125.130.0-255,1484,71778,77,353060
978,0.000859,172.31.40.0-255,66,71844,77,353060
979,0.000877,74.125.130.0-255,1484,73328,77,353060
980,0.000883,74.125.130.0-255,4320,77648,77,353060
981,0.000885,172.31.40.0-255,66,77714,77,353060
982,0.000891,74.125.130.0-255,5738,83452,77,353060
983,0.000893,172.31.40.0-255,66,83518,77,353060
984,0.000912,74.125.130.0-255,2902,86420,77,353060
985,0.000914,172.31.40.0-255,66,86486,77,353060
986,0.000919,74.125.130.0-255,4320,90806,77,353060
987,0.000923,74.125.130.0-255,4320,95126,77,353060
988,0.000941,74.125.130.0-255,1484,96610,77,353060
989,0.000947,172.31.40.0-255,66,96676,77,353060
990,0.000961,74.125.130.0-255,3602,100278,77,353060
991,0.000983,172.31.40.0-255,66,100344,77,353060
992,0.001127,74.125.130.0-255,1484,101828,77,353060
993,0.001145,74.125.130.0-255,2902,104730,77,353060
994,0.001148,172.31.40.0-255,66,104796,77,353060
995,0.001172,74.125.130.0-255,4320,109116,77,353060
996,0.001178,74.125.130.0-255,5738,114854,77,353060
997,0.001191,172.31.40.0-255,66,114920,77,353060
998,0.00122,74.125.130.0-255,9992,124912,77,353060
999,0.001231,172.31.40.0-255,66,124978,77,353060
1000,0.001257,74.125.130.0-255,4320,129298,77,353060
1001,0.001262,172.31.40.0-255,66,129364,77,353060
1002,0.001275,74.125.130.0-255,6438,135802,77,353060
1003,0.001283,74.125.130.0-255,2902,138704,77,353060
1004,0.001299,172.31.40.0-255,66,138770,77,353060
1005,0.001309,74.125.130.0-255,5738,144508,77,353060
1006,0.00133,74.125.130.0-255,9992,154500,77,353060
1007,0.001335,74.125.130.0-255,4320,158820,77,353060
1008,0.001348,172.31.40.0-255,66,158886,77,353060
1009,0.001384,74.125.130.0-255,7156,166042,77,353060
1010,0.001399,74.125.130.0-255,2184,168226,77,353060
1011,0.001406,172.31.40.0-255,66,168292,77,353060
1012,0.001571,74.125.130.0-255,1484,169776,77,353060
1013,0.001578,74.125.130.0-255,2902,172678,77,353060
1014,0.001584,74.125.130.0-255,5738,178416,77,353060
1015,0.001589,74.125.130.0-255,4320,182736,77,353060
1016,0.001602,74.125.130.0-255,2902,185638,77,353060
1017,0.001621,74.125.130.0-255,2902,188540,77,353060
1018,0.001649,74.125.130.0-255,9992,198532,77,353060
1019,0.001682,74.125.130.0-255,3602,202134,77,353060
1020,0.001838,74.125.130.0-255,1484,203618,77,353060
1021,0.001844,74.125.130.0-255,2902,206520,77,353060
1022,0.001896,74.125.130.0-255,5738,212258,77,353060
1023,0.001901,74.125.130.0-255,2902,215160,77,353060
1024,0.001906,74.125.130.0-255,4320,219480,77,353060
1025,0.001911,74.125.130.0-255,4320,223800,77,353060
1026,0.001926,74.125.130.0-255,4320,228120,77,353060
1027,0.001931,74.125.130.0-255,2902,231022,77,353060
1028,0.001933,74.125.130.0-255,1484,232506,77,353060
1029,0.001954,74.125.130.0-255,2902,235408,77,353060
1030,0.001974,74.125.130.0-255,4320,239728,77,353060
1031,0.001985,74.125.130.0-255,766,240494,77,353060
1032,0.001991,74.125.130.0-255,5738,246232,77,353060
1033,0.002042,74.125.130.0-255,8574,254806,77,353060
1034,0.002061,74.125.130.0-255,4320,259126,77,353060
1035,0.002082,74.125.130.0-255,2902,262028,77,353060
1036,0.002109,74.125.130.0-255,7856,269884,77,353060
1037,0.002123,74.125.130.0-255,2902,272786,77,353060
1038,0.002146,74.125.130.0-255,8574,281360,77,353060
1039,0.002161,74.125.130.0-255,5738,287098,77,353060
1040,0.002175,74.125.130.0-255,7156,294254,77,353060
1041,0.002178,74.125.130.0-255,1484,295738,77,353060
1042,0.002196,74.125.130.0-255,4320,300058,77,353060
1043,0.002232,74.125.130.0-255,3602,303660,77,353060
1044,0.002264,74.125.130.0-255,1484,305144,77,353060
1045,0.002281,74.125.130.0-255,2902,308046,77,353060
1046,0.002286,74.125.130.0-255,4320,312366,77,353060
1047,0.002288,74.125.130.0-255,1484,313850,77,353060
1048,0.002303,74.125.130.0-255,4320,318170,77,353060
1049,0.005917,172.31.40.0-255,66,318236,77,353060
1050,0.008222,74.125.130.0-255,5738,323974,77,353060
1051,0.008228,172.31.40.0-255,66,324040,77,353060
1052,0.010526,74.125.130.0-255,5738,329778,77,353060
1053,0.010534,172.31.40.0-255,66,329844,77,353060
1054,0.012824,74.125.130.0-255,5738,335582,77,353060
1055,0.012832,172.31.40.0-255,66,335648,77,353060
1056,0.015132,74.125.130.0-255,5738,341386,77,353060
1057,0.01514,172.31.40.0-255,66,341452,77,353060
1058,0.017436,74.125.130.0-255,5738,347190,77,353060
1059,0.017446,172.31.40.0-255,66,347256,77,353060
1060,0.019735,74.125.130.0-255,5738,352994,77,353060
1061,0.019743,172.31.40.0-255,66,353060,77,353060
1062,0.0,74.125.68.0-255,153,153,77,188894
1063,1.7e-05,172.31.40.0-255,66,219,77,188894
1064,5.7e-05,74.125.68.0-255,1484,1703,77,188894
1065,6.1e-05,172.31.40.0-255,66,1769,77,188894
1066,6.7e-05,74.125.68.0-255,2902,4671,77,188894
1067,7.1e-05,172.31.40.0-255,66,4737,77,188894
1068,7.6e-05,74.125.68.0-255,2902,7639,77,188894
1069,8e-05,172.31.40.0-255,66,7705,77,188894
1070,0.000109,74.125.68.0-255,1484,9189,77,188894
1071,0.000112,172.31.40.0-255,66,9255,77,188894
1072,0.000119,74.125.68.0-255,4738,13993,77,188894
1073,0.000122,172.31.40.0-255,66,14059,77,188894
1074,0.000127,74.125.68.0-255,2902,16961,77,188894
1075,0.000129,172.31.40.0-255,66,17027,77,188894
1076,0.000165,74.125.68.0-255,4320,21347,77,188894
1077,0.000168,172.31.40.0-255,66,21413,77,188894
1078,0.000188,74.125.68.0-255,7156,28569,77,188894
1079,0.000191,172.31.40.0-255,66,28635,77,188894
1080,0.000228,74.125.68.0-255,2543,31178,77,188894
1081,0.000231,172.31.40.0-255,66,31244,77,188894
1082,0.000417,74.125.68.0-255,1484,32728,77,188894
1083,0.000423,172.31.40.0-255,66,32794,77,188894
1084,0.000428,74.125.68.0-255,2902,35696,77,188894
1085,0.000431,172.31.40.0-255,66,35762,77,188894
1086,0.000454,74.125.68.0-255,4320,40082,77,188894
1087,0.000456,172.31.40.0-255,66,40148,77,188894
1088,0.000481,74.125.68.0-255,1484,41632,77,188894
1089,0.000483,172.31.40.0-255,66,41698,77,188894
1090,0.000489,74.125.68.0-255,2902,44600,77,188894
1091,0.000491,172.31.40.0-255,66,44666,77,188894
1092,0.000522,74.125.68.0-255,3961,48627,77,188894
1093,0.000526,172.31.40.0-255,66,48693,77,188894
1094,0.000534,74.125.68.0-255,7156,55849,77,188894
1095,0.000536,172.31.40.0-255,66,55915,77,188894
1096,0.000539,74.125.68.0-255,1484,57399,77,188894
1097,0.000565,74.125.68.0-255,2902,60301,77,188894
1098,0.000568,172.31.40.0-255,66,60367,77,188894
1099,0.000597,74.125.68.0-255,5691,66058,77,188894
1100,0.0006,172.31.40.0-255,66,66124,77,188894
1101,0.00066,74.125.68.0-255,112,66236,77,188894
1102,0.000768,74.125.68.0-255,1484,67720,77,188894
1103,0.000772,172.31.40.0-255,66,67786,77,188894
1104,0.000776,74.125.68.0-255,1484,69270,77,188894
1105,0.000798,74.125.68.0-255,1484,70754,77,188894
1106,0.0008,172.31.40.0-255,66,70820,77,188894
1107,0.000807,74.125.68.0-255,5738,76558,77,188894
1108,0.000809,172.31.40.0-255,66,76624,77,188894
1109,0.000839,74.125.68.0-255,2902,79526,77,188894
1110,0.000845,172.31.40.0-255,66,79592,77,188894
1111,0.000873,74.125.68.0-255,9992,89584,77,188894
1112,0.000875,172.31.40.0-255,66,89650,77,188894
1113,0.000904,74.125.68.0-255,7156,96806,77,188894
1114,0.000907,172.31.40.0-255,66,96872,77,188894
1115,0.000935,74.125.68.0-255,3866,100738,77,188894
1116,0.000938,172.31.40.0-255,66,100804,77,188894
1117,0.001138,74.125.68.0-255,1484,102288,77,188894
1118,0.00116,74.125.68.0-255,2902,105190,77,188894
1119,0.001164,172.31.40.0-255,66,105256,77,188894
1120,0.001172,74.125.68.0-255,5738,110994,77,188894
1121,0.001174,172.31.40.0-255,66,111060,77,188894
1122,0.001205,74.125.68.0-255,8574,119634,77,188894
1123,0.001208,172.31.40.0-255,66,119700,77,188894
1124,0.001236,74.125.68.0-255,5738,125438,77,188894
1125,0.001239,172.31.40.0-255,66,125504,77,188894
1126,0.001263,74.125.68.0-255,4320,129824,77,188894
1127,0.001266,172.31.40.0-255,66,129890,77,188894
1128,0.001295,74.125.68.0-255,5020,134910,77,188894
1129,0.001329,172.31.40.0-255,66,134976,77,188894
1130,0.002282,74.125.68.0-255,1484,136460,77,188894
1131,0.002302,74.125.68.0-255,2902,139362,77,188894
1132,0.002306,172.31.40.0-255,66,139428,77,188894
1133,0.002312,74.125.68.0-255,2902,142330,77,188894
1134,0.002314,172.31.40.0-255,66,142396,77,188894
1135,0.002334,74.125.68.0-255,1484,143880,77,188894
1136,0.00234,74.125.68.0-255,4320,148200,77,188894
1137,0.002342,172.31.40.0-255,66,148266,77,188894
1138,0.004628,74.125.68.0-255,5738,154004,77,188894
1139,0.004635,172.31.40.0-255,66,154070,77,188894
1140,0.006921,74.125.68.0-255,5738,159808,77,188894
1141,0.006927,172.31.40.0-255,66,159874,77,188894
1142,0.00923,74.125.68.0-255,5738,165612,77,188894
1143,0.009238,172.31.40.0-255,66,165678,77,188894
1144,0.01154,74.125.68.0-255,5738,171416,77,188894
1145,0.011548,172.31.40.0-255,66,171482,77,188894
1146,0.013848,74.125.68.0-255,5738,177220,77,188894
1147,0.013856,172.31.40.0-255,66,177286,77,188894
1148,0.016157,74.125.68.0-255,5738,183024,77,188894
1149,0.016167,172.31.40.0-255,66,183090,77,188894
1150,0.018467,74.125.68.0-255,5738,188828,77,188894
1151,0.018475,172.31.40.0-255,66,188894,77,188894
1152,0.0,74.125.24.0-255,153,153,77,151677
1153,2.2e-05,172.31.40.0-255,66,219,77,151677
1154,2.9e-05,74.125.24.0-255,1484,1703,77,151677
1155,3.3e-05,172.31.40.0-255,66,1769,77,151677
1156,3.8e-05,74.125.24.0-255,2902,4671,77,151677
1157,4.1e-05,172.31.40.0-255,66,4737,77,151677
1158,4.8e-05,74.125.24.0-255,7156,11893,77,151677
1159,5.1e-05,172.31.40.0-255,66,11959,77,151677
1160,7.4e-05,74.125.24.0-255,2001,13960,77,151677
1161,7.6e-05,172.31.40.0-255,66,14026,77,151677
1162,0.000354,74.125.24.0-255,1484,15510,77,151677
1163,0.000359,172.31.40.0-255,66,15576,77,151677
1164,0.000364,74.125.24.0-255,2902,18478,77,151677
1165,0.000366,172.31.40.0-255,66,18544,77,151677
1166,0.000368,74.125.24.0-255,1484,20028,77,151677
1167,0.00037,172.31.40.0-255,66,20094,77,151677
1168,0.000394,74.125.24.0-255,4320,24414,77,151677
1169,0.000396,172.31.40.0-255,66,24480,77,151677
1170,0.000441,74.125.24.0-255,1484,25964,77,151677
1171,0.000444,172.31.40.0-255,66,26030,77,151677
1172,0.000466,74.125.24.0-255,5379,31409,77,151677
1173,0.000469,172.31.40.0-255,66,31475,77,151677
1174,0.000687,74.125.24.0-255,1484,32959,77,151677
1175,0.000691,172.31.40.0-255,66,33025,77,151677
1176,0.000698,74.125.24.0-255,2902,35927,77,151677
1177,0.0007,172.31.40.0-255,66,35993,77,151677
1178,0.000704,74.125.24.0-255,1484,37477,77,151677
1179,0.000705,172.31.40.0-255,66,37543,77,151677
1180,0.000723,74.125.24.0-255,4320,41863,77,151677
1181,0.000725,172.31.40.0-255,66,41929,77,151677
1182,0.000757,74.125.24.0-255,6797,48726,77,151677
1183,0.000759,172.31.40.0-255,66,48792,77,151677
1184,0.001118,74.125.24.0-255,1484,50276,77,151677
1185,0.001126,74.125.24.0-255,2902,53178,77,151677
1186,0.001129,172.31.40.0-255,66,53244,77,151677
1187,0.00114,74.125.24.0-255,1484,54728,77,151677
1188,0.001154,74.125.24.0-255,4320,59048,77,151677
1189,0.001157,172.31.40.0-255,66,59114,77,151677
1190,0.001185,74.125.24.0-255,2902,62016,77,151677
1191,0.001188,172.31.40.0-255,66,62082,77,151677
1192,0.001202,74.125.24.0-255,4304,66386,77,151677
1193,0.001205,172.31.40.0-255,66,66452,77,151677
1194,0.001256,74.125.24.0-255,333,66785,77,151677
1195,0.001528,74.125.24.0-255,1484,68269,77,151677
1196,0.00153,172.31.40.0-255,66,68335,77,151677
1197,0.001534,74.125.24.0-255,2902,71237,77,151677
1198,0.001537,172.31.40.0-255,66,71303,77,151677
1199,0.001549,74.125.24.0-255,2902,74205,77,151677
1200,0.001551,172.31.40.0-255,66,74271,77,151677
1201,0.001571,74.125.24.0-255,2902,77173,77,151677
1202,0.001573,172.31.40.0-255,66,77239,77,151677
1203,0.001598,74.125.24.0-255,9633,86872,77,151677
1204,0.0016,172.31.40.0-255,66,86938,77,151677
1205,0.001607,74.125.24.0-255,7156,94094,77,151677
1206,0.001609,172.31.40.0-255,66,94160,77,151677
1207,0.001622,74.125.24.0-255,2902,97062,77,151677
1208,0.001624,172.31.40.0-255,66,97128,77,151677
1209,0.001629,74.125.24.0-255,3961,101089,77,151677
1210,0.001631,172.31.40.0-255,66,101155,77,151677
1211,0.002054,74.125.24.0-255,1484,102639,77,151677
1212,0.002066,74.125.24.0-255,1484,104123,77,151677
1213,0.002068,172.31.40.0-255,66,104189,77,151677
1214,0.003686,74.125.24.0-255,2902,107091,77,151677
1215,0.00369,172.31.40.0-255,66,107157,77,151677
1216,0.004124,74.125.24.0-255,2902,110059,77,151677
1217,0.004127,172.31.40.0-255,66,110125,77,151677
1218,0.005748,74.125.24.0-255,2902,113027,77,151677
1219,0.005756,172.31.40.0-255,66,113093,77,151677
1220,0.006182,74.125.24.0-255,2902,115995,77,151677
1221,0.006188,172.31.40.0-255,66,116061,77,151677
1222,0.007808,74.125.24.0-255,2902,118963,77,151677
1223,0.007815,172.31.40.0-255,66,119029,77,151677
1224,0.008218,74.125.24.0-255,2902,121931,77,151677
1225,0.008224,172.31.40.0-255,66,121997,77,151677
1226,0.009841,74.125.24.0-255,2902,124899,77,151677
1227,0.009848,172.31.40.0-255,66,124965,77,151677
1228,0.010275,74.125.24.0-255,2902,127867,77,151677
1229,0.01028,172.31.40.0-255,66,127933,77,151677
1230,0.011894,74.125.24.0-255,2902,130835,77,151677
1231,0.011902,172.31.40.0-255,66,130901,77,151677
1232,0.012315,74.125.24.0-255,2902,133803,77,151677
1233,0.012319,172.31.40.0-255,66,133869,77,151677
1234,0.013931,74.125.24.0-255,2902,136771,77,151677
1235,0.013938,172.31.40.0-255,66,136837,77,151677
1236,0.014379,74.125.24.0-255,2902,139739,77,151677
1237,0.014384,172.31.40.0-255,66,139805,77,151677
1238,0.016001,74.125.24.0-255,2902,142707,77,151677
1239,0.016009,172.31.40.0-255,66,142773,77,151677
1240,0.016435,74.125.24.0-255,2902,145675,77,151677
1241,0.016441,172.31.40.0-255,66,145741,77,151677
1242,0.01808,74.125.24.0-255,2902,148643,77,151677
1243,0.01809,172.31.40.0-255,66,148709,77,151677
1244,0.018484,74.125.24.0-255,2902,151611,77,151677
1245,0.018491,172.31.40.0-255,66,151677,77,151677
1246,0.0,74.125.200.0-255,155,155,77,188235
1247,2.3e-05,172.31.40.0-255,66,221,77,188235
1248,3e-05,74.125.200.0-255,1484,1705,77,188235
1249,3.4e-05,172.31.40.0-255,66,1771,77,188235
1250,4e-05,74.125.200.0-255,2902,4673,77,188235
1251,4.2e-05,172.31.40.0-255,66,4739,77,188235
1252,4.9e-05,74.125.200.0-255,5738,10477,77,188235
1253,5.4e-05,172.31.40.0-255,66,10543,77,188235
1254,8e-05,74.125.200.0-255,3448,13991,77,188235
1255,8.3e-05,172.31.40.0-255,66,14057,77,188235
1256,0.000135,74.125.200.0-255,1484,15541,77,188235
1257,0.000138,172.31.40.0-255,66,15607,77,188235
1258,0.000151,74.125.200.0-255,2902,18509,77,188235
1259,0.000154,172.31.40.0-255,66,18575,77,188235
1260,0.000172,74.125.200.0-255,1484,20059,77,188235
1261,0.000174,172.31.40.0-255,66,20125,77,188235
1262,0.000186,74.125.200.0-255,2902,23027,77,188235
1263,0.000188,172.31.40.0-255,66,23093,77,188235
1264,0.000204,74.125.200.0-255,5738,28831,77,188235
1265,0.000206,172.31.40.0-255,66,28897,77,188235
1266,0.00021,74.125.200.0-255,2543,31440,77,188235
1267,0.000213,172.31.40.0-255,66,31506,77,188235
1268,0.000319,74.125.200.0-255,1484,32990,77,188235
1269,0.000323,172.31.40.0-255,66,33056,77,188235
1270,0.000329,74.125.200.0-255,2902,35958,77,188235
1271,0.000332,172.31.40.0-255,66,36024,77,188235
1272,0.000335,74.125.200.0-255,1484,37508,77,188235
1273,0.000337,172.31.40.0-255,66,37574,77,188235
1274,0.000354,74.125.200.0-255,4320,41894,77,188235
1275,0.000356,172.31.40.0-255,66,41960,77,188235
1276,0.000359,74.125.200.0-255,1484,43444,77,188235
1277,0.000361,172.31.40.0-255,66,43510,77,188235
1278,0.000381,74.125.200.0-255,2902,46412,77,188235
1279,0.000384,172.31.40.0-255,66,46478,77,188235
1280,0.00039,74.125.200.0-255,5379,51857,77,188235
1281,0.000392,172.31.40.0-255,66,51923,77,188235
1282,0.000417,74.125.200.0-255,2902,54825,77,188235
1283,0.000419,172.31.40.0-255,66,54891,77,188235
1284,0.000438,74.125.200.0-255,7156,62047,77,188235
1285,0.000441,172.31.40.0-255,66,62113,77,188235
1286,0.000465,74.125.200.0-255,4273,66386,77,188235
1287,0.000468,172.31.40.0-255,66,66452,77,188235
1288,0.000513,74.125.200.0-255,345,66797,77,188235
1289,0.000629,74.125.200.0-255,1484,68281,77,188235
1290,0.000633,172.31.40.0-255,66,68347,77,188235
1291,0.000639,74.125.200.0-255,2902,71249,77,188235
1292,0.000641,172.31.40.0-255,66,71315,77,188235
1293,0.000659,74.125.200.0-255,5738,77053,77,188235
1294,0.000661,172.31.40.0-255,66,77119,77,188235
1295,0.000665,74.125.200.0-255,2902,80021,77,188235
1296,0.000668,172.31.40.0-255,66,80087,77,188235
1297,0.000685,74.125.200.0-255,1484,81571,77,188235
1298,0.000716,74.125.200.0-255,2543,84114,77,188235
1299,0.000721,172.31.40.0-255,66,84180,77,188235
1300,0.000757,74.125.200.0-255,2902,87082,77,188235
1301,0.00076,172.31.40.0-255,66,87148,77,188235
1302,0.000764,74.125.200.0-255,1484,88632,77,188235
1303,0.00078,74.125.200.0-255,2902,91534,77,188235
1304,0.000785,172.31.40.0-255,66,91600,77,188235
1305,0.000796,74.125.200.0-255,5738,97338,77,188235
1306,0.000798,172.31.40.0-255,66,97404,77,188235
1307,0.000816,74.125.200.0-255,1484,98888,77,188235
1308,0.000828,74.125.200.0-255,2543,101431,77,188235
1309,0.000831,172.31.40.0-255,66,101497,77,188235
1310,0.001199,74.125.200.0-255,1484,102981,77,188235
1311,0.001207,74.125.200.0-255,2902,105883,77,188235
1312,0.00121,172.31.40.0-255,66,105949,77,188235
1313,0.001217,74.125.200.0-255,4320,110269,77,188235
1314,0.001219,172.31.40.0-255,66,110335,77,188235
1315,0.001233,74.125.200.0-255,1484,111819,77,188235
1316,0.001237,74.125.200.0-255,2902,114721,77,188235
1317,0.00124,172.31.40.0-255,66,114787,77,188235
1318,0.001255,74.125.200.0-255,2902,117689,77,188235
1319,0.001257,172.31.40.0-255,66,117755,77,188235
1320,0.001278,74.125.200.0-255,7156,124911,77,188235
1321,0.001281,172.31.40.0-255,66,124977,77,188235
1322,0.001316,74.125.200.0-255,8574,133551,77,188235
1323,0.001318,172.31.40.0-255,66,133617,77,188235
1324,0.001338,74.125.200.0-255,2184,135801,77,188235
1325,0.001341,172.31.40.0-255,66,135867,77,188235
1326,0.003269,74.125.200.0-255,2902,138769,77,188235
1327,0.003276,172.31.40.0-255,66,138835,77,188235
1328,0.003297,74.125.200.0-255,2902,141737,77,188235
1329,0.0033,172.31.40.0-255,66,141803,77,188235
1330,0.00525,74.125.200.0-255,5738,147541,77,188235
1331,0.005253,172.31.40.0-255,66,147607,77,188235
1332,0.007214,74.125.200.0-255,5738,153345,77,188235
1333,0.00722,172.31.40.0-255,66,153411,77,188235
1334,0.009176,74.125.200.0-255,5738,159149,77,188235
1335,0.009184,172.31.40.0-255,66,159215,77,188235
1336,0.01114,74.125.200.0-255,5738,164953,77,188235
1337,0.011147,172.31.40.0-255,66,165019,77,188235
1338,0.013105,74.125.200.0-255,5738,170757,77,188235
1339,0.013112,172.31.40.0-255,66,170823,77,188235
1340,0.015077,74.125.200.0-255,5738,176561,77,188235
1341,0.015086,172.31.40.0-255,66,176627,77,188235
1342,0.017047,74.125.200.0-255,5738,182365,77,188235
1343,0.017054,172.31.40.0-255,66,182431,77,188235
1344,0.019028,74.125.200.0-255,5738,188169,77,188235
1345,0.019035,172.31.40.0-255,66,188235,77,188235
1346,0.0,74.125.24.0-255,153,153,77,329150
1347,2.4e-05,172.31.40.0-255,66,219,77,329150
1348,3.1e-05,74.125.24.0-255,1484,1703,77,329150
1349,3.5e-05,172.31.40.0-255,66,1769,77,329150
1350,4.1e-05,74.125.24.0-255,2902,4671,77,329150
1351,4.4e-05,172.31.40.0-255,66,4737,77,329150
1352,4.7e-05,74.125.24.0-255,1484,6221,77,329150
1353,4.9e-05,172.31.40.0-255,66,6287,77,329150
1354,5.4e-05,74.125.24.0-255,2902,9189,77,329150
1355,5.7e-05,172.31.40.0-255,66,9255,77,329150
1356,9.5e-05,74.125.24.0-255,4935,14190,77,329150
1357,9.8e-05,172.31.40.0-255,66,14256,77,329150
1358,0.000352,74.125.24.0-255,1484,15740,77,329150
1359,0.000357,172.31.40.0-255,66,15806,77,329150
1360,0.000364,74.125.24.0-255,2902,18708,77,329150
1361,0.000366,172.31.40.0-255,66,18774,77,329150
1362,0.000373,74.125.24.0-255,5738,24512,77,329150
1363,0.000376,172.31.40.0-255,66,24578,77,329150
1364,0.00038,74.125.24.0-255,2902,27480,77,329150
1365,0.000382,172.31.40.0-255,66,27546,77,329150
1366,0.00043,74.125.24.0-255,5738,33284,77,329150
1367,0.000433,172.31.40.0-255,66,33350,77,329150
1368,0.000459,74.125.24.0-255,5379,38729,77,329150
1369,0.000465,74.125.24.0-255,7156,45885,77,329150
1370,0.000469,172.31.40.0-255,66,45951,77,329150
1371,0.000472,172.31.40.0-255,66,46017,77,329150
1372,0.000486,74.125.24.0-255,2543,48560,77,329150
1373,0.000488,172.31.40.0-255,66,48626,77,329150
1374,0.000509,74.125.24.0-255,1484,50110,77,329150
1375,0.000511,172.31.40.0-255,66,50176,77,329150
1376,0.000533,74.125.24.0-255,1484,51660,77,329150
1377,0.000535,172.31.40.0-255,66,51726,77,329150
1378,0.000543,74.125.24.0-255,7156,58882,77,329150
1379,0.00055,74.125.24.0-255,4320,63202,77,329150
1380,0.000571,172.31.40.0-255,66,63268,77,329150
1381,0.000592,74.125.24.0-255,2851,66119,77,329150
1382,0.000609,172.31.40.0-255,66,66185,77,329150
1383,0.000905,74.125.24.0-255,346,66531,77,329150
1384,0.001009,172.31.40.0-255,101,66632,77,329150
1385,0.00104,74.125.24.0-255,1484,68116,77,329150
1386,0.001047,74.125.24.0-255,2902,71018,77,329150
1387,0.001053,74.125.24.0-255,5738,76756,77,329150
1388,0.001062,74.125.24.0-255,8574,85330,77,329150
1389,0.001073,74.125.24.0-255,9992,95322,77,329150
1390,0.001079,74.125.24.0-255,5020,100342,77,329150
1391,0.001098,172.31.40.0-255,66,100408,77,329150
1392,0.001129,74.125.24.0-255,1484,101892,77,329150
1393,0.001133,74.125.24.0-255,2902,104794,77,329150
1394,0.001137,74.125.24.0-255,2902,107696,77,329150
1395,0.001141,172.31.40.0-255,66,107762,77,329150
1396,0.001167,74.125.24.0-255,2902,110664,77,329150
1397,0.001176,74.125.24.0-255,7156,117820,77,329150
1398,0.001183,74.125.24.0-255,4320,122140,77,329150
1399,0.0012,172.31.40.0-255,66,122206,77,329150
1400,0.001217,74.125.24.0-255,9992,132198,77,329150
1401,0.001222,74.125.24.0-255,2184,134382,77,329150
1402,0.001243,74.125.24.0-255,5738,140120,77,329150
1403,0.001251,172.31.40.0-255,66,140186,77,329150
1404,0.001266,74.125.24.0-255,9992,150178,77,329150
1405,0.001272,172.31.40.0-255,66,150244,77,329150
1406,0.001292,74.125.24.0-255,2902,153146,77,329150
1407,0.001301,74.125.24.0-255,8574,161720,77,329150
1408,0.001309,74.125.24.0-255,6438,168158,77,329150
1409,0.001314,172.31.40.0-255,66,168224,77,329150
1410,0.001485,74.125.24.0-255,1484,169708,77,329150
1411,0.001491,74.125.24.0-255,2902,172610,77,329150
1412,0.001502,172.31.40.0-255,66,172676,77,329150
1413,0.001506,74.125.24.0-255,1484,174160,77,329150
1414,0.001524,74.125.24.0-255,4320,178480,77,329150
1415,0.001532,172.31.40.0-255,66,178546,77,329150
1416,0.001566,74.125.24.0-255,12828,191374,77,329150
1417,0.001572,74.125.24.0-255,5738,197112,77,329150
1418,0.001625,74.125.24.0-255,5020,202132,77,329150
1419,0.001629,74.125.24.0-255,2902,205034,77,329150
1420,0.001641,172.31.40.0-255,66,205100,77,329150
1421,0.001646,74.125.24.0-255,2902,208002,77,329150
1422,0.001651,172.31.40.0-255,66,208068,77,329150
1423,0.001664,74.125.24.0-255,5738,213806,77,329150
1424,0.00168,74.125.24.0-255,1484,215290,77,329150
1425,0.001716,74.125.24.0-255,8574,223864,77,329150
1426,0.001727,74.125.24.0-255,9992,233856,77,329150
1427,0.001745,74.125.24.0-255,2184,236040,77,329150
1428,0.001752,172.31.40.0-255,66,236106,77,329150
1429,0.00186,74.125.24.0-255,1484,237590,77,329150
1430,0.001879,74.125.24.0-255,2902,240492,77,329150
1431,0.00189,172.31.40.0-255,66,240558,77,329150
1432,0.001908,74.125.24.0-255,5738,246296,77,329150
1433,0.001912,74.125.24.0-255,2902,249198,77,329150
1434,0.001927,74.125.24.0-255,1484,250682,77,329150
1435,0.001934,172.31.40.0-255,66,250748,77,329150
1436,0.001946,74.125.24.0-255,2902,253650,77,329150
1437,0.001968,74.125.24.0-255,7156,260806,77,329150
1438,0.00198,74.125.24.0-255,1484,262290,77,329150
1439,0.001986,74.125.24.0-255,4320,266610,77,329150
1440,0.001993,172.31.40.0-255,66,266676,77,329150
1441,0.00201,74.125.24.0-255,3602,270278,77,329150
1442,0.002028,172.31.40.0-255,66,270344,77,329150
1443,0.00207,74.125.24.0-255,1484,271828,77,329150
1444,0.002091,74.125.24.0-255,2902,274730,77,329150
1445,0.002096,172.31.40.0-255,66,274796,77,329150
1446,0.002105,74.125.24.0-255,2902,277698,77,329150
1447,0.002122,74.125.24.0-255,2902,280600,77,329150
1448,0.002128,74.125.24.0-255,5738,286338,77,329150
1449,0.002136,172.31.40.0-255,66,286404,77,329150
1450,0.002151,74.125.24.0-255,4320,290724,77,329150
1451,0.002156,74.125.24.0-255,2902,293626,77,329150
1452,0.00217,172.31.40.0-255,66,293692,77,329150
1453,0.002187,74.125.24.0-255,10692,304384,77,329150
1454,0.002192,172.31.40.0-255,66,304450,77,329150
1455,0.003405,74.125.24.0-255,66,304516,77,329150
1456,0.004494,74.125.24.0-255,5738,310254,77,329150
1457,0.004502,172.31.40.0-255,66,310320,77,329150
1458,0.006819,74.125.24.0-255,5738,316058,77,329150
1459,0.013486,74.125.24.0-255,1484,317542,77,329150
1460,0.014185,172.31.40.0-255,66,317608,77,329150
1461,0.016496,74.125.24.0-255,5738,323346,77,329150
1462,0.016514,172.31.40.0-255,66,323412,77,329150
1463,0.01884,74.125.24.0-255,5738,329150,77,329150
1464,0.0,172.217.194.0-255,143,143,77,250295
1465,1.6e-05,172.31.40.0-255,66,209,77,250295
1466,3.7e-05,172.217.194.0-255,1484,1693,77,250295
1467,4.1e-05,172.31.40.0-255,66,1759,77,250295
1468,4.7e-05,172.217.194.0-255,2902,4661,77,250295
1469,5e-05,172.31.40.0-255,66,4727,77,250295
1470,7.9e-05,172.217.194.0-255,7156,11883,77,250295
1471,8.1e-05,172.31.40.0-255,66,11949,77,250295
1472,8.6e-05,172.217.194.0-255,2165,14114,77,250295
1473,8.8e-05,172.31.40.0-255,66,14180,77,250295
1474,0.000141,172.217.194.0-255,1484,15664,77,250295
1475,0.000144,172.31.40.0-255,66,15730,77,250295
1476,0.000149,172.217.194.0-255,2902,18632,77,250295
1477,0.000151,172.31.40.0-255,66,18698,77,250295
1478,0.000156,172.217.194.0-255,2902,21600,77,250295
1479,0.000158,172.31.40.0-255,66,21666,77,250295
1480,0.000181,172.217.194.0-255,2902,24568,77,250295
1481,0.000184,172.31.40.0-255,66,24634,77,250295
1482,0.000191,172.217.194.0-255,6797,31431,77,250295
1483,0.000193,172.31.40.0-255,66,31497,77,250295
1484,0.000298,172.217.194.0-255,1484,32981,77,250295
1485,0.000301,172.31.40.0-255,66,33047,77,250295
1486,0.000308,172.217.194.0-255,2902,35949,77,250295
1487,0.000311,172.31.40.0-255,66,36015,77,250295
1488,0.000317,172.217.194.0-255,5738,41753,77,250295
1489,0.00032,172.31.40.0-255,66,41819,77,250295
1490,0.000348,172.217.194.0-255,4320,46139,77,250295
1491,0.000351,172.31.40.0-255,66,46205,77,250295
1492,0.000385,172.217.194.0-255,6797,53002,77,250295
1493,0.000387,172.31.40.0-255,66,53068,77,250295
1494,0.000395,172.217.194.0-255,7156,60224,77,250295
1495,0.000397,172.31.40.0-255,66,60290,77,250295
1496,0.00043,172.217.194.0-255,1484,61774,77,250295
1497,0.000446,172.217.194.0-255,3961,65735,77,250295
1498,0.000449,172.31.40.0-255,66,65801,77,250295
1499,0.000705,172.217.194.0-255,648,66449,77,250295
1500,0.001009,172.31.40.0-255,66,66515,77,250295
1501,0.001079,172.217.194.0-255,1484,67999,77,250295
1502,0.001084,172.217.194.0-255,1484,69483,77,250295
1503,0.001087,172.31.40.0-255,66,69549,77,250295
1504,0.0011,172.217.194.0-255,1484,71033,77,250295
1505,0.001108,172.217.194.0-255,5738,76771,77,250295
1506,0.00111,172.31.40.0-255,66,76837,77,250295
1507,0.001122,172.217.194.0-255,1484,78321,77,250295
1508,0.001145,172.217.194.0-255,9992,88313,77,250295
1509,0.001149,172.31.40.0-255,66,88379,77,250295
1510,0.001177,172.217.194.0-255,2902,91281,77,250295
1511,0.00118,172.31.40.0-255,66,91347,77,250295
1512,0.001206,172.217.194.0-255,9274,100621,77,250295
1513,0.001208,172.31.40.0-255,66,100687,77,250295
1514,0.001344,172.217.194.0-255,1484,102171,77,250295
1515,0.00136,172.217.194.0-255,2902,105073,77,250295
1516,0.001363,172.31.40.0-255,66,105139,77,250295
1517,0.001368,172.217.194.0-255,2902,108041,77,250295
1518,0.00137,172.31.40.0-255,66,108107,77,250295
1519,0.001384,172.217.194.0-255,2902,111009,77,250295
1520,0.001386,172.31.40.0-255,66,111075,77,250295
1521,0.001424,172.217.194.0-255,12828,123903,77,250295
1522,0.001428,172.31.40.0-255,66,123969,77,250295
1523,0.001446,172.217.194.0-255,2902,126871,77,250295
1524,0.001449,172.31.40.0-255,66,126937,77,250295
1525,0.001469,172.217.194.0-255,7856,134793,77,250295
1526,0.001473,172.31.40.0-255,66,134859,77,250295
1527,0.001561,172.217.194.0-255,1484,136343,77,250295
1528,0.001574,172.217.194.0-255,2902,139245,77,250295
1529,0.001578,172.31.40.0-255,66,139311,77,250295
1530,0.001586,172.217.194.0-255,4320,143631,77,250295
1531,0.001588,172.31.40.0-255,66,143697,77,250295
1532,0.001604,172.217.194.0-255,1484,145181,77,250295
1533,0.001609,172.217.194.0-255,4320,149501,77,250295
1534,0.001612,172.31.40.0-255,66,149567,77,250295
1535,0.001642,172.217.194.0-255,8574,158141,77,250295
1536,0.001645,172.31.40.0-255,66,158207,77,250295
1537,0.001655,172.217.194.0-255,10692,168899,77,250295
1538,0.001658,172.31.40.0-255,66,168965,77,250295
1539,0.001953,172.217.194.0-255,1484,170449,77,250295
1540,0.001959,172.217.194.0-255,2902,173351,77,250295
1541,0.001963,172.31.40.0-255,66,173417,77,250295
1542,0.001979,172.217.194.0-255,5738,179155,77,250295
1543,0.001982,172.31.40.0-255,66,179221,77,250295
1544,0.001987,172.217.194.0-255,2902,182123,77,250295
1545,0.001989,172.31.40.0-255,66,182189,77,250295
1546,0.002011,172.217.194.0-255,4320,186509,77,250295
1547,0.002014,172.31.40.0-255,66,186575,77,250295
1548,0.002018,172.217.194.0-255,1484,188059,77,250295
1549,0.002056,172.217.194.0-255,12828,200887,77,250295
1550,0.002059,172.31.40.0-255,66,200953,77,250295
1551,0.002063,172.217.194.0-255,2184,203137,77,250295
1552,0.002065,172.31.40.0-255,66,203203,77,250295
1553,0.00413,172.217.194.0-255,5738,208941,77,250295
1554,0.004138,172.31.40.0-255,66,209007,77,250295
1555,0.00621,172.217.194.0-255,2902,211909,77,250295
1556,0.006213,172.31.40.0-255,66,211975,77,250295
1557,0.006232,172.217.194.0-255,2902,214877,77,250295
1558,0.006234,172.31.40.0-255,66,214943,77,250295
1559,0.008272,172.217.194.0-255,2902,217845,77,250295
1560,0.008278,172.31.40.0-255,66,217911,77,250295
1561,0.008309,172.217.194.0-255,2902,220813,77,250295
1562,0.008311,172.31.40.0-255,66,220879,77,250295
1563,0.010376,172.217.194.0-255,2902,223781,77,250295
1564,0.010384,172.31.40.0-255,66,223847,77,250295
1565,0.010406,172.217.194.0-255,2902,226749,77,250295
1566,0.010408,172.31.40.0-255,66,226815,77,250295
1567,0.012463,172.217.194.0-255,2902,229717,77,250295
1568,0.012471,172.31.40.0-255,66,229783,77,250295
1569,0.012494,172.217.194.0-255,2902,232685,77,250295
1570,0.012497,172.31.40.0-255,66,232751,77,250295
1571,0.014555,172.217.194.0-255,2902,235653,77,250295
1572,0.014562,172.31.40.0-255,66,235719,77,250295
1573,0.014584,172.217.194.0-255,2902,238621,77,250295
1574,0.014586,172.31.40.0-255,66,238687,77,250295
1575,0.01666,172.217.194.0-255,5738,244425,77,250295
1576,0.016668,172.31.40.0-255,66,244491,77,250295
1577,0.018798,172.217.194.0-255,5738,250229,77,250295
1578,0.018808,172.31.40.0-255,66,250295,77,250295
1579,0.0,172.217.194.0-255,162,162,77,243456
1580,1.1e-05,172.31.40.0-255,66,228,77,243456
1581,1.8e-05,172.217.194.0-255,1484,1712,77,243456
1582,2.2e-05,172.31.40.0-255,66,1778,77,243456
1583,5.3e-05,172.217.194.0-255,2902,4680,77,243456
1584,5.7e-05,172.31.40.0-255,66,4746,77,243456
1585,6e-05,172.217.194.0-255,1484,6230,77,243456
1586,6.3e-05,172.31.40.0-255,66,6296,77,243456
1587,7.8e-05,172.217.194.0-255,4320,10616,77,243456
1588,8.1e-05,172.31.40.0-255,66,10682,77,243456
1589,0.000109,172.217.194.0-255,1484,12166,77,243456
1590,0.000112,172.31.40.0-255,66,12232,77,243456
1591,0.000117,172.217.194.0-255,2022,14254,77,243456
1592,0.000119,172.31.40.0-255,66,14320,77,243456
1593,0.000261,172.217.194.0-255,1484,15804,77,243456
1594,0.000265,172.31.40.0-255,66,15870,77,243456
1595,0.000271,172.217.194.0-255,2902,18772,77,243456
1596,0.000273,172.31.40.0-255,66,18838,77,243456
1597,0.0003,172.217.194.0-255,5738,24576,77,243456
1598,0.000302,172.31.40.0-255,66,24642,77,243456
1599,0.00031,172.217.194.0-255,6797,31439,77,243456
1600,0.000312,172.31.40.0-255,66,31505,77,243456
1601,0.000363,172.31.40.0-255,66,31571,77,243456
1602,0.000381,172.31.40.0-255,66,31637,77,243456
1603,0.000404,172.217.194.0-255,1484,33121,77,243456
1604,0.000406,172.31.40.0-255,66,33187,77,243456
1605,0.000409,172.217.194.0-255,1090,34277,77,243456
1606,0.000411,172.31.40.0-255,66,34343,77,243456
1607,0.000451,172.217.194.0-255,1484,35827,77,243456
1608,0.000453,172.31.40.0-255,66,35893,77,243456
1609,0.000458,172.217.194.0-255,2902,38795,77,243456
1610,0.000481,172.217.194.0-255,5738,44533,77,243456
1611,0.000487,172.217.194.0-255,4320,48853,77,243456
1612,0.000511,172.217.194.0-255,8574,57427,77,243456
1613,0.000519,172.217.194.0-255,10692,68119,77,243456
1614,0.00053,172.217.194.0-255,384,68503,77,243456
1615,0.000569,172.31.40.0-255,66,68569,77,243456
1616,0.000648,172.217.194.0-255,1484,70053,77,243456
1617,0.00066,172.217.194.0-255,2902,72955,77,243456
1618,0.000669,172.31.40.0-255,66,73021,77,243456
1619,0.000674,172.217.194.0-255,2902,75923,77,243456
1620,0.000678,172.31.40.0-255,66,75989,77,243456
1621,0.000695,172.217.194.0-255,2902,78891,77,243456
1622,0.000702,172.217.194.0-255,7156,86047,77,243456
1623,0.000726,172.217.194.0-255,5738,91785,77,243456
1624,0.000737,172.217.194.0-255,10143,101928,77,243456
1625,0.000743,172.31.40.0-255,66,101994,77,243456
1626,0.000752,172.217.194.0-255,1484,103478,77,243456
1627,0.000763,172.217.194.0-255,1484,104962,77,243456
1628,0.000778,172.217.194.0-255,1484,106446,77,243456
1629,0.000784,172.217.194.0-255,5738,112184,77,243456
1630,0.000786,172.217.194.0-255,1484,113668,77,243456
1631,0.00079,172.31.40.0-255,66,113734,77,243456
1632,0.000812,172.217.194.0-255,11410,125144,77,243456
1633,0.00082,172.217.194.0-255,2902,128046,77,243456
1634,0.00083,172.31.40.0-255,66,128112,77,243456
1635,0.000851,172.217.194.0-255,7856,135968,77,243456
1636,0.000864,172.31.40.0-255,66,136034,77,243456
1637,0.001044,172.217.194.0-255,1484,137518,77,243456
1638,0.001058,172.217.194.0-255,2902,140420,77,243456
1639,0.001061,172.217.194.0-255,1484,141904,77,243456
1640,0.001065,172.31.40.0-255,66,141970,77,243456
1641,0.001089,172.217.194.0-255,4320,146290,77,243456
1642,0.001129,172.31.40.0-255,66,146356,77,243456
1643,0.001159,172.217.194.0-255,12828,159184,77,243456
1644,0.001166,172.217.194.0-255,8574,167758,77,243456
1645,0.00117,172.217.194.0-255,2184,169942,77,243456
1646,0.001178,172.31.40.0-255,66,170008,77,243456
1647,0.001547,172.217.194.0-255,1484,171492,77,243456
1648,0.001552,172.217.194.0-255,2902,174394,77,243456
1649,0.001555,172.31.40.0-255,66,174460,77,243456
1650,0.001559,172.217.194.0-255,2902,177362,77,243456
1651,0.001582,172.217.194.0-255,2902,180264,77,243456
1652,0.001589,172.217.194.0-255,7156,187420,77,243456
1653,0.001596,172.31.40.0-255,66,187486,77,243456
1654,0.001611,172.217.194.0-255,7156,194642,77,243456
1655,0.001625,172.217.194.0-255,5738,200380,77,243456
1656,0.001636,172.217.194.0-255,1484,201864,77,243456
1657,0.00164,172.217.194.0-255,2184,204048,77,243456
1658,0.001643,172.31.40.0-255,66,204114,77,243456
1659,0.002371,172.217.194.0-255,1484,205598,77,243456
1660,0.004036,172.217.194.0-255,4320,209918,77,243456
1661,0.004043,172.31.40.0-255,66,209984,77,243456
1662,0.006399,172.217.194.0-255,5738,215722,77,243456
1663,0.006404,172.31.40.0-255,66,215788,77,243456
1664,0.008789,172.217.194.0-255,5738,221526,77,243456
1665,0.008797,172.31.40.0-255,66,221592,77,243456
1666,0.011157,172.217.194.0-255,5738,227330,77,243456
1667,0.011164,172.31.40.0-255,66,227396,77,243456
1668,0.013543,172.217.194.0-255,4320,231716,77,243456
1669,0.013551,172.31.40.0-255,66,231782,77,243456
1670,0.013578,172.217.194.0-255,1484,233266,77,243456
1671,0.015922,172.217.194.0-255,4320,237586,77,243456
1672,0.01593,172.31.40.0-255,66,237652,77,243456
1673,0.018306,172.217.194.0-255,5738,243390,77,243456
1674,0.018315,172.31.40.0-255,66,243456,77,243456
1675,0.0,74.125.68.0-255,153,153,77,418178
1676,1.8e-05,172.31.40.0-255,66,219,77,418178
1677,4.1e-05,74.125.68.0-255,1484,1703,77,418178
1678,4.6e-05,172.31.40.0-255,66,1769,77,418178
1679,5.2e-05,74.125.68.0-255,2902,4671,77,418178
1680,5.6e-05,172.31.40.0-255,66,4737,77,418178
1681,6.9e-05,74.125.68.0-255,2902,7639,77,418178
1682,7.1e-05,172.31.40.0-255,66,7705,77,418178
1683,9e-05,74.125.68.0-255,2902,10607,77,418178
1684,9.2e-05,172.31.40.0-255,66,10673,77,418178
1685,9.8e-05,74.125.68.0-255,3401,14074,77,418178
1686,0.000101,172.31.40.0-255,66,14140,77,418178
1687,0.000287,74.125.68.0-255,1484,15624,77,418178
1688,0.000292,172.31.40.0-255,66,15690,77,418178
1689,0.000296,74.125.68.0-255,1484,17174,77,418178
1690,0.000298,172.31.40.0-255,66,17240,77,418178
1691,0.000303,74.125.68.0-255,2902,20142,77,418178
1692,0.000306,172.31.40.0-255,66,20208,77,418178
1693,0.000324,74.125.68.0-255,5738,25946,77,418178
1694,0.000326,172.31.40.0-255,66,26012,77,418178
1695,0.000343,74.125.68.0-255,5379,31391,77,418178
1696,0.000346,172.31.40.0-255,66,31457,77,418178
1697,0.000364,74.125.68.0-255,1484,32941,77,418178
1698,0.000367,172.31.40.0-255,66,33007,77,418178
1699,0.00038,74.125.68.0-255,4320,37327,77,418178
1700,0.000383,172.31.40.0-255,66,37393,77,418178
1701,0.000408,74.125.68.0-255,8574,45967,77,418178
1702,0.000411,172.31.40.0-255,66,46033,77,418178
1703,0.000442,74.125.68.0-255,2543,48576,77,418178
1704,0.000444,172.31.40.0-255,66,48642,77,418178
1705,0.000515,74.125.68.0-255,1484,50126,77,418178
1706,0.000519,172.31.40.0-255,66,50192,77,418178
1707,0.000542,74.125.68.0-255,2902,53094,77,418178
1708,0.000545,172.31.40.0-255,66,53160,77,418178
1709,0.00055,74.125.68.0-255,2902,56062,77,418178
1710,0.000552,172.31.40.0-255,66,56128,77,418178
1711,0.000579,74.125.68.0-255,4320,60448,77,418178
1712,0.000582,172.31.40.0-255,66,60514,77,418178
1713,0.000598,74.125.68.0-255,2902,63416,77,418178
1714,0.000602,172.31.40.0-255,66,63482,77,418178
1715,0.000616,74.125.68.0-255,2867,66349,77,418178
1716,0.00063,172.31.40.0-255,66,66415,77,418178
1717,0.000711,74.125.68.0-255,1484,67899,77,418178
1718,0.000716,74.125.68.0-255,1484,69383,77,418178
1719,0.000719,172.31.40.0-255,66,69449,77,418178
1720,0.000738,74.125.68.0-255,1484,70933,77,418178
1721,0.000741,74.125.68.0-255,1484,72417,77,418178
1722,0.000745,172.31.40.0-255,66,72483,77,418178
1723,0.000762,74.125.68.0-255,2902,75385,77,418178
1724,0.000765,172.31.40.0-255,66,75451,77,418178
1725,0.000771,74.125.68.0-255,5738,81189,77,418178
1726,0.000774,172.31.40.0-255,66,81255,77,418178
1727,0.000807,74.125.68.0-255,5379,86634,77,418178
1728,0.00081,172.31.40.0-255,66,86700,77,418178
1729,0.000834,74.125.68.0-255,1484,88184,77,418178
1730,0.000849,74.125.68.0-255,4320,92504,77,418178
1731,0.000852,172.31.40.0-255,66,92570,77,418178
1732,0.000857,74.125.68.0-255,2902,95472,77,418178
1733,0.000859,172.31.40.0-255,66,95538,77,418178
1734,0.000864,74.125.68.0-255,4320,99858,77,418178
1735,0.000866,172.31.40.0-255,66,99924,77,418178
1736,0.000896,74.125.68.0-255,1368,101292,77,418178
1737,0.000948,74.125.68.0-255,1484,102776,77,418178
1738,0.000965,172.31.40.0-255,66,102842,77,418178
1739,0.000971,74.125.68.0-255,2902,105744,77,418178
1740,0.000974,172.31.40.0-255,66,105810,77,418178
1741,0.000977,74.125.68.0-255,1484,107294,77,418178
1742,0.001006,74.125.68.0-255,4320,111614,77,418178
1743,0.001008,172.31.40.0-255,66,111680,77,418178
1744,0.001016,74.125.68.0-255,5738,117418,77,418178
1745,0.001019,172.31.40.0-255,66,117484,77,418178
1746,0.001048,74.125.68.0-255,7156,124640,77,418178
1747,0.001051,172.31.40.0-255,66,124706,77,418178
1748,0.001054,74.125.68.0-255,1484,126190,77,418178
1749,0.001059,74.125.68.0-255,2902,129092,77,418178
1750,0.001061,172.31.40.0-255,66,129158,77,418178
1751,0.001107,74.125.68.0-255,5738,134896,77,418178
1752,0.00111,172.31.40.0-255,66,134962,77,418178
1753,0.001112,74.125.68.0-255,766,135728,77,418178
1754,0.001194,74.125.68.0-255,1484,137212,77,418178
1755,0.001199,172.31.40.0-255,66,137278,77,418178
1756,0.001203,74.125.68.0-255,1484,138762,77,418178
1757,0.001206,74.125.68.0-255,1484,140246,77,418178
1758,0.001208,172.31.40.0-255,66,140312,77,418178
1759,0.001222,74.125.68.0-255,1484,141796,77,418178
1760,0.001249,74.125.68.0-255,5738,147534,77,418178
1761,0.001253,172.31.40.0-255,66,147600,77,418178
1762,0.001259,74.125.68.0-255,5738,153338,77,418178
1763,0.001262,172.31.40.0-255,66,153404,77,418178
1764,0.001291,74.125.68.0-255,4320,157724,77,418178
1765,0.001295,172.31.40.0-255,66,157790,77,418178
1766,0.001305,74.125.68.0-255,11410,169200,77,418178
1767,0.001309,172.31.40.0-255,66,169266,77,418178
1768,0.001311,74.125.68.0-255,766,170032,77,418178
1769,0.001354,74.125.68.0-255,1484,171516,77,418178
1770,0.001357,172.31.40.0-255,66,171582,77,418178
1771,0.001382,74.125.68.0-255,2902,174484,77,418178
1772,0.001385,172.31.40.0-255,66,174550,77,418178
1773,0.001391,74.125.68.0-255,5738,180288,77,418178
1774,0.001394,172.31.40.0-255,66,180354,77,418178
1775,0.00141,74.125.68.0-255,7156,187510,77,418178
1776,0.001412,172.31.40.0-255,66,187576,77,418178
1777,0.001424,74.125.68.0-255,1484,189060,77,418178
1778,0.001445,74.125.68.0-255,7156,196216,77,418178
1779,0.001448,172.31.40.0-255,66,196282,77,418178
1780,0.001453,74.125.68.0-255,2902,199184,77,418178
1781,0.001455,172.31.40.0-255,66,199250,77,418178
1782,0.001471,74.125.68.0-255,2902,202152,77,418178
1783,0.001473,172.31.40.0-255,66,202218,77,418178
1784,0.001509,74.125.68.0-255,2184,204402,77,418178
1785,0.001514,172.31.40.0-255,66,204468,77,418178
1786,0.002061,74.125.68.0-255,1484,205952,77,418178
1787,0.00207,74.125.68.0-255,2902,208854,77,418178
1788,0.002075,172.31.40.0-255,66,208920,77,418178
1789,0.002079,74.125.68.0-255,1484,210404,77,418178
1790,0.002101,74.125.68.0-255,4320,214724,77,418178
1791,0.002103,172.31.40.0-255,66,214790,77,418178
1792,0.002106,74.125.68.0-255,1484,216274,77,418178
1793,0.002137,74.125.68.0-255,11410,227684,77,418178
1794,0.00214,172.31.40.0-255,66,227750,77,418178
1795,0.00218,74.125.68.0-255,10692,238442,77,418178
1796,0.002183,172.31.40.0-255,66,238508,77,418178
1797,0.002225,74.125.68.0-255,1484,239992,77,418178
1798,0.002236,74.125.68.0-255,2902,242894,77,418178
1799,0.002238,172.31.40.0-255,66,242960,77,418178
1800,0.002262,74.125.68.0-255,2902,245862,77,418178
1801,0.002265,172.31.40.0-255,66,245928,77,418178
1802,0.002275,74.125.68.0-255,1484,247412,77,418178
1803,0.002279,74.125.68.0-255,1484,248896,77,418178
1804,0.002281,172.31.40.0-255,66,248962,77,418178
1805,0.002284,74.125.68.0-255,1484,250446,77,418178
1806,0.002292,74.125.68.0-255,1484,251930,77,418178
1807,0.002294,172.31.40.0-255,66,251996,77,418178
1808,0.002298,74.125.68.0-255,1484,253480,77,418178
1809,0.002322,74.125.68.0-255,4320,257800,77,418178
1810,0.002349,74.125.68.0-255,4320,262120,77,418178
1811,0.002356,74.125.68.0-255,7156,269276,77,418178
1812,0.002374,74.125.68.0-255,3602,272878,77,418178
1813,0.002388,74.125.68.0-255,2902,275780,77,418178
1814,0.002403,74.125.68.0-255,5738,281518,77,418178
1815,0.00241,74.125.68.0-255,4320,285838,77,418178
1816,0.002437,74.125.68.0-255,4320,290158,77,418178
1817,0.002444,74.125.68.0-255,5738,295896,77,418178
1818,0.002471,74.125.68.0-255,4320,300216,77,418178
1819,0.002498,74.125.68.0-255,6438,306654,77,418178
1820,0.002501,74.125.68.0-255,1484,308138,77,418178
1821,0.002515,74.125.68.0-255,1484,309622,77,418178
1822,0.002531,74.125.68.0-255,2902,312524,77,418178
1823,0.002533,74.125.68.0-255,1484,314008,77,418178
1824,0.002536,74.125.68.0-255,1484,315492,77,418178
1825,0.002595,74.125.68.0-255,1484,316976,77,418178
1826,0.002601,74.125.68.0-255,4320,321296,77,418178
1827,0.002606,74.125.68.0-255,5738,327034,77,418178
1828,0.002609,74.125.68.0-255,1484,328518,77,418178
1829,0.002628,74.125.68.0-255,7156,335674,77,418178
1830,0.002631,74.125.68.0-255,1484,337158,77,418178
1831,0.002648,74.125.68.0-255,2902,340060,77,418178
1832,0.002661,74.125.68.0-255,766,340826,77,418178
1833,0.002707,74.125.68.0-255,1484,342310,77,418178
1834,0.00272,74.125.68.0-255,1484,343794,77,418178
1835,0.002732,74.125.68.0-255,1484,345278,77,418178
1836,0.002743,74.125.68.0-255,1484,346762,77,418178
1837,0.002758,74.125.68.0-255,2902,349664,77,418178
1838,0.002773,74.125.68.0-255,4320,353984,77,418178
1839,0.002786,74.125.68.0-255,4320,358304,77,418178
1840,0.002788,74.125.68.0-255,1484,359788,77,418178
1841,0.002814,74.125.68.0-255,2902,362690,77,418178
1842,0.002835,74.125.68.0-255,4320,367010,77,418178
1843,0.002839,74.125.68.0-255,2902,369912,77,418178
1844,0.002843,74.125.68.0-255,4320,374232,77,418178
1845,0.002883,74.125.68.0-255,2902,377134,77,418178
1846,0.002893,74.125.68.0-255,2184,379318,77,418178
1847,0.002917,74.125.68.0-255,5738,385056,77,418178
1848,0.002921,74.125.68.0-255,2902,387958,77,418178
1849,0.002938,74.125.68.0-255,4320,392278,77,418178
1850,0.002959,74.125.68.0-255,5738,398016,77,418178
1851,0.002962,74.125.68.0-255,1484,399500,77,418178
1852,0.002964,74.125.68.0-255,1484,400984,77,418178
1853,0.002985,74.125.68.0-255,4320,405304,77,418178
1854,0.002996,74.125.68.0-255,1484,406788,77,418178
1855,0.00301,74.125.68.0-255,2184,408972,77,418178
1856,0.003027,74.125.68.0-255,2902,411874,77,418178
1857,0.003041,74.125.68.0-255,1484,413358,77,418178
1858,0.003055,74.125.68.0-255,1484,414842,77,418178
1859,0.003057,74.125.68.0-255,1484,416326,77,418178
1860,0.00306,74.125.68.0-255,1413,417739,77,418178
1861,0.003062,74.125.68.0-255,97,417836,77,418178
1862,0.00312,74.125.68.0-255,105,417941,77,418178
1863,0.004673,172.31.40.0-255,66,418007,77,418178
1864,0.007115,172.31.40.0-255,105,418112,77,418178
1865,0.009282,74.125.68.0-255,66,418178,77,418178
1866,0.0,74.125.68.0-255,146,146,77,312537
1867,2.4e-05,172.31.40.0-255,66,212,77,312537
1868,3.2e-05,74.125.68.0-255,1484,1696,77,312537
1869,3.7e-05,172.31.40.0-255,66,1762,77,312537
1870,4.2e-05,74.125.68.0-255,2902,4664,77,312537
1871,4.6e-05,172.31.40.0-255,66,4730,77,312537
1872,5.4e-05,74.125.68.0-255,7156,11886,77,312537
1873,5.8e-05,172.31.40.0-255,66,11952,77,312537
1874,6.2e-05,74.125.68.0-255,2164,14116,77,312537
1875,6.5e-05,172.31.40.0-255,66,14182,77,312537
1876,0.000103,74.125.68.0-255,1484,15666,77,312537
1877,0.000107,172.31.40.0-255,66,15732,77,312537
1878,0.000112,74.125.68.0-255,2902,18634,77,312537
1879,0.000114,172.31.40.0-255,66,18700,77,312537
1880,0.000145,74.125.68.0-255,5738,24438,77,312537
1881,0.000147,172.31.40.0-255,66,24504,77,312537
1882,0.000152,74.125.68.0-255,2902,27406,77,312537
1883,0.000154,172.31.40.0-255,66,27472,77,312537
1884,0.00017,74.125.68.0-255,3961,31433,77,312537
1885,0.000173,172.31.40.0-255,66,31499,77,312537
1886,0.000301,74.125.68.0-255,1484,32983,77,312537
1887,0.000304,172.31.40.0-255,66,33049,77,312537
1888,0.00031,74.125.68.0-255,2902,35951,77,312537
1889,0.000312,172.31.40.0-255,66,36017,77,312537
1890,0.000329,74.125.68.0-255,5738,41755,77,312537
1891,0.000331,172.31.40.0-255,66,41821,77,312537
1892,0.00035,74.125.68.0-255,1484,43305,77,312537
1893,0.000352,172.31.40.0-255,66,43371,77,312537
1894,0.000379,74.125.68.0-255,5379,48750,77,312537
1895,0.000381,172.31.40.0-255,66,48816,77,312537
1896,0.000388,74.125.68.0-255,7156,55972,77,312537
1897,0.000391,172.31.40.0-255,66,56038,77,312537
1898,0.000415,74.125.68.0-255,4320,60358,77,312537
1899,0.000417,172.31.40.0-255,66,60424,77,312537
1900,0.00044,74.125.68.0-255,5379,65803,77,312537
1901,0.000443,172.31.40.0-255,66,65869,77,312537
1902,0.000446,74.125.68.0-255,364,66233,77,312537
1903,0.000449,74.125.68.0-255,380,66613,77,312537
1904,0.000686,74.125.68.0-255,1484,68097,77,312537
1905,0.00069,172.31.40.0-255,66,68163,77,312537
1906,0.000696,74.125.68.0-255,2902,71065,77,312537
1907,0.000699,172.31.40.0-255,66,71131,77,312537
1908,0.000701,74.125.68.0-255,1484,72615,77,312537
1909,0.000728,74.125.68.0-255,1484,74099,77,312537
1910,0.000731,172.31.40.0-255,66,74165,77,312537
1911,0.000737,74.125.68.0-255,4320,78485,77,312537
1912,0.000739,172.31.40.0-255,66,78551,77,312537
1913,0.000744,74.125.68.0-255,4320,82871,77,312537
1914,0.000746,172.31.40.0-255,66,82937,77,312537
1915,0.000772,74.125.68.0-255,4320,87257,77,312537
1916,0.000775,172.31.40.0-255,66,87323,77,312537
1917,0.000782,74.125.68.0-255,7156,94479,77,312537
1918,0.000785,172.31.40.0-255,66,94545,77,312537
1919,0.000811,74.125.68.0-255,6438,100983,77,312537
1920,0.000814,172.31.40.0-255,66,101049,77,312537
1921,0.001008,74.125.68.0-255,1484,102533,77,312537
1922,0.001014,74.125.68.0-255,2902,105435,77,312537
1923,0.001017,172.31.40.0-255,66,105501,77,312537
1924,0.001038,74.125.68.0-255,5738,111239,77,312537
1925,0.001041,172.31.40.0-255,66,111305,77,312537
1926,0.001084,74.125.68.0-255,12828,124133,77,312537
1927,0.001088,172.31.40.0-255,66,124199,77,312537
1928,0.001112,74.125.68.0-255,2902,127101,77,312537
1929,0.001115,172.31.40.0-255,66,127167,77,312537
1930,0.001142,74.125.68.0-255,7856,135023,77,312537
1931,0.001145,172.31.40.0-255,66,135089,77,312537
1932,0.00162,74.125.68.0-255,1484,136573,77,312537
1933,0.001625,74.125.68.0-255,1484,138057,77,312537
1934,0.001628,172.31.40.0-255,66,138123,77,312537
1935,0.001647,74.125.68.0-255,1484,139607,77,312537
1936,0.001653,74.125.68.0-255,5738,145345,77,312537
1937,0.001655,172.31.40.0-255,66,145411,77,312537
1938,0.001685,74.125.68.0-255,8574,153985,77,312537
1939,0.001688,172.31.40.0-255,66,154051,77,312537
1940,0.001739,74.125.68.0-255,9992,164043,77,312537
1941,0.001741,172.31.40.0-255,66,164109,77,312537
1942,0.001747,74.125.68.0-255,5020,169129,77,312537
1943,0.001749,172.31.40.0-255,66,169195,77,312537
1944,0.001882,74.125.68.0-255,1484,170679,77,312537
1945,0.001886,74.125.68.0-255,1484,172163,77,312537
1946,0.001889,172.31.40.0-255,66,172229,77,312537
1947,0.001906,74.125.68.0-255,1484,173713,77,312537
1948,0.001913,74.125.68.0-255,5738,179451,77,312537
1949,0.001916,172.31.40.0-255,66,179517,77,312537
1950,0.001933,74.125.68.0-255,5738,185255,77,312537
1951,0.001935,172.31.40.0-255,66,185321,77,312537
1952,0.001939,74.125.68.0-255,1484,186805,77,312537
1953,0.001963,74.125.68.0-255,5738,192543,77,312537
1954,0.001966,172.31.40.0-255,66,192609,77,312537
1955,0.001985,74.125.68.0-255,2902,195511,77,312537
1956,0.001987,172.31.40.0-255,66,195577,77,312537
1957,0.002005,74.125.68.0-255,7856,203433,77,312537
1958,0.002007,172.31.40.0-255,66,203499,77,312537
1959,0.002036,74.125.68.0-255,11410,214909,77,312537
1960,0.002039,172.31.40.0-255,66,214975,77,312537
1961,0.002044,74.125.68.0-255,4320,219295,77,312537
1962,0.002046,172.31.40.0-255,66,219361,77,312537
1963,0.00208,74.125.68.0-255,8574,227935,77,312537
1964,0.002085,172.31.40.0-255,66,228001,77,312537
1965,0.002108,74.125.68.0-255,8574,236575,77,312537
1966,0.002111,172.31.40.0-255,66,236641,77,312537
1967,0.002114,74.125.68.0-255,766,237407,77,312537
1968,0.00216,74.125.68.0-255,1484,238891,77,312537
1969,0.002164,172.31.40.0-255,66,238957,77,312537
1970,0.002177,74.125.68.0-255,2902,241859,77,312537
1971,0.002179,172.31.40.0-255,66,241925,77,312537
1972,0.002182,74.125.68.0-255,1484,243409,77,312537
1973,0.002205,74.125.68.0-255,2902,246311,77,312537
1974,0.002208,172.31.40.0-255,66,246377,77,312537
1975,0.002215,74.125.68.0-255,5738,252115,77,312537
1976,0.002217,172.31.40.0-255,66,252181,77,312537
1977,0.002248,74.125.68.0-255,5738,257919,77,312537
1978,0.002252,172.31.40.0-255,66,257985,77,312537
1979,0.002259,74.125.68.0-255,7156,265141,77,312537
1980,0.002262,172.31.40.0-255,66,265207,77,312537
1981,0.002279,74.125.68.0-255,4320,269527,77,312537
1982,0.002282,172.31.40.0-255,66,269593,77,312537
1983,0.002303,74.125.68.0-255,2184,271777,77,312537
1984,0.002305,172.31.40.0-255,66,271843,77,312537
1985,0.004524,74.125.68.0-255,1484,273327,77,312537
1986,0.004543,74.125.68.0-255,4320,277647,77,312537
1987,0.004548,172.31.40.0-255,66,277713,77,312537
1988,0.006794,74.125.68.0-255,5738,283451,77,312537
1989,0.006803,172.31.40.0-255,66,283517,77,312537
1990,0.009054,74.125.68.0-255,5738,289255,77,312537
1991,0.00906,172.31.40.0-255,66,289321,77,312537
1992,0.011323,74.125.68.0-255,5738,295059,77,312537
1993,0.01133,172.31.40.0-255,66,295125,77,312537
1994,0.013596,74.125.68.0-255,5738,300863,77,312537
1995,0.013603,172.31.40.0-255,66,300929,77,312537
1996,0.016057,74.125.68.0-255,5738,306667,77,312537
1997,0.016064,172.31.40.0-255,66,306733,77,312537
1998,0.018326,74.125.68.0-255,5738,312471,77,312537
1999,0.018332,172.31.40.0-255,66,312537,77,312537
2000,0.0,172.31.40.0-255,105,105,77,105
2001,0.0,216.58.221.0-255,153,153,77,153390
2002,2.4e-05,172.31.40.0-255,66,219,77,153390
2003,3.1e-05,216.58.221.0-255,1484,1703,77,153390
2004,3.5e-05,172.31.40.0-255,66,1769,77,153390
2005,4.1e-05,216.58.221.0-255,2902,4671,77,153390
2006,4.5e-05,172.31.40.0-255,66,4737,77,153390
2007,5.2e-05,216.58.221.0-255,7156,11893,77,153390
2008,5.5e-05,172.31.40.0-255,66,11959,77,153390
2009,7.8e-05,216.58.221.0-255,1999,13958,77,153390
2010,8.1e-05,172.31.40.0-255,66,14024,77,153390
2011,8.6e-05,216.58.221.0-255,2902,16926,77,153390
2012,8.8e-05,172.31.40.0-255,66,16992,77,153390
2013,9.3e-05,216.58.221.0-255,2902,19894,77,153390
2014,9.5e-05,172.31.40.0-255,66,19960,77,153390
2015,0.000123,216.58.221.0-255,4320,24280,77,153390
2016,0.000126,172.31.40.0-255,66,24346,77,153390
2017,0.000133,216.58.221.0-255,6797,31143,77,153390
2018,0.000136,172.31.40.0-255,66,31209,77,153390
2019,0.000327,216.58.221.0-255,1484,32693,77,153390
2020,0.000332,172.31.40.0-255,66,32759,77,153390
2021,0.000339,216.58.221.0-255,2902,35661,77,153390
2022,0.000342,172.31.40.0-255,66,35727,77,153390
2023,0.000348,216.58.221.0-255,5738,41465,77,153390
2024,0.000351,172.31.40.0-255,66,41531,77,153390
2025,0.000402,216.58.221.0-255,6797,48328,77,153390
2026,0.000406,172.31.40.0-255,66,48394,77,153390
2027,0.000776,216.58.221.0-255,1484,49878,77,153390
2028,0.000781,172.31.40.0-255,66,49944,77,153390
2029,0.000787,216.58.221.0-255,2902,52846,77,153390
2030,0.000789,172.31.40.0-255,66,52912,77,153390
2031,0.000793,216.58.221.0-255,1484,54396,77,153390
2032,0.000795,172.31.40.0-255,66,54462,77,153390
2033,0.000824,216.58.221.0-255,4320,58782,77,153390
2034,0.000827,172.31.40.0-255,66,58848,77,153390
2035,0.000832,216.58.221.0-255,4320,63168,77,153390
2036,0.000834,172.31.40.0-255,66,63234,77,153390
2037,0.000855,216.58.221.0-255,1484,64718,77,153390
2038,0.000872,216.58.221.0-255,1454,66172,77,153390
2039,0.000875,172.31.40.0-255,66,66238,77,153390
2040,0.001123,216.58.221.0-255,1484,67722,77,153390
2041,0.00113,216.58.221.0-255,2902,70624,77,153390
2042,0.001133,172.31.40.0-255,66,70690,77,153390
2043,0.001137,216.58.221.0-255,1484,72174,77,153390
2044,0.001155,216.58.221.0-255,4320,76494,77,153390
2045,0.001157,172.31.40.0-255,66,76560,77,153390
2046,0.001162,216.58.221.0-255,2902,79462,77,153390
2047,0.001164,172.31.40.0-255,66,79528,77,153390
2048,0.001181,216.58.221.0-255,4243,83771,77,153390
2049,0.001183,172.31.40.0-255,66,83837,77,153390
2050,0.001218,216.58.221.0-255,4320,88157,77,153390
2051,0.001221,172.31.40.0-255,66,88223,77,153390
2052,0.001229,216.58.221.0-255,5738,93961,77,153390
2053,0.001231,172.31.40.0-255,66,94027,77,153390
2054,0.001267,216.58.221.0-255,4320,98347,77,153390
2055,0.001271,172.31.40.0-255,66,98413,77,153390
2056,0.001286,216.58.221.0-255,2543,100956,77,153390
2057,0.001288,172.31.40.0-255,66,101022,77,153390
2058,0.003151,216.58.221.0-255,2902,103924,77,153390
2059,0.003159,172.31.40.0-255,66,103990,77,153390
2060,0.003179,216.58.221.0-255,2902,106892,77,153390
2061,0.003181,172.31.40.0-255,66,106958,77,153390
2062,0.005086,216.58.221.0-255,5738,112696,77,153390
2063,0.005088,172.31.40.0-255,66,112762,77,153390
2064,0.006977,216.58.221.0-255,5738,118500,77,153390
2065,0.006983,172.31.40.0-255,66,118566,77,153390
2066,0.008876,216.58.221.0-255,5738,124304,77,153390
2067,0.008883,172.31.40.0-255,66,124370,77,153390
2068,0.010802,216.58.221.0-255,5738,130108,77,153390
2069,0.010809,172.31.40.0-255,66,130174,77,153390
2070,0.012704,216.58.221.0-255,5738,135912,77,153390
2071,0.012712,172.31.40.0-255,66,135978,77,153390
2072,0.014607,216.58.221.0-255,5738,141716,77,153390
2073,0.014619,172.31.40.0-255,66,141782,77,153390
2074,0.016519,216.58.221.0-255,5738,147520,77,153390
2075,0.016526,172.31.40.0-255,66,147586,77,153390
2076,0.018418,216.58.221.0-255,5738,153324,77,153390
2077,0.018422,172.31.40.0-255,66,153390,77,153390
2078,0.0,172.217.194.0-255,153,153,77,356969
2079,2.3e-05,172.31.40.0-255,66,219,77,356969
2080,3e-05,172.217.194.0-255,1484,1703,77,356969
2081,3.5e-05,172.31.40.0-255,66,1769,77,356969
2082,4e-05,172.217.194.0-255,2902,4671,77,356969
2083,4.3e-05,172.31.40.0-255,66,4737,77,356969
2084,4.7e-05,172.217.194.0-255,2902,7639,77,356969
2085,5e-05,172.31.40.0-255,66,7705,77,356969
2086,5.5e-05,172.217.194.0-255,4320,12025,77,356969
2087,5.8e-05,172.31.40.0-255,66,12091,77,356969
2088,9.4e-05,172.217.194.0-255,9189,21280,77,356969
2089,9.8e-05,172.31.40.0-255,66,21346,77,356969
2090,0.000106,172.217.194.0-255,7156,28502,77,356969
2091,0.000109,172.31.40.0-255,66,28568,77,356969
2092,0.000133,172.217.194.0-255,2543,31111,77,356969
2093,0.000136,172.31.40.0-255,66,31177,77,356969
2094,0.00018,172.217.194.0-255,1484,32661,77,356969
2095,0.000183,172.31.40.0-255,66,32727,77,356969
2096,0.000201,172.217.194.0-255,2902,35629,77,356969
2097,0.000204,172.31.40.0-255,66,35695,77,356969
2098,0.00021,172.217.194.0-255,5738,41433,77,356969
2099,0.000212,172.31.40.0-255,66,41499,77,356969
2100,0.000242,172.217.194.0-255,9992,51491,77,356969
2101,0.000245,172.31.40.0-255,66,51557,77,356969
2102,0.000266,172.217.194.0-255,3961,55518,77,356969
2103,0.000269,172.31.40.0-255,66,55584,77,356969
2104,0.000278,172.217.194.0-255,8574,64158,77,356969
2105,0.000281,172.31.40.0-255,66,64224,77,356969
2106,0.00031,172.217.194.0-255,1746,65970,77,356969
2107,0.000313,172.31.40.0-255,66,66036,77,356969
2108,0.000488,172.217.194.0-255,1484,67520,77,356969
2109,0.000492,172.31.40.0-255,66,67586,77,356969
2110,0.000498,172.217.194.0-255,2902,70488,77,356969
2111,0.000504,172.217.194.0-255,2902,73390,77,356969
2112,0.000522,172.217.194.0-255,2902,76292,77,356969
2113,0.000527,172.217.194.0-255,2902,79194,77,356969
2114,0.000546,172.217.194.0-255,9992,89186,77,356969
2115,0.000555,172.217.194.0-255,8574,97760,77,356969
2116,0.000569,172.217.194.0-255,2184,99944,77,356969
2117,0.000573,172.31.40.0-255,66,100010,77,356969
2118,0.000818,172.217.194.0-255,1484,101494,77,356969
2119,0.000825,172.217.194.0-255,2902,104396,77,356969
2120,0.000843,172.217.194.0-255,5738,110134,77,356969
2121,0.000848,172.217.194.0-255,4320,114454,77,356969
2122,0.000858,172.31.40.0-255,66,114520,77,356969
2123,0.000886,172.217.194.0-255,11410,125930,77,356969
2124,0.000929,172.31.40.0-255,66,125996,77,356969
2125,0.000942,172.217.194.0-255,7856,133852,77,356969
2126,0.000946,172.31.40.0-255,66,133918,77,356969
2127,0.000966,172.217.194.0-255,5738,139656,77,356969
2128,0.000974,172.217.194.0-255,7156,146812,77,356969
2129,0.000988,172.31.40.0-255,66,146878,77,356969
2130,0.000998,172.217.194.0-255,5738,152616,77,356969
2131,0.001003,172.31.40.0-255,66,152682,77,356969
2132,0.001016,172.217.194.0-255,8574,161256,77,356969
2133,0.001023,172.217.194.0-255,6438,167694,77,356969
2134,0.001054,172.31.40.0-255,66,167760,77,356969
2135,0.001185,172.31.40.0-255,101,167861,77,356969
2136,0.001333,172.217.194.0-255,1484,169345,77,356969
2137,0.00134,172.217.194.0-255,2902,172247,77,356969
2138,0.001343,172.31.40.0-255,66,172313,77,356969
2139,0.001348,172.217.194.0-255,2902,175215,77,356969
2140,0.001363,172.217.194.0-255,2902,178117,77,356969
2141,0.001369,172.217.194.0-255,5738,183855,77,356969
2142,0.001377,172.31.40.0-255,66,183921,77,356969
2143,0.001381,172.217.194.0-255,2902,186823,77,356969
2144,0.001386,172.31.40.0-255,66,186889,77,356969
2145,0.001404,172.217.194.0-255,9992,196881,77,356969
2146,0.001409,172.217.194.0-255,5020,201901,77,356969
2147,0.001428,172.31.40.0-255,66,201967,77,356969
2148,0.001479,172.217.194.0-255,1484,203451,77,356969
2149,0.001483,172.217.194.0-255,1484,204935,77,356969
2150,0.001492,172.31.40.0-255,66,205001,77,356969
2151,0.001495,172.217.194.0-255,1484,206485,77,356969
2152,0.001498,172.217.194.0-255,1484,207969,77,356969
2153,0.001502,172.31.40.0-255,66,208035,77,356969
2154,0.001515,172.217.194.0-255,4320,212355,77,356969
2155,0.001523,172.217.194.0-255,5738,218093,77,356969
2156,0.001545,172.31.40.0-255,66,218159,77,356969
2157,0.001555,172.217.194.0-255,9992,228151,77,356969
2158,0.00156,172.31.40.0-255,66,228217,77,356969
2159,0.001571,172.217.194.0-255,7156,235373,77,356969
2160,0.001573,172.217.194.0-255,766,236139,77,356969
2161,0.001597,172.31.40.0-255,66,236205,77,356969
2162,0.001618,172.217.194.0-255,5738,241943,77,356969
2163,0.001621,172.217.194.0-255,1484,243427,77,356969
2164,0.001636,172.31.40.0-255,66,243493,77,356969
2165,0.001647,172.217.194.0-255,5738,249231,77,356969
2166,0.001659,172.217.194.0-255,5738,254969,77,356969
2167,0.001665,172.31.40.0-255,66,255035,77,356969
2168,0.001688,172.217.194.0-255,8574,263609,77,356969
2169,0.001695,172.217.194.0-255,6438,270047,77,356969
2170,0.001706,172.31.40.0-255,66,270113,77,356969
2171,0.001761,172.217.194.0-255,1484,271597,77,356969
2172,0.001776,172.217.194.0-255,2902,274499,77,356969
2173,0.001782,172.217.194.0-255,4320,278819,77,356969
2174,0.001795,172.217.194.0-255,1484,280303,77,356969
2175,0.001803,172.31.40.0-255,66,280369,77,356969
2176,0.001833,172.217.194.0-255,12828,293197,77,356969
2177,0.001842,172.217.194.0-255,8574,301771,77,356969
2178,0.001868,172.217.194.0-255,2184,303955,77,356969
2179,0.001874,172.31.40.0-255,66,304021,77,356969
2180,0.001882,172.217.194.0-255,2902,306923,77,356969
2181,0.001888,172.31.40.0-255,66,306989,77,356969
2182,0.0019,172.217.194.0-255,7156,314145,77,356969
2183,0.001971,172.217.194.0-255,12828,326973,77,356969
2184,0.001985,172.31.40.0-255,66,327039,77,356969
2185,0.001995,172.217.194.0-255,3602,330641,77,356969
2186,0.002005,172.217.194.0-255,11410,342051,77,356969
2187,0.00201,172.31.40.0-255,66,342117,77,356969
2188,0.002037,172.217.194.0-255,4320,346437,77,356969
2189,0.002046,172.31.40.0-255,66,346503,77,356969
2190,0.002093,172.217.194.0-255,9992,356495,77,356969
2191,0.002109,172.31.40.0-255,66,356561,77,356969
2192,0.002125,172.217.194.0-255,105,356666,77,356969
2193,0.002141,172.31.40.0-255,66,356732,77,356969
2194,0.003366,172.217.194.0-255,66,356798,77,356969
2195,0.004296,172.31.40.0-255,105,356903,77,356969
2196,0.006459,172.217.194.0-255,66,356969,77,356969
2197,0.0,172.31.40.0-255,105,105,77,459
2198,0.000221,172.31.40.0-255,90,195,77,459
2199,0.000229,172.31.40.0-255,66,261,77,459
2200,0.002585,172.217.194.0-255,66,327,77,459
2201,0.002607,172.217.194.0-255,66,393,77,459
2202,0.002624,172.31.40.0-255,66,459,77,459
2203,0.0,172.217.194.0-255,153,153,77,397628
2204,1.1e-05,172.31.40.0-255,66,219,77,397628
2205,1.7e-05,172.217.194.0-255,1484,1703,77,397628
2206,2.1e-05,172.31.40.0-255,66,1769,77,397628
2207,5.3e-05,172.217.194.0-255,2902,4671,77,397628
2208,5.6e-05,172.31.40.0-255,66,4737,77,397628
2209,6.1e-05,172.217.194.0-255,2902,7639,77,397628
2210,6.3e-05,172.31.40.0-255,66,7705,77,397628
2211,8.7e-05,172.217.194.0-255,2902,10607,77,397628
2212,9e-05,172.31.40.0-255,66,10673,77,397628
2213,9.3e-05,172.217.194.0-255,1484,12157,77,397628
2214,9.5e-05,172.31.40.0-255,66,12223,77,397628
2215,0.000124,172.217.194.0-255,2067,14290,77,397628
2216,0.000127,172.31.40.0-255,66,14356,77,397628
2217,0.000188,172.217.194.0-255,1484,15840,77,397628
2218,0.000191,172.31.40.0-255,66,15906,77,397628
2219,0.00021,172.217.194.0-255,2902,18808,77,397628
2220,0.000213,172.31.40.0-255,66,18874,77,397628
2221,0.000216,172.217.194.0-255,1484,20358,77,397628
2222,0.000218,172.31.40.0-255,66,20424,77,397628
2223,0.000247,172.217.194.0-255,2902,23326,77,397628
2224,0.00025,172.31.40.0-255,66,23392,77,397628
2225,0.000277,172.217.194.0-255,1484,24876,77,397628
2226,0.000279,172.31.40.0-255,66,24942,77,397628
2227,0.000311,172.217.194.0-255,6797,31739,77,397628
2228,0.000314,172.31.40.0-255,66,31805,77,397628
2229,0.00056,172.217.194.0-255,1484,33289,77,397628
2230,0.000565,172.31.40.0-255,66,33355,77,397628
2231,0.000572,172.217.194.0-255,2902,36257,77,397628
2232,0.000575,172.31.40.0-255,66,36323,77,397628
2233,0.000578,172.217.194.0-255,1484,37807,77,397628
2234,0.000584,172.31.40.0-255,66,37873,77,397628
2235,0.000613,172.217.194.0-255,4320,42193,77,397628
2236,0.000616,172.31.40.0-255,66,42259,77,397628
2237,0.000624,172.217.194.0-255,6797,49056,77,397628
2238,0.000626,172.31.40.0-255,66,49122,77,397628
2239,0.000658,172.217.194.0-255,2902,52024,77,397628
2240,0.00066,172.31.40.0-255,66,52090,77,397628
2241,0.000697,172.217.194.0-255,11410,63500,77,397628
2242,0.000701,172.217.194.0-255,2543,66043,77,397628
2243,0.000703,172.217.194.0-255,363,66406,77,397628
2244,0.000708,172.31.40.0-255,66,66472,77,397628
2245,0.000711,172.31.40.0-255,66,66538,77,397628
2246,0.000838,172.217.194.0-255,380,66918,77,397628
2247,0.001111,172.217.194.0-255,1484,68402,77,397628
2248,0.001115,172.31.40.0-255,66,68468,77,397628
2249,0.00112,172.217.194.0-255,1484,69952,77,397628
2250,0.001139,172.217.194.0-255,1484,71436,77,397628
2251,0.001142,172.31.40.0-255,66,71502,77,397628
2252,0.001148,172.217.194.0-255,5738,77240,77,397628
2253,0.00115,172.31.40.0-255,66,77306,77,397628
2254,0.001163,172.217.194.0-255,8574,85880,77,397628
2255,0.001166,172.31.40.0-255,66,85946,77,397628
2256,0.001212,172.217.194.0-255,4320,90266,77,397628
2257,0.001216,172.31.40.0-255,66,90332,77,397628
2258,0.001227,172.217.194.0-255,10692,101024,77,397628
2259,0.001228,172.31.40.0-255,66,101090,77,397628
2260,0.00132,172.217.194.0-255,1484,102574,77,397628
2261,0.001324,172.217.194.0-255,1484,104058,77,397628
2262,0.001326,172.31.40.0-255,66,104124,77,397628
2263,0.001353,172.217.194.0-255,1484,105608,77,397628
2264,0.001359,172.217.194.0-255,5738,111346,77,397628
2265,0.001366,172.217.194.0-255,7156,118502,77,397628
2266,0.001391,172.31.40.0-255,66,118568,77,397628
2267,0.001394,172.31.40.0-255,66,118634,77,397628
2268,0.001401,172.217.194.0-255,5738,124372,77,397628
2269,0.001403,172.31.40.0-255,66,124438,77,397628
2270,0.001417,172.217.194.0-255,10692,135130,77,397628
2271,0.001419,172.31.40.0-255,66,135196,77,397628
2272,0.001467,172.217.194.0-255,1484,136680,77,397628
2273,0.001481,172.217.194.0-255,2902,139582,77,397628
2274,0.001484,172.31.40.0-255,66,139648,77,397628
2275,0.001489,172.217.194.0-255,2902,142550,77,397628
2276,0.00149,172.31.40.0-255,66,142616,77,397628
2277,0.001514,172.217.194.0-255,2902,145518,77,397628
2278,0.001516,172.31.40.0-255,66,145584,77,397628
2279,0.001528,172.217.194.0-255,12828,158412,77,397628
2280,0.00153,172.31.40.0-255,66,158478,77,397628
2281,0.001536,172.217.194.0-255,4320,162798,77,397628
2282,0.001539,172.31.40.0-255,66,162864,77,397628
2283,0.001573,172.217.194.0-255,6438,169302,77,397628
2284,0.001576,172.31.40.0-255,66,169368,77,397628
2285,0.001653,172.217.194.0-255,1484,170852,77,397628
2286,0.001658,172.217.194.0-255,2902,173754,77,397628
2287,0.001661,172.31.40.0-255,66,173820,77,397628
2288,0.001664,172.217.194.0-255,1484,175304,77,397628
2289,0.00169,172.217.194.0-255,4320,179624,77,397628
2290,0.001693,172.31.40.0-255,66,179690,77,397628
2291,0.0017,172.217.194.0-255,5738,185428,77,397628
2292,0.001702,172.31.40.0-255,66,185494,77,397628
2293,0.00173,172.217.194.0-255,12828,198322,77,397628
2294,0.001733,172.31.40.0-255,66,198388,77,397628
2295,0.001743,172.217.194.0-255,5020,203408,77,397628
2296,0.001745,172.31.40.0-255,66,203474,77,397628
2297,0.001789,172.217.194.0-255,1484,204958,77,397628
2298,0.001792,172.217.194.0-255,1484,206442,77,397628
2299,0.001801,172.31.40.0-255,66,206508,77,397628
2300,0.001805,172.217.194.0-255,1484,207992,77,397628
2301,0.001808,172.217.194.0-255,1484,209476,77,397628
2302,0.00181,172.31.40.0-255,66,209542,77,397628
2303,0.001839,172.217.194.0-255,4320,213862,77,397628
2304,0.001842,172.31.40.0-255,66,213928,77,397628
2305,0.001847,172.217.194.0-255,4320,218248,77,397628
2306,0.00185,172.31.40.0-255,66,218314,77,397628
2307,0.001886,172.217.194.0-255,8574,226888,77,397628
2308,0.001896,172.217.194.0-255,10692,237580,77,397628
2309,0.001931,172.31.40.0-255,66,237646,77,397628
2310,0.001933,172.31.40.0-255,66,237712,77,397628
2311,0.001966,172.217.194.0-255,11410,249122,77,397628
2312,0.001988,172.217.194.0-255,4320,253442,77,397628
2313,0.001995,172.31.40.0-255,66,253508,77,397628
2314,0.001998,172.31.40.0-255,66,253574,77,397628
2315,0.002011,172.31.40.0-255,66,253640,77,397628
2316,0.002014,172.217.194.0-255,766,254406,77,397628
2317,0.002021,172.217.194.0-255,5738,260144,77,397628
2318,0.002031,172.217.194.0-255,9992,270136,77,397628
2319,0.002036,172.31.40.0-255,66,270202,77,397628
2320,0.002038,172.31.40.0-255,66,270268,77,397628
2321,0.002065,172.217.194.0-255,2902,273170,77,397628
2322,0.002067,172.31.40.0-255,66,273236,77,397628
2323,0.002089,172.217.194.0-255,11410,284646,77,397628
2324,0.002092,172.31.40.0-255,66,284712,77,397628
2325,0.002098,172.217.194.0-255,3602,288314,77,397628
2326,0.0021,172.31.40.0-255,66,288380,77,397628
2327,0.002144,172.217.194.0-255,1484,289864,77,397628
2328,0.00216,172.217.194.0-255,2902,292766,77,397628
2329,0.002178,172.217.194.0-255,5738,298504,77,397628
2330,0.002198,172.217.194.0-255,4320,302824,77,397628
2331,0.002218,172.217.194.0-255,2902,305726,77,397628
2332,0.002242,172.217.194.0-255,7156,312882,77,397628
2333,0.00227,172.217.194.0-255,7156,320038,77,397628
2334,0.002273,172.217.194.0-255,2184,322222,77,397628
2335,0.002294,172.217.194.0-255,1484,323706,77,397628
2336,0.002314,172.217.194.0-255,2902,326608,77,397628
2337,0.002329,172.217.194.0-255,4320,330928,77,397628
2338,0.002331,172.217.194.0-255,1484,332412,77,397628
2339,0.002346,172.217.194.0-255,1484,333896,77,397628
2340,0.00235,172.217.194.0-255,1484,335380,77,397628
2341,0.002378,172.217.194.0-255,4320,339700,77,397628
2342,0.002391,172.217.194.0-255,2902,342602,77,397628
2343,0.002418,172.217.194.0-255,5738,348340,77,397628
2344,0.002422,172.217.194.0-255,2902,351242,77,397628
2345,0.002443,172.217.194.0-255,1484,352726,77,397628
2346,0.002456,172.217.194.0-255,2902,355628,77,397628
2347,0.002472,172.217.194.0-255,766,356394,77,397628
2348,0.002496,172.217.194.0-255,4320,360714,77,397628
2349,0.002509,172.217.194.0-255,4320,365034,77,397628
2350,0.002526,172.217.194.0-255,1484,366518,77,397628
2351,0.002533,172.217.194.0-255,5738,372256,77,397628
2352,0.00256,172.217.194.0-255,5738,377994,77,397628
2353,0.002566,172.217.194.0-255,5738,383732,77,397628
2354,0.002609,172.217.194.0-255,4320,388052,77,397628
2355,0.002633,172.217.194.0-255,5020,393072,77,397628
2356,0.002651,172.217.194.0-255,3864,396936,77,397628
2357,0.002671,172.217.194.0-255,105,397041,77,397628
2358,0.011111,172.31.40.0-255,66,397107,77,397628
2359,0.011323,172.31.40.0-255,101,397208,77,397628
2360,0.011375,172.217.194.0-255,105,397313,77,397628
2361,0.011386,172.31.40.0-255,78,397391,77,397628
2362,0.013342,172.217.194.0-255,66,397457,77,397628
2363,0.013749,172.31.40.0-255,105,397562,77,397628
2364,0.015795,172.217.194.0-255,66,397628,77,397628
2365,0.0,172.31.40.0-255,105,105,77,210
2366,0.00178,157.240.25.0-255,105,210,77,210
2367,0.0,74.125.200.0-255,155,155,77,372772
2368,1.7e-05,172.31.40.0-255,66,221,77,372772
2369,2.4e-05,74.125.200.0-255,1484,1705,77,372772
2370,2.9e-05,172.31.40.0-255,66,1771,77,372772
2371,4.1e-05,74.125.200.0-255,2902,4673,77,372772
2372,4.4e-05,172.31.40.0-255,66,4739,77,372772
2373,5.2e-05,74.125.200.0-255,5738,10477,77,372772
2374,5.5e-05,172.31.40.0-255,66,10543,77,372772
2375,7.5e-05,74.125.200.0-255,1484,12027,77,372772
2376,8.2e-05,172.31.40.0-255,66,12093,77,372772
2377,8.7e-05,74.125.200.0-255,2026,14119,77,372772
2378,9e-05,172.31.40.0-255,66,14185,77,372772
2379,9.5e-05,74.125.200.0-255,2902,17087,77,372772
2380,9.7e-05,172.31.40.0-255,66,17153,77,372772
2381,0.000105,74.125.200.0-255,7156,24309,77,372772
2382,0.000107,172.31.40.0-255,66,24375,77,372772
2383,0.000112,74.125.200.0-255,4320,28695,77,372772
2384,0.000115,172.31.40.0-255,66,28761,77,372772
2385,0.000147,74.125.200.0-255,2543,31304,77,372772
2386,0.000149,172.31.40.0-255,66,31370,77,372772
2387,0.000222,74.125.200.0-255,1484,32854,77,372772
2388,0.000226,172.31.40.0-255,66,32920,77,372772
2389,0.000248,74.125.200.0-255,2902,35822,77,372772
2390,0.000251,172.31.40.0-255,66,35888,77,372772
2391,0.000265,74.125.200.0-255,2902,38790,77,372772
2392,0.000268,172.31.40.0-255,66,38856,77,372772
2393,0.000275,74.125.200.0-255,1484,40340,77,372772
2394,0.000277,172.31.40.0-255,66,40406,77,372772
2395,0.000307,74.125.200.0-255,2902,43308,77,372772
2396,0.00031,172.31.40.0-255,66,43374,77,372772
2397,0.000316,74.125.200.0-255,5738,49112,77,372772
2398,0.000318,172.31.40.0-255,66,49178,77,372772
2399,0.000355,74.125.200.0-255,2543,51721,77,372772
2400,0.000358,172.31.40.0-255,66,51787,77,372772
2401,0.000366,74.125.200.0-255,8574,60361,77,372772
2402,0.000368,172.31.40.0-255,66,60427,77,372772
2403,0.000374,74.125.200.0-255,5653,66080,77,372772
2404,0.000377,172.31.40.0-255,66,66146,77,372772
2405,0.00038,74.125.200.0-255,135,66281,77,372772
2406,0.000499,74.125.200.0-255,343,66624,77,372772
2407,0.000766,74.125.200.0-255,1484,68108,77,372772
2408,0.00077,172.31.40.0-255,66,68174,77,372772
2409,0.000774,74.125.200.0-255,1484,69658,77,372772
2410,0.000797,74.125.200.0-255,1484,71142,77,372772
2411,0.000799,172.31.40.0-255,66,71208,77,372772
2412,0.000805,74.125.200.0-255,5738,76946,77,372772
2413,0.000807,172.31.40.0-255,66,77012,77,372772
2414,0.000843,74.125.200.0-255,11410,88422,77,372772
2415,0.000846,172.31.40.0-255,66,88488,77,372772
2416,0.000849,74.125.200.0-255,1484,89972,77,372772
2417,0.000878,74.125.200.0-255,10692,100664,77,372772
2418,0.00088,172.31.40.0-255,66,100730,77,372772
2419,0.000969,74.125.200.0-255,1484,102214,77,372772
2420,0.000987,74.125.200.0-255,2902,105116,77,372772
2421,0.000989,172.31.40.0-255,66,105182,77,372772
2422,0.000993,74.125.200.0-255,2902,108084,77,372772
2423,0.000995,172.31.40.0-255,66,108150,77,372772
2424,0.001016,74.125.200.0-255,2902,111052,77,372772
2425,0.001021,172.31.40.0-255,66,111118,77,372772
2426,0.001039,74.125.200.0-255,2902,114020,77,372772
2427,0.001041,172.31.40.0-255,66,114086,77,372772
2428,0.00107,74.125.200.0-255,7156,121242,77,372772
2429,0.001073,172.31.40.0-255,66,121308,77,372772
2430,0.001075,74.125.200.0-255,1484,122792,77,372772
2431,0.001113,74.125.200.0-255,9992,132784,77,372772
2432,0.001115,172.31.40.0-255,66,132850,77,372772
2433,0.001119,74.125.200.0-255,2184,135034,77,372772
2434,0.00112,172.31.40.0-255,66,135100,77,372772
2435,0.001214,74.125.200.0-255,1484,136584,77,372772
2436,0.001219,74.125.200.0-255,2902,139486,77,372772
2437,0.001222,172.31.40.0-255,66,139552,77,372772
2438,0.001252,74.125.200.0-255,5738,145290,77,372772
2439,0.001254,172.31.40.0-255,66,145356,77,372772
2440,0.001278,74.125.200.0-255,2902,148258,77,372772
2441,0.001281,172.31.40.0-255,66,148324,77,372772
2442,0.001305,74.125.200.0-255,8574,156898,77,372772
2443,0.001307,172.31.40.0-255,66,156964,77,372772
2444,0.001323,74.125.200.0-255,12110,169074,77,372772
2445,0.001325,172.31.40.0-255,66,169140,77,372772
2446,0.001346,74.125.200.0-255,1484,170624,77,372772
2447,0.001367,74.125.200.0-255,2902,173526,77,372772
2448,0.001369,172.31.40.0-255,66,173592,77,372772
2449,0.001373,74.125.200.0-255,2902,176494,77,372772
2450,0.001375,172.31.40.0-255,66,176560,77,372772
2451,0.001409,74.125.200.0-255,1484,178044,77,372772
2452,0.001436,74.125.200.0-255,2902,180946,77,372772
2453,0.001439,172.31.40.0-255,66,181012,77,372772
2454,0.001446,74.125.200.0-255,8574,189586,77,372772
2455,0.001448,172.31.40.0-255,66,189652,77,372772
2456,0.001455,74.125.200.0-255,8574,198226,77,372772
2457,0.001457,172.31.40.0-255,66,198292,77,372772
2458,0.001476,74.125.200.0-255,2902,201194,77,372772
2459,0.001478,172.31.40.0-255,66,201260,77,372772
2460,0.001504,74.125.200.0-255,2184,203444,77,372772
2461,0.001506,172.31.40.0-255,66,203510,77,372772
2462,0.001574,74.125.200.0-255,1484,204994,77,372772
2463,0.001578,74.125.200.0-255,1484,206478,77,372772
2464,0.00158,172.31.40.0-255,66,206544,77,372772
2465,0.001593,74.125.200.0-255,1484,208028,77,372772
2466,0.001604,74.125.200.0-255,5738,213766,77,372772
2467,0.001607,172.31.40.0-255,66,213832,77,372772
2468,0.001639,74.125.200.0-255,4320,218152,77,372772
2469,0.001641,172.31.40.0-255,66,218218,77,372772
2470,0.001662,74.125.200.0-255,7156,225374,77,372772
2471,0.001665,172.31.40.0-255,66,225440,77,372772
2472,0.001678,74.125.200.0-255,12110,237550,77,372772
2473,0.001681,172.31.40.0-255,66,237616,77,372772
2474,0.001795,74.125.200.0-255,1484,239100,77,372772
2475,0.001809,74.125.200.0-255,2902,242002,77,372772
2476,0.001812,172.31.40.0-255,66,242068,77,372772
2477,0.001823,74.125.200.0-255,1484,243552,77,372772
2478,0.001849,74.125.200.0-255,4320,247872,77,372772
2479,0.001851,172.31.40.0-255,66,247938,77,372772
2480,0.001868,74.125.200.0-255,7156,255094,77,372772
2481,0.00187,172.31.40.0-255,66,255160,77,372772
2482,0.0019,74.125.200.0-255,8574,263734,77,372772
2483,0.001903,172.31.40.0-255,66,263800,77,372772
2484,0.001926,74.125.200.0-255,5738,269538,77,372772
2485,0.001929,172.31.40.0-255,66,269604,77,372772
2486,0.001933,74.125.200.0-255,2184,271788,77,372772
2487,0.001935,172.31.40.0-255,66,271854,77,372772
2488,0.001965,74.125.200.0-255,1484,273338,77,372772
2489,0.00198,74.125.200.0-255,2902,276240,77,372772
2490,0.001983,172.31.40.0-255,66,276306,77,372772
2491,0.00199,74.125.200.0-255,5738,282044,77,372772
2492,0.001993,172.31.40.0-255,66,282110,77,372772
2493,0.001998,74.125.200.0-255,4320,286430,77,372772
2494,0.002,172.31.40.0-255,66,286496,77,372772
2495,0.002011,74.125.200.0-255,5738,292234,77,372772
2496,0.002013,172.31.40.0-255,66,292300,77,372772
2497,0.002038,74.125.200.0-255,7156,299456,77,372772
2498,0.002041,172.31.40.0-255,66,299522,77,372772
2499,0.002067,74.125.200.0-255,4320,303842,77,372772
2500,0.002071,74.125.200.0-255,2184,306026,77,372772
2501,0.00208,172.31.40.0-255,66,306092,77,372772
2502,0.002093,74.125.200.0-255,8574,314666,77,372772
2503,0.002097,172.31.40.0-255,66,314732,77,372772
2504,0.002115,74.125.200.0-255,7156,321888,77,372772
2505,0.002119,74.125.200.0-255,2902,324790,77,372772
2506,0.002122,74.125.200.0-255,1484,326274,77,372772
2507,0.002156,172.31.40.0-255,66,326340,77,372772
2508,0.004235,74.125.200.0-255,5738,332078,77,372772
2509,0.004242,172.31.40.0-255,66,332144,77,372772
2510,0.006322,74.125.200.0-255,5738,337882,77,372772
2511,0.006328,172.31.40.0-255,66,337948,77,372772
2512,0.008407,74.125.200.0-255,5738,343686,77,372772
2513,0.008412,172.31.40.0-255,66,343752,77,372772
2514,0.010501,74.125.200.0-255,5738,349490,77,372772
2515,0.010508,172.31.40.0-255,66,349556,77,372772
2516,0.012598,74.125.200.0-255,5738,355294,77,372772
2517,0.012606,172.31.40.0-255,66,355360,77,372772
2518,0.014697,74.125.200.0-255,5738,361098,77,372772
2519,0.014705,172.31.40.0-255,66,361164,77,372772
2520,0.016829,74.125.200.0-255,5738,366902,77,372772
2521,0.016836,172.31.40.0-255,66,366968,77,372772
2522,0.018913,74.125.200.0-255,5738,372706,77,372772
2523,0.018921,172.31.40.0-255,66,372772,77,372772
2524,0.0,172.217.194.0-255,296,296,77,357153
2525,2.6e-05,172.31.40.0-255,66,362,77,357153
2526,3.4e-05,172.217.194.0-255,1484,1846,77,357153
2527,3.8e-05,172.31.40.0-255,66,1912,77,357153
2528,4.5e-05,172.217.194.0-255,4320,6232,77,357153
2529,4.8e-05,172.31.40.0-255,66,6298,77,357153
2530,5.5e-05,172.217.194.0-255,5738,12036,77,357153
2531,5.9e-05,172.31.40.0-255,66,12102,77,357153
2532,7.7e-05,172.217.194.0-255,1484,13586,77,357153
2533,7.9e-05,172.31.40.0-255,66,13652,77,357153
2534,0.000115,172.217.194.0-255,7517,21169,77,357153
2535,0.000118,172.31.40.0-255,66,21235,77,357153
2536,0.000127,172.217.194.0-255,9633,30868,77,357153
2537,0.00013,172.31.40.0-255,66,30934,77,357153
2538,0.000184,172.217.194.0-255,1484,32418,77,357153
2539,0.000187,172.31.40.0-255,66,32484,77,357153
2540,0.000192,172.217.194.0-255,2902,35386,77,357153
2541,0.000194,172.31.40.0-255,66,35452,77,357153
2542,0.000224,172.217.194.0-255,5738,41190,77,357153
2543,0.000227,172.31.40.0-255,66,41256,77,357153
2544,0.000252,172.217.194.0-255,6797,48053,77,357153
2545,0.000255,172.31.40.0-255,66,48119,77,357153
2546,0.000281,172.217.194.0-255,9992,58111,77,357153
2547,0.000283,172.31.40.0-255,66,58177,77,357153
2548,0.000301,172.217.194.0-255,4320,62497,77,357153
2549,0.000303,172.31.40.0-255,66,62563,77,357153
2550,0.000308,172.217.194.0-255,2543,65106,77,357153
2551,0.00031,172.31.40.0-255,66,65172,77,357153
2552,0.000312,172.217.194.0-255,349,65521,77,357153
2553,0.000314,172.31.40.0-255,66,65587,77,357153
2554,0.000366,172.217.194.0-255,116,65703,77,357153
2555,0.000369,172.31.40.0-255,66,65769,77,357153
2556,0.000386,172.217.194.0-255,378,66147,77,357153
2557,0.00078,172.217.194.0-255,1484,67631,77,357153
2558,0.000795,172.217.194.0-255,2902,70533,77,357153
2559,0.000803,172.31.40.0-255,66,70599,77,357153
2560,0.00082,172.217.194.0-255,5738,76337,77,357153
2561,0.000823,172.217.194.0-255,1484,77821,77,357153
2562,0.000836,172.31.40.0-255,66,77887,77,357153
2563,0.000854,172.217.194.0-255,11410,89297,77,357153
2564,0.000861,172.217.194.0-255,7156,96453,77,357153
2565,0.000878,172.217.194.0-255,3602,100055,77,357153
2566,0.000894,172.31.40.0-255,66,100121,77,357153
2567,0.000966,172.31.40.0-255,101,100222,77,357153
2568,0.000987,172.217.194.0-255,1484,101706,77,357153
2569,0.000993,172.217.194.0-255,2902,104608,77,357153
2570,0.001008,172.217.194.0-255,5738,110346,77,357153
2571,0.001029,172.217.194.0-255,4320,114666,77,357153
2572,0.001032,172.31.40.0-255,66,114732,77,357153
2573,0.001048,172.217.194.0-255,8574,123306,77,357153
2574,0.001054,172.217.194.0-255,4320,127626,77,357153
2575,0.001058,172.31.40.0-255,66,127692,77,357153
2576,0.001072,172.217.194.0-255,6438,134130,77,357153
2577,0.001135,172.217.194.0-255,2902,137032,77,357153
2578,0.001144,172.31.40.0-255,66,137098,77,357153
2579,0.001177,172.217.194.0-255,7856,144954,77,357153
2580,0.001201,172.31.40.0-255,66,145020,77,357153
2581,0.001977,172.217.194.0-255,1484,146504,77,357153
2582,0.001992,172.217.194.0-255,2902,149406,77,357153
2583,0.001996,172.31.40.0-255,66,149472,77,357153
2584,0.002004,172.217.194.0-255,5738,155210,77,357153
2585,0.002015,172.217.194.0-255,1484,156694,77,357153
2586,0.002019,172.31.40.0-255,66,156760,77,357153
2587,0.002037,172.217.194.0-255,11410,168170,77,357153
2588,0.002051,172.31.40.0-255,66,168236,77,357153
2589,0.002067,172.217.194.0-255,10692,178928,77,357153
2590,0.00209,172.31.40.0-255,66,178994,77,357153
2591,0.002717,172.217.194.0-255,1484,180478,77,357153
2592,0.002728,172.217.194.0-255,2902,183380,77,357153
2593,0.002733,172.31.40.0-255,66,183446,77,357153
2594,0.002759,172.217.194.0-255,5738,189184,77,357153
2595,0.002764,172.217.194.0-255,2902,192086,77,357153
2596,0.002779,172.217.194.0-255,7156,199242,77,357153
2597,0.002806,172.217.194.0-255,5738,204980,77,357153
2598,0.002826,172.217.194.0-255,7856,212836,77,357153
2599,0.003068,172.217.194.0-255,1484,214320,77,357153
2600,0.003077,172.217.194.0-255,2902,217222,77,357153
2601,0.00308,172.217.194.0-255,1484,218706,77,357153
2602,0.003108,172.217.194.0-255,4320,223026,77,357153
2603,0.003115,172.217.194.0-255,7156,230182,77,357153
2604,0.003125,172.217.194.0-255,2902,233084,77,357153
2605,0.003144,172.217.194.0-255,5738,238822,77,357153
2606,0.003159,172.217.194.0-255,4320,243142,77,357153
2607,0.003196,172.217.194.0-255,10692,253834,77,357153
2608,0.003205,172.217.194.0-255,8574,262408,77,357153
2609,0.003213,172.217.194.0-255,8574,270982,77,357153
2610,0.003241,172.217.194.0-255,9274,280256,77,357153
2611,0.003244,172.217.194.0-255,1484,281740,77,357153
2612,0.00326,172.217.194.0-255,2902,284642,77,357153
2613,0.00328,172.217.194.0-255,5738,290380,77,357153
2614,0.003318,172.217.194.0-255,5738,296118,77,357153
2615,0.003343,172.217.194.0-255,7156,303274,77,357153
2616,0.003354,172.217.194.0-255,10692,313966,77,357153
2617,0.003357,172.217.194.0-255,66,314032,77,357153
2618,0.003378,172.217.194.0-255,1484,315516,77,357153
2619,0.003396,172.217.194.0-255,2902,318418,77,357153
2620,0.003399,172.217.194.0-255,1484,319902,77,357153
2621,0.003412,172.217.194.0-255,1484,321386,77,357153
2622,0.003434,172.217.194.0-255,2902,324288,77,357153
2623,0.003441,172.217.194.0-255,7156,331444,77,357153
2624,0.003459,172.217.194.0-255,1484,332928,77,357153
2625,0.003538,172.217.194.0-255,7156,340084,77,357153
2626,0.003541,172.217.194.0-255,1484,341568,77,357153
2627,0.003569,172.217.194.0-255,4320,345888,77,357153
2628,0.003593,172.217.194.0-255,10923,356811,77,357153
2629,0.003624,172.217.194.0-255,105,356916,77,357153
2630,0.010209,172.31.40.0-255,66,356982,77,357153
2631,0.012707,172.31.40.0-255,105,357087,77,357153
2632,0.018656,172.217.194.0-255,66,357153,77,357153
2633,0.0,172.217.194.0-255,150,150,77,336046
2634,2e-05,172.31.40.0-255,66,216,77,336046
2635,2.7e-05,172.217.194.0-255,1484,1700,77,336046
2636,3.1e-05,172.31.40.0-255,66,1766,77,336046
2637,4.4e-05,172.217.194.0-255,2902,4668,77,336046
2638,4.7e-05,172.31.40.0-255,66,4734,77,336046
2639,5.4e-05,172.217.194.0-255,7156,11890,77,336046
2640,5.7e-05,172.31.40.0-255,66,11956,77,336046
2641,6.4e-05,172.217.194.0-255,8574,20530,77,336046
2642,6.7e-05,172.31.40.0-255,66,20596,77,336046
2643,0.000104,172.217.194.0-255,7710,28306,77,336046
2644,0.000107,172.31.40.0-255,66,28372,77,336046
2645,0.000111,172.217.194.0-255,2543,30915,77,336046
2646,0.000113,172.31.40.0-255,66,30981,77,336046
2647,0.000212,172.217.194.0-255,1484,32465,77,336046
2648,0.000216,172.31.40.0-255,66,32531,77,336046
2649,0.000227,172.217.194.0-255,2902,35433,77,336046
2650,0.000233,172.31.40.0-255,66,35499,77,336046
2651,0.000261,172.217.194.0-255,5738,41237,77,336046
2652,0.000264,172.31.40.0-255,66,41303,77,336046
2653,0.00027,172.217.194.0-255,7156,48459,77,336046
2654,0.000272,172.31.40.0-255,66,48525,77,336046
2655,0.000291,172.217.194.0-255,1125,49650,77,336046
2656,0.000296,172.31.40.0-255,66,49716,77,336046
2657,0.000307,172.217.194.0-255,11410,61126,77,336046
2658,0.000309,172.31.40.0-255,66,61192,77,336046
2659,0.00033,172.217.194.0-255,3961,65153,77,336046
2660,0.000332,172.31.40.0-255,66,65219,77,336046
2661,0.000439,172.217.194.0-255,341,65560,77,336046
2662,0.000442,172.31.40.0-255,66,65626,77,336046
2663,0.000513,172.217.194.0-255,1484,67110,77,336046
2664,0.000518,172.31.40.0-255,66,67176,77,336046
2665,0.000547,172.217.194.0-255,2902,70078,77,336046
2666,0.00055,172.31.40.0-255,66,70144,77,336046
2667,0.000556,172.217.194.0-255,5738,75882,77,336046
2668,0.000558,172.31.40.0-255,66,75948,77,336046
2669,0.000572,172.217.194.0-255,12828,88776,77,336046
2670,0.000574,172.31.40.0-255,66,88842,77,336046
2671,0.000583,172.217.194.0-255,9992,98834,77,336046
2672,0.000585,172.31.40.0-255,66,98900,77,336046
2673,0.000622,172.217.194.0-255,1103,100003,77,336046
2674,0.000656,172.217.194.0-255,1484,101487,77,336046
2675,0.000658,172.31.40.0-255,66,101553,77,336046
2676,0.000665,172.217.194.0-255,4320,105873,77,336046
2677,0.000667,172.31.40.0-255,66,105939,77,336046
2678,0.000695,172.217.194.0-255,7156,113095,77,336046
2679,0.000697,172.31.40.0-255,66,113161,77,336046
2680,0.000723,172.217.194.0-255,1484,114645,77,336046
2681,0.00075,172.31.40.0-255,66,114711,77,336046
2682,0.000756,172.217.194.0-255,5020,119731,77,336046
2683,0.000758,172.31.40.0-255,66,119797,77,336046
2684,0.000782,172.217.194.0-255,1484,121281,77,336046
2685,0.000807,172.217.194.0-255,12828,134109,77,336046
2686,0.00081,172.31.40.0-255,66,134175,77,336046
2687,0.000819,172.217.194.0-255,11410,145585,77,336046
2688,0.000821,172.31.40.0-255,66,145651,77,336046
2689,0.000841,172.217.194.0-255,4320,149971,77,336046
2690,0.000843,172.31.40.0-255,66,150037,77,336046
2691,0.000847,172.217.194.0-255,3602,153639,77,336046
2692,0.000849,172.31.40.0-255,66,153705,77,336046
2693,0.000925,172.217.194.0-255,1484,155189,77,336046
2694,0.00093,172.217.194.0-255,2902,158091,77,336046
2695,0.000932,172.31.40.0-255,66,158157,77,336046
2696,0.000956,172.217.194.0-255,5738,163895,77,336046
2697,0.000958,172.31.40.0-255,66,163961,77,336046
2698,0.000993,172.217.194.0-255,12828,176789,77,336046
2699,0.000996,172.31.40.0-255,66,176855,77,336046
2700,0.001038,172.217.194.0-255,7156,184011,77,336046
2701,0.001041,172.31.40.0-255,66,184077,77,336046
2702,0.001065,172.217.194.0-255,3602,187679,77,336046
2703,0.001067,172.31.40.0-255,66,187745,77,336046
2704,0.001445,172.217.194.0-255,1484,189229,77,336046
2705,0.001449,172.217.194.0-255,1484,190713,77,336046
2706,0.001452,172.31.40.0-255,66,190779,77,336046
2707,0.001477,172.217.194.0-255,1484,192263,77,336046
2708,0.001483,172.217.194.0-255,5738,198001,77,336046
2709,0.001485,172.31.40.0-255,66,198067,77,336046
2710,0.001511,172.217.194.0-255,9992,208059,77,336046
2711,0.001513,172.31.40.0-255,66,208125,77,336046
2712,0.001536,172.217.194.0-255,1484,209609,77,336046
2713,0.001542,172.217.194.0-255,5738,215347,77,336046
2714,0.001544,172.31.40.0-255,66,215413,77,336046
2715,0.001575,172.217.194.0-255,6438,221851,77,336046
2716,0.001577,172.31.40.0-255,66,221917,77,336046
2717,0.001683,172.217.194.0-255,1484,223401,77,336046
2718,0.001701,172.217.194.0-255,2902,226303,77,336046
2719,0.001704,172.31.40.0-255,66,226369,77,336046
2720,0.00171,172.217.194.0-255,5738,232107,77,336046
2721,0.001712,172.31.40.0-255,66,232173,77,336046
2722,0.001731,172.217.194.0-255,4320,236493,77,336046
2723,0.001733,172.31.40.0-255,66,236559,77,336046
2724,0.00177,172.217.194.0-255,8574,245133,77,336046
2725,0.001772,172.31.40.0-255,66,245199,77,336046
2726,0.001782,172.217.194.0-255,10692,255891,77,336046
2727,0.001783,172.31.40.0-255,66,255957,77,336046
2728,0.001812,172.217.194.0-255,1484,257441,77,336046
2729,0.001818,172.217.194.0-255,2902,260343,77,336046
2730,0.001823,172.31.40.0-255,66,260409,77,336046
2731,0.001859,172.217.194.0-255,5738,266147,77,336046
2732,0.001863,172.31.40.0-255,66,266213,77,336046
2733,0.001871,172.217.194.0-255,9992,276205,77,336046
2734,0.001873,172.31.40.0-255,66,276271,77,336046
2735,0.001882,172.217.194.0-255,4320,280591,77,336046
2736,0.001884,172.31.40.0-255,66,280657,77,336046
2737,0.001908,172.217.194.0-255,7156,287813,77,336046
2738,0.00191,172.31.40.0-255,66,287879,77,336046
2739,0.001923,172.217.194.0-255,10692,298571,77,336046
2740,0.001925,172.31.40.0-255,66,298637,77,336046
2741,0.001933,172.217.194.0-255,11410,310047,77,336046
2742,0.001935,172.31.40.0-255,66,310113,77,336046
2743,0.001962,172.217.194.0-255,2902,313015,77,336046
2744,0.001964,172.31.40.0-255,66,313081,77,336046
2745,0.002009,172.31.40.0-255,66,313147,77,336046
2746,0.002012,172.217.194.0-255,2902,316049,77,336046
2747,0.002014,172.31.40.0-255,66,316115,77,336046
2748,0.002055,172.31.40.0-255,66,316181,77,336046
2749,0.002065,172.217.194.0-255,12110,328291,77,336046
2750,0.002071,172.31.40.0-255,66,328357,77,336046
2751,0.002103,172.217.194.0-255,5738,334095,77,336046
2752,0.002106,172.31.40.0-255,66,334161,77,336046
2753,0.002145,172.31.40.0-255,66,334227,77,336046
2754,0.004143,172.217.194.0-255,1123,335350,77,336046
2755,0.010216,172.31.40.0-255,105,335455,77,336046
2756,0.010248,172.31.40.0-255,105,335560,77,336046
2757,0.010487,172.31.40.0-255,90,335650,77,336046
2758,0.010497,172.31.40.0-255,66,335716,77,336046
2759,0.0122,172.217.194.0-255,66,335782,77,336046
2760,0.01221,172.217.194.0-255,66,335848,77,336046
2761,0.012469,172.217.194.0-255,66,335914,77,336046
2762,0.012493,172.217.194.0-255,66,335980,77,336046
2763,0.0125,172.31.40.0-255,66,336046,77,336046
2764,0.0,74.125.24.0-255,152,152,77,306267
2765,1.9e-05,172.31.40.0-255,66,218,77,306267
2766,2.6e-05,74.125.24.0-255,1484,1702,77,306267
2767,3.2e-05,172.31.40.0-255,66,1768,77,306267
2768,3.8e-05,74.125.24.0-255,2902,4670,77,306267
2769,5.2e-05,172.31.40.0-255,66,4736,77,306267
2770,6e-05,74.125.24.0-255,7156,11892,77,306267
2771,6.3e-05,172.31.40.0-255,66,11958,77,306267
2772,6.8e-05,74.125.24.0-255,2155,14113,77,306267
2773,7e-05,172.31.40.0-255,66,14179,77,306267
2774,0.000166,74.125.24.0-255,1484,15663,77,306267
2775,0.00017,172.31.40.0-255,66,15729,77,306267
2776,0.000176,74.125.24.0-255,2902,18631,77,306267
2777,0.00018,172.31.40.0-255,66,18697,77,306267
2778,0.000205,74.125.24.0-255,5738,24435,77,306267
2779,0.000209,172.31.40.0-255,66,24501,77,306267
2780,0.000217,74.125.24.0-255,6797,31298,77,306267
2781,0.000219,172.31.40.0-255,66,31364,77,306267
2782,0.000266,74.125.24.0-255,1484,32848,77,306267
2783,0.000269,172.31.40.0-255,66,32914,77,306267
2784,0.000274,74.125.24.0-255,2902,35816,77,306267
2785,0.000276,172.31.40.0-255,66,35882,77,306267
2786,0.000283,74.125.24.0-255,5738,41620,77,306267
2787,0.000285,172.31.40.0-255,66,41686,77,306267
2788,0.000294,74.125.24.0-255,2902,44588,77,306267
2789,0.000297,172.31.40.0-255,66,44654,77,306267
2790,0.00035,74.125.24.0-255,3961,48615,77,306267
2791,0.000353,172.31.40.0-255,66,48681,77,306267
2792,0.000685,74.125.24.0-255,1484,50165,77,306267
2793,0.00069,172.31.40.0-255,66,50231,77,306267
2794,0.000697,74.125.24.0-255,2902,53133,77,306267
2795,0.000699,172.31.40.0-255,66,53199,77,306267
2796,0.000711,74.125.24.0-255,5738,58937,77,306267
2797,0.000714,172.31.40.0-255,66,59003,77,306267
2798,0.000717,74.125.24.0-255,1484,60487,77,306267
2799,0.00077,74.125.24.0-255,5990,66477,77,306267
2800,0.000775,172.31.40.0-255,66,66543,77,306267
2801,0.000879,74.125.24.0-255,1484,68027,77,306267
2802,0.0009,74.125.24.0-255,2902,70929,77,306267
2803,0.000903,172.31.40.0-255,66,70995,77,306267
2804,0.00093,74.125.24.0-255,2902,73897,77,306267
2805,0.000933,172.31.40.0-255,66,73963,77,306267
2806,0.000957,74.125.24.0-255,2902,76865,77,306267
2807,0.000959,172.31.40.0-255,66,76931,77,306267
2808,0.000997,74.125.24.0-255,8574,85505,77,306267
2809,0.000999,172.31.40.0-255,66,85571,77,306267
2810,0.001027,74.125.24.0-255,5379,90950,77,306267
2811,0.00103,172.31.40.0-255,66,91016,77,306267
2812,0.001037,74.125.24.0-255,5738,96754,77,306267
2813,0.00104,172.31.40.0-255,66,96820,77,306267
2814,0.001049,74.125.24.0-255,3961,100781,77,306267
2815,0.001051,172.31.40.0-255,66,100847,77,306267
2816,0.001461,74.125.24.0-255,1484,102331,77,306267
2817,0.001468,74.125.24.0-255,2902,105233,77,306267
2818,0.001471,172.31.40.0-255,66,105299,77,306267
2819,0.001478,74.125.24.0-255,4320,109619,77,306267
2820,0.00148,172.31.40.0-255,66,109685,77,306267
2821,0.001508,74.125.24.0-255,1484,111169,77,306267
2822,0.00153,74.125.24.0-255,4320,115489,77,306267
2823,0.001533,172.31.40.0-255,66,115555,77,306267
2824,0.001566,74.125.24.0-255,8574,124129,77,306267
2825,0.001568,172.31.40.0-255,66,124195,77,306267
2826,0.001572,74.125.24.0-255,1484,125679,77,306267
2827,0.001585,74.125.24.0-255,9274,134953,77,306267
2828,0.001587,172.31.40.0-255,66,135019,77,306267
2829,0.001799,74.125.24.0-255,1484,136503,77,306267
2830,0.001805,74.125.24.0-255,2902,139405,77,306267
2831,0.001808,172.31.40.0-255,66,139471,77,306267
2832,0.001814,74.125.24.0-255,4320,143791,77,306267
2833,0.001817,172.31.40.0-255,66,143857,77,306267
2834,0.001845,74.125.24.0-255,1484,145341,77,306267
2835,0.001856,74.125.24.0-255,12828,158169,77,306267
2836,0.001859,172.31.40.0-255,66,158235,77,306267
2837,0.001898,74.125.24.0-255,10692,168927,77,306267
2838,0.001901,172.31.40.0-255,66,168993,77,306267
2839,0.001951,74.125.24.0-255,1484,170477,77,306267
2840,0.001956,74.125.24.0-255,2902,173379,77,306267
2841,0.001958,74.125.24.0-255,1484,174863,77,306267
2842,0.001963,172.31.40.0-255,66,174929,77,306267
2843,0.00199,74.125.24.0-255,4320,179249,77,306267
2844,0.001993,172.31.40.0-255,66,179315,77,306267
2845,0.002003,74.125.24.0-255,9992,189307,77,306267
2846,0.002007,172.31.40.0-255,66,189373,77,306267
2847,0.002046,74.125.24.0-255,2902,192275,77,306267
2848,0.002049,172.31.40.0-255,66,192341,77,306267
2849,0.002059,74.125.24.0-255,10692,203033,77,306267
2850,0.002067,172.31.40.0-255,66,203099,77,306267
2851,0.002133,74.125.24.0-255,1484,204583,77,306267
2852,0.002146,74.125.24.0-255,2902,207485,77,306267
2853,0.002149,172.31.40.0-255,66,207551,77,306267
2854,0.002153,74.125.24.0-255,1484,209035,77,306267
2855,0.002183,74.125.24.0-255,4320,213355,77,306267
2856,0.002186,172.31.40.0-255,66,213421,77,306267
2857,0.002196,74.125.24.0-255,9992,223413,77,306267
2858,0.002198,172.31.40.0-255,66,223479,77,306267
2859,0.002223,74.125.24.0-255,4320,227799,77,306267
2860,0.002225,172.31.40.0-255,66,227865,77,306267
2861,0.00226,74.125.24.0-255,9274,237139,77,306267
2862,0.002265,172.31.40.0-255,66,237205,77,306267
2863,0.002376,74.125.24.0-255,1484,238689,77,306267
2864,0.002381,74.125.24.0-255,2902,241591,77,306267
2865,0.002385,172.31.40.0-255,66,241657,77,306267
2866,0.00239,74.125.24.0-255,2902,244559,77,306267
2867,0.002392,172.31.40.0-255,66,244625,77,306267
2868,0.002424,74.125.24.0-255,2902,247527,77,306267
2869,0.002427,172.31.40.0-255,66,247593,77,306267
2870,0.002441,74.125.24.0-255,8574,256167,77,306267
2871,0.002449,172.31.40.0-255,66,256233,77,306267
2872,0.002457,74.125.24.0-255,9992,266225,77,306267
2873,0.00246,172.31.40.0-255,66,266291,77,306267
2874,0.002463,74.125.24.0-255,1484,267775,77,306267
2875,0.002494,74.125.24.0-255,3602,271377,77,306267
2876,0.002497,172.31.40.0-255,66,271443,77,306267
2877,0.005141,74.125.24.0-255,5738,277181,77,306267
2878,0.005156,172.31.40.0-255,66,277247,77,306267
2879,0.007786,74.125.24.0-255,5738,282985,77,306267
2880,0.0078,172.31.40.0-255,66,283051,77,306267
2881,0.010402,74.125.24.0-255,5738,288789,77,306267
2882,0.010407,172.31.40.0-255,66,288855,77,306267
2883,0.013068,74.125.24.0-255,5738,294593,77,306267
2884,0.013074,172.31.40.0-255,66,294659,77,306267
2885,0.015685,74.125.24.0-255,5738,300397,77,306267
2886,0.015694,172.31.40.0-255,66,300463,77,306267
2887,0.018358,74.125.24.0-255,5738,306201,77,306267
2888,0.018366,172.31.40.0-255,66,306267,77,306267
2889,0.0,74.125.200.0-255,146,146,77,194595
2890,2.3e-05,172.31.40.0-255,66,212,77,194595
2891,3e-05,74.125.200.0-255,1484,1696,77,194595
2892,3.6e-05,172.31.40.0-255,66,1762,77,194595
2893,4.2e-05,74.125.200.0-255,2902,4664,77,194595
2894,4.5e-05,172.31.40.0-255,66,4730,77,194595
2895,5.2e-05,74.125.200.0-255,5738,10468,77,194595
2896,5.5e-05,172.31.40.0-255,66,10534,77,194595
2897,9.4e-05,74.125.200.0-255,3490,14024,77,194595
2898,9.8e-05,172.31.40.0-255,66,14090,77,194595
2899,0.000262,74.125.200.0-255,1484,15574,77,194595
2900,0.000267,172.31.40.0-255,66,15640,77,194595
2901,0.000272,74.125.200.0-255,2902,18542,77,194595
2902,0.000274,172.31.40.0-255,66,18608,77,194595
2903,0.000296,74.125.200.0-255,2902,21510,77,194595
2904,0.000299,172.31.40.0-255,66,21576,77,194595
2905,0.000304,74.125.200.0-255,4320,25896,77,194595
2906,0.000306,172.31.40.0-255,66,25962,77,194595
2907,0.000358,74.125.200.0-255,2902,28864,77,194595
2908,0.000362,172.31.40.0-255,66,28930,77,194595
2909,0.000379,74.125.200.0-255,2543,31473,77,194595
2910,0.000381,172.31.40.0-255,66,31539,77,194595
2911,0.000465,74.125.200.0-255,1484,33023,77,194595
2912,0.000469,172.31.40.0-255,66,33089,77,194595
2913,0.000474,74.125.200.0-255,2902,35991,77,194595
2914,0.000477,172.31.40.0-255,66,36057,77,194595
2915,0.000501,74.125.200.0-255,5738,41795,77,194595
2916,0.000504,172.31.40.0-255,66,41861,77,194595
2917,0.000508,74.125.200.0-255,2902,44763,77,194595
2918,0.00051,172.31.40.0-255,66,44829,77,194595
2919,0.000515,74.125.200.0-255,3961,48790,77,194595
2920,0.000518,172.31.40.0-255,66,48856,77,194595
2921,0.000546,74.125.200.0-255,8574,57430,77,194595
2922,0.000553,74.125.200.0-255,4320,61750,77,194595
2923,0.000578,172.31.40.0-255,66,61816,77,194595
2924,0.000601,74.125.200.0-255,3961,65777,77,194595
2925,0.000622,74.125.200.0-255,646,66423,77,194595
2926,0.000628,172.31.40.0-255,66,66489,77,194595
2927,0.000924,74.125.200.0-255,1484,67973,77,194595
2928,0.000944,74.125.200.0-255,2902,70875,77,194595
2929,0.000955,172.31.40.0-255,66,70941,77,194595
2930,0.000966,74.125.200.0-255,4320,75261,77,194595
2931,0.000971,172.31.40.0-255,66,75327,77,194595
2932,0.00101,74.125.200.0-255,8574,83901,77,194595
2933,0.001017,74.125.200.0-255,4320,88221,77,194595
2934,0.001023,74.125.200.0-255,5738,93959,77,194595
2935,0.001052,74.125.200.0-255,4320,98279,77,194595
2936,0.001064,74.125.200.0-255,2184,100463,77,194595
2937,0.001592,74.125.200.0-255,1484,101947,77,194595
2938,0.001601,74.125.200.0-255,2902,104849,77,194595
2939,0.001613,74.125.200.0-255,1484,106333,77,194595
2940,0.001631,74.125.200.0-255,2902,109235,77,194595
2941,0.001639,74.125.200.0-255,7156,116391,77,194595
2942,0.00165,74.125.200.0-255,1484,117875,77,194595
2943,0.001658,74.125.200.0-255,8574,126449,77,194595
2944,0.001705,74.125.200.0-255,4320,130769,77,194595
2945,0.001721,74.125.200.0-255,3602,134371,77,194595
2946,0.001993,74.125.200.0-255,1484,135855,77,194595
2947,0.002012,74.125.200.0-255,2902,138757,77,194595
2948,0.002033,74.125.200.0-255,1484,140241,77,194595
2949,0.002049,74.125.200.0-255,2902,143143,77,194595
2950,0.002083,74.125.200.0-255,1484,144627,77,194595
2951,0.002099,74.125.200.0-255,7156,151783,77,194595
2952,0.002106,74.125.200.0-255,7156,158939,77,194595
2953,0.002116,74.125.200.0-255,1484,160423,77,194595
2954,0.002133,74.125.200.0-255,7156,167579,77,194595
2955,0.002136,74.125.200.0-255,766,168345,77,194595
2956,0.002551,74.125.200.0-255,1484,169829,77,194595
2957,0.002562,74.125.200.0-255,1484,171313,77,194595
2958,0.007044,172.31.40.0-255,66,171379,77,194595
2959,0.00962,74.125.200.0-255,5738,177117,77,194595
2960,0.00963,172.31.40.0-255,66,177183,77,194595
2961,0.012198,74.125.200.0-255,5738,182921,77,194595
2962,0.012548,172.31.40.0-255,66,182987,77,194595
2963,0.015113,74.125.200.0-255,5738,188725,77,194595
2964,0.015127,172.31.40.0-255,66,188791,77,194595
2965,0.017702,74.125.200.0-255,5738,194529,77,194595
2966,0.017713,172.31.40.0-255,66,194595,77,194595
2967,0.0,172.217.194.0-255,153,153,77,347694
2968,1.7e-05,172.31.40.0-255,66,219,77,347694
2969,2.4e-05,172.217.194.0-255,1484,1703,77,347694
2970,2.9e-05,172.31.40.0-255,66,1769,77,347694
2971,3.5e-05,172.217.194.0-255,2902,4671,77,347694
2972,3.7e-05,172.31.40.0-255,66,4737,77,347694
2973,4.5e-05,172.217.194.0-255,7156,11893,77,347694
2974,4.8e-05,172.31.40.0-255,66,11959,77,347694
2975,6.4e-05,172.217.194.0-255,2064,14023,77,347694
2976,6.7e-05,172.31.40.0-255,66,14089,77,347694
2977,0.000395,172.217.194.0-255,1484,15573,77,347694
2978,0.0004,172.31.40.0-255,66,15639,77,347694
2979,0.000407,172.217.194.0-255,2902,18541,77,347694
2980,0.00041,172.31.40.0-255,66,18607,77,347694
2981,0.000415,172.217.194.0-255,4320,22927,77,347694
2982,0.000418,172.31.40.0-255,66,22993,77,347694
2983,0.000438,172.217.194.0-255,1484,24477,77,347694
2984,0.00044,172.31.40.0-255,66,24543,77,347694
2985,0.000447,172.217.194.0-255,5738,30281,77,347694
2986,0.000449,172.31.40.0-255,66,30347,77,347694
2987,0.000488,172.217.194.0-255,13887,44234,77,347694
2988,0.000491,172.31.40.0-255,66,44300,77,347694
2989,0.000496,172.217.194.0-255,3961,48261,77,347694
2990,0.000498,172.31.40.0-255,66,48327,77,347694
2991,0.000538,172.217.194.0-255,7156,55483,77,347694
2992,0.000542,172.31.40.0-255,66,55549,77,347694
2993,0.000567,172.217.194.0-255,9633,65182,77,347694
2994,0.00057,172.31.40.0-255,66,65248,77,347694
2995,0.000574,172.217.194.0-255,677,65925,77,347694
2996,0.000575,172.31.40.0-255,66,65991,77,347694
2997,0.000615,172.31.40.0-255,101,66092,77,347694
2998,0.00063,172.217.194.0-255,1484,67576,77,347694
2999,0.000637,172.217.194.0-255,2902,70478,77,347694
3000,0.000639,172.31.40.0-255,66,70544,77,347694
3001,0.000645,172.217.194.0-255,4320,74864,77,347694
3002,0.000648,172.31.40.0-255,66,74930,77,347694
3003,0.000665,172.217.194.0-255,1484,76414,77,347694
3004,0.000708,172.217.194.0-255,4320,80734,77,347694
3005,0.000711,172.31.40.0-255,66,80800,77,347694
3006,0.000736,172.217.194.0-255,5379,86179,77,347694
3007,0.00074,172.31.40.0-255,66,86245,77,347694
3008,0.000749,172.217.194.0-255,9992,96237,77,347694
3009,0.000752,172.31.40.0-255,66,96303,77,347694
3010,0.000758,172.217.194.0-255,3961,100264,77,347694
3011,0.000761,172.31.40.0-255,66,100330,77,347694
3012,0.001064,172.217.194.0-255,1484,101814,77,347694
3013,0.00107,172.217.194.0-255,2902,104716,77,347694
3014,0.001074,172.31.40.0-255,66,104782,77,347694
3015,0.001078,172.217.194.0-255,1484,106266,77,347694
3016,0.001099,172.217.194.0-255,4320,110586,77,347694
3017,0.001102,172.31.40.0-255,66,110652,77,347694
3018,0.001108,172.217.194.0-255,4320,114972,77,347694
3019,0.001111,172.31.40.0-255,66,115038,77,347694
3020,0.001144,172.217.194.0-255,8574,123612,77,347694
3021,0.001147,172.31.40.0-255,66,123678,77,347694
3022,0.001157,172.217.194.0-255,10692,134370,77,347694
3023,0.001158,172.31.40.0-255,66,134436,77,347694
3024,0.001184,172.217.194.0-255,1484,135920,77,347694
3025,0.001203,172.217.194.0-255,2902,138822,77,347694
3026,0.001206,172.31.40.0-255,66,138888,77,347694
3027,0.001212,172.217.194.0-255,5738,144626,77,347694
3028,0.001214,172.31.40.0-255,66,144692,77,347694
3029,0.001227,172.217.194.0-255,1484,146176,77,347694
3030,0.001252,172.217.194.0-255,11410,157586,77,347694
3031,0.001256,172.31.40.0-255,66,157652,77,347694
3032,0.00126,172.217.194.0-255,2902,160554,77,347694
3033,0.001262,172.31.40.0-255,66,160620,77,347694
3034,0.001304,172.217.194.0-255,7156,167776,77,347694
3035,0.001308,172.31.40.0-255,66,167842,77,347694
3036,0.001328,172.217.194.0-255,766,168608,77,347694
3037,0.001337,172.217.194.0-255,8574,177182,77,347694
3038,0.00134,172.31.40.0-255,66,177248,77,347694
3039,0.001344,172.217.194.0-255,2902,180150,77,347694
3040,0.001346,172.31.40.0-255,66,180216,77,347694
3041,0.001392,172.31.40.0-255,66,180282,77,347694
3042,0.001396,172.217.194.0-255,2902,183184,77,347694
3043,0.001398,172.31.40.0-255,66,183250,77,347694
3044,0.001401,172.217.194.0-255,1484,184734,77,347694
3045,0.00143,172.217.194.0-255,6438,191172,77,347694
3046,0.001434,172.31.40.0-255,66,191238,77,347694
3047,0.001441,172.217.194.0-255,7156,198394,77,347694
3048,0.001444,172.31.40.0-255,66,198460,77,347694
3049,0.001461,172.217.194.0-255,1484,199944,77,347694
3050,0.00148,172.31.40.0-255,66,200010,77,347694
3051,0.001485,172.217.194.0-255,2184,202194,77,347694
3052,0.001488,172.31.40.0-255,66,202260,77,347694
3053,0.00155,172.217.194.0-255,1484,203744,77,347694
3054,0.001555,172.217.194.0-255,2902,206646,77,347694
3055,0.001559,172.31.40.0-255,66,206712,77,347694
3056,0.00161,172.217.194.0-255,5738,212450,77,347694
3057,0.001615,172.31.40.0-255,66,212516,77,347694
3058,0.00163,172.217.194.0-255,12828,225344,77,347694
3059,0.001633,172.31.40.0-255,66,225410,77,347694
3060,0.001642,172.217.194.0-255,10692,236102,77,347694
3061,0.001645,172.31.40.0-255,66,236168,77,347694
3062,0.0018,172.217.194.0-255,1484,237652,77,347694
3063,0.001806,172.217.194.0-255,2902,240554,77,347694
3064,0.001809,172.31.40.0-255,66,240620,77,347694
3065,0.001834,172.217.194.0-255,5738,246358,77,347694
3066,0.001838,172.31.40.0-255,66,246424,77,347694
3067,0.001843,172.217.194.0-255,5738,252162,77,347694
3068,0.001845,172.31.40.0-255,66,252228,77,347694
3069,0.001866,172.217.194.0-255,7156,259384,77,347694
3070,0.001869,172.31.40.0-255,66,259450,77,347694
3071,0.001873,172.217.194.0-255,2902,262352,77,347694
3072,0.001875,172.31.40.0-255,66,262418,77,347694
3073,0.001902,172.217.194.0-255,7156,269574,77,347694
3074,0.001905,172.31.40.0-255,66,269640,77,347694
3075,0.001908,172.217.194.0-255,766,270406,77,347694
3076,0.002025,172.217.194.0-255,1484,271890,77,347694
3077,0.002028,172.31.40.0-255,66,271956,77,347694
3078,0.002038,172.217.194.0-255,1484,273440,77,347694
3079,0.002051,172.217.194.0-255,1484,274924,77,347694
3080,0.002053,172.31.40.0-255,66,274990,77,347694
3081,0.00206,172.217.194.0-255,5738,280728,77,347694
3082,0.002062,172.31.40.0-255,66,280794,77,347694
3083,0.002067,172.217.194.0-255,4320,285114,77,347694
3084,0.00207,172.31.40.0-255,66,285180,77,347694
3085,0.002095,172.217.194.0-255,4320,289500,77,347694
3086,0.002099,172.31.40.0-255,66,289566,77,347694
3087,0.00213,172.217.194.0-255,4320,293886,77,347694
3088,0.002133,172.31.40.0-255,66,293952,77,347694
3089,0.002165,172.217.194.0-255,12110,306062,77,347694
3090,0.002168,172.31.40.0-255,66,306128,77,347694
3091,0.002184,172.31.40.0-255,66,306194,77,347694
3092,0.002198,172.31.40.0-255,66,306260,77,347694
3093,0.002255,172.217.194.0-255,8574,314834,77,347694
3094,0.002259,172.31.40.0-255,66,314900,77,347694
3095,0.002281,172.217.194.0-255,12828,327728,77,347694
3096,0.002283,172.31.40.0-255,66,327794,77,347694
3097,0.002296,172.217.194.0-255,2902,330696,77,347694
3098,0.002298,172.31.40.0-255,66,330762,77,347694
3099,0.002326,172.217.194.0-255,8574,339336,77,347694
3100,0.002329,172.31.40.0-255,66,339402,77,347694
3101,0.002336,172.217.194.0-255,7884,347286,77,347694
3102,0.002338,172.31.40.0-255,66,347352,77,347694
3103,0.00234,172.217.194.0-255,105,347457,77,347694
3104,0.003129,172.217.194.0-255,66,347523,77,347694
3105,0.014918,172.31.40.0-255,105,347628,77,347694
3106,0.01753,172.217.194.0-255,66,347694,77,347694
3107,0.0,172.217.194.0-255,153,153,77,342419
3108,2.9e-05,172.31.40.0-255,66,219,77,342419
3109,3.8e-05,172.217.194.0-255,1484,1703,77,342419
3110,4.2e-05,172.31.40.0-255,66,1769,77,342419
3111,4.9e-05,172.217.194.0-255,2902,4671,77,342419
3112,5.3e-05,172.31.40.0-255,66,4737,77,342419
3113,6.1e-05,172.217.194.0-255,7156,11893,77,342419
3114,6.5e-05,172.31.40.0-255,66,11959,77,342419
3115,0.000101,172.217.194.0-255,9992,21951,77,342419
3116,0.000104,172.31.40.0-255,66,22017,77,342419
3117,0.000126,172.217.194.0-255,6357,28374,77,342419
3118,0.000129,172.31.40.0-255,66,28440,77,342419
3119,0.000134,172.217.194.0-255,2543,30983,77,342419
3120,0.000136,172.31.40.0-255,66,31049,77,342419
3121,0.000139,172.217.194.0-255,1484,32533,77,342419
3122,0.000141,172.31.40.0-255,66,32599,77,342419
3123,0.000146,172.217.194.0-255,2902,35501,77,342419
3124,0.000149,172.31.40.0-255,66,35567,77,342419
3125,0.000155,172.217.194.0-255,4320,39887,77,342419
3126,0.000158,172.31.40.0-255,66,39953,77,342419
3127,0.000175,172.217.194.0-255,1484,41437,77,342419
3128,0.000177,172.31.40.0-255,66,41503,77,342419
3129,0.000185,172.217.194.0-255,5738,47241,77,342419
3130,0.000188,172.31.40.0-255,66,47307,77,342419
3131,0.00021,172.217.194.0-255,6797,54104,77,342419
3132,0.000213,172.31.40.0-255,66,54170,77,342419
3133,0.000229,172.217.194.0-255,4320,58490,77,342419
3134,0.000232,172.31.40.0-255,66,58556,77,342419
3135,0.000258,172.217.194.0-255,7119,65675,77,342419
3136,0.000261,172.31.40.0-255,66,65741,77,342419
3137,0.000263,172.217.194.0-255,366,66107,77,342419
3138,0.000265,172.31.40.0-255,66,66173,77,342419
3139,0.000399,172.217.194.0-255,1484,67657,77,342419
3140,0.000407,172.217.194.0-255,2902,70559,77,342419
3141,0.000411,172.31.40.0-255,66,70625,77,342419
3142,0.000433,172.217.194.0-255,4320,74945,77,342419
3143,0.000436,172.31.40.0-255,66,75011,77,342419
3144,0.000456,172.217.194.0-255,1484,76495,77,342419
3145,0.000465,172.217.194.0-255,7156,83651,77,342419
3146,0.000467,172.31.40.0-255,66,83717,77,342419
3147,0.000477,172.217.194.0-255,9992,93709,77,342419
3148,0.00048,172.31.40.0-255,66,93775,77,342419
3149,0.000504,172.217.194.0-255,4320,98095,77,342419
3150,0.000506,172.31.40.0-255,66,98161,77,342419
3151,0.00051,172.217.194.0-255,2184,100345,77,342419
3152,0.000513,172.31.40.0-255,66,100411,77,342419
3153,0.000736,172.217.194.0-255,1484,101895,77,342419
3154,0.000743,172.217.194.0-255,2902,104797,77,342419
3155,0.000748,172.31.40.0-255,66,104863,77,342419
3156,0.000754,172.217.194.0-255,4320,109183,77,342419
3157,0.000756,172.31.40.0-255,66,109249,77,342419
3158,0.00077,172.217.194.0-255,1484,110733,77,342419
3159,0.000783,172.217.194.0-255,12828,123561,77,342419
3160,0.000785,172.31.40.0-255,66,123627,77,342419
3161,0.000794,172.217.194.0-255,7156,130783,77,342419
3162,0.000797,172.31.40.0-255,66,130849,77,342419
3163,0.000812,172.217.194.0-255,3602,134451,77,342419
3164,0.000814,172.31.40.0-255,66,134517,77,342419
3165,0.000882,172.217.194.0-255,1484,136001,77,342419
3166,0.000887,172.217.194.0-255,1484,137485,77,342419
3167,0.00089,172.31.40.0-255,66,137551,77,342419
3168,0.000912,172.217.194.0-255,1484,139035,77,342419
3169,0.000919,172.217.194.0-255,5738,144773,77,342419
3170,0.000922,172.31.40.0-255,66,144839,77,342419
3171,0.000931,172.217.194.0-255,9992,154831,77,342419
3172,0.000934,172.31.40.0-255,66,154897,77,342419
3173,0.000947,172.217.194.0-255,2902,157799,77,342419
3174,0.000949,172.31.40.0-255,66,157865,77,342419
3175,0.000954,172.217.194.0-255,2902,160767,77,342419
3176,0.000956,172.31.40.0-255,66,160833,77,342419
3177,0.000986,172.217.194.0-255,7856,168689,77,342419
3178,0.000989,172.31.40.0-255,66,168755,77,342419
3179,0.000997,172.217.194.0-255,8574,177329,77,342419
3180,0.001,172.31.40.0-255,66,177395,77,342419
3181,0.001005,172.217.194.0-255,4320,181715,77,342419
3182,0.001007,172.31.40.0-255,66,181781,77,342419
3183,0.001031,172.217.194.0-255,5738,187519,77,342419
3184,0.001033,172.31.40.0-255,66,187585,77,342419
3185,0.001048,172.217.194.0-255,2902,190487,77,342419
3186,0.00105,172.31.40.0-255,66,190553,77,342419
3187,0.001077,172.217.194.0-255,11410,201963,77,342419
3188,0.00108,172.31.40.0-255,66,202029,77,342419
3189,0.001094,172.217.194.0-255,766,202795,77,342419
3190,0.001731,172.217.194.0-255,1484,204279,77,342419
3191,0.001736,172.31.40.0-255,66,204345,77,342419
3192,0.001742,172.217.194.0-255,2902,207247,77,342419
3193,0.001744,172.31.40.0-255,66,207313,77,342419
3194,0.001782,172.217.194.0-255,4320,211633,77,342419
3195,0.001785,172.31.40.0-255,66,211699,77,342419
3196,0.001803,172.217.194.0-255,1484,213183,77,342419
3197,0.001815,172.217.194.0-255,12828,226011,77,342419
3198,0.001818,172.31.40.0-255,66,226077,77,342419
3199,0.001828,172.217.194.0-255,10692,236769,77,342419
3200,0.00183,172.31.40.0-255,66,236835,77,342419
3201,0.001943,172.217.194.0-255,1484,238319,77,342419
3202,0.001949,172.217.194.0-255,2902,241221,77,342419
3203,0.001952,172.31.40.0-255,66,241287,77,342419
3204,0.001959,172.217.194.0-255,4320,245607,77,342419
3205,0.001961,172.31.40.0-255,66,245673,77,342419
3206,0.001982,172.217.194.0-255,1484,247157,77,342419
3207,0.001987,172.217.194.0-255,2902,250059,77,342419
3208,0.001989,172.31.40.0-255,66,250125,77,342419
3209,0.002024,172.217.194.0-255,9992,260117,77,342419
3210,0.002027,172.31.40.0-255,66,260183,77,342419
3211,0.002037,172.217.194.0-255,10692,270875,77,342419
3212,0.002039,172.31.40.0-255,66,270941,77,342419
3213,0.002045,172.217.194.0-255,4320,275261,77,342419
3214,0.002047,172.31.40.0-255,66,275327,77,342419
3215,0.002083,172.217.194.0-255,7156,282483,77,342419
3216,0.002086,172.31.40.0-255,66,282549,77,342419
3217,0.002121,172.31.40.0-255,66,282615,77,342419
3218,0.002129,172.217.194.0-255,7856,290471,77,342419
3219,0.002131,172.31.40.0-255,66,290537,77,342419
3220,0.002169,172.31.40.0-255,66,290603,77,342419
3221,0.002199,172.217.194.0-255,1484,292087,77,342419
3222,0.002209,172.217.194.0-255,9274,301361,77,342419
3223,0.002212,172.31.40.0-255,66,301427,77,342419
3224,0.002221,172.217.194.0-255,9992,311419,77,342419
3225,0.002224,172.31.40.0-255,66,311485,77,342419
3226,0.002242,172.31.40.0-255,66,311551,77,342419
3227,0.002267,172.217.194.0-255,4320,315871,77,342419
3228,0.002269,172.31.40.0-255,66,315937,77,342419
3229,0.002277,172.217.194.0-255,6438,322375,77,342419
3230,0.002279,172.31.40.0-255,66,322441,77,342419
3231,0.002285,172.217.194.0-255,4320,326761,77,342419
3232,0.002288,172.31.40.0-255,66,326827,77,342419
3233,0.002324,172.217.194.0-255,2902,329729,77,342419
3234,0.002327,172.31.40.0-255,66,329795,77,342419
3235,0.002343,172.31.40.0-255,66,329861,77,342419
3236,0.002354,172.217.194.0-255,11936,341797,77,342419
3237,0.002356,172.31.40.0-255,66,341863,77,342419
3238,0.002359,172.217.194.0-255,97,341960,77,342419
3239,0.004632,172.217.194.0-255,105,342065,77,342419
3240,0.010879,172.217.194.0-255,105,342170,77,342419
3241,0.010895,172.31.40.0-255,78,342248,77,342419
3242,0.011163,172.31.40.0-255,105,342353,77,342419
3243,0.01339,172.217.194.0-255,66,342419,77,342419
3244,0.0,172.31.40.0-255,105,105,77,210
3245,0.001748,157.240.25.0-255,105,210,77,210
3246,0.0,74.125.24.0-255,153,153,77,302077
3247,2.2e-05,172.31.40.0-255,66,219,77,302077
3248,2.9e-05,74.125.24.0-255,1484,1703,77,302077
3249,3.3e-05,172.31.40.0-255,66,1769,77,302077
3250,3.8e-05,74.125.24.0-255,2902,4671,77,302077
3251,4.1e-05,172.31.40.0-255,66,4737,77,302077
3252,4.8e-05,74.125.24.0-255,7156,11893,77,302077
3253,5.3e-05,172.31.40.0-255,66,11959,77,302077
3254,5.7e-05,74.125.24.0-255,2098,14057,77,302077
3255,6e-05,172.31.40.0-255,66,14123,77,302077
3256,7e-05,74.125.24.0-255,11410,25533,77,302077
3257,7.3e-05,172.31.40.0-255,66,25599,77,302077
3258,8.1e-05,74.125.24.0-255,5379,30978,77,302077
3259,8.4e-05,172.31.40.0-255,66,31044,77,302077
3260,0.000161,74.125.24.0-255,1484,32528,77,302077
3261,0.000164,172.31.40.0-255,66,32594,77,302077
3262,0.000169,74.125.24.0-255,2902,35496,77,302077
3263,0.000171,172.31.40.0-255,66,35562,77,302077
3264,0.000195,74.125.24.0-255,2902,38464,77,302077
3265,0.000197,172.31.40.0-255,66,38530,77,302077
3266,0.000221,74.125.24.0-255,2902,41432,77,302077
3267,0.000224,172.31.40.0-255,66,41498,77,302077
3268,0.000231,74.125.24.0-255,6797,48295,77,302077
3269,0.000233,172.31.40.0-255,66,48361,77,302077
3270,0.000247,74.125.24.0-255,1484,49845,77,302077
3271,0.000249,172.31.40.0-255,66,49911,77,302077
3272,0.000294,172.31.40.0-255,66,49977,77,302077
3273,0.000297,74.125.24.0-255,1430,51407,77,302077
3274,0.0003,172.31.40.0-255,66,51473,77,302077
3275,0.000459,74.125.24.0-255,116,51589,77,302077
3276,0.000464,172.31.40.0-255,66,51655,77,302077
3277,0.000497,74.125.24.0-255,1484,53139,77,302077
3278,0.000502,74.125.24.0-255,1484,54623,77,302077
3279,0.000504,172.31.40.0-255,66,54689,77,302077
3280,0.000527,74.125.24.0-255,1484,56173,77,302077
3281,0.000534,74.125.24.0-255,7156,63329,77,302077
3282,0.000536,172.31.40.0-255,66,63395,77,302077
3283,0.000539,74.125.24.0-255,1484,64879,77,302077
3284,0.000572,172.31.40.0-255,66,64945,77,302077
3285,0.000588,74.125.24.0-255,2902,67847,77,302077
3286,0.000592,172.31.40.0-255,66,67913,77,302077
3287,0.000605,74.125.24.0-255,3866,71779,77,302077
3288,0.000608,172.31.40.0-255,66,71845,77,302077
3289,0.000677,74.125.24.0-255,1484,73329,77,302077
3290,0.000692,74.125.24.0-255,2902,76231,77,302077
3291,0.000695,172.31.40.0-255,66,76297,77,302077
3292,0.000699,74.125.24.0-255,1484,77781,77,302077
3293,0.000717,74.125.24.0-255,4320,82101,77,302077
3294,0.00072,172.31.40.0-255,66,82167,77,302077
3295,0.000729,74.125.24.0-255,8574,90741,77,302077
3296,0.000731,172.31.40.0-255,66,90807,77,302077
3297,0.000759,74.125.24.0-255,1484,92291,77,302077
3298,0.000773,74.125.24.0-255,12980,105271,77,302077
3299,0.000776,172.31.40.0-255,66,105337,77,302077
3300,0.000838,74.125.24.0-255,1484,106821,77,302077
3301,0.000843,74.125.24.0-255,2902,109723,77,302077
3302,0.000847,172.31.40.0-255,66,109789,77,302077
3303,0.000854,74.125.24.0-255,5738,115527,77,302077
3304,0.000857,172.31.40.0-255,66,115593,77,302077
3305,0.000891,74.125.24.0-255,9992,125585,77,302077
3306,0.000894,172.31.40.0-255,66,125651,77,302077
3307,0.000913,74.125.24.0-255,2902,128553,77,302077
3308,0.000915,172.31.40.0-255,66,128619,77,302077
3309,0.000921,74.125.24.0-255,4320,132939,77,302077
3310,0.000923,172.31.40.0-255,66,133005,77,302077
3311,0.000929,74.125.24.0-255,5738,138743,77,302077
3312,0.000932,172.31.40.0-255,66,138809,77,302077
3313,0.000935,74.125.24.0-255,766,139575,77,302077
3314,0.001055,74.125.24.0-255,1484,141059,77,302077
3315,0.001059,172.31.40.0-255,66,141125,77,302077
3316,0.001064,74.125.24.0-255,2902,144027,77,302077
3317,0.001067,172.31.40.0-255,66,144093,77,302077
3318,0.001072,74.125.24.0-255,2902,146995,77,302077
3319,0.001074,172.31.40.0-255,66,147061,77,302077
3320,0.001087,74.125.24.0-255,2902,149963,77,302077
3321,0.001089,172.31.40.0-255,66,150029,77,302077
3322,0.001094,74.125.24.0-255,2902,152931,77,302077
3323,0.001097,172.31.40.0-255,66,152997,77,302077
3324,0.001134,74.125.24.0-255,9992,162989,77,302077
3325,0.001137,172.31.40.0-255,66,163055,77,302077
3326,0.001141,74.125.24.0-255,2902,165957,77,302077
3327,0.001143,172.31.40.0-255,66,166023,77,302077
3328,0.001158,74.125.24.0-255,4320,170343,77,302077
3329,0.001161,172.31.40.0-255,66,170409,77,302077
3330,0.001191,74.125.24.0-255,3602,174011,77,302077
3331,0.001194,172.31.40.0-255,66,174077,77,302077
3332,0.001713,74.125.24.0-255,1484,175561,77,302077
3333,0.001719,74.125.24.0-255,2902,178463,77,302077
3334,0.001722,172.31.40.0-255,66,178529,77,302077
3335,0.001744,74.125.24.0-255,4320,182849,77,302077
3336,0.001747,172.31.40.0-255,66,182915,77,302077
3337,0.001758,74.125.24.0-255,1484,184399,77,302077
3338,0.001784,74.125.24.0-255,7156,191555,77,302077
3339,0.001787,172.31.40.0-255,66,191621,77,302077
3340,0.001796,74.125.24.0-255,8574,200195,77,302077
3341,0.001798,172.31.40.0-255,66,200261,77,302077
3342,0.001853,74.125.24.0-255,1484,201745,77,302077
3343,0.001857,74.125.24.0-255,2902,204647,77,302077
3344,0.001859,172.31.40.0-255,66,204713,77,302077
3345,0.001882,74.125.24.0-255,3602,208315,77,302077
3346,0.001885,172.31.40.0-255,66,208381,77,302077
3347,0.002264,74.125.24.0-255,1484,209865,77,302077
3348,0.002289,74.125.24.0-255,2902,212767,77,302077
3349,0.002293,172.31.40.0-255,66,212833,77,302077
3350,0.002301,74.125.24.0-255,5738,218571,77,302077
3351,0.002303,172.31.40.0-255,66,218637,77,302077
3352,0.002314,74.125.24.0-255,8574,227211,77,302077
3353,0.002316,172.31.40.0-255,66,227277,77,302077
3354,0.00234,74.125.24.0-255,4320,231597,77,302077
3355,0.002342,172.31.40.0-255,66,231663,77,302077
3356,0.002352,74.125.24.0-255,10692,242355,77,302077
3357,0.002354,172.31.40.0-255,66,242421,77,302077
3358,0.002381,74.125.24.0-255,1484,243905,77,302077
3359,0.002406,74.125.24.0-255,1484,245389,77,302077
3360,0.002408,172.31.40.0-255,66,245455,77,302077
3361,0.002414,74.125.24.0-255,4320,249775,77,302077
3362,0.002416,172.31.40.0-255,66,249841,77,302077
3363,0.002424,74.125.24.0-255,8574,258415,77,302077
3364,0.002426,172.31.40.0-255,66,258481,77,302077
3365,0.00243,74.125.24.0-255,2902,261383,77,302077
3366,0.002433,172.31.40.0-255,66,261449,77,302077
3367,0.004787,74.125.24.0-255,5738,267187,77,302077
3368,0.004795,172.31.40.0-255,66,267253,77,302077
3369,0.007154,74.125.24.0-255,5738,272991,77,302077
3370,0.00716,172.31.40.0-255,66,273057,77,302077
3371,0.009567,74.125.24.0-255,5738,278795,77,302077
3372,0.009584,172.31.40.0-255,66,278861,77,302077
3373,0.011981,74.125.24.0-255,5738,284599,77,302077
3374,0.011993,172.31.40.0-255,66,284665,77,302077
3375,0.014384,74.125.24.0-255,5738,290403,77,302077
3376,0.014391,172.31.40.0-255,66,290469,77,302077
3377,0.016773,74.125.24.0-255,5738,296207,77,302077
3378,0.016783,172.31.40.0-255,66,296273,77,302077
3379,0.019174,74.125.24.0-255,5738,302011,77,302077
3380,0.019182,172.31.40.0-255,66,302077,77,302077
3381,0.0,74.125.68.0-255,153,153,77,245151
3382,2.2e-05,172.31.40.0-255,66,219,77,245151
3383,2.9e-05,74.125.68.0-255,1484,1703,77,245151
3384,3.4e-05,172.31.40.0-255,66,1769,77,245151
3385,4e-05,74.125.68.0-255,2902,4671,77,245151
3386,4.2e-05,172.31.40.0-255,66,4737,77,245151
3387,4.9e-05,74.125.68.0-255,5738,10475,77,245151
3388,5.2e-05,172.31.40.0-255,66,10541,77,245151
3389,5.7e-05,74.125.68.0-255,2902,13443,77,245151
3390,6e-05,172.31.40.0-255,66,13509,77,245151
3391,8.1e-05,74.125.68.0-255,716,14225,77,245151
3392,8.3e-05,172.31.40.0-255,66,14291,77,245151
3393,8.9e-05,74.125.68.0-255,4320,18611,77,245151
3394,9.2e-05,172.31.40.0-255,66,18677,77,245151
3395,0.000125,74.125.68.0-255,5738,24415,77,245151
3396,0.000128,172.31.40.0-255,66,24481,77,245151
3397,0.000134,74.125.68.0-255,5738,30219,77,245151
3398,0.000136,172.31.40.0-255,66,30285,77,245151
3399,0.000159,74.125.68.0-255,1484,31769,77,245151
3400,0.000161,172.31.40.0-255,66,31835,77,245151
3401,0.00017,74.125.68.0-255,8574,40409,77,245151
3402,0.000172,172.31.40.0-255,66,40475,77,245151
3403,0.000219,74.125.68.0-255,4320,44795,77,245151
3404,0.000221,172.31.40.0-255,66,44861,77,245151
3405,0.000236,74.125.68.0-255,3602,48463,77,245151
3406,0.000238,172.31.40.0-255,66,48529,77,245151
3407,0.000257,74.125.68.0-255,1484,50013,77,245151
3408,0.000259,172.31.40.0-255,66,50079,77,245151
3409,0.000303,74.125.68.0-255,2902,52981,77,245151
3410,0.000306,172.31.40.0-255,66,53047,77,245151
3411,0.000309,74.125.68.0-255,1484,54531,77,245151
3412,0.000312,172.31.40.0-255,66,54597,77,245151
3413,0.000318,74.125.68.0-255,2902,57499,77,245151
3414,0.000321,172.31.40.0-255,66,57565,77,245151
3415,0.000349,74.125.68.0-255,5738,63303,77,245151
3416,0.000351,172.31.40.0-255,66,63369,77,245151
3417,0.000354,74.125.68.0-255,1484,64853,77,245151
3418,0.000369,74.125.68.0-255,1467,66320,77,245151
3419,0.000371,172.31.40.0-255,66,66386,77,245151
3420,0.000437,74.125.68.0-255,1484,67870,77,245151
3421,0.000452,74.125.68.0-255,2902,70772,77,245151
3422,0.000455,172.31.40.0-255,66,70838,77,245151
3423,0.00046,74.125.68.0-255,2902,73740,77,245151
3424,0.000463,172.31.40.0-255,66,73806,77,245151
3425,0.000483,74.125.68.0-255,4320,78126,77,245151
3426,0.000486,172.31.40.0-255,66,78192,77,245151
3427,0.00049,74.125.68.0-255,2902,81094,77,245151
3428,0.000493,172.31.40.0-255,66,81160,77,245151
3429,0.000515,74.125.68.0-255,5738,86898,77,245151
3430,0.000519,172.31.40.0-255,66,86964,77,245151
3431,0.000536,74.125.68.0-255,1484,88448,77,245151
3432,0.00055,74.125.68.0-255,2902,91350,77,245151
3433,0.000553,172.31.40.0-255,66,91416,77,245151
3434,0.000565,74.125.68.0-255,1484,92900,77,245151
3435,0.00057,74.125.68.0-255,2902,95802,77,245151
3436,0.000572,172.31.40.0-255,66,95868,77,245151
3437,0.0006,74.125.68.0-255,4320,100188,77,245151
3438,0.000603,172.31.40.0-255,66,100254,77,245151
3439,0.000605,74.125.68.0-255,766,101020,77,245151
3440,0.000608,74.125.68.0-255,1484,102504,77,245151
3441,0.00061,172.31.40.0-255,66,102570,77,245151
3442,0.000616,74.125.68.0-255,4320,106890,77,245151
3443,0.000618,172.31.40.0-255,66,106956,77,245151
3444,0.000621,74.125.68.0-255,1484,108440,77,245151
3445,0.000624,74.125.68.0-255,1484,109924,77,245151
3446,0.000626,172.31.40.0-255,66,109990,77,245151
3447,0.000644,74.125.68.0-255,5738,115728,77,245151
3448,0.000646,172.31.40.0-255,66,115794,77,245151
3449,0.000663,74.125.68.0-255,1484,117278,77,245151
3450,0.000684,74.125.68.0-255,2902,120180,77,245151
3451,0.000687,172.31.40.0-255,66,120246,77,245151
3452,0.000694,74.125.68.0-255,5738,125984,77,245151
3453,0.000696,172.31.40.0-255,66,126050,77,245151
3454,0.000748,74.125.68.0-255,4320,130370,77,245151
3455,0.000751,172.31.40.0-255,66,130436,77,245151
3456,0.00077,74.125.68.0-255,4718,135154,77,245151
3457,0.000772,172.31.40.0-255,66,135220,77,245151
3458,0.000941,74.125.68.0-255,1484,136704,77,245151
3459,0.000971,74.125.68.0-255,2902,139606,77,245151
3460,0.000974,172.31.40.0-255,66,139672,77,245151
3461,0.000979,74.125.68.0-255,2902,142574,77,245151
3462,0.000982,172.31.40.0-255,66,142640,77,245151
3463,0.000985,74.125.68.0-255,1484,144124,77,245151
3464,0.001006,74.125.68.0-255,2902,147026,77,245151
3465,0.001009,172.31.40.0-255,66,147092,77,245151
3466,0.001026,74.125.68.0-255,4320,151412,77,245151
3467,0.001028,172.31.40.0-255,66,151478,77,245151
3468,0.00105,74.125.68.0-255,2902,154380,77,245151
3469,0.001052,172.31.40.0-255,66,154446,77,245151
3470,0.001059,74.125.68.0-255,5738,160184,77,245151
3471,0.001061,172.31.40.0-255,66,160250,77,245151
3472,0.001074,74.125.68.0-255,2902,163152,77,245151
3473,0.001076,172.31.40.0-255,66,163218,77,245151
3474,0.001082,74.125.68.0-255,6438,169656,77,245151
3475,0.001085,172.31.40.0-255,66,169722,77,245151
3476,0.001321,172.31.40.0-255,101,169823,77,245151
3477,0.001948,74.125.68.0-255,1484,171307,77,245151
3478,0.001956,74.125.68.0-255,2902,174209,77,245151
3479,0.001959,172.31.40.0-255,66,174275,77,245151
3480,0.001963,74.125.68.0-255,1484,175759,77,245151
3481,0.001981,74.125.68.0-255,4320,180079,77,245151
3482,0.001983,172.31.40.0-255,66,180145,77,245151
3483,0.001988,74.125.68.0-255,2902,183047,77,245151
3484,0.00199,172.31.40.0-255,66,183113,77,245151
3485,0.00202,74.125.68.0-255,4320,187433,77,245151
3486,0.002023,172.31.40.0-255,66,187499,77,245151
3487,0.002026,74.125.68.0-255,1484,188983,77,245151
3488,0.00204,74.125.68.0-255,5738,194721,77,245151
3489,0.002042,172.31.40.0-255,66,194787,77,245151
3490,0.002055,74.125.68.0-255,1484,196271,77,245151
3491,0.002061,74.125.68.0-255,4320,200591,77,245151
3492,0.002064,172.31.40.0-255,66,200657,77,245151
3493,0.002091,74.125.68.0-255,1484,202141,77,245151
3494,0.002105,74.125.68.0-255,2184,204325,77,245151
3495,0.002109,172.31.40.0-255,66,204391,77,245151
3496,0.002286,74.125.68.0-255,1484,205875,77,245151
3497,0.003569,74.125.68.0-255,66,205941,77,245151
3498,0.004381,74.125.68.0-255,4320,210261,77,245151
3499,0.004387,172.31.40.0-255,66,210327,77,245151
3500,0.006665,74.125.68.0-255,5738,216065,77,245151
3501,0.006669,172.31.40.0-255,66,216131,77,245151
3502,0.008949,74.125.68.0-255,5738,221869,77,245151
3503,0.008956,172.31.40.0-255,66,221935,77,245151
3504,0.011258,74.125.68.0-255,5738,227673,77,245151
3505,0.011276,172.31.40.0-255,66,227739,77,245151
3506,0.01356,74.125.68.0-255,5738,233477,77,245151
3507,0.013575,172.31.40.0-255,66,233543,77,245151
3508,0.015879,74.125.68.0-255,5738,239281,77,245151
3509,0.015894,172.31.40.0-255,66,239347,77,245151
3510,0.018185,74.125.68.0-255,5738,245085,77,245151
3511,0.018195,172.31.40.0-255,66,245151,77,245151
3512,0.0,74.125.24.0-255,153,153,77,383929
3513,1.5e-05,172.31.40.0-255,66,219,77,383929
3514,2.2e-05,74.125.24.0-255,1484,1703,77,383929
3515,2.6e-05,172.31.40.0-255,66,1769,77,383929
3516,4e-05,74.125.24.0-255,2902,4671,77,383929
3517,4.3e-05,172.31.40.0-255,66,4737,77,383929
3518,5.1e-05,74.125.24.0-255,7156,11893,77,383929
3519,5.4e-05,172.31.40.0-255,66,11959,77,383929
3520,5.8e-05,74.125.24.0-255,2090,14049,77,383929
3521,6.1e-05,172.31.40.0-255,66,14115,77,383929
3522,0.000437,74.125.24.0-255,1484,15599,77,383929
3523,0.000443,172.31.40.0-255,66,15665,77,383929
3524,0.000449,74.125.24.0-255,2902,18567,77,383929
3525,0.000452,172.31.40.0-255,66,18633,77,383929
3526,0.000464,74.125.24.0-255,5738,24371,77,383929
3527,0.000467,172.31.40.0-255,66,24437,77,383929
3528,0.000515,74.125.24.0-255,6797,31234,77,383929
3529,0.000519,172.31.40.0-255,66,31300,77,383929
3530,0.000524,74.125.24.0-255,4320,35620,77,383929
3531,0.000526,172.31.40.0-255,66,35686,77,383929
3532,0.000556,74.125.24.0-255,2902,38588,77,383929
3533,0.000559,172.31.40.0-255,66,38654,77,383929
3534,0.000568,74.125.24.0-255,9633,48287,77,383929
3535,0.000575,172.31.40.0-255,66,48353,77,383929
3536,0.000939,74.125.24.0-255,1484,49837,77,383929
3537,0.000944,172.31.40.0-255,66,49903,77,383929
3538,0.00095,74.125.24.0-255,2902,52805,77,383929
3539,0.000952,172.31.40.0-255,66,52871,77,383929
3540,0.000982,74.125.24.0-255,5738,58609,77,383929
3541,0.000984,172.31.40.0-255,66,58675,77,383929
3542,0.000992,74.125.24.0-255,6797,65472,77,383929
3543,0.000994,172.31.40.0-255,66,65538,77,383929
3544,0.00109,74.125.24.0-255,1484,67022,77,383929
3545,0.001096,74.125.24.0-255,2902,69924,77,383929
3546,0.001098,172.31.40.0-255,66,69990,77,383929
3547,0.001105,74.125.24.0-255,5738,75728,77,383929
3548,0.001107,172.31.40.0-255,66,75794,77,383929
3549,0.001117,74.125.24.0-255,4320,80114,77,383929
3550,0.001119,172.31.40.0-255,66,80180,77,383929
3551,0.001151,74.125.24.0-255,2543,82723,77,383929
3552,0.001154,172.31.40.0-255,66,82789,77,383929
3553,0.001232,74.125.24.0-255,1484,84273,77,383929
3554,0.001237,74.125.24.0-255,2902,87175,77,383929
3555,0.00124,172.31.40.0-255,66,87241,77,383929
3556,0.001271,74.125.24.0-255,5738,92979,77,383929
3557,0.001275,172.31.40.0-255,66,93045,77,383929
3558,0.001279,74.125.24.0-255,2902,95947,77,383929
3559,0.001281,172.31.40.0-255,66,96013,77,383929
3560,0.001306,74.125.24.0-255,1484,97497,77,383929
3561,0.001311,74.125.24.0-255,2543,100040,77,383929
3562,0.001313,172.31.40.0-255,66,100106,77,383929
3563,0.001339,74.125.24.0-255,2902,103008,77,383929
3564,0.001347,172.31.40.0-255,66,103074,77,383929
3565,0.001355,74.125.24.0-255,7156,110230,77,383929
3566,0.001358,172.31.40.0-255,66,110296,77,383929
3567,0.001368,74.125.24.0-255,5738,116034,77,383929
3568,0.00137,172.31.40.0-255,66,116100,77,383929
3569,0.001407,172.31.40.0-255,66,116166,77,383929
3570,0.001413,74.125.24.0-255,3602,119768,77,383929
3571,0.001416,172.31.40.0-255,66,119834,77,383929
3572,0.001454,74.125.24.0-255,4320,124154,77,383929
3573,0.001458,172.31.40.0-255,66,124220,77,383929
3574,0.001463,74.125.24.0-255,4320,128540,77,383929
3575,0.001466,172.31.40.0-255,66,128606,77,383929
3576,0.001504,74.125.24.0-255,9992,138598,77,383929
3577,0.001507,172.31.40.0-255,66,138664,77,383929
3578,0.001566,172.31.40.0-255,66,138730,77,383929
3579,0.001569,74.125.24.0-255,1484,140214,77,383929
3580,0.00159,74.125.24.0-255,8574,148788,77,383929
3581,0.001593,172.31.40.0-255,66,148854,77,383929
3582,0.001601,74.125.24.0-255,8574,157428,77,383929
3583,0.001604,172.31.40.0-255,66,157494,77,383929
3584,0.001628,74.125.24.0-255,2902,160396,77,383929
3585,0.00163,172.31.40.0-255,66,160462,77,383929
3586,0.001645,74.125.24.0-255,12110,172572,77,383929
3587,0.001648,172.31.40.0-255,66,172638,77,383929
3588,0.001697,74.125.24.0-255,9992,182630,77,383929
3589,0.001701,172.31.40.0-255,66,182696,77,383929
3590,0.001715,74.125.24.0-255,11410,194106,77,383929
3591,0.001718,172.31.40.0-255,66,194172,77,383929
3592,0.001734,74.125.24.0-255,12110,206282,77,383929
3593,0.001737,172.31.40.0-255,66,206348,77,383929
3594,0.001852,74.125.24.0-255,1484,207832,77,383929
3595,0.001859,74.125.24.0-255,2902,210734,77,383929
3596,0.001862,172.31.40.0-255,66,210800,77,383929
3597,0.001898,74.125.24.0-255,5738,216538,77,383929
3598,0.001901,172.31.40.0-255,66,216604,77,383929
3599,0.001917,74.125.24.0-255,12828,229432,77,383929
3600,0.001925,172.31.40.0-255,66,229498,77,383929
3601,0.001935,74.125.24.0-255,10692,240190,77,383929
3602,0.001937,172.31.40.0-255,66,240256,77,383929
3603,0.001965,74.125.24.0-255,648,240904,77,383929
3604,0.002078,74.125.24.0-255,1484,242388,77,383929
3605,0.002083,172.31.40.0-255,66,242454,77,383929
3606,0.002089,74.125.24.0-255,2902,245356,77,383929
3607,0.002091,172.31.40.0-255,66,245422,77,383929
3608,0.002102,74.125.24.0-255,5738,251160,77,383929
3609,0.002105,172.31.40.0-255,66,251226,77,383929
3610,0.002117,74.125.24.0-255,12828,264054,77,383929
3611,0.002121,172.31.40.0-255,66,264120,77,383929
3612,0.002126,74.125.24.0-255,4320,268440,77,383929
3613,0.002128,172.31.40.0-255,66,268506,77,383929
3614,0.002168,74.125.24.0-255,6438,274944,77,383929
3615,0.002172,172.31.40.0-255,66,275010,77,383929
3616,0.002271,74.125.24.0-255,1484,276494,77,383929
3617,0.002278,74.125.24.0-255,2902,279396,77,383929
3618,0.002282,172.31.40.0-255,66,279462,77,383929
3619,0.002287,74.125.24.0-255,2902,282364,77,383929
3620,0.002289,172.31.40.0-255,66,282430,77,383929
3621,0.002323,74.125.24.0-255,2902,285332,77,383929
3622,0.002325,172.31.40.0-255,66,285398,77,383929
3623,0.002336,74.125.24.0-255,12828,298226,77,383929
3624,0.002343,172.31.40.0-255,66,298292,77,383929
3625,0.00235,74.125.24.0-255,7156,305448,77,383929
3626,0.002352,172.31.40.0-255,66,305514,77,383929
3627,0.0024,74.125.24.0-255,3602,309116,77,383929
3628,0.002407,172.31.40.0-255,66,309182,77,383929
3629,0.002433,74.125.24.0-255,2902,312084,77,383929
3630,0.002436,172.31.40.0-255,66,312150,77,383929
3631,0.002441,74.125.24.0-255,4320,316470,77,383929
3632,0.002443,172.31.40.0-255,66,316536,77,383929
3633,0.002449,74.125.24.0-255,4320,320856,77,383929
3634,0.002451,172.31.40.0-255,66,320922,77,383929
3635,0.00248,74.125.24.0-255,4320,325242,77,383929
3636,0.002482,172.31.40.0-255,66,325308,77,383929
3637,0.002494,74.125.24.0-255,11410,336718,77,383929
3638,0.002497,172.31.40.0-255,66,336784,77,383929
3639,0.00254,74.125.24.0-255,6438,343222,77,383929
3640,0.002543,172.31.40.0-255,66,343288,77,383929
3641,0.002546,74.125.24.0-255,1484,344772,77,383929
3642,0.002551,74.125.24.0-255,2902,347674,77,383929
3643,0.002553,172.31.40.0-255,66,347740,77,383929
3644,0.002563,74.125.24.0-255,5738,353478,77,383929
3645,0.002566,172.31.40.0-255,66,353544,77,383929
3646,0.002572,74.125.24.0-255,5738,359282,77,383929
3647,0.002574,172.31.40.0-255,66,359348,77,383929
3648,0.002608,74.125.24.0-255,7156,366504,77,383929
3649,0.002615,172.31.40.0-255,66,366570,77,383929
3650,0.002623,74.125.24.0-255,7156,373726,77,383929
3651,0.002624,172.31.40.0-255,66,373792,77,383929
3652,0.002629,74.125.24.0-255,3602,377394,77,383929
3653,0.002631,172.31.40.0-255,66,377460,77,383929
3654,0.005192,74.125.24.0-255,5738,383198,77,383929
3655,0.0052,172.31.40.0-255,66,383264,77,383929
3656,0.007744,74.125.24.0-255,428,383692,77,383929
3657,0.012794,172.31.40.0-255,66,383758,77,383929
3658,0.012845,172.31.40.0-255,105,383863,77,383929
3659,0.015359,74.125.24.0-255,66,383929,77,383929
3660,0.0,74.125.24.0-255,300,300,77,231748
3661,2.2e-05,172.31.40.0-255,66,366,77,231748
3662,2.9e-05,74.125.24.0-255,1484,1850,77,231748
3663,3.3e-05,172.31.40.0-255,66,1916,77,231748
3664,4.9e-05,74.125.24.0-255,4320,6236,77,231748
3665,5.3e-05,172.31.40.0-255,66,6302,77,231748
3666,5.6e-05,74.125.24.0-255,1484,7786,77,231748
3667,5.8e-05,172.31.40.0-255,66,7852,77,231748
3668,9.4e-05,74.125.24.0-255,6097,13949,77,231748
3669,9.7e-05,172.31.40.0-255,66,14015,77,231748
3670,0.000169,74.125.24.0-255,1484,15499,77,231748
3671,0.000172,172.31.40.0-255,66,15565,77,231748
3672,0.000175,74.125.24.0-255,1484,17049,77,231748
3673,0.000177,172.31.40.0-255,66,17115,77,231748
3674,0.000208,74.125.24.0-255,1484,18599,77,231748
3675,0.000211,172.31.40.0-255,66,18665,77,231748
3676,0.000218,74.125.24.0-255,5738,24403,77,231748
3677,0.00022,172.31.40.0-255,66,24469,77,231748
3678,0.000232,74.125.24.0-255,6797,31266,77,231748
3679,0.000234,172.31.40.0-255,66,31332,77,231748
3680,0.000237,74.125.24.0-255,1484,32816,77,231748
3681,0.000239,172.31.40.0-255,66,32882,77,231748
3682,0.000282,74.125.24.0-255,12828,45710,77,231748
3683,0.000284,172.31.40.0-255,66,45776,77,231748
3684,0.000294,74.125.24.0-255,11410,57186,77,231748
3685,0.000297,172.31.40.0-255,66,57252,77,231748
3686,0.000327,74.125.24.0-255,1484,58736,77,231748
3687,0.000329,172.31.40.0-255,66,58802,77,231748
3688,0.000366,74.125.24.0-255,6770,65572,77,231748
3689,0.000369,172.31.40.0-255,66,65638,77,231748
3690,0.000423,74.125.24.0-255,344,65982,77,231748
3691,0.000425,172.31.40.0-255,66,66048,77,231748
3692,0.000571,74.125.24.0-255,1484,67532,77,231748
3693,0.000587,74.125.24.0-255,2902,70434,77,231748
3694,0.000604,74.125.24.0-255,5738,76172,77,231748
3695,0.00064,74.125.24.0-255,4320,80492,77,231748
3696,0.000659,74.125.24.0-255,8574,89066,77,231748
3697,0.00069,74.125.24.0-255,4320,93386,77,231748
3698,0.000708,74.125.24.0-255,6438,99824,77,231748
3699,0.000851,74.125.24.0-255,1484,101308,77,231748
3700,0.000869,74.125.24.0-255,2902,104210,77,231748
3701,0.000913,74.125.24.0-255,2902,107112,77,231748
3702,0.00095,74.125.24.0-255,7156,114268,77,231748
3703,0.00098,74.125.24.0-255,8574,122842,77,231748
3704,0.000983,74.125.24.0-255,1484,124326,77,231748
3705,0.001003,74.125.24.0-255,5738,130064,77,231748
3706,0.001033,172.31.40.0-255,66,130130,77,231748
3707,0.001051,74.125.24.0-255,3602,133732,77,231748
3708,0.001075,74.125.24.0-255,1484,135216,77,231748
3709,0.001088,74.125.24.0-255,2902,138118,77,231748
3710,0.00109,74.125.24.0-255,1484,139602,77,231748
3711,0.001111,74.125.24.0-255,5738,145340,77,231748
3712,0.001146,74.125.24.0-255,1484,146824,77,231748
3713,0.001172,74.125.24.0-255,11410,158234,77,231748
3714,0.001181,74.125.24.0-255,9274,167508,77,231748
3715,0.001374,172.31.40.0-255,66,167574,77,231748
3716,0.002006,74.125.24.0-255,1484,169058,77,231748
3717,0.002012,74.125.24.0-255,1484,170542,77,231748
3718,0.002023,74.125.24.0-255,1484,172026,77,231748
3719,0.002039,74.125.24.0-255,5738,177764,77,231748
3720,0.002041,74.125.24.0-255,1484,179248,77,231748
3721,0.002045,172.31.40.0-255,66,179314,77,231748
3722,0.002051,172.31.40.0-255,66,179380,77,231748
3723,0.002062,74.125.24.0-255,2902,182282,77,231748
3724,0.002069,74.125.24.0-255,1484,183766,77,231748
3725,0.002093,74.125.24.0-255,1484,185250,77,231748
3726,0.002103,172.31.40.0-255,66,185316,77,231748
3727,0.004177,74.125.24.0-255,5738,191054,77,231748
3728,0.004185,172.31.40.0-255,66,191120,77,231748
3729,0.006225,74.125.24.0-255,5738,196858,77,231748
3730,0.007009,172.31.40.0-255,66,196924,77,231748
3731,0.00909,74.125.24.0-255,5738,202662,77,231748
3732,0.009096,172.31.40.0-255,66,202728,77,231748
3733,0.011113,74.125.24.0-255,5738,208466,77,231748
3734,0.01112,172.31.40.0-255,66,208532,77,231748
3735,0.013165,74.125.24.0-255,5738,214270,77,231748
3736,0.013172,172.31.40.0-255,66,214336,77,231748
3737,0.01523,74.125.24.0-255,5738,220074,77,231748
3738,0.015237,172.31.40.0-255,66,220140,77,231748
3739,0.017286,74.125.24.0-255,5738,225878,77,231748
3740,0.017295,172.31.40.0-255,66,225944,77,231748
3741,0.019312,74.125.24.0-255,5738,231682,77,231748
3742,0.01932,172.31.40.0-255,66,231748,77,231748
3743,0.0,74.125.130.0-255,150,150,77,358574
3744,2.3e-05,172.31.40.0-255,66,216,77,358574
3745,3e-05,74.125.130.0-255,1484,1700,77,358574
3746,3.6e-05,172.31.40.0-255,66,1766,77,358574
3747,4.3e-05,74.125.130.0-255,2902,4668,77,358574
3748,5.4e-05,172.31.40.0-255,66,4734,77,358574
3749,6e-05,74.125.130.0-255,4320,9054,77,358574
3750,6.3e-05,172.31.40.0-255,66,9120,77,358574
3751,6.9e-05,74.125.130.0-255,4320,13440,77,358574
3752,7.2e-05,172.31.40.0-255,66,13506,77,358574
3753,9.3e-05,74.125.130.0-255,621,14127,77,358574
3754,9.6e-05,172.31.40.0-255,66,14193,77,358574
3755,0.000135,74.125.130.0-255,1484,15677,77,358574
3756,0.000138,172.31.40.0-255,66,15743,77,358574
3757,0.000144,74.125.130.0-255,2902,18645,77,358574
3758,0.000146,172.31.40.0-255,66,18711,77,358574
3759,0.000182,74.125.130.0-255,5738,24449,77,358574
3760,0.000185,172.31.40.0-255,66,24515,77,358574
3761,0.000191,74.125.130.0-255,4320,28835,77,358574
3762,0.000194,172.31.40.0-255,66,28901,77,358574
3763,0.00022,74.125.130.0-255,2543,31444,77,358574
3764,0.000223,172.31.40.0-255,66,31510,77,358574
3765,0.00031,74.125.130.0-255,1484,32994,77,358574
3766,0.000313,172.31.40.0-255,66,33060,77,358574
3767,0.000346,74.125.130.0-255,2902,35962,77,358574
3768,0.000349,172.31.40.0-255,66,36028,77,358574
3769,0.000356,74.125.130.0-255,4320,40348,77,358574
3770,0.000358,172.31.40.0-255,66,40414,77,358574
3771,0.000372,74.125.130.0-255,9633,50047,77,358574
3772,0.000374,172.31.40.0-255,66,50113,77,358574
3773,0.000379,74.125.130.0-255,2902,53015,77,358574
3774,0.000381,172.31.40.0-255,66,53081,77,358574
3775,0.00042,74.125.130.0-255,8574,61655,77,358574
3776,0.000423,172.31.40.0-255,66,61721,77,358574
3777,0.000428,74.125.130.0-255,4267,65988,77,358574
3778,0.000431,172.31.40.0-255,66,66054,77,358574
3779,0.00045,74.125.130.0-255,381,66435,77,358574
3780,0.000639,74.125.130.0-255,1484,67919,77,358574
3781,0.000644,172.31.40.0-255,66,67985,77,358574
3782,0.00065,74.125.130.0-255,2902,70887,77,358574
3783,0.000653,172.31.40.0-255,66,70953,77,358574
3784,0.000665,74.125.130.0-255,5738,76691,77,358574
3785,0.000667,172.31.40.0-255,66,76757,77,358574
3786,0.000714,74.125.130.0-255,11410,88167,77,358574
3787,0.000718,172.31.40.0-255,66,88233,77,358574
3788,0.000724,74.125.130.0-255,5738,93971,77,358574
3789,0.000726,172.31.40.0-255,66,94037,77,358574
3790,0.000756,74.125.130.0-255,6438,100475,77,358574
3791,0.000759,172.31.40.0-255,66,100541,77,358574
3792,0.000762,74.125.130.0-255,1484,102025,77,358574
3793,0.000788,74.125.130.0-255,2902,104927,77,358574
3794,0.00079,172.31.40.0-255,66,104993,77,358574
3795,0.000796,74.125.130.0-255,4320,109313,77,358574
3796,0.000798,172.31.40.0-255,66,109379,77,358574
3797,0.000836,74.125.130.0-255,1484,110863,77,358574
3798,0.000877,74.125.130.0-255,7156,118019,77,358574
3799,0.000881,172.31.40.0-255,66,118085,77,358574
3800,0.000902,172.31.40.0-255,66,118151,77,358574
3801,0.000928,74.125.130.0-255,1484,119635,77,358574
3802,0.000933,74.125.130.0-255,2902,122537,77,358574
3803,0.000936,172.31.40.0-255,66,122603,77,358574
3804,0.000968,74.125.130.0-255,5738,128341,77,358574
3805,0.000971,172.31.40.0-255,66,128407,77,358574
3806,0.00098,74.125.130.0-255,8574,136981,77,358574
3807,0.000982,172.31.40.0-255,66,137047,77,358574
3808,0.001003,74.125.130.0-255,4320,141367,77,358574
3809,0.001006,172.31.40.0-255,66,141433,77,358574
3810,0.001013,74.125.130.0-255,7156,148589,77,358574
3811,0.001015,172.31.40.0-255,66,148655,77,358574
3812,0.001043,74.125.130.0-255,3602,152257,77,358574
3813,0.001045,172.31.40.0-255,66,152323,77,358574
3814,0.001112,74.125.130.0-255,1484,153807,77,358574
3815,0.001116,74.125.130.0-255,1484,155291,77,358574
3816,0.001119,172.31.40.0-255,66,155357,77,358574
3817,0.001148,74.125.130.0-255,1484,156841,77,358574
3818,0.001155,74.125.130.0-255,5738,162579,77,358574
3819,0.001158,172.31.40.0-255,66,162645,77,358574
3820,0.001165,74.125.130.0-255,7156,169801,77,358574
3821,0.001167,172.31.40.0-255,66,169867,77,358574
3822,0.001179,74.125.130.0-255,7156,177023,77,358574
3823,0.001181,172.31.40.0-255,66,177089,77,358574
3824,0.001216,74.125.130.0-255,7156,184245,77,358574
3825,0.00122,172.31.40.0-255,66,184311,77,358574
3826,0.001224,74.125.130.0-255,2184,186495,77,358574
3827,0.001226,172.31.40.0-255,66,186561,77,358574
3828,0.001275,74.125.130.0-255,1484,188045,77,358574
3829,0.001293,74.125.130.0-255,1484,189529,77,358574
3830,0.001296,172.31.40.0-255,66,189595,77,358574
3831,0.001301,74.125.130.0-255,2902,192497,77,358574
3832,0.001303,172.31.40.0-255,66,192563,77,358574
3833,0.001309,74.125.130.0-255,5738,198301,77,358574
3834,0.001317,172.31.40.0-255,66,198367,77,358574
3835,0.00136,74.125.130.0-255,12828,211195,77,358574
3836,0.001369,74.125.130.0-255,8574,219769,77,358574
3837,0.001374,172.31.40.0-255,66,219835,77,358574
3838,0.001384,172.31.40.0-255,66,219901,77,358574
3839,0.001396,74.125.130.0-255,4320,224221,77,358574
3840,0.001399,172.31.40.0-255,66,224287,77,358574
3841,0.00147,74.125.130.0-255,10692,234979,77,358574
3842,0.001491,172.31.40.0-255,66,235045,77,358574
3843,0.0015,74.125.130.0-255,1484,236529,77,358574
3844,0.001518,74.125.130.0-255,2902,239431,77,358574
3845,0.00152,74.125.130.0-255,1484,240915,77,358574
3846,0.001527,172.31.40.0-255,66,240981,77,358574
3847,0.001538,74.125.130.0-255,4320,245301,77,358574
3848,0.001557,74.125.130.0-255,5738,251039,77,358574
3849,0.001572,172.31.40.0-255,66,251105,77,358574
3850,0.001586,74.125.130.0-255,8215,259320,77,358574
3851,0.001597,74.125.130.0-255,7156,266476,77,358574
3852,0.001642,172.31.40.0-255,66,266542,77,358574
3853,0.001708,74.125.130.0-255,1484,268026,77,358574
3854,0.001712,74.125.130.0-255,1484,269510,77,358574
3855,0.001725,172.31.40.0-255,66,269576,77,358574
3856,0.001729,74.125.130.0-255,1484,271060,77,358574
3857,0.001735,74.125.130.0-255,5738,276798,77,358574
3858,0.001749,74.125.130.0-255,1484,278282,77,358574
3859,0.001752,172.31.40.0-255,66,278348,77,358574
3860,0.001778,74.125.130.0-255,11410,289758,77,358574
3861,0.001785,74.125.130.0-255,5738,295496,77,358574
3862,0.001796,172.31.40.0-255,66,295562,77,358574
3863,0.001808,74.125.130.0-255,5020,300582,77,358574
3864,0.001822,74.125.130.0-255,11410,311992,77,358574
3865,0.001826,74.125.130.0-255,2902,314894,77,358574
3866,0.001846,74.125.130.0-255,11410,326304,77,358574
3867,0.001862,74.125.130.0-255,4320,330624,77,358574
3868,0.001874,172.31.40.0-255,66,330690,77,358574
3869,0.001911,74.125.130.0-255,10692,341382,77,358574
3870,0.00192,74.125.130.0-255,8574,349956,77,358574
3871,0.001935,172.31.40.0-255,66,350022,77,358574
3872,0.001944,74.125.130.0-255,8144,358166,77,358574
3873,0.001955,172.31.40.0-255,66,358232,77,358574
3874,0.001962,74.125.130.0-255,105,358337,77,358574
3875,0.010938,172.31.40.0-255,66,358403,77,358574
3876,0.010987,172.31.40.0-255,105,358508,77,358574
3877,0.013533,74.125.130.0-255,66,358574,77,358574
3878,0.0,74.125.130.0-255,153,153,77,202705
3879,2.1e-05,172.31.40.0-255,66,219,77,202705
3880,2.8e-05,74.125.130.0-255,1484,1703,77,202705
3881,3.3e-05,172.31.40.0-255,66,1769,77,202705
3882,3.9e-05,74.125.130.0-255,2902,4671,77,202705
3883,4.8e-05,172.31.40.0-255,66,4737,77,202705
3884,5.5e-05,74.125.130.0-255,5738,10475,77,202705
3885,5.8e-05,172.31.40.0-255,66,10541,77,202705
3886,6.5e-05,74.125.130.0-255,3482,14023,77,202705
3887,6.8e-05,172.31.40.0-255,66,14089,77,202705
3888,0.000153,74.125.130.0-255,1484,15573,77,202705
3889,0.000157,172.31.40.0-255,66,15639,77,202705
3890,0.00016,74.125.130.0-255,1484,17123,77,202705
3891,0.000162,172.31.40.0-255,66,17189,77,202705
3892,0.000188,74.125.130.0-255,2902,20091,77,202705
3893,0.000191,172.31.40.0-255,66,20157,77,202705
3894,0.000202,74.125.130.0-255,5738,25895,77,202705
3895,0.000204,172.31.40.0-255,66,25961,77,202705
3896,0.000242,74.125.130.0-255,5379,31340,77,202705
3897,0.000244,172.31.40.0-255,66,31406,77,202705
3898,0.000751,74.125.130.0-255,1484,32890,77,202705
3899,0.000757,172.31.40.0-255,66,32956,77,202705
3900,0.000766,74.125.130.0-255,2902,35858,77,202705
3901,0.000768,172.31.40.0-255,66,35924,77,202705
3902,0.00078,74.125.130.0-255,2902,38826,77,202705
3903,0.000782,172.31.40.0-255,66,38892,77,202705
3904,0.000788,74.125.130.0-255,4320,43212,77,202705
3905,0.000789,172.31.40.0-255,66,43278,77,202705
3906,0.000822,74.125.130.0-255,4320,47598,77,202705
3907,0.000826,172.31.40.0-255,66,47664,77,202705
3908,0.000853,74.125.130.0-255,5379,53043,77,202705
3909,0.000855,172.31.40.0-255,66,53109,77,202705
3910,0.000865,74.125.130.0-255,9992,63101,77,202705
3911,0.000866,172.31.40.0-255,66,63167,77,202705
3912,0.000871,74.125.130.0-255,2543,65710,77,202705
3913,0.000872,172.31.40.0-255,66,65776,77,202705
3914,0.000916,74.125.130.0-255,677,66453,77,202705
3915,0.001325,74.125.130.0-255,1484,67937,77,202705
3916,0.001333,172.31.40.0-255,66,68003,77,202705
3917,0.001339,74.125.130.0-255,2902,70905,77,202705
3918,0.001342,172.31.40.0-255,66,70971,77,202705
3919,0.00138,74.125.130.0-255,5738,76709,77,202705
3920,0.001383,172.31.40.0-255,66,76775,77,202705
3921,0.00139,74.125.130.0-255,7156,83931,77,202705
3922,0.001393,172.31.40.0-255,66,83997,77,202705
3923,0.001426,74.125.130.0-255,8574,92571,77,202705
3924,0.001429,172.31.40.0-255,66,92637,77,202705
3925,0.001482,74.125.130.0-255,4320,96957,77,202705
3926,0.001485,172.31.40.0-255,66,97023,77,202705
3927,0.001491,74.125.130.0-255,3602,100625,77,202705
3928,0.001493,172.31.40.0-255,66,100691,77,202705
3929,0.001614,74.125.130.0-255,1484,102175,77,202705
3930,0.001636,74.125.130.0-255,2902,105077,77,202705
3931,0.00164,172.31.40.0-255,66,105143,77,202705
3932,0.001644,74.125.130.0-255,1484,106627,77,202705
3933,0.001661,74.125.130.0-255,2902,109529,77,202705
3934,0.001664,172.31.40.0-255,66,109595,77,202705
3935,0.001697,74.125.130.0-255,8574,118169,77,202705
3936,0.0017,172.31.40.0-255,66,118235,77,202705
3937,0.001704,74.125.130.0-255,2902,121137,77,202705
3938,0.001706,172.31.40.0-255,66,121203,77,202705
3939,0.001738,74.125.130.0-255,8574,129777,77,202705
3940,0.001741,172.31.40.0-255,66,129843,77,202705
3941,0.001782,74.125.130.0-255,4320,134163,77,202705
3942,0.001786,172.31.40.0-255,66,134229,77,202705
3943,0.001788,74.125.130.0-255,766,134995,77,202705
3944,0.002405,74.125.130.0-255,1484,136479,77,202705
3945,0.00241,172.31.40.0-255,66,136545,77,202705
3946,0.002416,74.125.130.0-255,2902,139447,77,202705
3947,0.002418,172.31.40.0-255,66,139513,77,202705
3948,0.002438,74.125.130.0-255,4320,143833,77,202705
3949,0.002441,172.31.40.0-255,66,143899,77,202705
3950,0.002473,74.125.130.0-255,5738,149637,77,202705
3951,0.002476,172.31.40.0-255,66,149703,77,202705
3952,0.002486,74.125.130.0-255,11410,161113,77,202705
3953,0.002488,172.31.40.0-255,66,161179,77,202705
3954,0.002497,74.125.130.0-255,2902,164081,77,202705
3955,0.0025,172.31.40.0-255,66,164147,77,202705
3956,0.002506,74.125.130.0-255,4320,168467,77,202705
3957,0.002508,172.31.40.0-255,66,168533,77,202705
3958,0.002536,74.125.130.0-255,766,169299,77,202705
3959,0.005008,74.125.130.0-255,4320,173619,77,202705
3960,0.005013,172.31.40.0-255,66,173685,77,202705
3961,0.007514,74.125.130.0-255,5738,179423,77,202705
3962,0.007521,172.31.40.0-255,66,179489,77,202705
3963,0.010023,74.125.130.0-255,5738,185227,77,202705
3964,0.010032,172.31.40.0-255,66,185293,77,202705
3965,0.012537,74.125.130.0-255,5738,191031,77,202705
3966,0.012545,172.31.40.0-255,66,191097,77,202705
3967,0.015049,74.125.130.0-255,5738,196835,77,202705
3968,0.015057,172.31.40.0-255,66,196901,77,202705
3969,0.017584,74.125.130.0-255,5738,202639,77,202705
3970,0.017591,172.31.40.0-255,66,202705,77,202705
3971,0.0,74.125.24.0-255,298,298,77,369236
3972,2.3e-05,172.31.40.0-255,66,364,77,369236
3973,3e-05,74.125.24.0-255,1484,1848,77,369236
3974,3.6e-05,172.31.40.0-255,66,1914,77,369236
3975,4.3e-05,74.125.24.0-255,4320,6234,77,369236
3976,4.5e-05,172.31.40.0-255,66,6300,77,369236
3977,6.5e-05,74.125.24.0-255,4320,10620,77,369236
3978,6.8e-05,172.31.40.0-255,66,10686,77,369236
3979,9.2e-05,74.125.24.0-255,3123,13809,77,369236
3980,9.5e-05,172.31.40.0-255,66,13875,77,369236
3981,0.000155,74.125.24.0-255,1484,15359,77,369236
3982,0.000158,172.31.40.0-255,66,15425,77,369236
3983,0.000163,74.125.24.0-255,2902,18327,77,369236
3984,0.000165,172.31.40.0-255,66,18393,77,369236
3985,0.000187,74.125.24.0-255,2902,21295,77,369236
3986,0.00019,172.31.40.0-255,66,21361,77,369236
3987,0.000209,74.125.24.0-255,2902,24263,77,369236
3988,0.000212,172.31.40.0-255,66,24329,77,369236
3989,0.000218,74.125.24.0-255,4320,28649,77,369236
3990,0.00022,172.31.40.0-255,66,28715,77,369236
3991,0.000233,74.125.24.0-255,2543,31258,77,369236
3992,0.000235,172.31.40.0-255,66,31324,77,369236
3993,0.000255,74.125.24.0-255,1484,32808,77,369236
3994,0.000258,172.31.40.0-255,66,32874,77,369236
3995,0.000262,74.125.24.0-255,2902,35776,77,369236
3996,0.000264,172.31.40.0-255,66,35842,77,369236
3997,0.000267,74.125.24.0-255,1484,37326,77,369236
3998,0.000269,172.31.40.0-255,66,37392,77,369236
3999,0.000295,74.125.24.0-255,4320,41712,77,369236
4000,0.000299,172.31.40.0-255,66,41778,77,369236
4001,0.000305,74.125.24.0-255,5738,47516,77,369236
4002,0.000307,172.31.40.0-255,66,47582,77,369236
4003,0.000319,74.125.24.0-255,1125,48707,77,369236
4004,0.000721,74.125.24.0-255,1484,50191,77,369236
4005,0.000727,172.31.40.0-255,66,50257,77,369236
4006,0.000732,74.125.24.0-255,2902,53159,77,369236
4007,0.000734,172.31.40.0-255,66,53225,77,369236
4008,0.000741,74.125.24.0-255,5738,58963,77,369236
4009,0.000759,74.125.24.0-255,2902,61865,77,369236
4010,0.000771,74.125.24.0-255,3961,65826,77,369236
4011,0.000775,172.31.40.0-255,66,65892,77,369236
4012,0.00078,172.31.40.0-255,66,65958,77,369236
4013,0.000878,74.125.24.0-255,648,66606,77,369236
4014,0.000904,74.125.24.0-255,1484,68090,77,369236
4015,0.000907,172.31.40.0-255,66,68156,77,369236
4016,0.000931,74.125.24.0-255,4320,72476,77,369236
4017,0.000934,172.31.40.0-255,66,72542,77,369236
4018,0.000958,74.125.24.0-255,9992,82534,77,369236
4019,0.000963,74.125.24.0-255,2902,85436,77,369236
4020,0.000975,172.31.40.0-255,66,85502,77,369236
4021,0.000991,74.125.24.0-255,4320,89822,77,369236
4022,0.001017,74.125.24.0-255,9992,99814,77,369236
4023,0.00102,74.125.24.0-255,766,100580,77,369236
4024,0.001024,172.31.40.0-255,66,100646,77,369236
4025,0.001061,74.125.24.0-255,1484,102130,77,369236
4026,0.001066,74.125.24.0-255,2902,105032,77,369236
4027,0.001083,74.125.24.0-255,5738,110770,77,369236
4028,0.001089,172.31.40.0-255,66,110836,77,369236
4029,0.001114,74.125.24.0-255,12828,123664,77,369236
4030,0.001122,74.125.24.0-255,8574,132238,77,369236
4031,0.001138,172.31.40.0-255,66,132304,77,369236
4032,0.001156,74.125.24.0-255,1484,133788,77,369236
4033,0.001183,74.125.24.0-255,12828,146616,77,369236
4034,0.001189,172.31.40.0-255,66,146682,77,369236
4035,0.00121,74.125.24.0-255,8723,155405,77,369236
4036,0.001221,74.125.24.0-255,11410,166815,77,369236
4037,0.001223,74.125.24.0-255,766,167581,77,369236
4038,0.001283,172.31.40.0-255,66,167647,77,369236
4039,0.001335,74.125.24.0-255,1484,169131,77,369236
4040,0.001339,74.125.24.0-255,1484,170615,77,369236
4041,0.001351,74.125.24.0-255,1484,172099,77,369236
4042,0.001357,74.125.24.0-255,5738,177837,77,369236
4043,0.001369,172.31.40.0-255,66,177903,77,369236
4044,0.001399,74.125.24.0-255,12828,190731,77,369236
4045,0.001419,74.125.24.0-255,1484,192215,77,369236
4046,0.001436,74.125.24.0-255,7156,199371,77,369236
4047,0.001451,172.31.40.0-255,66,199437,77,369236
4048,0.001456,74.125.24.0-255,2184,201621,77,369236
4049,0.001461,172.31.40.0-255,66,201687,77,369236
4050,0.001479,74.125.24.0-255,1484,203171,77,369236
4051,0.001483,74.125.24.0-255,1484,204655,77,369236
4052,0.001498,74.125.24.0-255,1484,206139,77,369236
4053,0.001504,74.125.24.0-255,5738,211877,77,369236
4054,0.001515,172.31.40.0-255,66,211943,77,369236
4055,0.00152,74.125.24.0-255,2902,214845,77,369236
4056,0.001524,172.31.40.0-255,66,214911,77,369236
4057,0.001539,74.125.24.0-255,9992,224903,77,369236
4058,0.001545,74.125.24.0-255,4320,229223,77,369236
4059,0.001568,74.125.24.0-255,2902,232125,77,369236
4060,0.001571,172.31.40.0-255,66,232191,77,369236
4061,0.001583,74.125.24.0-255,3602,235793,77,369236
4062,0.001586,172.31.40.0-255,66,235859,77,369236
4063,0.001612,172.31.40.0-255,66,235925,77,369236
4064,0.001663,74.125.24.0-255,1484,237409,77,369236
4065,0.001669,74.125.24.0-255,2902,240311,77,369236
4066,0.001674,74.125.24.0-255,2902,243213,77,369236
4067,0.001679,172.31.40.0-255,66,243279,77,369236
4068,0.001694,74.125.24.0-255,2902,246181,77,369236
4069,0.001701,74.125.24.0-255,5738,251919,77,369236
4070,0.001721,74.125.24.0-255,1484,253403,77,369236
4071,0.001734,74.125.24.0-255,12828,266231,77,369236
4072,0.001745,74.125.24.0-255,1484,267715,77,369236
4073,0.001749,74.125.24.0-255,2184,269899,77,369236
4074,0.001753,172.31.40.0-255,66,269965,77,369236
4075,0.001758,172.31.40.0-255,66,270031,77,369236
4076,0.001888,74.125.24.0-255,1484,271515,77,369236
4077,0.001911,74.125.24.0-255,2902,274417,77,369236
4078,0.001916,74.125.24.0-255,2902,277319,77,369236
4079,0.001929,74.125.24.0-255,2902,280221,77,369236
4080,0.001946,74.125.24.0-255,4320,284541,77,369236
4081,0.001949,172.31.40.0-255,66,284607,77,369236
4082,0.001954,172.31.40.0-255,66,284673,77,369236
4083,0.00199,74.125.24.0-255,11410,296083,77,369236
4084,0.001999,74.125.24.0-255,9992,306075,77,369236
4085,0.002016,74.125.24.0-255,5020,311095,77,369236
4086,0.002023,74.125.24.0-255,5738,316833,77,369236
4087,0.00203,172.31.40.0-255,66,316899,77,369236
4088,0.002046,74.125.24.0-255,9992,326891,77,369236
4089,0.00205,74.125.24.0-255,1484,328375,77,369236
4090,0.002082,172.31.40.0-255,66,328441,77,369236
4091,0.004139,74.125.24.0-255,5738,334179,77,369236
4092,0.006882,172.31.40.0-255,66,334245,77,369236
4093,0.006962,172.31.40.0-255,101,334346,77,369236
4094,0.008904,74.125.24.0-255,5738,340084,77,369236
4095,0.008911,172.31.40.0-255,66,340150,77,369236
4096,0.008935,74.125.24.0-255,66,340216,77,369236
4097,0.010953,74.125.24.0-255,5738,345954,77,369236
4098,0.01096,172.31.40.0-255,66,346020,77,369236
4099,0.013004,74.125.24.0-255,5738,351758,77,369236
4100,0.01301,172.31.40.0-255,66,351824,77,369236
4101,0.01506,74.125.24.0-255,5738,357562,77,369236
4102,0.015069,172.31.40.0-255,66,357628,77,369236
4103,0.017098,74.125.24.0-255,5738,363366,77,369236
4104,0.017105,172.31.40.0-255,66,363432,77,369236
4105,0.019159,74.125.24.0-255,5738,369170,77,369236
4106,0.019169,172.31.40.0-255,66,369236,77,369236
4107,0.0,216.58.221.0-255,146,146,77,125970
4108,2.4e-05,172.31.40.0-255,66,212,77,125970
4109,3.1e-05,216.58.221.0-255,1484,1696,77,125970
4110,3.6e-05,172.31.40.0-255,66,1762,77,125970
4111,4.2e-05,216.58.221.0-255,2902,4664,77,125970
4112,4.6e-05,172.31.40.0-255,66,4730,77,125970
4113,7.8e-05,216.58.221.0-255,1484,6214,77,125970
4114,8.1e-05,172.31.40.0-255,66,6280,77,125970
4115,9.4e-05,216.58.221.0-255,2902,9182,77,125970
4116,9.6e-05,172.31.40.0-255,66,9248,77,125970
4117,0.000175,216.58.221.0-255,4818,14066,77,125970
4118,0.000178,172.31.40.0-255,66,14132,77,125970
4119,0.000922,216.58.221.0-255,1484,15616,77,125970
4120,0.000929,172.31.40.0-255,66,15682,77,125970
4121,0.00094,216.58.221.0-255,2902,18584,77,125970
4122,0.000942,172.31.40.0-255,66,18650,77,125970
4123,0.00097,216.58.221.0-255,4320,22970,77,125970
4124,0.000973,172.31.40.0-255,66,23036,77,125970
4125,0.001001,216.58.221.0-255,1484,24520,77,125970
4126,0.001004,172.31.40.0-255,66,24586,77,125970
4127,0.001091,216.58.221.0-255,6797,31383,77,125970
4128,0.001094,172.31.40.0-255,66,31449,77,125970
4129,0.001234,216.58.221.0-255,5738,37187,77,125970
4130,0.001239,172.31.40.0-255,66,37253,77,125970
4131,0.001264,216.58.221.0-255,8574,45827,77,125970
4132,0.001267,172.31.40.0-255,66,45893,77,125970
4133,0.001511,216.58.221.0-255,5738,51631,77,125970
4134,0.001514,172.31.40.0-255,66,51697,77,125970
4135,0.001531,216.58.221.0-255,5738,57435,77,125970
4136,0.001533,172.31.40.0-255,66,57501,77,125970
4137,0.001738,216.58.221.0-255,8185,65686,77,125970
4138,0.001741,172.31.40.0-255,66,65752,77,125970
4139,0.001862,216.58.221.0-255,116,65868,77,125970
4140,0.003634,216.58.221.0-255,4320,70188,77,125970
4141,0.003665,172.31.40.0-255,66,70254,77,125970
4142,0.005565,216.58.221.0-255,5738,75992,77,125970
4143,0.005572,172.31.40.0-255,66,76058,77,125970
4144,0.007468,216.58.221.0-255,5738,81796,77,125970
4145,0.007476,172.31.40.0-255,66,81862,77,125970
4146,0.009413,216.58.221.0-255,5738,87600,77,125970
4147,0.009421,172.31.40.0-255,66,87666,77,125970
4148,0.011325,216.58.221.0-255,5738,93404,77,125970
4149,0.011597,172.31.40.0-255,66,93470,77,125970
4150,0.013508,216.58.221.0-255,5738,99208,77,125970
4151,0.013516,172.31.40.0-255,66,99274,77,125970
4152,0.015415,216.58.221.0-255,5738,105012,77,125970
4153,0.01542,172.31.40.0-255,66,105078,77,125970
4154,0.017318,216.58.221.0-255,5738,110816,77,125970
4155,0.017325,172.31.40.0-255,66,110882,77,125970
4156,0.01779,172.31.40.0-255,562,111444,77,125970
4157,0.017821,172.31.40.0-255,1116,112560,77,125970
4158,0.01789,172.31.40.0-255,1514,114074,77,125970
4159,0.017892,172.31.40.0-255,1514,115588,77,125970
4160,0.017893,172.31.40.0-255,1514,117102,77,125970
4161,0.017898,172.31.40.0-255,1514,118616,77,125970
4162,0.0179,172.31.40.0-255,1286,119902,77,125970
4163,0.019229,216.58.221.0-255,5738,125640,77,125970
4164,0.019236,172.31.40.0-255,66,125706,77,125970
4165,0.019349,104.244.42.0-255,66,125772,77,125970
4166,0.019356,104.244.42.0-255,66,125838,77,125970
4167,0.019458,104.244.42.0-255,66,125904,77,125970
4168,0.019464,104.244.42.0-255,66,125970,77,125970
4169,0.0,172.217.194.0-255,153,153,77,323911
4170,2.4e-05,172.31.40.0-255,66,219,77,323911
4171,3.1e-05,172.217.194.0-255,1484,1703,77,323911
4172,3.6e-05,172.31.40.0-255,66,1769,77,323911
4173,4.2e-05,172.217.194.0-255,2902,4671,77,323911
4174,4.6e-05,172.31.40.0-255,66,4737,77,323911
4175,5.4e-05,172.217.194.0-255,7156,11893,77,323911
4176,5.8e-05,172.31.40.0-255,66,11959,77,323911
4177,9.1e-05,172.217.194.0-255,2002,13961,77,323911
4178,9.4e-05,172.31.40.0-255,66,14027,77,323911
4179,0.000302,172.217.194.0-255,1484,15511,77,323911
4180,0.000306,172.31.40.0-255,66,15577,77,323911
4181,0.000311,172.217.194.0-255,2902,18479,77,323911
4182,0.000314,172.31.40.0-255,66,18545,77,323911
4183,0.000317,172.217.194.0-255,1484,20029,77,323911
4184,0.000319,172.31.40.0-255,66,20095,77,323911
4185,0.000346,172.217.194.0-255,4320,24415,77,323911
4186,0.00035,172.31.40.0-255,66,24481,77,323911
4187,0.000353,172.217.194.0-255,1484,25965,77,323911
4188,0.000355,172.31.40.0-255,66,26031,77,323911
4189,0.00036,172.217.194.0-255,2902,28933,77,323911
4190,0.000363,172.31.40.0-255,66,28999,77,323911
4191,0.000402,172.217.194.0-255,2543,31542,77,323911
4192,0.000405,172.31.40.0-255,66,31608,77,323911
4193,0.000432,172.217.194.0-255,2902,34510,77,323911
4194,0.000434,172.31.40.0-255,66,34576,77,323911
4195,0.000459,172.217.194.0-255,7156,41732,77,323911
4196,0.000462,172.31.40.0-255,66,41798,77,323911
4197,0.000508,172.217.194.0-255,6797,48595,77,323911
4198,0.000512,172.31.40.0-255,66,48661,77,323911
4199,0.001651,172.217.194.0-255,1484,50145,77,323911
4200,0.001659,172.31.40.0-255,66,50211,77,323911
4201,0.001665,172.217.194.0-255,2902,53113,77,323911
4202,0.001669,172.31.40.0-255,66,53179,77,323911
4203,0.001676,172.217.194.0-255,5738,58917,77,323911
4204,0.001679,172.31.40.0-255,66,58983,77,323911
4205,0.001714,172.217.194.0-255,4320,63303,77,323911
4206,0.001716,172.31.40.0-255,66,63369,77,323911
4207,0.001743,172.217.194.0-255,6797,70166,77,323911
4208,0.001746,172.31.40.0-255,66,70232,77,323911
4209,0.001753,172.217.194.0-255,5738,75970,77,323911
4210,0.001755,172.31.40.0-255,66,76036,77,323911
4211,0.001779,172.217.194.0-255,2902,78938,77,323911
4212,0.001782,172.31.40.0-255,66,79004,77,323911
4213,0.001792,172.217.194.0-255,9992,88996,77,323911
4214,0.001795,172.31.40.0-255,66,89062,77,323911
4215,0.001802,172.217.194.0-255,7156,96218,77,323911
4216,0.001804,172.31.40.0-255,66,96284,77,323911
4217,0.001826,172.217.194.0-255,4182,100466,77,323911
4218,0.001829,172.31.40.0-255,66,100532,77,323911
4219,0.002299,172.217.194.0-255,1484,102016,77,323911
4220,0.002322,172.217.194.0-255,2902,104918,77,323911
4221,0.002328,172.31.40.0-255,66,104984,77,323911
4222,0.002336,172.217.194.0-255,5738,110722,77,323911
4223,0.002338,172.31.40.0-255,66,110788,77,323911
4224,0.002341,172.217.194.0-255,1484,112272,77,323911
4225,0.002357,172.217.194.0-255,1484,113756,77,323911
4226,0.002359,172.31.40.0-255,66,113822,77,323911
4227,0.002363,172.217.194.0-255,1484,115306,77,323911
4228,0.002381,172.217.194.0-255,1484,116790,77,323911
4229,0.002384,172.31.40.0-255,66,116856,77,323911
4230,0.002399,172.217.194.0-255,2902,119758,77,323911
4231,0.002402,172.31.40.0-255,66,119824,77,323911
4232,0.00243,172.217.194.0-255,9992,129816,77,323911
4233,0.002433,172.31.40.0-255,66,129882,77,323911
4234,0.002441,172.217.194.0-255,5020,134902,77,323911
4235,0.002443,172.31.40.0-255,66,134968,77,323911
4236,0.003862,172.217.194.0-255,1484,136452,77,323911
4237,0.003867,172.217.194.0-255,1484,137936,77,323911
4238,0.003871,172.31.40.0-255,66,138002,77,323911
4239,0.003889,172.217.194.0-255,1484,139486,77,323911
4240,0.003895,172.217.194.0-255,5738,145224,77,323911
4241,0.003898,172.31.40.0-255,66,145290,77,323911
4242,0.003924,172.217.194.0-255,12828,158118,77,323911
4243,0.003926,172.31.40.0-255,66,158184,77,323911
4244,0.003929,172.217.194.0-255,1484,159668,77,323911
4245,0.003962,172.217.194.0-255,9274,168942,77,323911
4246,0.003964,172.31.40.0-255,66,169008,77,323911
4247,0.004089,172.217.194.0-255,1484,170492,77,323911
4248,0.004111,172.217.194.0-255,1484,171976,77,323911
4249,0.004113,172.31.40.0-255,66,172042,77,323911
4250,0.004118,172.217.194.0-255,4320,176362,77,323911
4251,0.004122,172.31.40.0-255,66,176428,77,323911
4252,0.004155,172.217.194.0-255,4320,180748,77,323911
4253,0.004157,172.31.40.0-255,66,180814,77,323911
4254,0.004179,172.217.194.0-255,4320,185134,77,323911
4255,0.004181,172.31.40.0-255,66,185200,77,323911
4256,0.004194,172.31.40.0-255,66,185266,77,323911
4257,0.004198,172.217.194.0-255,3602,188868,77,323911
4258,0.0042,172.31.40.0-255,66,188934,77,323911
4259,0.004204,172.217.194.0-255,4320,193254,77,323911
4260,0.004206,172.31.40.0-255,66,193320,77,323911
4261,0.004212,172.217.194.0-255,5738,199058,77,323911
4262,0.004214,172.31.40.0-255,66,199124,77,323911
4263,0.00425,172.217.194.0-255,4320,203444,77,323911
4264,0.004253,172.31.40.0-255,66,203510,77,323911
4265,0.004267,172.31.40.0-255,66,203576,77,323911
4266,0.004295,172.217.194.0-255,9992,213568,77,323911
4267,0.004298,172.31.40.0-255,66,213634,77,323911
4268,0.004312,172.217.194.0-255,6438,220072,77,323911
4269,0.004314,172.31.40.0-255,66,220138,77,323911
4270,0.004317,172.217.194.0-255,1484,221622,77,323911
4271,0.004325,172.217.194.0-255,4320,225942,77,323911
4272,0.004328,172.31.40.0-255,66,226008,77,323911
4273,0.004364,172.31.40.0-255,66,226074,77,323911
4274,0.004366,172.217.194.0-255,1484,227558,77,323911
4275,0.004388,172.217.194.0-255,2902,230460,77,323911
4276,0.00439,172.31.40.0-255,66,230526,77,323911
4277,0.004416,172.217.194.0-255,12828,243354,77,323911
4278,0.004443,172.217.194.0-255,7156,250510,77,323911
4279,0.004452,172.217.194.0-255,9992,260502,77,323911
4280,0.004464,172.217.194.0-255,3602,264104,77,323911
4281,0.004468,172.217.194.0-255,2902,267006,77,323911
4282,0.004486,172.217.194.0-255,9992,276998,77,323911
4283,0.004507,172.217.194.0-255,1484,278482,77,323911
4284,0.004524,172.217.194.0-255,4320,282802,77,323911
4285,0.004549,172.217.194.0-255,11410,294212,77,323911
4286,0.004587,172.217.194.0-255,9992,304204,77,323911
4287,0.00461,172.217.194.0-255,7856,312060,77,323911
4288,0.004667,172.217.194.0-255,5020,317080,77,323911
4289,0.00467,172.217.194.0-255,1484,318564,77,323911
4290,0.004674,172.217.194.0-255,5005,323569,77,323911
4291,0.004687,172.217.194.0-255,105,323674,77,323911
4292,0.005399,172.31.40.0-255,66,323740,77,323911
4293,0.012952,172.31.40.0-255,105,323845,77,323911
4294,0.015226,172.217.194.0-255,66,323911,77,323911
4295,0.0,74.125.68.0-255,150,150,77,396845
4296,1.8e-05,172.31.40.0-255,66,216,77,396845
4297,3.8e-05,74.125.68.0-255,1484,1700,77,396845
4298,4.3e-05,172.31.40.0-255,66,1766,77,396845
4299,4.9e-05,74.125.68.0-255,2902,4668,77,396845
4300,5.3e-05,172.31.40.0-255,66,4734,77,396845
4301,7.8e-05,74.125.68.0-255,2902,7636,77,396845
4302,8.1e-05,172.31.40.0-255,66,7702,77,396845
4303,9.4e-05,74.125.68.0-255,1484,9186,77,396845
4304,9.7e-05,172.31.40.0-255,66,9252,77,396845
4305,0.00012,74.125.68.0-255,2902,12154,77,396845
4306,0.000122,172.31.40.0-255,66,12220,77,396845
4307,0.000126,74.125.68.0-255,2047,14267,77,396845
4308,0.000128,172.31.40.0-255,66,14333,77,396845
4309,0.00014,74.125.68.0-255,1484,15817,77,396845
4310,0.000142,172.31.40.0-255,66,15883,77,396845
4311,0.000155,74.125.68.0-255,1484,17367,77,396845
4312,0.000158,172.31.40.0-255,66,17433,77,396845
4313,0.000194,74.125.68.0-255,5738,23171,77,396845
4314,0.000197,172.31.40.0-255,66,23237,77,396845
4315,0.000238,74.125.68.0-255,1484,24721,77,396845
4316,0.000241,172.31.40.0-255,66,24787,77,396845
4317,0.000261,74.125.68.0-255,2902,27689,77,396845
4318,0.000264,172.31.40.0-255,66,27755,77,396845
4319,0.000267,74.125.68.0-255,1484,29239,77,396845
4320,0.000269,172.31.40.0-255,66,29305,77,396845
4321,0.000304,74.125.68.0-255,2543,31848,77,396845
4322,0.000307,172.31.40.0-255,66,31914,77,396845
4323,0.000435,74.125.68.0-255,1484,33398,77,396845
4324,0.000439,172.31.40.0-255,66,33464,77,396845
4325,0.000453,74.125.68.0-255,2902,36366,77,396845
4326,0.000456,172.31.40.0-255,66,36432,77,396845
4327,0.000479,74.125.68.0-255,2902,39334,77,396845
4328,0.000482,172.31.40.0-255,66,39400,77,396845
4329,0.000501,74.125.68.0-255,4320,43720,77,396845
4330,0.000503,172.31.40.0-255,66,43786,77,396845
4331,0.00053,74.125.68.0-255,4320,48106,77,396845
4332,0.000534,172.31.40.0-255,66,48172,77,396845
4333,0.000544,74.125.68.0-255,2902,51074,77,396845
4334,0.000546,172.31.40.0-255,66,51140,77,396845
4335,0.000598,74.125.68.0-255,2902,54042,77,396845
4336,0.000602,172.31.40.0-255,66,54108,77,396845
4337,0.000623,74.125.68.0-255,5738,59846,77,396845
4338,0.000626,172.31.40.0-255,66,59912,77,396845
4339,0.000629,74.125.68.0-255,1484,61396,77,396845
4340,0.000652,74.125.68.0-255,2902,64298,77,396845
4341,0.000655,172.31.40.0-255,66,64364,77,396845
4342,0.000684,74.125.68.0-255,1484,65848,77,396845
4343,0.00072,74.125.68.0-255,766,66614,77,396845
4344,0.000723,172.31.40.0-255,66,66680,77,396845
4345,0.000991,74.125.68.0-255,363,67043,77,396845
4346,0.000996,74.125.68.0-255,130,67173,77,396845
4347,0.001158,172.31.40.0-255,66,67239,77,396845
4348,0.001577,74.125.68.0-255,1484,68723,77,396845
4349,0.001598,74.125.68.0-255,1484,70207,77,396845
4350,0.001603,172.31.40.0-255,66,70273,77,396845
4351,0.001609,74.125.68.0-255,2902,73175,77,396845
4352,0.001611,172.31.40.0-255,66,73241,77,396845
4353,0.001635,74.125.68.0-255,5738,78979,77,396845
4354,0.001637,172.31.40.0-255,66,79045,77,396845
4355,0.00166,74.125.68.0-255,1484,80529,77,396845
4356,0.001677,74.125.68.0-255,5738,86267,77,396845
4357,0.001679,172.31.40.0-255,66,86333,77,396845
4358,0.00169,74.125.68.0-255,9992,96325,77,396845
4359,0.001692,172.31.40.0-255,66,96391,77,396845
4360,0.001709,74.125.68.0-255,2902,99293,77,396845
4361,0.001712,172.31.40.0-255,66,99359,77,396845
4362,0.001736,74.125.68.0-255,2184,101543,77,396845
4363,0.001739,172.31.40.0-255,66,101609,77,396845
4364,0.001743,74.125.68.0-255,1484,103093,77,396845
4365,0.001759,74.125.68.0-255,1484,104577,77,396845
4366,0.001761,172.31.40.0-255,66,104643,77,396845
4367,0.001765,74.125.68.0-255,1484,106127,77,396845
4368,0.001784,74.125.68.0-255,5738,111865,77,396845
4369,0.001787,172.31.40.0-255,66,111931,77,396845
4370,0.001791,74.125.68.0-255,2902,114833,77,396845
4371,0.001794,172.31.40.0-255,66,114899,77,396845
4372,0.001823,74.125.68.0-255,11410,126309,77,396845
4373,0.001826,172.31.40.0-255,66,126375,77,396845
4374,0.001829,74.125.68.0-255,1484,127859,77,396845
4375,0.001853,74.125.68.0-255,7156,135015,77,396845
4376,0.001856,172.31.40.0-255,66,135081,77,396845
4377,0.001873,74.125.68.0-255,1484,136565,77,396845
4378,0.001897,74.125.68.0-255,7856,144421,77,396845
4379,0.0019,172.31.40.0-255,66,144487,77,396845
4380,0.001904,74.125.68.0-255,2902,147389,77,396845
4381,0.001906,172.31.40.0-255,66,147455,77,396845
4382,0.00194,74.125.68.0-255,12828,160283,77,396845
4383,0.001942,172.31.40.0-255,66,160349,77,396845
4384,0.001963,74.125.68.0-255,1484,161833,77,396845
4385,0.001971,74.125.68.0-255,7156,168989,77,396845
4386,0.001974,172.31.40.0-255,66,169055,77,396845
4387,0.001978,74.125.68.0-255,2902,171957,77,396845
4388,0.001981,172.31.40.0-255,66,172023,77,396845
4389,0.002008,74.125.68.0-255,5020,177043,77,396845
4390,0.002012,172.31.40.0-255,66,177109,77,396845
4391,0.002016,74.125.68.0-255,2902,180011,77,396845
4392,0.002018,172.31.40.0-255,66,180077,77,396845
4393,0.002021,74.125.68.0-255,1484,181561,77,396845
4394,0.002053,74.125.68.0-255,11410,192971,77,396845
4395,0.002056,172.31.40.0-255,66,193037,77,396845
4396,0.002065,74.125.68.0-255,8574,201611,77,396845
4397,0.002067,172.31.40.0-255,66,201677,77,396845
4398,0.00209,74.125.68.0-255,2902,204579,77,396845
4399,0.002092,172.31.40.0-255,66,204645,77,396845
4400,0.002114,74.125.68.0-255,6438,211083,77,396845
4401,0.002117,172.31.40.0-255,66,211149,77,396845
4402,0.002123,74.125.68.0-255,5738,216887,77,396845
4403,0.002125,172.31.40.0-255,66,216953,77,396845
4404,0.002144,74.125.68.0-255,4320,221273,77,396845
4405,0.002146,172.31.40.0-255,66,221339,77,396845
4406,0.002152,74.125.68.0-255,4320,225659,77,396845
4407,0.002154,172.31.40.0-255,66,225725,77,396845
4408,0.002179,74.125.68.0-255,8574,234299,77,396845
4409,0.002182,172.31.40.0-255,66,234365,77,396845
4410,0.002236,74.125.68.0-255,13528,247893,77,396845
4411,0.002239,172.31.40.0-255,66,247959,77,396845
4412,0.00225,74.125.68.0-255,5738,253697,77,396845
4413,0.002252,172.31.40.0-255,66,253763,77,396845
4414,0.002299,172.31.40.0-255,66,253829,77,396845
4415,0.002322,74.125.68.0-255,1484,255313,77,396845
4416,0.002326,74.125.68.0-255,1484,256797,77,396845
4417,0.002328,172.31.40.0-255,66,256863,77,396845
4418,0.002344,74.125.68.0-255,1484,258347,77,396845
4419,0.002362,74.125.68.0-255,5738,264085,77,396845
4420,0.002365,172.31.40.0-255,66,264151,77,396845
4421,0.002369,74.125.68.0-255,2902,267053,77,396845
4422,0.002371,172.31.40.0-255,66,267119,77,396845
4423,0.002377,74.125.68.0-255,4320,271439,77,396845
4424,0.00238,172.31.40.0-255,66,271505,77,396845
4425,0.002382,74.125.68.0-255,1484,272989,77,396845
4426,0.002413,74.125.68.0-255,7156,280145,77,396845
4427,0.002415,172.31.40.0-255,66,280211,77,396845
4428,0.002422,74.125.68.0-255,7156,287367,77,396845
4429,0.002424,172.31.40.0-255,66,287433,77,396845
4430,0.002458,74.125.68.0-255,2902,290335,77,396845
4431,0.002461,172.31.40.0-255,66,290401,77,396845
4432,0.002473,74.125.68.0-255,3602,294003,77,396845
4433,0.002476,172.31.40.0-255,66,294069,77,396845
4434,0.002483,74.125.68.0-255,7156,301225,77,396845
4435,0.002501,172.31.40.0-255,66,301291,77,396845
4436,0.002529,74.125.68.0-255,11410,312701,77,396845
4437,0.002533,172.31.40.0-255,66,312767,77,396845
4438,0.002578,74.125.68.0-255,12110,324877,77,396845
4439,0.002582,172.31.40.0-255,66,324943,77,396845
4440,0.00262,74.125.68.0-255,12828,337771,77,396845
4441,0.002623,172.31.40.0-255,66,337837,77,396845
4442,0.002645,74.125.68.0-255,2902,340739,77,396845
4443,0.002649,172.31.40.0-255,66,340805,77,396845
4444,0.002678,74.125.68.0-255,11410,352215,77,396845
4445,0.002681,172.31.40.0-255,66,352281,77,396845
4446,0.002687,74.125.68.0-255,3602,355883,77,396845
4447,0.002689,172.31.40.0-255,66,355949,77,396845
4448,0.002694,74.125.68.0-255,4320,360269,77,396845
4449,0.002697,172.31.40.0-255,66,360335,77,396845
4450,0.002728,74.125.68.0-255,8574,368909,77,396845
4451,0.002732,172.31.40.0-255,66,368975,77,396845
4452,0.005392,74.125.68.0-255,5738,374713,77,396845
4453,0.005415,172.31.40.0-255,66,374779,77,396845
4454,0.008074,74.125.68.0-255,5738,380517,77,396845
4455,0.008087,172.31.40.0-255,66,380583,77,396845
4456,0.010728,74.125.68.0-255,5738,386321,77,396845
4457,0.010736,172.31.40.0-255,66,386387,77,396845
4458,0.013374,74.125.68.0-255,5738,392125,77,396845
4459,0.013379,172.31.40.0-255,66,392191,77,396845
4460,0.016042,74.125.68.0-255,4417,396608,77,396845
4461,0.016058,172.31.40.0-255,66,396674,77,396845
4462,0.016647,172.31.40.0-255,105,396779,77,396845
4463,0.019267,74.125.68.0-255,66,396845,77,396845
4464,0.0,74.125.24.0-255,296,296,77,308119
4465,2.1e-05,172.31.40.0-255,66,362,77,308119
4466,2.7e-05,74.125.24.0-255,1484,1846,77,308119
4467,3.1e-05,172.31.40.0-255,66,1912,77,308119
4468,3.7e-05,74.125.24.0-255,4320,6232,77,308119
4469,4e-05,172.31.40.0-255,66,6298,77,308119
4470,4.4e-05,74.125.24.0-255,4320,10618,77,308119
4471,4.8e-05,172.31.40.0-255,66,10684,77,308119
4472,6.8e-05,74.125.24.0-255,1484,12168,77,308119
4473,7.1e-05,172.31.40.0-255,66,12234,77,308119
4474,9.2e-05,74.125.24.0-255,1815,14049,77,308119
4475,9.4e-05,172.31.40.0-255,66,14115,77,308119
4476,9.8e-05,74.125.24.0-255,2902,17017,77,308119
4477,0.0001,172.31.40.0-255,66,17083,77,308119
4478,0.000112,74.125.24.0-255,1484,18567,77,308119
4479,0.000114,172.31.40.0-255,66,18633,77,308119
4480,0.000143,74.125.24.0-255,9992,28625,77,308119
4481,0.000145,172.31.40.0-255,66,28691,77,308119
4482,0.000173,74.125.24.0-255,2543,31234,77,308119
4483,0.000175,172.31.40.0-255,66,31300,77,308119
4484,0.000178,74.125.24.0-255,1484,32784,77,308119
4485,0.00018,172.31.40.0-255,66,32850,77,308119
4486,0.000195,74.125.24.0-255,1484,34334,77,308119
4487,0.000197,172.31.40.0-255,66,34400,77,308119
4488,0.000203,74.125.24.0-255,7156,41556,77,308119
4489,0.000205,172.31.40.0-255,66,41622,77,308119
4490,0.000236,74.125.24.0-255,6797,48419,77,308119
4491,0.000238,172.31.40.0-255,66,48485,77,308119
4492,0.000523,74.125.24.0-255,1484,49969,77,308119
4493,0.000528,172.31.40.0-255,66,50035,77,308119
4494,0.000533,74.125.24.0-255,2902,52937,77,308119
4495,0.000535,172.31.40.0-255,66,53003,77,308119
4496,0.000567,74.125.24.0-255,5738,58741,77,308119
4497,0.00057,172.31.40.0-255,66,58807,77,308119
4498,0.000584,74.125.24.0-255,4320,63127,77,308119
4499,0.000586,172.31.40.0-255,66,63193,77,308119
4500,0.000601,74.125.24.0-255,2543,65736,77,308119
4501,0.000603,172.31.40.0-255,66,65802,77,308119
4502,0.000628,74.125.24.0-255,2902,68704,77,308119
4503,0.00063,172.31.40.0-255,66,68770,77,308119
4504,0.000656,74.125.24.0-255,4320,73090,77,308119
4505,0.000658,172.31.40.0-255,66,73156,77,308119
4506,0.000667,74.125.24.0-255,10214,83370,77,308119
4507,0.00067,172.31.40.0-255,66,83436,77,308119
4508,0.000725,74.125.24.0-255,1484,84920,77,308119
4509,0.00074,74.125.24.0-255,2902,87822,77,308119
4510,0.000743,172.31.40.0-255,66,87888,77,308119
4511,0.000764,74.125.24.0-255,5738,93626,77,308119
4512,0.000767,172.31.40.0-255,66,93692,77,308119
4513,0.000782,74.125.24.0-255,1484,95176,77,308119
4514,0.000801,74.125.24.0-255,8574,103750,77,308119
4515,0.000804,172.31.40.0-255,66,103816,77,308119
4516,0.000822,74.125.24.0-255,2902,106718,77,308119
4517,0.000825,172.31.40.0-255,66,106784,77,308119
4518,0.000873,74.125.24.0-255,10027,116811,77,308119
4519,0.000876,172.31.40.0-255,66,116877,77,308119
4520,0.000926,74.125.24.0-255,1484,118361,77,308119
4521,0.000944,74.125.24.0-255,2902,121263,77,308119
4522,0.000948,172.31.40.0-255,66,121329,77,308119
4523,0.000952,74.125.24.0-255,2902,124231,77,308119
4524,0.000954,172.31.40.0-255,66,124297,77,308119
4525,0.000971,74.125.24.0-255,2902,127199,77,308119
4526,0.000974,172.31.40.0-255,66,127265,77,308119
4527,0.000983,74.125.24.0-255,1484,128749,77,308119
4528,0.000997,74.125.24.0-255,8574,137323,77,308119
4529,0.001,172.31.40.0-255,66,137389,77,308119
4530,0.001017,74.125.24.0-255,403,137792,77,308119
4531,0.001023,74.125.24.0-255,5738,143530,77,308119
4532,0.001026,172.31.40.0-255,66,143596,77,308119
4533,0.001042,74.125.24.0-255,5738,149334,77,308119
4534,0.001048,172.31.40.0-255,66,149400,77,308119
4535,0.001064,74.125.24.0-255,1484,150884,77,308119
4536,0.001077,74.125.24.0-255,1484,152368,77,308119
4537,0.00108,172.31.40.0-255,66,152434,77,308119
4538,0.001101,74.125.24.0-255,5738,158172,77,308119
4539,0.001104,172.31.40.0-255,66,158238,77,308119
4540,0.001107,74.125.24.0-255,1484,159722,77,308119
4541,0.001128,74.125.24.0-255,8574,168296,77,308119
4542,0.00113,172.31.40.0-255,66,168362,77,308119
4543,0.001133,74.125.24.0-255,766,169128,77,308119
4544,0.00164,172.31.40.0-255,101,169229,77,308119
4545,0.001678,74.125.24.0-255,1484,170713,77,308119
4546,0.001702,74.125.24.0-255,2902,173615,77,308119
4547,0.001707,74.125.24.0-255,5738,179353,77,308119
4548,0.001715,172.31.40.0-255,66,179419,77,308119
4549,0.001718,172.31.40.0-255,66,179485,77,308119
4550,0.001732,74.125.24.0-255,1484,180969,77,308119
4551,0.001751,74.125.24.0-255,8574,189543,77,308119
4552,0.001753,172.31.40.0-255,66,189609,77,308119
4553,0.001796,74.125.24.0-255,4320,193929,77,308119
4554,0.001801,74.125.24.0-255,5738,199667,77,308119
4555,0.001805,172.31.40.0-255,66,199733,77,308119
4556,0.001807,172.31.40.0-255,66,199799,77,308119
4557,0.001817,74.125.24.0-255,3602,203401,77,308119
4558,0.001819,172.31.40.0-255,66,203467,77,308119
4559,0.002037,74.125.24.0-255,1484,204951,77,308119
4560,0.002042,74.125.24.0-255,2902,207853,77,308119
4561,0.002045,172.31.40.0-255,66,207919,77,308119
4562,0.002066,74.125.24.0-255,5738,213657,77,308119
4563,0.002069,172.31.40.0-255,66,213723,77,308119
4564,0.002072,74.125.24.0-255,1484,215207,77,308119
4565,0.002093,74.125.24.0-255,5738,220945,77,308119
4566,0.002095,172.31.40.0-255,66,221011,77,308119
4567,0.002137,172.31.40.0-255,66,221077,77,308119
4568,0.00214,74.125.24.0-255,2184,223261,77,308119
4569,0.002142,172.31.40.0-255,66,223327,77,308119
4570,0.002158,74.125.24.0-255,4320,227647,77,308119
4571,0.00216,172.31.40.0-255,66,227713,77,308119
4572,0.002213,172.31.40.0-255,66,227779,77,308119
4573,0.002221,74.125.24.0-255,8574,236353,77,308119
4574,0.002223,172.31.40.0-255,66,236419,77,308119
4575,0.002229,74.125.24.0-255,6438,242857,77,308119
4576,0.002231,172.31.40.0-255,66,242923,77,308119
4577,0.002291,74.125.24.0-255,7156,250079,77,308119
4578,0.002295,172.31.40.0-255,66,250145,77,308119
4579,0.0023,74.125.24.0-255,4320,254465,77,308119
4580,0.002304,172.31.40.0-255,66,254531,77,308119
4581,0.002314,74.125.24.0-255,12828,267359,77,308119
4582,0.002318,172.31.40.0-255,66,267425,77,308119
4583,0.003872,74.125.24.0-255,66,267491,77,308119
4584,0.004633,74.125.24.0-255,5738,273229,77,308119
4585,0.004648,172.31.40.0-255,66,273295,77,308119
4586,0.006911,74.125.24.0-255,5738,279033,77,308119
4587,0.006925,172.31.40.0-255,66,279099,77,308119
4588,0.009209,74.125.24.0-255,5738,284837,77,308119
4589,0.009229,172.31.40.0-255,66,284903,77,308119
4590,0.011516,74.125.24.0-255,5738,290641,77,308119
4591,0.011533,172.31.40.0-255,66,290707,77,308119
4592,0.01384,74.125.24.0-255,5738,296445,77,308119
4593,0.013845,172.31.40.0-255,66,296511,77,308119
4594,0.016142,74.125.24.0-255,5738,302249,77,308119
4595,0.016149,172.31.40.0-255,66,302315,77,308119
4596,0.018444,74.125.24.0-255,5738,308053,77,308119
4597,0.018466,172.31.40.0-255,66,308119,77,308119
4598,0.0,172.217.194.0-255,152,152,77,100604
4599,2.2e-05,172.31.40.0-255,66,218,77,100604
4600,2.9e-05,172.217.194.0-255,1484,1702,77,100604
4601,3.4e-05,172.31.40.0-255,66,1768,77,100604
4602,3.9e-05,172.217.194.0-255,2902,4670,77,100604
4603,4.3e-05,172.31.40.0-255,66,4736,77,100604
4604,7.9e-05,172.217.194.0-255,5738,10474,77,100604
4605,8.2e-05,172.31.40.0-255,66,10540,77,100604
4606,0.000194,172.217.194.0-255,3458,13998,77,100604
4607,0.000197,172.31.40.0-255,66,14064,77,100604
4608,0.000259,172.217.194.0-255,5738,19802,77,100604
4609,0.000262,172.31.40.0-255,66,19868,77,100604
4610,0.000281,172.217.194.0-255,5738,25606,77,100604
4611,0.000283,172.31.40.0-255,66,25672,77,100604
4612,0.000476,172.217.194.0-255,2902,28574,77,100604
4613,0.00048,172.31.40.0-255,66,28640,77,100604
4614,0.000501,172.217.194.0-255,8574,37214,77,100604
4615,0.000504,172.31.40.0-255,66,37280,77,100604
4616,0.000706,172.217.194.0-255,4320,41600,77,100604
4617,0.00071,172.31.40.0-255,66,41666,77,100604
4618,0.000733,172.217.194.0-255,6438,48104,77,100604
4619,0.000735,172.31.40.0-255,66,48170,77,100604
4620,0.000915,172.217.194.0-255,8574,56744,77,100604
4621,0.000919,172.31.40.0-255,66,56810,77,100604
4622,0.000955,172.31.40.0-255,66,56876,77,100604
4623,0.001395,172.217.194.0-255,2902,59778,77,100604
4624,0.001401,172.31.40.0-255,66,59844,77,100604
4625,0.001481,172.31.40.0-255,66,59910,77,100604
4626,0.002352,172.217.194.0-255,4320,64230,77,100604
4627,0.002355,172.31.40.0-255,66,64296,77,100604
4628,0.003216,172.217.194.0-255,5738,70034,77,100604
4629,0.004187,172.217.194.0-255,2902,72936,77,100604
4630,0.004251,172.217.194.0-255,9992,82928,77,100604
4631,0.006544,172.31.40.0-255,66,82994,77,100604
4632,0.009111,172.217.194.0-255,2902,85896,77,100604
4633,0.009119,172.31.40.0-255,66,85962,77,100604
4634,0.009142,172.217.194.0-255,2902,88864,77,100604
4635,0.011583,172.31.40.0-255,66,88930,77,100604
4636,0.011664,172.217.194.0-255,2902,91832,77,100604
4637,0.014127,172.217.194.0-255,2902,94734,77,100604
4638,0.016601,172.31.40.0-255,66,94800,77,100604
4639,0.019162,172.217.194.0-255,5738,100538,77,100604
4640,0.019174,172.31.40.0-255,66,100604,77,100604
4641,0.0,74.125.24.0-255,153,153,77,268734
4642,1.5e-05,172.31.40.0-255,66,219,77,268734
4643,2.2e-05,74.125.24.0-255,1484,1703,77,268734
4644,2.7e-05,172.31.40.0-255,66,1769,77,268734
4645,3.2e-05,74.125.24.0-255,2902,4671,77,268734
4646,4.3e-05,172.31.40.0-255,66,4737,77,268734
4647,5.1e-05,74.125.24.0-255,7156,11893,77,268734
4648,5.4e-05,172.31.40.0-255,66,11959,77,268734
4649,8.7e-05,74.125.24.0-255,2030,13989,77,268734
4650,9e-05,172.31.40.0-255,66,14055,77,268734
4651,0.00041,74.125.24.0-255,1484,15539,77,268734
4652,0.000415,172.31.40.0-255,66,15605,77,268734
4653,0.000421,74.125.24.0-255,2902,18507,77,268734
4654,0.000423,172.31.40.0-255,66,18573,77,268734
4655,0.000443,74.125.24.0-255,4320,22893,77,268734
4656,0.000449,172.31.40.0-255,66,22959,77,268734
4657,0.000474,74.125.24.0-255,1484,24443,77,268734
4658,0.000476,172.31.40.0-255,66,24509,77,268734
4659,0.000483,74.125.24.0-255,6797,31306,77,268734
4660,0.000485,172.31.40.0-255,66,31372,77,268734
4661,0.000564,74.125.24.0-255,1484,32856,77,268734
4662,0.000567,172.31.40.0-255,66,32922,77,268734
4663,0.000572,74.125.24.0-255,2902,35824,77,268734
4664,0.000574,172.31.40.0-255,66,35890,77,268734
4665,0.000606,74.125.24.0-255,5738,41628,77,268734
4666,0.000608,172.31.40.0-255,66,41694,77,268734
4667,0.000615,74.125.24.0-255,6797,48491,77,268734
4668,0.000617,172.31.40.0-255,66,48557,77,268734
4669,0.000658,172.31.40.0-255,66,48623,77,268734
4670,0.000662,74.125.24.0-255,2543,51166,77,268734
4671,0.000664,172.31.40.0-255,66,51232,77,268734
4672,0.000697,74.125.24.0-255,646,51878,77,268734
4673,0.000953,172.31.40.0-255,66,51944,77,268734
4674,0.001003,74.125.24.0-255,1484,53428,77,268734
4675,0.001007,74.125.24.0-255,1484,54912,77,268734
4676,0.001009,172.31.40.0-255,66,54978,77,268734
4677,0.001025,74.125.24.0-255,1484,56462,77,268734
4678,0.00103,74.125.24.0-255,5738,62200,77,268734
4679,0.001032,172.31.40.0-255,66,62266,77,268734
4680,0.001055,74.125.24.0-255,1484,63750,77,268734
4681,0.001075,74.125.24.0-255,9992,73742,77,268734
4682,0.001078,172.31.40.0-255,66,73808,77,268734
4683,0.001103,74.125.24.0-255,1484,75292,77,268734
4684,0.001106,74.125.24.0-255,1484,76776,77,268734
4685,0.001107,172.31.40.0-255,66,76842,77,268734
4686,0.001114,74.125.24.0-255,5738,82580,77,268734
4687,0.001116,172.31.40.0-255,66,82646,77,268734
4688,0.001137,74.125.24.0-255,3602,86248,77,268734
4689,0.001143,172.31.40.0-255,66,86314,77,268734
4690,0.001162,74.125.24.0-255,5738,92052,77,268734
4691,0.001164,172.31.40.0-255,66,92118,77,268734
4692,0.001169,74.125.24.0-255,4320,96438,77,268734
4693,0.001171,172.31.40.0-255,66,96504,77,268734
4694,0.001193,74.125.24.0-255,2902,99406,77,268734
4695,0.001198,172.31.40.0-255,66,99472,77,268734
4696,0.001211,74.125.24.0-255,4320,103792,77,268734
4697,0.001213,172.31.40.0-255,66,103858,77,268734
4698,0.001241,74.125.24.0-255,7156,111014,77,268734
4699,0.001244,172.31.40.0-255,66,111080,77,268734
4700,0.001279,74.125.24.0-255,9274,120354,77,268734
4701,0.001282,172.31.40.0-255,66,120420,77,268734
4702,0.00133,74.125.24.0-255,1484,121904,77,268734
4703,0.001345,74.125.24.0-255,2902,124806,77,268734
4704,0.001347,172.31.40.0-255,66,124872,77,268734
4705,0.001367,74.125.24.0-255,5738,130610,77,268734
4706,0.00137,172.31.40.0-255,66,130676,77,268734
4707,0.001403,74.125.24.0-255,9992,140668,77,268734
4708,0.001406,172.31.40.0-255,66,140734,77,268734
4709,0.001425,74.125.24.0-255,5738,146472,77,268734
4710,0.001428,172.31.40.0-255,66,146538,77,268734
4711,0.001462,74.125.24.0-255,5738,152276,77,268734
4712,0.001465,172.31.40.0-255,66,152342,77,268734
4713,0.001469,74.125.24.0-255,2184,154526,77,268734
4714,0.001471,172.31.40.0-255,66,154592,77,268734
4715,0.001779,74.125.24.0-255,1484,156076,77,268734
4716,0.001807,74.125.24.0-255,2902,158978,77,268734
4717,0.00181,172.31.40.0-255,66,159044,77,268734
4718,0.001816,74.125.24.0-255,5738,164782,77,268734
4719,0.001818,172.31.40.0-255,66,164848,77,268734
4720,0.001823,74.125.24.0-255,5738,170586,77,268734
4721,0.001825,172.31.40.0-255,66,170652,77,268734
4722,0.001871,74.125.24.0-255,7156,177808,77,268734
4723,0.001874,172.31.40.0-255,66,177874,77,268734
4724,0.001882,74.125.24.0-255,9992,187866,77,268734
4725,0.001884,172.31.40.0-255,66,187932,77,268734
4726,0.00189,74.125.24.0-255,766,188698,77,268734
4727,0.001958,74.125.24.0-255,1484,190182,77,268734
4728,0.001961,172.31.40.0-255,66,190248,77,268734
4729,0.001966,74.125.24.0-255,2902,193150,77,268734
4730,0.001967,172.31.40.0-255,66,193216,77,268734
4731,0.00197,74.125.24.0-255,1484,194700,77,268734
4732,0.001989,74.125.24.0-255,4320,199020,77,268734
4733,0.001991,172.31.40.0-255,66,199086,77,268734
4734,0.001995,74.125.24.0-255,2902,201988,77,268734
4735,0.001996,172.31.40.0-255,66,202054,77,268734
4736,0.002022,74.125.24.0-255,2902,204956,77,268734
4737,0.002028,172.31.40.0-255,66,205022,77,268734
4738,0.002038,74.125.24.0-255,12828,217850,77,268734
4739,0.00204,172.31.40.0-255,66,217916,77,268734
4740,0.002045,74.125.24.0-255,4320,222236,77,268734
4741,0.002046,172.31.40.0-255,66,222302,77,268734
4742,0.004078,74.125.24.0-255,5738,228040,77,268734
4743,0.004096,172.31.40.0-255,66,228106,77,268734
4744,0.006121,74.125.24.0-255,5738,233844,77,268734
4745,0.006126,172.31.40.0-255,66,233910,77,268734
4746,0.008183,74.125.24.0-255,5738,239648,77,268734
4747,0.008193,172.31.40.0-255,66,239714,77,268734
4748,0.010267,74.125.24.0-255,5738,245452,77,268734
4749,0.010275,172.31.40.0-255,66,245518,77,268734
4750,0.012343,74.125.24.0-255,5738,251256,77,268734
4751,0.012351,172.31.40.0-255,66,251322,77,268734
4752,0.014431,74.125.24.0-255,5738,257060,77,268734
4753,0.014439,172.31.40.0-255,66,257126,77,268734
4754,0.01647,74.125.24.0-255,5738,262864,77,268734
4755,0.016483,172.31.40.0-255,66,262930,77,268734
4756,0.018566,74.125.24.0-255,5738,268668,77,268734
4757,0.018581,172.31.40.0-255,66,268734,77,268734
4758,0.0,172.217.194.0-255,350,350,77,334027
4759,2.3e-05,172.31.40.0-255,66,416,77,334027
4760,3e-05,172.217.194.0-255,1484,1900,77,334027
4761,3.5e-05,172.31.40.0-255,66,1966,77,334027
4762,4.3e-05,172.217.194.0-255,4320,6286,77,334027
4763,5.4e-05,172.31.40.0-255,66,6352,77,334027
4764,6.5e-05,172.217.194.0-255,8991,15343,77,334027
4765,6.8e-05,172.31.40.0-255,66,15409,77,334027
4766,7.5e-05,172.217.194.0-255,7156,22565,77,334027
4767,7.8e-05,172.31.40.0-255,66,22631,77,334027
4768,0.000125,172.217.194.0-255,8215,30846,77,334027
4769,0.000129,172.31.40.0-255,66,30912,77,334027
4770,0.000618,172.217.194.0-255,1484,32396,77,334027
4771,0.000623,172.31.40.0-255,66,32462,77,334027
4772,0.00063,172.217.194.0-255,2902,35364,77,334027
4773,0.000632,172.31.40.0-255,66,35430,77,334027
4774,0.000636,172.217.194.0-255,1484,36914,77,334027
4775,0.000638,172.31.40.0-255,66,36980,77,334027
4776,0.000655,172.217.194.0-255,4320,41300,77,334027
4777,0.000662,172.31.40.0-255,66,41366,77,334027
4778,0.000688,172.217.194.0-255,1484,42850,77,334027
4779,0.00069,172.31.40.0-255,66,42916,77,334027
4780,0.000728,172.217.194.0-255,8215,51131,77,334027
4781,0.000732,172.31.40.0-255,66,51197,77,334027
4782,0.000742,172.217.194.0-255,9992,61189,77,334027
4783,0.000749,172.31.40.0-255,66,61255,77,334027
4784,0.000754,172.217.194.0-255,4251,65506,77,334027
4785,0.000757,172.31.40.0-255,66,65572,77,334027
4786,0.000786,172.217.194.0-255,366,65938,77,334027
4787,0.000788,172.31.40.0-255,66,66004,77,334027
4788,0.00087,172.217.194.0-255,1484,67488,77,334027
4789,0.000874,172.31.40.0-255,66,67554,77,334027
4790,0.00088,172.217.194.0-255,2902,70456,77,334027
4791,0.000883,172.31.40.0-255,66,70522,77,334027
4792,0.000905,172.217.194.0-255,5738,76260,77,334027
4793,0.000908,172.31.40.0-255,66,76326,77,334027
4794,0.000939,172.217.194.0-255,5738,82064,77,334027
4795,0.000941,172.31.40.0-255,66,82130,77,334027
4796,0.000956,172.217.194.0-255,7156,89286,77,334027
4797,0.000963,172.31.40.0-255,66,89352,77,334027
4798,0.000968,172.217.194.0-255,2902,92254,77,334027
4799,0.00097,172.31.40.0-255,66,92320,77,334027
4800,0.000975,172.217.194.0-255,2902,95222,77,334027
4801,0.000977,172.31.40.0-255,66,95288,77,334027
4802,0.001027,172.31.40.0-255,66,95354,77,334027
4803,0.001037,172.217.194.0-255,9992,105346,77,334027
4804,0.001039,172.31.40.0-255,66,105412,77,334027
4805,0.001068,172.217.194.0-255,2902,108314,77,334027
4806,0.00107,172.31.40.0-255,66,108380,77,334027
4807,0.001121,172.31.40.0-255,66,108446,77,334027
4808,0.001128,172.217.194.0-255,7156,115602,77,334027
4809,0.00113,172.31.40.0-255,66,115668,77,334027
4810,0.00118,172.31.40.0-255,66,115734,77,334027
4811,0.001186,172.217.194.0-255,5020,120754,77,334027
4812,0.001188,172.31.40.0-255,66,120820,77,334027
4813,0.00122,172.31.40.0-255,66,120886,77,334027
4814,0.001223,172.217.194.0-255,766,121652,77,334027
4815,0.001336,172.217.194.0-255,1484,123136,77,334027
4816,0.00134,172.31.40.0-255,66,123202,77,334027
4817,0.001346,172.217.194.0-255,2902,126104,77,334027
4818,0.001349,172.31.40.0-255,66,126170,77,334027
4819,0.001359,172.217.194.0-255,2902,129072,77,334027
4820,0.001361,172.31.40.0-255,66,129138,77,334027
4821,0.001386,172.217.194.0-255,2902,132040,77,334027
4822,0.001389,172.31.40.0-255,66,132106,77,334027
4823,0.001394,172.217.194.0-255,4320,136426,77,334027
4824,0.001397,172.31.40.0-255,66,136492,77,334027
4825,0.001412,172.217.194.0-255,11410,147902,77,334027
4826,0.001414,172.31.40.0-255,66,147968,77,334027
4827,0.001454,172.217.194.0-255,7856,155824,77,334027
4828,0.001457,172.31.40.0-255,66,155890,77,334027
4829,0.00146,172.217.194.0-255,1484,157374,77,334027
4830,0.001482,172.217.194.0-255,1484,158858,77,334027
4831,0.001485,172.31.40.0-255,66,158924,77,334027
4832,0.00149,172.217.194.0-255,4320,163244,77,334027
4833,0.001493,172.31.40.0-255,66,163310,77,334027
4834,0.001498,172.217.194.0-255,4320,167630,77,334027
4835,0.001501,172.31.40.0-255,66,167696,77,334027
4836,0.001541,172.217.194.0-255,4320,172016,77,334027
4837,0.001544,172.31.40.0-255,66,172082,77,334027
4838,0.001567,172.217.194.0-255,12828,184910,77,334027
4839,0.00157,172.31.40.0-255,66,184976,77,334027
4840,0.001576,172.217.194.0-255,5020,189996,77,334027
4841,0.001579,172.31.40.0-255,66,190062,77,334027
4842,0.001666,172.217.194.0-255,1484,191546,77,334027
4843,0.001671,172.217.194.0-255,1484,193030,77,334027
4844,0.001674,172.31.40.0-255,66,193096,77,334027
4845,0.001697,172.217.194.0-255,1484,194580,77,334027
4846,0.001704,172.217.194.0-255,4320,198900,77,334027
4847,0.001707,172.31.40.0-255,66,198966,77,334027
4848,0.001736,172.217.194.0-255,1484,200450,77,334027
4849,0.001743,172.217.194.0-255,5738,206188,77,334027
4850,0.001746,172.31.40.0-255,66,206254,77,334027
4851,0.001751,172.217.194.0-255,4320,210574,77,334027
4852,0.001753,172.31.40.0-255,66,210640,77,334027
4853,0.00178,172.217.194.0-255,8574,219214,77,334027
4854,0.001786,172.31.40.0-255,66,219280,77,334027
4855,0.001793,172.217.194.0-255,5020,224300,77,334027
4856,0.001795,172.31.40.0-255,66,224366,77,334027
4857,0.001845,172.217.194.0-255,1484,225850,77,334027
4858,0.00186,172.217.194.0-255,2902,228752,77,334027
4859,0.001863,172.31.40.0-255,66,228818,77,334027
4860,0.001867,172.217.194.0-255,2902,231720,77,334027
4861,0.001869,172.31.40.0-255,66,231786,77,334027
4862,0.001886,172.217.194.0-255,2902,234688,77,334027
4863,0.001893,172.31.40.0-255,66,234754,77,334027
4864,0.001896,172.217.194.0-255,1484,236238,77,334027
4865,0.001919,172.217.194.0-255,9992,246230,77,334027
4866,0.001922,172.31.40.0-255,66,246296,77,334027
4867,0.001947,172.217.194.0-255,1484,247780,77,334027
4868,0.001955,172.217.194.0-255,7156,254936,77,334027
4869,0.001958,172.31.40.0-255,66,255002,77,334027
4870,0.00199,172.217.194.0-255,9992,264994,77,334027
4871,0.001995,172.31.40.0-255,66,265060,77,334027
4872,0.002004,172.217.194.0-255,3602,268662,77,334027
4873,0.002007,172.31.40.0-255,66,268728,77,334027
4874,0.002012,172.217.194.0-255,4320,273048,77,334027
4875,0.002014,172.31.40.0-255,66,273114,77,334027
4876,0.002059,172.217.194.0-255,9992,283106,77,334027
4877,0.002063,172.31.40.0-255,66,283172,77,334027
4878,0.00207,172.217.194.0-255,7156,290328,77,334027
4879,0.002072,172.31.40.0-255,66,290394,77,334027
4880,0.002101,172.217.194.0-255,5738,296132,77,334027
4881,0.002104,172.31.40.0-255,66,296198,77,334027
4882,0.00214,172.217.194.0-255,13528,309726,77,334027
4883,0.002143,172.31.40.0-255,66,309792,77,334027
4884,0.002152,172.217.194.0-255,9992,319784,77,334027
4885,0.002155,172.31.40.0-255,66,319850,77,334027
4886,0.00219,172.217.194.0-255,10692,330542,77,334027
4887,0.002193,172.31.40.0-255,66,330608,77,334027
4888,0.0022,172.217.194.0-255,3046,333654,77,334027
4889,0.002203,172.31.40.0-255,66,333720,77,334027
4890,0.004277,172.217.194.0-255,136,333856,77,334027
4891,0.004679,172.31.40.0-255,66,333922,77,334027
4892,0.019798,172.31.40.0-255,105,334027,77,334027
4893,0.0,74.125.24.0-255,150,150,77,343913
4894,2.4e-05,172.31.40.0-255,66,216,77,343913
4895,3e-05,74.125.24.0-255,1484,1700,77,343913
4896,3.5e-05,172.31.40.0-255,66,1766,77,343913
4897,5e-05,74.125.24.0-255,2902,4668,77,343913
4898,5.3e-05,172.31.40.0-255,66,4734,77,343913
4899,6.1e-05,74.125.24.0-255,7156,11890,77,343913
4900,6.5e-05,172.31.40.0-255,66,11956,77,343913
4901,6.9e-05,74.125.24.0-255,2166,14122,77,343913
4902,7.2e-05,172.31.40.0-255,66,14188,77,343913
4903,0.000144,74.125.24.0-255,1484,15672,77,343913
4904,0.000148,172.31.40.0-255,66,15738,77,343913
4905,0.000152,74.125.24.0-255,1484,17222,77,343913
4906,0.000154,172.31.40.0-255,66,17288,77,343913
4907,0.000186,74.125.24.0-255,1484,18772,77,343913
4908,0.000189,172.31.40.0-255,66,18838,77,343913
4909,0.000196,74.125.24.0-255,5738,24576,77,343913
4910,0.000199,172.31.40.0-255,66,24642,77,343913
4911,0.000204,74.125.24.0-255,2902,27544,77,343913
4912,0.000206,172.31.40.0-255,66,27610,77,343913
4913,0.000232,74.125.24.0-255,3961,31571,77,343913
4914,0.000235,172.31.40.0-255,66,31637,77,343913
4915,0.000242,74.125.24.0-255,7156,38793,77,343913
4916,0.000245,172.31.40.0-255,66,38859,77,343913
4917,0.00025,74.125.24.0-255,4320,43179,77,343913
4918,0.000252,172.31.40.0-255,66,43245,77,343913
4919,0.00028,74.125.24.0-255,5379,48624,77,343913
4920,0.000283,172.31.40.0-255,66,48690,77,343913
4921,0.000298,74.125.24.0-255,1484,50174,77,343913
4922,0.0003,172.31.40.0-255,66,50240,77,343913
4923,0.00031,74.125.24.0-255,2902,53142,77,343913
4924,0.000312,172.31.40.0-255,66,53208,77,343913
4925,0.000318,74.125.24.0-255,5738,58946,77,343913
4926,0.000321,172.31.40.0-255,66,59012,77,343913
4927,0.000345,74.125.24.0-255,2902,61914,77,343913
4928,0.000348,172.31.40.0-255,66,61980,77,343913
4929,0.00037,74.125.24.0-255,3961,65941,77,343913
4930,0.000373,172.31.40.0-255,66,66007,77,343913
4931,0.000375,74.125.24.0-255,394,66401,77,343913
4932,0.000453,74.125.24.0-255,1484,67885,77,343913
4933,0.000456,172.31.40.0-255,66,67951,77,343913
4934,0.000462,74.125.24.0-255,2902,70853,77,343913
4935,0.000465,172.31.40.0-255,66,70919,77,343913
4936,0.000476,74.125.24.0-255,5738,76657,77,343913
4937,0.000479,172.31.40.0-255,66,76723,77,343913
4938,0.000513,74.125.24.0-255,13887,90610,77,343913
4939,0.000516,172.31.40.0-255,66,90676,77,343913
4940,0.000523,74.125.24.0-255,7156,97832,77,343913
4941,0.000525,172.31.40.0-255,66,97898,77,343913
4942,0.000568,74.125.24.0-255,2543,100441,77,343913
4943,0.000574,172.31.40.0-255,66,100507,77,343913
4944,0.000595,74.125.24.0-255,349,100856,77,343913
4945,0.000667,74.125.24.0-255,1484,102340,77,343913
4946,0.000672,172.31.40.0-255,66,102406,77,343913
4947,0.000676,74.125.24.0-255,2902,105308,77,343913
4948,0.000679,172.31.40.0-255,66,105374,77,343913
4949,0.000713,74.125.24.0-255,5738,111112,77,343913
4950,0.000716,172.31.40.0-255,66,111178,77,343913
4951,0.000725,74.125.24.0-255,8574,119752,77,343913
4952,0.000728,172.31.40.0-255,66,119818,77,343913
4953,0.000769,74.125.24.0-255,4320,124138,77,343913
4954,0.000773,172.31.40.0-255,66,124204,77,343913
4955,0.000807,74.125.24.0-255,10692,134896,77,343913
4956,0.00081,172.31.40.0-255,66,134962,77,343913
4957,0.000817,74.125.24.0-255,7156,142118,77,343913
4958,0.00082,172.31.40.0-255,66,142184,77,343913
4959,0.000851,74.125.24.0-255,8574,150758,77,343913
4960,0.000854,172.31.40.0-255,66,150824,77,343913
4961,0.00086,74.125.24.0-255,4320,155144,77,343913
4962,0.000862,172.31.40.0-255,66,155210,77,343913
4963,0.000903,74.125.24.0-255,12828,168038,77,343913
4964,0.000907,172.31.40.0-255,66,168104,77,343913
4965,0.000924,74.125.24.0-255,766,168870,77,343913
4966,0.001109,74.125.24.0-255,1484,170354,77,343913
4967,0.001116,172.31.40.0-255,66,170420,77,343913
4968,0.001122,74.125.24.0-255,2902,173322,77,343913
4969,0.001124,172.31.40.0-255,66,173388,77,343913
4970,0.001127,74.125.24.0-255,1484,174872,77,343913
4971,0.001147,74.125.24.0-255,4320,179192,77,343913
4972,0.001149,172.31.40.0-255,66,179258,77,343913
4973,0.001155,74.125.24.0-255,5738,184996,77,343913
4974,0.001165,172.31.40.0-255,66,185062,77,343913
4975,0.001173,74.125.24.0-255,8574,193636,77,343913
4976,0.001176,172.31.40.0-255,66,193702,77,343913
4977,0.001189,74.125.24.0-255,4320,198022,77,343913
4978,0.001192,172.31.40.0-255,66,198088,77,343913
4979,0.001201,74.125.24.0-255,4320,202408,77,343913
4980,0.001204,172.31.40.0-255,66,202474,77,343913
4981,0.001227,74.125.24.0-255,766,203240,77,343913
4982,0.001302,74.125.24.0-255,1484,204724,77,343913
4983,0.001305,172.31.40.0-255,66,204790,77,343913
4984,0.00131,74.125.24.0-255,2902,207692,77,343913
4985,0.001313,172.31.40.0-255,66,207758,77,343913
4986,0.00134,74.125.24.0-255,5738,213496,77,343913
4987,0.001343,172.31.40.0-255,66,213562,77,343913
4988,0.001361,74.125.24.0-255,2902,216464,77,343913
4989,0.001363,172.31.40.0-255,66,216530,77,343913
4990,0.001386,74.125.24.0-255,4320,220850,77,343913
4991,0.001389,172.31.40.0-255,66,220916,77,343913
4992,0.001403,172.31.40.0-255,66,220982,77,343913
4993,0.001408,74.125.24.0-255,2184,223166,77,343913
4994,0.00141,172.31.40.0-255,66,223232,77,343913
4995,0.001447,74.125.24.0-255,1484,224716,77,343913
4996,0.001452,74.125.24.0-255,2902,227618,77,343913
4997,0.001454,172.31.40.0-255,66,227684,77,343913
4998,0.001475,74.125.24.0-255,5738,233422,77,343913
4999,0.001477,172.31.40.0-255,66,233488,77,343913
5000,0.001517,74.125.24.0-255,12828,246316,77,343913
5001,0.001521,172.31.40.0-255,66,246382,77,343913
5002,0.001528,74.125.24.0-255,7156,253538,77,343913
5003,0.00153,172.31.40.0-255,66,253604,77,343913
5004,0.001588,172.31.40.0-255,66,253670,77,343913
5005,0.001658,172.31.40.0-255,66,253736,77,343913
5006,0.001662,74.125.24.0-255,2902,256638,77,343913
5007,0.001665,172.31.40.0-255,66,256704,77,343913
5008,0.00167,74.125.24.0-255,4320,261024,77,343913
5009,0.001672,172.31.40.0-255,66,261090,77,343913
5010,0.001675,74.125.24.0-255,1484,262574,77,343913
5011,0.00171,74.125.24.0-255,7156,269730,77,343913
5012,0.001713,172.31.40.0-255,66,269796,77,343913
5013,0.001753,74.125.24.0-255,1484,271280,77,343913
5014,0.001758,74.125.24.0-255,2902,274182,77,343913
5015,0.001778,74.125.24.0-255,5738,279920,77,343913
5016,0.001792,74.125.24.0-255,1484,281404,77,343913
5017,0.001814,74.125.24.0-255,11410,292814,77,343913
5018,0.001821,74.125.24.0-255,7156,299970,77,343913
5019,0.001867,74.125.24.0-255,3602,303572,77,343913
5020,0.001896,74.125.24.0-255,4320,307892,77,343913
5021,0.001899,74.125.24.0-255,1484,309376,77,343913
5022,0.00191,74.125.24.0-255,1484,310860,77,343913
5023,0.001912,74.125.24.0-255,1484,312344,77,343913
5024,0.001937,74.125.24.0-255,7156,319500,77,343913
5025,0.001961,74.125.24.0-255,4320,323820,77,343913
5026,0.001964,172.31.40.0-255,66,323886,77,343913
5027,0.00197,172.31.40.0-255,66,323952,77,343913
5028,0.002005,74.125.24.0-255,13528,337480,77,343913
5029,0.002012,74.125.24.0-255,5437,342917,77,343913
5030,0.002043,74.125.24.0-255,105,343022,77,343913
5031,0.002055,172.31.40.0-255,66,343088,77,343913
5032,0.002086,74.125.24.0-255,129,343217,77,343913
5033,0.005269,172.31.40.0-255,105,343322,77,343913
5034,0.005305,172.31.40.0-255,105,343427,77,343913
5035,0.005528,172.31.40.0-255,90,343517,77,343913
5036,0.005538,172.31.40.0-255,66,343583,77,343913
5037,0.007536,74.125.24.0-255,66,343649,77,343913
5038,0.007546,74.125.24.0-255,66,343715,77,343913
5039,0.007745,74.125.24.0-255,66,343781,77,343913
5040,0.007777,74.125.24.0-255,66,343847,77,343913
5041,0.007784,172.31.40.0-255,66,343913,77,343913
5042,0.0,172.31.40.0-255,105,105,77,210
5043,0.001496,157.240.13.0-255,105,210,77,210
5044,0.0,74.125.68.0-255,153,153,77,239947
5045,2e-05,172.31.40.0-255,66,219,77,239947
5046,2.6e-05,74.125.68.0-255,1484,1703,77,239947
5047,3.1e-05,172.31.40.0-255,66,1769,77,239947
5048,3.8e-05,74.125.68.0-255,2902,4671,77,239947
5049,4.1e-05,172.31.40.0-255,66,4737,77,239947
5050,7e-05,74.125.68.0-255,5738,10475,77,239947
5051,7.3e-05,172.31.40.0-255,66,10541,77,239947
5052,9.6e-05,74.125.68.0-255,3409,13950,77,239947
5053,9.8e-05,172.31.40.0-255,66,14016,77,239947
5054,0.000123,74.125.68.0-255,1484,15500,77,239947
5055,0.000126,172.31.40.0-255,66,15566,77,239947
5056,0.000146,74.125.68.0-255,2902,18468,77,239947
5057,0.000149,172.31.40.0-255,66,18534,77,239947
5058,0.000164,74.125.68.0-255,5738,24272,77,239947
5059,0.000166,172.31.40.0-255,66,24338,77,239947
5060,0.000169,74.125.68.0-255,1484,25822,77,239947
5061,0.000171,172.31.40.0-255,66,25888,77,239947
5062,0.000192,74.125.68.0-255,4320,30208,77,239947
5063,0.000194,172.31.40.0-255,66,30274,77,239947
5064,0.000219,74.125.68.0-255,1125,31399,77,239947
5065,0.000222,172.31.40.0-255,66,31465,77,239947
5066,0.000458,74.125.68.0-255,1484,32949,77,239947
5067,0.000464,172.31.40.0-255,66,33015,77,239947
5068,0.000483,74.125.68.0-255,2902,35917,77,239947
5069,0.000488,172.31.40.0-255,66,35983,77,239947
5070,0.000524,74.125.68.0-255,4320,40303,77,239947
5071,0.000527,172.31.40.0-255,66,40369,77,239947
5072,0.00053,74.125.68.0-255,1484,41853,77,239947
5073,0.000532,172.31.40.0-255,66,41919,77,239947
5074,0.00055,74.125.68.0-255,2902,44821,77,239947
5075,0.000552,172.31.40.0-255,66,44887,77,239947
5076,0.000579,74.125.68.0-255,6797,51684,77,239947
5077,0.000582,172.31.40.0-255,66,51750,77,239947
5078,0.000614,74.125.68.0-255,7156,58906,77,239947
5079,0.000617,172.31.40.0-255,66,58972,77,239947
5080,0.000636,74.125.68.0-255,5738,64710,77,239947
5081,0.000638,172.31.40.0-255,66,64776,77,239947
5082,0.000654,74.125.68.0-255,1437,66213,77,239947
5083,0.000657,74.125.68.0-255,112,66325,77,239947
5084,0.001039,74.125.68.0-255,328,66653,77,239947
5085,0.001046,172.31.40.0-255,66,66719,77,239947
5086,0.001248,74.125.68.0-255,1484,68203,77,239947
5087,0.001258,74.125.68.0-255,2902,71105,77,239947
5088,0.001262,172.31.40.0-255,66,71171,77,239947
5089,0.001267,74.125.68.0-255,1484,72655,77,239947
5090,0.001284,74.125.68.0-255,4320,76975,77,239947
5091,0.001286,172.31.40.0-255,66,77041,77,239947
5092,0.001291,74.125.68.0-255,2902,79943,77,239947
5093,0.001293,172.31.40.0-255,66,80009,77,239947
5094,0.001296,74.125.68.0-255,1484,81493,77,239947
5095,0.00131,74.125.68.0-255,2902,84395,77,239947
5096,0.001312,172.31.40.0-255,66,84461,77,239947
5097,0.00134,74.125.68.0-255,2902,87363,77,239947
5098,0.001342,172.31.40.0-255,66,87429,77,239947
5099,0.001357,74.125.68.0-255,5738,93167,77,239947
5100,0.001359,172.31.40.0-255,66,93233,77,239947
5101,0.001391,74.125.68.0-255,2902,96135,77,239947
5102,0.001394,172.31.40.0-255,66,96201,77,239947
5103,0.001412,74.125.68.0-255,2902,99103,77,239947
5104,0.001415,172.31.40.0-255,66,99169,77,239947
5105,0.00146,74.125.68.0-255,2184,101353,77,239947
5106,0.001463,172.31.40.0-255,66,101419,77,239947
5107,0.001636,74.125.68.0-255,1484,102903,77,239947
5108,0.001657,74.125.68.0-255,2902,105805,77,239947
5109,0.00166,172.31.40.0-255,66,105871,77,239947
5110,0.001677,74.125.68.0-255,5738,111609,77,239947
5111,0.001679,172.31.40.0-255,66,111675,77,239947
5112,0.001708,74.125.68.0-255,5738,117413,77,239947
5113,0.00171,172.31.40.0-255,66,117479,77,239947
5114,0.001713,74.125.68.0-255,1484,118963,77,239947
5115,0.001738,74.125.68.0-255,5738,124701,77,239947
5116,0.001741,172.31.40.0-255,66,124767,77,239947
5117,0.001745,74.125.68.0-255,2902,127669,77,239947
5118,0.001747,172.31.40.0-255,66,127735,77,239947
5119,0.001764,74.125.68.0-255,1484,129219,77,239947
5120,0.001778,74.125.68.0-255,2902,132121,77,239947
5121,0.00178,172.31.40.0-255,66,132187,77,239947
5122,0.001793,74.125.68.0-255,3602,135789,77,239947
5123,0.001795,172.31.40.0-255,66,135855,77,239947
5124,0.001895,74.125.68.0-255,1484,137339,77,239947
5125,0.001934,74.125.68.0-255,2902,140241,77,239947
5126,0.001938,172.31.40.0-255,66,140307,77,239947
5127,0.001961,74.125.68.0-255,4320,144627,77,239947
5128,0.001964,172.31.40.0-255,66,144693,77,239947
5129,0.002015,74.125.68.0-255,8574,153267,77,239947
5130,0.002017,172.31.40.0-255,66,153333,77,239947
5131,0.002022,74.125.68.0-255,4320,157653,77,239947
5132,0.002024,172.31.40.0-255,66,157719,77,239947
5133,0.002054,74.125.68.0-255,2902,160621,77,239947
5134,0.002056,172.31.40.0-255,66,160687,77,239947
5135,0.002081,74.125.68.0-255,2902,163589,77,239947
5136,0.002083,172.31.40.0-255,66,163655,77,239947
5137,0.002128,74.125.68.0-255,1484,165139,77,239947
5138,0.00215,74.125.68.0-255,1484,166623,77,239947
5139,0.002152,172.31.40.0-255,66,166689,77,239947
5140,0.002167,74.125.68.0-255,2902,169591,77,239947
5141,0.002169,172.31.40.0-255,66,169657,77,239947
5142,0.002185,74.125.68.0-255,766,170423,77,239947
5143,0.002423,74.125.68.0-255,1484,171907,77,239947
5144,0.002427,172.31.40.0-255,66,171973,77,239947
5145,0.002431,74.125.68.0-255,1484,173457,77,239947
5146,0.002446,74.125.68.0-255,1484,174941,77,239947
5147,0.002448,172.31.40.0-255,66,175007,77,239947
5148,0.002451,74.125.68.0-255,1484,176491,77,239947
5149,0.002454,74.125.68.0-255,1484,177975,77,239947
5150,0.002457,172.31.40.0-255,66,178041,77,239947
5151,0.002474,74.125.68.0-255,1484,179525,77,239947
5152,0.002487,74.125.68.0-255,4320,183845,77,239947
5153,0.00249,172.31.40.0-255,66,183911,77,239947
5154,0.002508,74.125.68.0-255,1484,185395,77,239947
5155,0.002512,74.125.68.0-255,2902,188297,77,239947
5156,0.002515,172.31.40.0-255,66,188363,77,239947
5157,0.00252,74.125.68.0-255,4320,192683,77,239947
5158,0.002522,172.31.40.0-255,66,192749,77,239947
5159,0.00255,74.125.68.0-255,8574,201323,77,239947
5160,0.002553,172.31.40.0-255,66,201389,77,239947
5161,0.002559,74.125.68.0-255,3602,204991,77,239947
5162,0.002561,172.31.40.0-255,66,205057,77,239947
5163,0.005078,74.125.68.0-255,1484,206541,77,239947
5164,0.005098,74.125.68.0-255,4320,210861,77,239947
5165,0.005101,172.31.40.0-255,66,210927,77,239947
5166,0.007649,74.125.68.0-255,5738,216665,77,239947
5167,0.007656,172.31.40.0-255,66,216731,77,239947
5168,0.010202,74.125.68.0-255,5738,222469,77,239947
5169,0.010213,172.31.40.0-255,66,222535,77,239947
5170,0.012756,74.125.68.0-255,5738,228273,77,239947
5171,0.012791,172.31.40.0-255,66,228339,77,239947
5172,0.01535,74.125.68.0-255,5738,234077,77,239947
5173,0.01536,172.31.40.0-255,66,234143,77,239947
5174,0.01791,74.125.68.0-255,5738,239881,77,239947
5175,0.017927,172.31.40.0-255,66,239947,77,239947
5176,0.0,172.31.40.0-255,105,105,77,459
5177,0.000206,172.31.40.0-255,90,195,77,459
5178,0.000215,172.31.40.0-255,66,261,77,459
5179,0.002231,74.125.24.0-255,66,327,77,459
5180,0.002274,74.125.24.0-255,66,393,77,459
5181,0.002297,172.31.40.0-255,66,459,77,459
5182,0.0,74.125.24.0-255,153,153,77,221542
5183,1.6e-05,172.31.40.0-255,66,219,77,221542
5184,2.3e-05,74.125.24.0-255,1484,1703,77,221542
5185,2.8e-05,172.31.40.0-255,66,1769,77,221542
5186,3.4e-05,74.125.24.0-255,2902,4671,77,221542
5187,3.7e-05,172.31.40.0-255,66,4737,77,221542
5188,6.4e-05,74.125.24.0-255,7156,11893,77,221542
5189,6.8e-05,172.31.40.0-255,66,11959,77,221542
5190,0.000114,74.125.24.0-255,2902,14861,77,221542
5191,0.000117,172.31.40.0-255,66,14927,77,221542
5192,0.000132,74.125.24.0-255,3445,18372,77,221542
5193,0.000135,172.31.40.0-255,66,18438,77,221542
5194,0.000192,74.125.24.0-255,12469,30907,77,221542
5195,0.000195,172.31.40.0-255,66,30973,77,221542
5196,0.000288,74.125.24.0-255,5738,36711,77,221542
5197,0.000293,172.31.40.0-255,66,36777,77,221542
5198,0.000314,74.125.24.0-255,7156,43933,77,221542
5199,0.000317,172.31.40.0-255,66,43999,77,221542
5200,0.000397,74.125.24.0-255,2902,46901,77,221542
5201,0.0004,172.31.40.0-255,66,46967,77,221542
5202,0.00045,172.31.40.0-255,66,47033,77,221542
5203,0.000464,74.125.24.0-255,2496,49529,77,221542
5204,0.000467,172.31.40.0-255,66,49595,77,221542
5205,0.000586,74.125.24.0-255,1484,51079,77,221542
5206,0.000589,74.125.24.0-255,374,51453,77,221542
5207,0.000598,172.31.40.0-255,78,51531,77,221542
5208,0.000603,172.31.40.0-255,66,51597,77,221542
5209,0.000609,74.125.24.0-255,4320,55917,77,221542
5210,0.000612,172.31.40.0-255,66,55983,77,221542
5211,0.000647,74.125.24.0-255,2902,58885,77,221542
5212,0.00065,172.31.40.0-255,66,58951,77,221542
5213,0.000676,74.125.24.0-255,7156,66107,77,221542
5214,0.000679,172.31.40.0-255,66,66173,77,221542
5215,0.000732,74.125.24.0-255,2902,69075,77,221542
5216,0.000736,172.31.40.0-255,66,69141,77,221542
5217,0.000769,172.31.40.0-255,66,69207,77,221542
5218,0.000864,74.125.24.0-255,766,69973,77,221542
5219,0.000893,74.125.24.0-255,7156,77129,77,221542
5220,0.000897,172.31.40.0-255,66,77195,77,221542
5221,0.00091,74.125.24.0-255,2902,80097,77,221542
5222,0.000912,172.31.40.0-255,66,80163,77,221542
5223,0.00099,74.125.24.0-255,9992,90155,77,221542
5224,0.000993,172.31.40.0-255,66,90221,77,221542
5225,0.001008,74.125.24.0-255,2902,93123,77,221542
5226,0.001011,172.31.40.0-255,66,93189,77,221542
5227,0.001096,74.125.24.0-255,2902,96091,77,221542
5228,0.001099,172.31.40.0-255,66,96157,77,221542
5229,0.001148,172.31.40.0-255,66,96223,77,221542
5230,0.001343,74.125.24.0-255,4320,100543,77,221542
5231,0.001347,172.31.40.0-255,66,100609,77,221542
5232,0.001383,74.125.24.0-255,13528,114137,77,221542
5233,0.001386,172.31.40.0-255,66,114203,77,221542
5234,0.001529,74.125.24.0-255,4320,118523,77,221542
5235,0.001534,172.31.40.0-255,66,118589,77,221542
5236,0.001559,172.31.40.0-255,66,118655,77,221542
5237,0.001679,74.125.24.0-255,9992,128647,77,221542
5238,0.001683,172.31.40.0-255,66,128713,77,221542
5239,0.001702,74.125.24.0-255,5020,133733,77,221542
5240,0.001705,172.31.40.0-255,66,133799,77,221542
5241,0.001821,74.125.24.0-255,11410,145209,77,221542
5242,0.001825,172.31.40.0-255,66,145275,77,221542
5243,0.001845,74.125.24.0-255,4320,149595,77,221542
5244,0.001848,172.31.40.0-255,66,149661,77,221542
5245,0.001941,74.125.24.0-255,5738,155399,77,221542
5246,0.001944,172.31.40.0-255,66,155465,77,221542
5247,0.001977,74.125.24.0-255,12110,167575,77,221542
5248,0.001981,172.31.40.0-255,66,167641,77,221542
5249,0.002108,74.125.24.0-255,4320,171961,77,221542
5250,0.002112,172.31.40.0-255,66,172027,77,221542
5251,0.00218,172.31.40.0-255,66,172093,77,221542
5252,0.002429,74.125.24.0-255,2902,174995,77,221542
5253,0.002433,172.31.40.0-255,66,175061,77,221542
5254,0.002463,74.125.24.0-255,12828,187889,77,221542
5255,0.002466,172.31.40.0-255,66,187955,77,221542
5256,0.002563,74.125.24.0-255,5738,193693,77,221542
5257,0.002567,172.31.40.0-255,66,193759,77,221542
5258,0.002602,172.31.40.0-255,66,193825,77,221542
5259,0.002771,74.125.24.0-255,11410,205235,77,221542
5260,0.002777,172.31.40.0-255,66,205301,77,221542
5261,0.002813,172.31.40.0-255,66,205367,77,221542
5262,0.002865,172.31.40.0-255,66,205433,77,221542
5263,0.003332,74.125.24.0-255,11410,216843,77,221542
5264,0.003394,74.125.24.0-255,2901,219744,77,221542
5265,0.011007,172.31.40.0-255,66,219810,77,221542
5266,0.013002,74.125.24.0-255,1483,221293,77,221542
5267,0.013013,172.31.40.0-255,78,221371,77,221542
5268,0.013354,172.31.40.0-255,105,221476,77,221542
5269,0.015688,74.125.24.0-255,66,221542,77,221542
5270,0.0,172.217.160.0-255,153,153,77,353017
5271,1.3e-05,172.31.40.0-255,66,219,77,353017
5272,1.9e-05,172.217.160.0-255,1484,1703,77,353017
5273,2.3e-05,172.31.40.0-255,66,1769,77,353017
5274,2.9e-05,172.217.160.0-255,2902,4671,77,353017
5275,3.2e-05,172.31.40.0-255,66,4737,77,353017
5276,4e-05,172.217.160.0-255,7156,11893,77,353017
5277,4.3e-05,172.31.40.0-255,66,11959,77,353017
5278,4.8e-05,172.217.160.0-255,2155,14114,77,353017
5279,5e-05,172.31.40.0-255,66,14180,77,353017
5280,7.4e-05,172.217.160.0-255,4320,18500,77,353017
5281,7.7e-05,172.31.40.0-255,66,18566,77,353017
5282,9.9e-05,172.217.160.0-255,7156,25722,77,353017
5283,0.000102,172.31.40.0-255,66,25788,77,353017
5284,0.000108,172.217.160.0-255,5379,31167,77,353017
5285,0.000111,172.31.40.0-255,66,31233,77,353017
5286,0.000167,172.217.160.0-255,1484,32717,77,353017
5287,0.00017,172.31.40.0-255,66,32783,77,353017
5288,0.000189,172.217.160.0-255,2902,35685,77,353017
5289,0.000191,172.31.40.0-255,66,35751,77,353017
5290,0.000195,172.217.160.0-255,1484,37235,77,353017
5291,0.000197,172.31.40.0-255,66,37301,77,353017
5292,0.000215,172.217.160.0-255,5738,43039,77,353017
5293,0.000217,172.31.40.0-255,66,43105,77,353017
5294,0.000251,172.217.160.0-255,2902,46007,77,353017
5295,0.000255,172.31.40.0-255,66,46073,77,353017
5296,0.000268,172.217.160.0-255,2543,48616,77,353017
5297,0.00027,172.31.40.0-255,66,48682,77,353017
5298,0.000333,172.217.160.0-255,1484,50166,77,353017
5299,0.000337,172.31.40.0-255,66,50232,77,353017
5300,0.000341,172.217.160.0-255,2902,53134,77,353017
5301,0.000344,172.31.40.0-255,66,53200,77,353017
5302,0.000366,172.217.160.0-255,5738,58938,77,353017
5303,0.000368,172.31.40.0-255,66,59004,77,353017
5304,0.000412,172.217.160.0-255,7064,66068,77,353017
5305,0.000415,172.31.40.0-255,66,66134,77,353017
5306,0.000596,172.217.160.0-255,120,66254,77,353017
5307,0.000945,172.217.160.0-255,1484,67738,77,353017
5308,0.00095,172.31.40.0-255,66,67804,77,353017
5309,0.000956,172.217.160.0-255,2902,70706,77,353017
5310,0.000958,172.31.40.0-255,66,70772,77,353017
5311,0.000966,172.217.160.0-255,5738,76510,77,353017
5312,0.000967,172.31.40.0-255,66,76576,77,353017
5313,0.000982,172.217.160.0-255,1484,78060,77,353017
5314,0.001006,172.217.160.0-255,12469,90529,77,353017
5315,0.001009,172.31.40.0-255,66,90595,77,353017
5316,0.001015,172.217.160.0-255,4320,94915,77,353017
5317,0.001017,172.31.40.0-255,66,94981,77,353017
5318,0.001037,172.217.160.0-255,5677,100658,77,353017
5319,0.00104,172.31.40.0-255,66,100724,77,353017
5320,0.001397,172.217.160.0-255,1484,102208,77,353017
5321,0.001403,172.217.160.0-255,2902,105110,77,353017
5322,0.001406,172.31.40.0-255,66,105176,77,353017
5323,0.001412,172.217.160.0-255,2902,108078,77,353017
5324,0.001414,172.31.40.0-255,66,108144,77,353017
5325,0.001431,172.217.160.0-255,2902,111046,77,353017
5326,0.001433,172.31.40.0-255,66,111112,77,353017
5327,0.001438,172.217.160.0-255,4320,115432,77,353017
5328,0.00144,172.31.40.0-255,66,115498,77,353017
5329,0.001475,172.217.160.0-255,4320,119818,77,353017
5330,0.001477,172.31.40.0-255,66,119884,77,353017
5331,0.001487,172.217.160.0-255,9992,129876,77,353017
5332,0.001489,172.31.40.0-255,66,129942,77,353017
5333,0.001506,172.217.160.0-255,2902,132844,77,353017
5334,0.001509,172.31.40.0-255,66,132910,77,353017
5335,0.001529,172.217.160.0-255,2184,135094,77,353017
5336,0.001532,172.31.40.0-255,66,135160,77,353017
5337,0.0018,172.217.160.0-255,1484,136644,77,353017
5338,0.001818,172.217.160.0-255,1484,138128,77,353017
5339,0.001821,172.31.40.0-255,66,138194,77,353017
5340,0.001825,172.217.160.0-255,1484,139678,77,353017
5341,0.001867,172.217.160.0-255,7156,146834,77,353017
5342,0.00187,172.31.40.0-255,66,146900,77,353017
5343,0.001873,172.217.160.0-255,1484,148384,77,353017
5344,0.001877,172.217.160.0-255,4320,152704,77,353017
5345,0.001879,172.31.40.0-255,66,152770,77,353017
5346,0.001891,172.217.160.0-255,1484,154254,77,353017
5347,0.001912,172.217.160.0-255,9992,164246,77,353017
5348,0.001915,172.31.40.0-255,66,164312,77,353017
5349,0.001935,172.217.160.0-255,4320,168632,77,353017
5350,0.001938,172.31.40.0-255,66,168698,77,353017
5351,0.001941,172.217.160.0-255,766,169464,77,353017
5352,0.002183,172.31.40.0-255,66,169530,77,353017
5353,0.00225,172.217.160.0-255,1484,171014,77,353017
5354,0.002258,172.217.160.0-255,2902,173916,77,353017
5355,0.002261,172.31.40.0-255,66,173982,77,353017
5356,0.002282,172.217.160.0-255,5738,179720,77,353017
5357,0.002285,172.31.40.0-255,66,179786,77,353017
5358,0.00229,172.217.160.0-255,4320,184106,77,353017
5359,0.002292,172.31.40.0-255,66,184172,77,353017
5360,0.002312,172.217.160.0-255,8574,192746,77,353017
5361,0.002314,172.31.40.0-255,66,192812,77,353017
5362,0.002321,172.217.160.0-255,5738,198550,77,353017
5363,0.002322,172.31.40.0-255,66,198616,77,353017
5364,0.002341,172.217.160.0-255,5020,203636,77,353017
5365,0.002343,172.31.40.0-255,66,203702,77,353017
5366,0.002357,172.217.160.0-255,2902,206604,77,353017
5367,0.002359,172.31.40.0-255,66,206670,77,353017
5368,0.002384,172.217.160.0-255,8574,215244,77,353017
5369,0.002386,172.31.40.0-255,66,215310,77,353017
5370,0.002393,172.217.160.0-255,5738,221048,77,353017
5371,0.002395,172.31.40.0-255,66,221114,77,353017
5372,0.002434,172.217.160.0-255,7156,228270,77,353017
5373,0.002437,172.31.40.0-255,66,228336,77,353017
5374,0.002465,172.217.160.0-255,9274,237610,77,353017
5375,0.002467,172.31.40.0-255,66,237676,77,353017
5376,0.00247,172.217.160.0-255,1484,239160,77,353017
5377,0.002476,172.217.160.0-255,2902,242062,77,353017
5378,0.002478,172.31.40.0-255,66,242128,77,353017
5379,0.002482,172.217.160.0-255,1484,243612,77,353017
5380,0.002506,172.217.160.0-255,4320,247932,77,353017
5381,0.002509,172.31.40.0-255,66,247998,77,353017
5382,0.002521,172.217.160.0-255,7156,255154,77,353017
5383,0.002524,172.31.40.0-255,66,255220,77,353017
5384,0.002556,172.217.160.0-255,5738,260958,77,353017
5385,0.002559,172.31.40.0-255,66,261024,77,353017
5386,0.002569,172.217.160.0-255,10692,271716,77,353017
5387,0.002572,172.31.40.0-255,66,271782,77,353017
5388,0.002623,172.217.160.0-255,1484,273266,77,353017
5389,0.002627,172.217.160.0-255,1484,274750,77,353017
5390,0.002631,172.31.40.0-255,66,274816,77,353017
5391,0.002645,172.217.160.0-255,1484,276300,77,353017
5392,0.00266,172.217.160.0-255,5738,282038,77,353017
5393,0.002663,172.31.40.0-255,66,282104,77,353017
5394,0.002668,172.217.160.0-255,2902,285006,77,353017
5395,0.00267,172.31.40.0-255,66,285072,77,353017
5396,0.002673,172.217.160.0-255,1484,286556,77,353017
5397,0.002711,172.217.160.0-255,8574,295130,77,353017
5398,0.002734,172.217.160.0-255,5738,300868,77,353017
5399,0.00274,172.217.160.0-255,5020,305888,77,353017
5400,0.002764,172.217.160.0-255,4320,310208,77,353017
5401,0.002778,172.217.160.0-255,1484,311692,77,353017
5402,0.002785,172.217.160.0-255,5738,317430,77,353017
5403,0.002836,172.217.160.0-255,5738,323168,77,353017
5404,0.002857,172.217.160.0-255,7156,330324,77,353017
5405,0.002897,172.217.160.0-255,5738,336062,77,353017
5406,0.002918,172.217.160.0-255,3602,339664,77,353017
5407,0.002935,172.217.160.0-255,1484,341148,77,353017
5408,0.002954,172.217.160.0-255,11410,352558,77,353017
5409,0.003009,172.217.160.0-255,105,352663,77,353017
5410,0.009344,172.217.160.0-255,105,352768,77,353017
5411,0.009358,172.31.40.0-255,78,352846,77,353017
5412,0.013013,172.31.40.0-255,105,352951,77,353017
5413,0.014631,172.217.160.0-255,66,353017,77,353017
5414,0.0,172.217.194.0-255,146,146,77,133831
5415,1.5e-05,172.31.40.0-255,66,212,77,133831
5416,2.1e-05,172.217.194.0-255,1484,1696,77,133831
5417,2.6e-05,172.31.40.0-255,66,1762,77,133831
5418,3.3e-05,172.217.194.0-255,2902,4664,77,133831
5419,3.6e-05,172.31.40.0-255,66,4730,77,133831
5420,9e-05,172.217.194.0-255,7156,11886,77,133831
5421,9.3e-05,172.31.40.0-255,66,11952,77,133831
5422,9.8e-05,172.217.194.0-255,2029,13981,77,133831
5423,0.0001,172.31.40.0-255,66,14047,77,133831
5424,0.000105,172.217.194.0-255,2902,16949,77,133831
5425,0.000107,172.31.40.0-255,66,17015,77,133831
5426,0.00011,172.217.194.0-255,1484,18499,77,133831
5427,0.000112,172.31.40.0-255,66,18565,77,133831
5428,0.00014,172.217.194.0-255,5738,24303,77,133831
5429,0.000142,172.31.40.0-255,66,24369,77,133831
5430,0.00015,172.217.194.0-255,7156,31525,77,133831
5431,0.000152,172.31.40.0-255,66,31591,77,133831
5432,0.000158,172.217.194.0-255,4320,35911,77,133831
5433,0.000161,172.31.40.0-255,66,35977,77,133831
5434,0.000197,172.217.194.0-255,11410,47387,77,133831
5435,0.0002,172.31.40.0-255,66,47453,77,133831
5436,0.000203,172.217.194.0-255,766,48219,77,133831
5437,0.000205,172.31.40.0-255,66,48285,77,133831
5438,0.000493,172.217.194.0-255,1484,49769,77,133831
5439,0.000498,172.31.40.0-255,66,49835,77,133831
5440,0.000503,172.217.194.0-255,1484,51319,77,133831
5441,0.000505,172.31.40.0-255,66,51385,77,133831
5442,0.000519,172.217.194.0-255,1484,52869,77,133831
5443,0.000521,172.31.40.0-255,66,52935,77,133831
5444,0.000527,172.217.194.0-255,4320,57255,77,133831
5445,0.00053,172.31.40.0-255,66,57321,77,133831
5446,0.000556,172.217.194.0-255,1484,58805,77,133831
5447,0.000562,172.217.194.0-255,2902,61707,77,133831
5448,0.000565,172.31.40.0-255,66,61773,77,133831
5449,0.000587,172.217.194.0-255,4282,66055,77,133831
5450,0.00059,172.31.40.0-255,66,66121,77,133831
5451,0.001354,172.217.194.0-255,1484,67605,77,133831
5452,0.001366,172.217.194.0-255,2902,70507,77,133831
5453,0.001371,172.31.40.0-255,66,70573,77,133831
5454,0.001379,172.217.194.0-255,5738,76311,77,133831
5455,0.001382,172.31.40.0-255,66,76377,77,133831
5456,0.001404,172.217.194.0-255,4320,80697,77,133831
5457,0.001407,172.31.40.0-255,66,80763,77,133831
5458,0.001435,172.217.194.0-255,5738,86501,77,133831
5459,0.001439,172.31.40.0-255,66,86567,77,133831
5460,0.00145,172.217.194.0-255,11410,97977,77,133831
5461,0.001452,172.31.40.0-255,66,98043,77,133831
5462,0.001457,172.217.194.0-255,2184,100227,77,133831
5463,0.001459,172.31.40.0-255,66,100293,77,133831
5464,0.005863,172.217.194.0-255,1484,101777,77,133831
5465,0.005884,172.217.194.0-255,2902,104679,77,133831
5466,0.005895,172.31.40.0-255,66,104745,77,133831
5467,0.005903,172.217.194.0-255,1484,106229,77,133831
5468,0.008281,172.217.194.0-255,4320,110549,77,133831
5469,0.008298,172.31.40.0-255,66,110615,77,133831
5470,0.010687,172.217.194.0-255,5738,116353,77,133831
5471,0.010706,172.31.40.0-255,66,116419,77,133831
5472,0.0131,172.217.194.0-255,5738,122157,77,133831
5473,0.013119,172.31.40.0-255,66,122223,77,133831
5474,0.015486,172.217.194.0-255,5738,127961,77,133831
5475,0.015506,172.31.40.0-255,66,128027,77,133831
5476,0.017887,172.217.194.0-255,5738,133765,77,133831
5477,0.017905,172.31.40.0-255,66,133831,77,133831
5478,0.0,74.125.68.0-255,146,146,77,212987
5479,2.1e-05,172.31.40.0-255,66,212,77,212987
5480,2.8e-05,74.125.68.0-255,1484,1696,77,212987
5481,3.2e-05,172.31.40.0-255,66,1762,77,212987
5482,3.9e-05,74.125.68.0-255,2902,4664,77,212987
5483,4.2e-05,172.31.40.0-255,66,4730,77,212987
5484,7e-05,74.125.68.0-255,2902,7632,77,212987
5485,7.4e-05,172.31.40.0-255,66,7698,77,212987
5486,9.2e-05,74.125.68.0-255,2902,10600,77,212987
5487,9.5e-05,172.31.40.0-255,66,10666,77,212987
5488,0.000101,74.125.68.0-255,3386,14052,77,212987
5489,0.000104,172.31.40.0-255,66,14118,77,212987
5490,0.000557,74.125.68.0-255,1484,15602,77,212987
5491,0.000564,172.31.40.0-255,66,15668,77,212987
5492,0.000573,74.125.68.0-255,2902,18570,77,212987
5493,0.000575,172.31.40.0-255,66,18636,77,212987
5494,0.000603,74.125.68.0-255,5738,24374,77,212987
5495,0.000605,172.31.40.0-255,66,24440,77,212987
5496,0.000629,74.125.68.0-255,1484,25924,77,212987
5497,0.000631,172.31.40.0-255,66,25990,77,212987
5498,0.000655,74.125.68.0-255,5379,31369,77,212987
5499,0.000658,172.31.40.0-255,66,31435,77,212987
5500,0.000677,74.125.68.0-255,1484,32919,77,212987
5501,0.000681,172.31.40.0-255,66,32985,77,212987
5502,0.000686,74.125.68.0-255,2902,35887,77,212987
5503,0.000688,172.31.40.0-255,66,35953,77,212987
5504,0.000691,74.125.68.0-255,1484,37437,77,212987
5505,0.000693,172.31.40.0-255,66,37503,77,212987
5506,0.000706,74.125.68.0-255,1484,38987,77,212987
5507,0.000708,172.31.40.0-255,66,39053,77,212987
5508,0.000734,74.125.68.0-255,2902,41955,77,212987
5509,0.000737,172.31.40.0-255,66,42021,77,212987
5510,0.000751,74.125.68.0-255,2902,44923,77,212987
5511,0.000753,172.31.40.0-255,66,44989,77,212987
5512,0.000778,74.125.68.0-255,3961,48950,77,212987
5513,0.000781,172.31.40.0-255,66,49016,77,212987
5514,0.001216,74.125.68.0-255,1484,50500,77,212987
5515,0.001224,74.125.68.0-255,1484,51984,77,212987
5516,0.001228,172.31.40.0-255,66,52050,77,212987
5517,0.00125,74.125.68.0-255,1484,53534,77,212987
5518,0.001258,74.125.68.0-255,5738,59272,77,212987
5519,0.001261,172.31.40.0-255,66,59338,77,212987
5520,0.00131,74.125.68.0-255,4320,63658,77,212987
5521,0.001313,172.31.40.0-255,66,63724,77,212987
5522,0.001325,74.125.68.0-255,2543,66267,77,212987
5523,0.001328,172.31.40.0-255,66,66333,77,212987
5524,0.001364,74.125.68.0-255,1484,67817,77,212987
5525,0.00137,74.125.68.0-255,2902,70719,77,212987
5526,0.001373,172.31.40.0-255,66,70785,77,212987
5527,0.00139,74.125.68.0-255,1484,72269,77,212987
5528,0.001404,74.125.68.0-255,2902,75171,77,212987
5529,0.001407,172.31.40.0-255,66,75237,77,212987
5530,0.001417,74.125.68.0-255,1484,76721,77,212987
5531,0.001439,74.125.68.0-255,4320,81041,77,212987
5532,0.001442,172.31.40.0-255,66,81107,77,212987
5533,0.001462,74.125.68.0-255,3961,85068,77,212987
5534,0.001464,172.31.40.0-255,66,85134,77,212987
5535,0.001467,74.125.68.0-255,1484,86618,77,212987
5536,0.001484,74.125.68.0-255,2902,89520,77,212987
5537,0.001486,172.31.40.0-255,66,89586,77,212987
5538,0.001506,74.125.68.0-255,4320,93906,77,212987
5539,0.001508,172.31.40.0-255,66,93972,77,212987
5540,0.001534,74.125.68.0-255,5738,99710,77,212987
5541,0.001537,172.31.40.0-255,66,99776,77,212987
5542,0.001541,74.125.68.0-255,1707,101483,77,212987
5543,0.001543,172.31.40.0-255,66,101549,77,212987
5544,0.001821,74.125.68.0-255,1484,103033,77,212987
5545,0.001825,74.125.68.0-255,2902,105935,77,212987
5546,0.001828,172.31.40.0-255,66,106001,77,212987
5547,0.00183,74.125.68.0-255,1484,107485,77,212987
5548,0.001833,74.125.68.0-255,1484,108969,77,212987
5549,0.001835,172.31.40.0-255,66,109035,77,212987
5550,0.001847,74.125.68.0-255,1484,110519,77,212987
5551,0.001854,74.125.68.0-255,5738,116257,77,212987
5552,0.001857,172.31.40.0-255,66,116323,77,212987
5553,0.001865,74.125.68.0-255,8574,124897,77,212987
5554,0.001868,172.31.40.0-255,66,124963,77,212987
5555,0.001873,74.125.68.0-255,4320,129283,77,212987
5556,0.001875,172.31.40.0-255,66,129349,77,212987
5557,0.0019,74.125.68.0-255,5738,135087,77,212987
5558,0.001903,172.31.40.0-255,66,135153,77,212987
5559,0.001905,74.125.68.0-255,766,135919,77,212987
5560,0.001937,74.125.68.0-255,1484,137403,77,212987
5561,0.00194,172.31.40.0-255,66,137469,77,212987
5562,0.001943,74.125.68.0-255,1484,138953,77,212987
5563,0.00196,74.125.68.0-255,2902,141855,77,212987
5564,0.001963,172.31.40.0-255,66,141921,77,212987
5565,0.001983,74.125.68.0-255,5738,147659,77,212987
5566,0.001986,172.31.40.0-255,66,147725,77,212987
5567,0.002014,74.125.68.0-255,8574,156299,77,212987
5568,0.002017,172.31.40.0-255,66,156365,77,212987
5569,0.002022,74.125.68.0-255,4320,160685,77,212987
5570,0.002024,172.31.40.0-255,66,160751,77,212987
5571,0.002043,74.125.68.0-255,5738,166489,77,212987
5572,0.002045,172.31.40.0-255,66,166555,77,212987
5573,0.004046,74.125.68.0-255,5738,172293,77,212987
5574,0.004053,172.31.40.0-255,66,172359,77,212987
5575,0.006062,74.125.68.0-255,5738,178097,77,212987
5576,0.006069,172.31.40.0-255,66,178163,77,212987
5577,0.008075,74.125.68.0-255,5738,183901,77,212987
5578,0.008082,172.31.40.0-255,66,183967,77,212987
5579,0.010092,74.125.68.0-255,5738,189705,77,212987
5580,0.010099,172.31.40.0-255,66,189771,77,212987
5581,0.012125,74.125.68.0-255,5738,195509,77,212987
5582,0.012133,172.31.40.0-255,66,195575,77,212987
5583,0.014157,74.125.68.0-255,5738,201313,77,212987
5584,0.014164,172.31.40.0-255,66,201379,77,212987
5585,0.016178,74.125.68.0-255,5738,207117,77,212987
5586,0.016187,172.31.40.0-255,66,207183,77,212987
5587,0.018206,74.125.68.0-255,5738,212921,77,212987
5588,0.018213,172.31.40.0-255,66,212987,77,212987
5589,0.0,172.217.194.0-255,152,152,77,309976
5590,2.2e-05,172.31.40.0-255,66,218,77,309976
5591,2.9e-05,172.217.194.0-255,1484,1702,77,309976
5592,3.3e-05,172.31.40.0-255,66,1768,77,309976
5593,4.5e-05,172.217.194.0-255,2902,4670,77,309976
5594,4.8e-05,172.31.40.0-255,66,4736,77,309976
5595,5.6e-05,172.217.194.0-255,7156,11892,77,309976
5596,5.9e-05,172.31.40.0-255,66,11958,77,309976
5597,6.3e-05,172.217.194.0-255,1929,13887,77,309976
5598,6.5e-05,172.31.40.0-255,66,13953,77,309976
5599,0.000109,172.217.194.0-255,1484,15437,77,309976
5600,0.000112,172.31.40.0-255,66,15503,77,309976
5601,0.000118,172.217.194.0-255,2902,18405,77,309976
5602,0.00012,172.31.40.0-255,66,18471,77,309976
5603,0.000154,172.217.194.0-255,5738,24209,77,309976
5604,0.000157,172.31.40.0-255,66,24275,77,309976
5605,0.000166,172.217.194.0-255,6797,31072,77,309976
5606,0.000173,172.31.40.0-255,66,31138,77,309976
5607,0.00019,172.217.194.0-255,1484,32622,77,309976
5608,0.000192,172.31.40.0-255,66,32688,77,309976
5609,0.000222,172.217.194.0-255,5738,38426,77,309976
5610,0.000225,172.31.40.0-255,66,38492,77,309976
5611,0.000232,172.217.194.0-255,7156,45648,77,309976
5612,0.000235,172.31.40.0-255,66,45714,77,309976
5613,0.00026,172.217.194.0-255,2543,48257,77,309976
5614,0.000262,172.31.40.0-255,66,48323,77,309976
5615,0.000266,172.217.194.0-255,1484,49807,77,309976
5616,0.000267,172.31.40.0-255,66,49873,77,309976
5617,0.00029,172.217.194.0-255,1484,51357,77,309976
5618,0.000292,172.31.40.0-255,66,51423,77,309976
5619,0.000299,172.217.194.0-255,7156,58579,77,309976
5620,0.000301,172.31.40.0-255,66,58645,77,309976
5621,0.000311,172.217.194.0-255,4320,62965,77,309976
5622,0.000314,172.31.40.0-255,66,63031,77,309976
5623,0.00036,172.217.194.0-255,3157,66188,77,309976
5624,0.000363,172.31.40.0-255,66,66254,77,309976
5625,0.000508,172.217.194.0-255,1484,67738,77,309976
5626,0.000515,172.217.194.0-255,2902,70640,77,309976
5627,0.000519,172.31.40.0-255,66,70706,77,309976
5628,0.000523,172.217.194.0-255,1484,72190,77,309976
5629,0.000541,172.217.194.0-255,4320,76510,77,309976
5630,0.000543,172.31.40.0-255,66,76576,77,309976
5631,0.000547,172.217.194.0-255,1484,78060,77,309976
5632,0.000604,172.217.194.0-255,8574,86634,77,309976
5633,0.000607,172.31.40.0-255,66,86700,77,309976
5634,0.000625,172.217.194.0-255,2902,89602,77,309976
5635,0.000627,172.31.40.0-255,66,89668,77,309976
5636,0.000637,172.217.194.0-255,10692,100360,77,309976
5637,0.000639,172.31.40.0-255,66,100426,77,309976
5638,0.000867,172.217.194.0-255,1484,101910,77,309976
5639,0.000873,172.217.194.0-255,2902,104812,77,309976
5640,0.000875,172.217.194.0-255,1484,106296,77,309976
5641,0.000881,172.31.40.0-255,66,106362,77,309976
5642,0.000898,172.217.194.0-255,4320,110682,77,309976
5643,0.0009,172.31.40.0-255,66,110748,77,309976
5644,0.000904,172.217.194.0-255,2902,113650,77,309976
5645,0.000906,172.31.40.0-255,66,113716,77,309976
5646,0.000945,172.217.194.0-255,9992,123708,77,309976
5647,0.000951,172.217.194.0-255,4320,128028,77,309976
5648,0.000956,172.31.40.0-255,66,128094,77,309976
5649,0.000959,172.31.40.0-255,66,128160,77,309976
5650,0.000984,172.217.194.0-255,5738,133898,77,309976
5651,0.000991,172.31.40.0-255,66,133964,77,309976
5652,0.000994,172.217.194.0-255,766,134730,77,309976
5653,0.001041,172.217.194.0-255,1484,136214,77,309976
5654,0.001044,172.31.40.0-255,66,136280,77,309976
5655,0.001049,172.217.194.0-255,2902,139182,77,309976
5656,0.001051,172.31.40.0-255,66,139248,77,309976
5657,0.001056,172.217.194.0-255,4320,143568,77,309976
5658,0.001062,172.31.40.0-255,66,143634,77,309976
5659,0.001096,172.217.194.0-255,1484,145118,77,309976
5660,0.001104,172.217.194.0-255,7156,152274,77,309976
5661,0.001106,172.31.40.0-255,66,152340,77,309976
5662,0.001126,172.31.40.0-255,66,152406,77,309976
5663,0.00113,172.217.194.0-255,2184,154590,77,309976
5664,0.001132,172.31.40.0-255,66,154656,77,309976
5665,0.001186,172.217.194.0-255,2902,157558,77,309976
5666,0.00119,172.31.40.0-255,66,157624,77,309976
5667,0.001193,172.217.194.0-255,1484,159108,77,309976
5668,0.0012,172.217.194.0-255,5738,164846,77,309976
5669,0.001207,172.31.40.0-255,66,164912,77,309976
5670,0.001243,172.217.194.0-255,12828,177740,77,309976
5671,0.001249,172.217.194.0-255,5738,183478,77,309976
5672,0.001253,172.31.40.0-255,66,183544,77,309976
5673,0.001256,172.31.40.0-255,66,183610,77,309976
5674,0.001296,172.217.194.0-255,5020,188630,77,309976
5675,0.001299,172.31.40.0-255,66,188696,77,309976
5676,0.001387,172.217.194.0-255,1484,190180,77,309976
5677,0.001404,172.217.194.0-255,2902,193082,77,309976
5678,0.001407,172.31.40.0-255,66,193148,77,309976
5679,0.001415,172.217.194.0-255,5738,198886,77,309976
5680,0.001417,172.31.40.0-255,66,198952,77,309976
5681,0.001449,172.217.194.0-255,7156,206108,77,309976
5682,0.001453,172.31.40.0-255,66,206174,77,309976
5683,0.00148,172.217.194.0-255,8574,214748,77,309976
5684,0.001484,172.31.40.0-255,66,214814,77,309976
5685,0.001513,172.217.194.0-255,5738,220552,77,309976
5686,0.001516,172.31.40.0-255,66,220618,77,309976
5687,0.001523,172.217.194.0-255,2184,222802,77,309976
5688,0.001525,172.31.40.0-255,66,222868,77,309976
5689,0.001738,172.217.194.0-255,1484,224352,77,309976
5690,0.001743,172.217.194.0-255,1484,225836,77,309976
5691,0.001747,172.31.40.0-255,66,225902,77,309976
5692,0.001775,172.217.194.0-255,1484,227386,77,309976
5693,0.001783,172.217.194.0-255,5738,233124,77,309976
5694,0.001785,172.31.40.0-255,66,233190,77,309976
5695,0.001804,172.217.194.0-255,8574,241764,77,309976
5696,0.001807,172.31.40.0-255,66,241830,77,309976
5697,0.001826,172.217.194.0-255,4320,246150,77,309976
5698,0.001829,172.31.40.0-255,66,246216,77,309976
5699,0.001838,172.217.194.0-255,9992,256208,77,309976
5700,0.001841,172.31.40.0-255,66,256274,77,309976
5701,0.001958,172.217.194.0-255,1484,257758,77,309976
5702,0.001965,172.31.40.0-255,66,257824,77,309976
5703,0.001981,172.217.194.0-255,3602,261426,77,309976
5704,0.002007,172.217.194.0-255,4320,265746,77,309976
5705,0.002015,172.31.40.0-255,66,265812,77,309976
5706,0.002061,172.217.194.0-255,4320,270132,77,309976
5707,0.002071,172.217.194.0-255,9274,279406,77,309976
5708,0.002078,172.217.194.0-255,5738,285144,77,309976
5709,0.002092,172.217.194.0-255,1484,286628,77,309976
5710,0.002095,172.31.40.0-255,66,286694,77,309976
5711,0.004094,172.217.194.0-255,4320,291014,77,309976
5712,0.004103,172.31.40.0-255,66,291080,77,309976
5713,0.006129,172.217.194.0-255,5738,296818,77,309976
5714,0.013496,172.217.194.0-255,1484,298302,77,309976
5715,0.015184,172.31.40.0-255,66,298368,77,309976
5716,0.017213,172.217.194.0-255,5738,304106,77,309976
5717,0.017222,172.31.40.0-255,66,304172,77,309976
5718,0.019262,172.217.194.0-255,5738,309910,77,309976
5719,0.019276,172.31.40.0-255,66,309976,77,309976
5720,0.0,172.31.40.0-255,105,105,77,459
5721,0.000206,172.31.40.0-255,90,195,77,459
5722,0.000217,172.31.40.0-255,66,261,77,459
5723,0.002496,74.125.200.0-255,66,327,77,459
5724,0.002529,74.125.200.0-255,66,393,77,459
5725,0.002551,172.31.40.0-255,66,459,77,459
5726,0.0,172.217.194.0-255,150,150,77,326874
5727,2.4e-05,172.31.40.0-255,66,216,77,326874
5728,3.1e-05,172.217.194.0-255,1484,1700,77,326874
5729,3.7e-05,172.31.40.0-255,66,1766,77,326874
5730,4.3e-05,172.217.194.0-255,2902,4668,77,326874
5731,4.7e-05,172.31.40.0-255,66,4734,77,326874
5732,5.3e-05,172.217.194.0-255,5738,10472,77,326874
5733,5.7e-05,172.31.40.0-255,66,10538,77,326874
5734,0.00014,172.217.194.0-255,4936,15474,77,326874
5735,0.000145,172.31.40.0-255,66,15540,77,326874
5736,0.000152,172.217.194.0-255,5738,21278,77,326874
5737,0.000155,172.31.40.0-255,66,21344,77,326874
5738,0.000164,172.217.194.0-255,9633,30977,77,326874
5739,0.000166,172.31.40.0-255,66,31043,77,326874
5740,0.00035,172.217.194.0-255,1484,32527,77,326874
5741,0.000355,172.31.40.0-255,66,32593,77,326874
5742,0.000362,172.217.194.0-255,2902,35495,77,326874
5743,0.000364,172.31.40.0-255,66,35561,77,326874
5744,0.000371,172.217.194.0-255,5738,41299,77,326874
5745,0.000374,172.31.40.0-255,66,41365,77,326874
5746,0.000402,172.217.194.0-255,8215,49580,77,326874
5747,0.000405,172.31.40.0-255,66,49646,77,326874
5748,0.000411,172.217.194.0-255,4320,53966,77,326874
5749,0.000413,172.31.40.0-255,66,54032,77,326874
5750,0.000427,172.217.194.0-255,4320,58352,77,326874
5751,0.000429,172.31.40.0-255,66,58418,77,326874
5752,0.000449,172.217.194.0-255,6797,65215,77,326874
5753,0.000451,172.31.40.0-255,66,65281,77,326874
5754,0.000699,172.217.194.0-255,646,65927,77,326874
5755,0.000703,172.31.40.0-255,66,65993,77,326874
5756,0.001072,172.217.194.0-255,1484,67477,77,326874
5757,0.001077,172.31.40.0-255,66,67543,77,326874
5758,0.001084,172.217.194.0-255,2902,70445,77,326874
5759,0.001086,172.31.40.0-255,66,70511,77,326874
5760,0.001092,172.217.194.0-255,4320,74831,77,326874
5761,0.001094,172.31.40.0-255,66,74897,77,326874
5762,0.001111,172.217.194.0-255,1484,76381,77,326874
5763,0.001119,172.217.194.0-255,5738,82119,77,326874
5764,0.001122,172.31.40.0-255,66,82185,77,326874
5765,0.001125,172.217.194.0-255,1484,83669,77,326874
5766,0.001157,172.217.194.0-255,11410,95079,77,326874
5767,0.001159,172.31.40.0-255,66,95145,77,326874
5768,0.001167,172.217.194.0-255,4471,99616,77,326874
5769,0.001169,172.31.40.0-255,66,99682,77,326874
5770,0.00125,172.217.194.0-255,1484,101166,77,326874
5771,0.001256,172.217.194.0-255,2902,104068,77,326874
5772,0.001259,172.31.40.0-255,66,104134,77,326874
5773,0.001283,172.217.194.0-255,5738,109872,77,326874
5774,0.001286,172.31.40.0-255,66,109938,77,326874
5775,0.001314,172.217.194.0-255,2902,112840,77,326874
5776,0.001316,172.31.40.0-255,66,112906,77,326874
5777,0.001345,172.217.194.0-255,9992,122898,77,326874
5778,0.001347,172.31.40.0-255,66,122964,77,326874
5779,0.00135,172.217.194.0-255,1484,124448,77,326874
5780,0.001355,172.217.194.0-255,2902,127350,77,326874
5781,0.001357,172.31.40.0-255,66,127416,77,326874
5782,0.00136,172.217.194.0-255,1484,128900,77,326874
5783,0.001413,172.217.194.0-255,2902,131802,77,326874
5784,0.001417,172.31.40.0-255,66,131868,77,326874
5785,0.001436,172.217.194.0-255,2184,134052,77,326874
5786,0.001438,172.31.40.0-255,66,134118,77,326874
5787,0.001467,172.217.194.0-255,4320,138438,77,326874
5788,0.00147,172.31.40.0-255,66,138504,77,326874
5789,0.001477,172.217.194.0-255,5738,144242,77,326874
5790,0.001479,172.31.40.0-255,66,144308,77,326874
5791,0.001482,172.217.194.0-255,1484,145792,77,326874
5792,0.001505,172.217.194.0-255,9992,155784,77,326874
5793,0.001508,172.31.40.0-255,66,155850,77,326874
5794,0.001511,172.217.194.0-255,1484,157334,77,326874
5795,0.001533,172.217.194.0-255,9992,167326,77,326874
5796,0.00161,172.217.194.0-255,2902,170228,77,326874
5797,0.001632,172.217.194.0-255,3602,173830,77,326874
5798,0.001639,172.217.194.0-255,7156,180986,77,326874
5799,0.001659,172.217.194.0-255,5020,186006,77,326874
5800,0.001914,172.217.194.0-255,1484,187490,77,326874
5801,0.001922,172.217.194.0-255,2902,190392,77,326874
5802,0.001938,172.217.194.0-255,1484,191876,77,326874
5803,0.001943,172.217.194.0-255,2902,194778,77,326874
5804,0.001986,172.217.194.0-255,4320,199098,77,326874
5805,0.002011,172.217.194.0-255,5738,204836,77,326874
5806,0.00203,172.217.194.0-255,5738,210574,77,326874
5807,0.002054,172.217.194.0-255,4320,214894,77,326874
5808,0.002066,172.217.194.0-255,2902,217796,77,326874
5809,0.00207,172.217.194.0-255,1484,219280,77,326874
5810,0.002084,172.217.194.0-255,766,220046,77,326874
5811,0.002282,172.217.194.0-255,1484,221530,77,326874
5812,0.002298,172.217.194.0-255,2902,224432,77,326874
5813,0.002309,172.217.194.0-255,1484,225916,77,326874
5814,0.002322,172.217.194.0-255,4320,230236,77,326874
5815,0.002345,172.217.194.0-255,7156,237392,77,326874
5816,0.00237,172.217.194.0-255,2902,240294,77,326874
5817,0.0024,172.217.194.0-255,2902,243196,77,326874
5818,0.002417,172.217.194.0-255,8574,251770,77,326874
5819,0.002435,172.217.194.0-255,2184,253954,77,326874
5820,0.002554,172.217.194.0-255,1484,255438,77,326874
5821,0.002572,172.217.194.0-255,2902,258340,77,326874
5822,0.002577,172.217.194.0-255,2902,261242,77,326874
5823,0.002594,172.217.194.0-255,2902,264144,77,326874
5824,0.002609,172.217.194.0-255,5738,269882,77,326874
5825,0.002625,172.217.194.0-255,2902,272784,77,326874
5826,0.002645,172.217.194.0-255,1484,274268,77,326874
5827,0.002664,172.217.194.0-255,9992,284260,77,326874
5828,0.002675,172.217.194.0-255,3602,287862,77,326874
5829,0.002689,172.217.194.0-255,5738,293600,77,326874
5830,0.002714,172.217.194.0-255,9992,303592,77,326874
5831,0.008201,172.31.40.0-255,66,303658,77,326874
5832,0.010852,172.217.194.0-255,5738,309396,77,326874
5833,0.010865,172.31.40.0-255,66,309462,77,326874
5834,0.013509,172.217.194.0-255,5738,315200,77,326874
5835,0.013516,172.31.40.0-255,66,315266,77,326874
5836,0.016158,172.217.194.0-255,5738,321004,77,326874
5837,0.016178,172.31.40.0-255,66,321070,77,326874
5838,0.018821,172.217.194.0-255,5738,326808,77,326874
5839,0.018839,172.31.40.0-255,66,326874,77,326874
5840,0.0,172.217.194.0-255,150,150,77,368132
5841,2.2e-05,172.31.40.0-255,66,216,77,368132
5842,2.9e-05,172.217.194.0-255,1484,1700,77,368132
5843,3.4e-05,172.31.40.0-255,66,1766,77,368132
5844,3.9e-05,172.217.194.0-255,2902,4668,77,368132
5845,5e-05,172.31.40.0-255,66,4734,77,368132
5846,5.8e-05,172.217.194.0-255,7156,11890,77,368132
5847,6.1e-05,172.31.40.0-255,66,11956,77,368132
5848,6.6e-05,172.217.194.0-255,2070,14026,77,368132
5849,6.9e-05,172.31.40.0-255,66,14092,77,368132
5850,7.6e-05,172.217.194.0-255,4320,18412,77,368132
5851,7.9e-05,172.31.40.0-255,66,18478,77,368132
5852,0.000103,172.217.194.0-255,7156,25634,77,368132
5853,0.000106,172.31.40.0-255,66,25700,77,368132
5854,0.000117,172.217.194.0-255,5379,31079,77,368132
5855,0.000119,172.31.40.0-255,66,31145,77,368132
5856,0.000169,172.217.194.0-255,1484,32629,77,368132
5857,0.000172,172.31.40.0-255,66,32695,77,368132
5858,0.000178,172.217.194.0-255,2902,35597,77,368132
5859,0.00018,172.31.40.0-255,66,35663,77,368132
5860,0.000183,172.217.194.0-255,1484,37147,77,368132
5861,0.000185,172.31.40.0-255,66,37213,77,368132
5862,0.000214,172.217.194.0-255,4320,41533,77,368132
5863,0.000217,172.31.40.0-255,66,41599,77,368132
5864,0.000225,172.217.194.0-255,6797,48396,77,368132
5865,0.000227,172.31.40.0-255,66,48462,77,368132
5866,0.000239,172.217.194.0-255,7156,55618,77,368132
5867,0.000241,172.31.40.0-255,66,55684,77,368132
5868,0.00029,172.217.194.0-255,9885,65569,77,368132
5869,0.000293,172.31.40.0-255,66,65635,77,368132
5870,0.000361,172.217.194.0-255,118,65753,77,368132
5871,0.000365,172.31.40.0-255,66,65819,77,368132
5872,0.000393,172.217.194.0-255,382,66201,77,368132
5873,0.000908,172.217.194.0-255,1484,67685,77,368132
5874,0.000914,172.31.40.0-255,66,67751,77,368132
5875,0.000919,172.217.194.0-255,2902,70653,77,368132
5876,0.000921,172.31.40.0-255,66,70719,77,368132
5877,0.000959,172.217.194.0-255,5738,76457,77,368132
5878,0.000961,172.31.40.0-255,66,76523,77,368132
5879,0.000971,172.217.194.0-255,8574,85097,77,368132
5880,0.000993,172.217.194.0-255,4320,89417,77,368132
5881,0.001005,172.31.40.0-255,66,89483,77,368132
5882,0.001023,172.217.194.0-255,5738,95221,77,368132
5883,0.001046,172.217.194.0-255,5020,100241,77,368132
5884,0.001051,172.31.40.0-255,66,100307,77,368132
5885,0.001065,172.217.194.0-255,5738,106045,77,368132
5886,0.001086,172.217.194.0-255,5738,111783,77,368132
5887,0.001097,172.217.194.0-255,12828,124611,77,368132
5888,0.001121,172.217.194.0-255,1484,126095,77,368132
5889,0.001124,172.31.40.0-255,66,126161,77,368132
5890,0.001135,172.217.194.0-255,5738,131899,77,368132
5891,0.001142,172.31.40.0-255,66,131965,77,368132
5892,0.001164,172.217.194.0-255,9274,141239,77,368132
5893,0.001175,172.217.194.0-255,12828,154067,77,368132
5894,0.00121,172.31.40.0-255,66,154133,77,368132
5895,0.001216,172.217.194.0-255,4320,158453,77,368132
5896,0.001227,172.217.194.0-255,12110,170563,77,368132
5897,0.001258,172.31.40.0-255,66,170629,77,368132
5898,0.001286,172.217.194.0-255,8574,179203,77,368132
5899,0.00129,172.217.194.0-255,217,179420,77,368132
5900,0.001299,172.31.40.0-255,66,179486,77,368132
5901,0.00134,172.217.194.0-255,1484,180970,77,368132
5902,0.001344,172.217.194.0-255,2902,183872,77,368132
5903,0.001363,172.217.194.0-255,5738,189610,77,368132
5904,0.001371,172.217.194.0-255,5738,195348,77,368132
5905,0.001376,172.31.40.0-255,66,195414,77,368132
5906,0.001384,172.217.194.0-255,2902,198316,77,368132
5907,0.001389,172.31.40.0-255,66,198382,77,368132
5908,0.001418,172.217.194.0-255,9992,208374,77,368132
5909,0.001425,172.217.194.0-255,5020,213394,77,368132
5910,0.001481,172.31.40.0-255,66,213460,77,368132
5911,0.001774,172.217.194.0-255,1484,214944,77,368132
5912,0.00178,172.217.194.0-255,2902,217846,77,368132
5913,0.001802,172.217.194.0-255,5738,223584,77,368132
5914,0.001814,172.31.40.0-255,66,223650,77,368132
5915,0.001824,172.217.194.0-255,4320,227970,77,368132
5916,0.001829,172.31.40.0-255,66,228036,77,368132
5917,0.001847,172.217.194.0-255,2902,230938,77,368132
5918,0.001865,172.217.194.0-255,8574,239512,77,368132
5919,0.001886,172.217.194.0-255,7856,247368,77,368132
5920,0.001905,172.31.40.0-255,66,247434,77,368132
5921,0.001945,172.217.194.0-255,1484,248918,77,368132
5922,0.00195,172.217.194.0-255,2902,251820,77,368132
5923,0.001955,172.31.40.0-255,66,251886,77,368132
5924,0.00197,172.217.194.0-255,5738,257624,77,368132
5925,0.00198,172.217.194.0-255,4320,261944,77,368132
5926,0.001994,172.217.194.0-255,1484,263428,77,368132
5927,0.002001,172.31.40.0-255,66,263494,77,368132
5928,0.00203,172.217.194.0-255,12828,276322,77,368132
5929,0.002036,172.217.194.0-255,5020,281342,77,368132
5930,0.002053,172.31.40.0-255,66,281408,77,368132
5931,0.002107,172.217.194.0-255,1484,282892,77,368132
5932,0.002112,172.217.194.0-255,2902,285794,77,368132
5933,0.002117,172.31.40.0-255,66,285860,77,368132
5934,0.00213,172.217.194.0-255,1484,287344,77,368132
5935,0.002155,172.217.194.0-255,4320,291664,77,368132
5936,0.002158,172.217.194.0-255,1484,293148,77,368132
5937,0.002184,172.217.194.0-255,11410,304558,77,368132
5938,0.002193,172.217.194.0-255,8574,313132,77,368132
5939,0.002211,172.217.194.0-255,2184,315316,77,368132
5940,0.002216,172.31.40.0-255,66,315382,77,368132
5941,0.002221,172.31.40.0-255,66,315448,77,368132
5942,0.002251,172.217.194.0-255,7156,322604,77,368132
5943,0.002258,172.31.40.0-255,66,322670,77,368132
5944,0.002273,172.217.194.0-255,8574,331244,77,368132
5945,0.002287,172.217.194.0-255,12828,344072,77,368132
5946,0.00231,172.217.194.0-255,4320,348392,77,368132
5947,0.002321,172.217.194.0-255,12110,360502,77,368132
5948,0.002327,172.31.40.0-255,66,360568,77,368132
5949,0.002353,172.217.194.0-255,7156,367724,77,368132
5950,0.002364,172.31.40.0-255,66,367790,77,368132
5951,0.002396,172.217.194.0-255,105,367895,77,368132
5952,0.002416,172.31.40.0-255,66,367961,77,368132
5953,0.004639,172.31.40.0-255,105,368066,77,368132
5954,0.007194,172.217.194.0-255,66,368132,77,368132
5955,0.0,216.58.203.0-255,152,152,77,244097
5956,1.5e-05,172.31.40.0-255,66,218,77,244097
5957,2.1e-05,216.58.203.0-255,1484,1702,77,244097
5958,2.6e-05,172.31.40.0-255,66,1768,77,244097
5959,3.1e-05,216.58.203.0-255,2902,4670,77,244097
5960,3.4e-05,172.31.40.0-255,66,4736,77,244097
5961,3.6e-05,216.58.203.0-255,1484,6220,77,244097
5962,3.9e-05,172.31.40.0-255,66,6286,77,244097
5963,7.4e-05,216.58.203.0-255,1484,7770,77,244097
5964,7.7e-05,172.31.40.0-255,66,7836,77,244097
5965,8.2e-05,216.58.203.0-255,4320,12156,77,244097
5966,8.5e-05,172.31.40.0-255,66,12222,77,244097
5967,0.000111,216.58.203.0-255,4320,16542,77,244097
5968,0.000114,172.31.40.0-255,66,16608,77,244097
5969,0.000134,216.58.203.0-255,4900,21508,77,244097
5970,0.000137,172.31.40.0-255,66,21574,77,244097
5971,0.000142,216.58.203.0-255,4320,25894,77,244097
5972,0.000144,172.31.40.0-255,66,25960,77,244097
5973,0.00017,216.58.203.0-255,5379,31339,77,244097
5974,0.000173,172.31.40.0-255,66,31405,77,244097
5975,0.000409,216.58.203.0-255,1484,32889,77,244097
5976,0.000415,172.31.40.0-255,66,32955,77,244097
5977,0.000422,216.58.203.0-255,2902,35857,77,244097
5978,0.000424,172.31.40.0-255,66,35923,77,244097
5979,0.000443,216.58.203.0-255,2902,38825,77,244097
5980,0.000446,172.31.40.0-255,66,38891,77,244097
5981,0.000463,216.58.203.0-255,2902,41793,77,244097
5982,0.000465,172.31.40.0-255,66,41859,77,244097
5983,0.000472,216.58.203.0-255,4320,46179,77,244097
5984,0.000474,172.31.40.0-255,66,46245,77,244097
5985,0.000479,216.58.203.0-255,2543,48788,77,244097
5986,0.000482,172.31.40.0-255,66,48854,77,244097
5987,0.000485,216.58.203.0-255,1484,50338,77,244097
5988,0.000502,216.58.203.0-255,1484,51822,77,244097
5989,0.000519,216.58.203.0-255,2902,54724,77,244097
5990,0.000546,216.58.203.0-255,4320,59044,77,244097
5991,0.000617,216.58.203.0-255,5738,64782,77,244097
5992,0.000629,216.58.203.0-255,1419,66201,77,244097
5993,0.000692,172.31.40.0-255,66,66267,77,244097
5994,0.000805,216.58.203.0-255,382,66649,77,244097
5995,0.000922,216.58.203.0-255,1484,68133,77,244097
5996,0.000933,172.31.40.0-255,66,68199,77,244097
5997,0.00095,216.58.203.0-255,2902,71101,77,244097
5998,0.000955,216.58.203.0-255,2902,74003,77,244097
5999,0.000971,172.31.40.0-255,66,74069,77,244097
6000,0.000977,216.58.203.0-255,2902,76971,77,244097
6001,0.000982,172.31.40.0-255,66,77037,77,244097
6002,0.001035,216.58.203.0-255,1484,78521,77,244097
6003,0.001054,216.58.203.0-255,4320,82841,77,244097
6004,0.001073,216.58.203.0-255,4320,87161,77,244097
6005,0.001087,216.58.203.0-255,3961,91122,77,244097
6006,0.00109,216.58.203.0-255,1484,92606,77,244097
6007,0.001103,172.31.40.0-255,66,92672,77,244097
6008,0.001109,216.58.203.0-255,4320,96992,77,244097
6009,0.001114,172.31.40.0-255,66,97058,77,244097
6010,0.001121,216.58.203.0-255,1484,98542,77,244097
6011,0.001153,216.58.203.0-255,2543,101085,77,244097
6012,0.001177,172.31.40.0-255,66,101151,77,244097
6013,0.001615,216.58.203.0-255,1484,102635,77,244097
6014,0.001622,216.58.203.0-255,2902,105537,77,244097
6015,0.001625,172.31.40.0-255,66,105603,77,244097
6016,0.001651,216.58.203.0-255,5738,111341,77,244097
6017,0.001654,172.31.40.0-255,66,111407,77,244097
6018,0.001681,216.58.203.0-255,9992,121399,77,244097
6019,0.001693,172.31.40.0-255,66,121465,77,244097
6020,0.001714,216.58.203.0-255,1484,122949,77,244097
6021,0.001722,216.58.203.0-255,7156,130105,77,244097
6022,0.001739,216.58.203.0-255,2902,133007,77,244097
6023,0.001751,216.58.203.0-255,2184,135191,77,244097
6024,0.001754,172.31.40.0-255,66,135257,77,244097
6025,0.001758,172.31.40.0-255,66,135323,77,244097
6026,0.001766,216.58.203.0-255,1484,136807,77,244097
6027,0.00177,216.58.203.0-255,2902,139709,77,244097
6028,0.00179,216.58.203.0-255,5738,145447,77,244097
6029,0.001798,216.58.203.0-255,7156,152603,77,244097
6030,0.001815,216.58.203.0-255,5738,158341,77,244097
6031,0.001818,172.31.40.0-255,66,158407,77,244097
6032,0.001823,172.31.40.0-255,66,158473,77,244097
6033,0.00184,216.58.203.0-255,4320,162793,77,244097
6034,0.001852,172.31.40.0-255,66,162859,77,244097
6035,0.001864,216.58.203.0-255,6438,169297,77,244097
6036,0.001867,216.58.203.0-255,1484,170781,77,244097
6037,0.00187,216.58.203.0-255,1484,172265,77,244097
6038,0.001875,216.58.203.0-255,2902,175167,77,244097
6039,0.00188,216.58.203.0-255,4320,179487,77,244097
6040,0.001884,172.31.40.0-255,66,179553,77,244097
6041,0.001894,216.58.203.0-255,1484,181037,77,244097
6042,0.001899,216.58.203.0-255,2902,183939,77,244097
6043,0.001904,216.58.203.0-255,4320,188259,77,244097
6044,0.00191,216.58.203.0-255,5738,193997,77,244097
6045,0.001923,216.58.203.0-255,2902,196899,77,244097
6046,0.001927,216.58.203.0-255,2902,199801,77,244097
6047,0.001945,216.58.203.0-255,3602,203403,77,244097
6048,0.001953,172.31.40.0-255,66,203469,77,244097
6049,0.003635,216.58.203.0-255,5738,209207,77,244097
6050,0.003643,172.31.40.0-255,66,209273,77,244097
6051,0.005319,216.58.203.0-255,5738,215011,77,244097
6052,0.008708,172.31.40.0-255,66,215077,77,244097
6053,0.010385,216.58.203.0-255,5738,220815,77,244097
6054,0.010393,172.31.40.0-255,66,220881,77,244097
6055,0.012069,216.58.203.0-255,5738,226619,77,244097
6056,0.014229,172.31.40.0-255,66,226685,77,244097
6057,0.015904,216.58.203.0-255,5738,232423,77,244097
6058,0.015916,172.31.40.0-255,66,232489,77,244097
6059,0.017594,216.58.203.0-255,5738,238227,77,244097
6060,0.017604,172.31.40.0-255,66,238293,77,244097
6061,0.019284,216.58.203.0-255,5738,244031,77,244097
6062,0.019292,172.31.40.0-255,66,244097,77,244097
6063,0.0,172.253.118.0-255,150,150,77,392830
6064,1.7e-05,172.31.40.0-255,66,216,77,392830
6065,2.3e-05,172.253.118.0-255,1484,1700,77,392830
6066,2.8e-05,172.31.40.0-255,66,1766,77,392830
6067,3.4e-05,172.253.118.0-255,2902,4668,77,392830
6068,3.7e-05,172.31.40.0-255,66,4734,77,392830
6069,4.5e-05,172.253.118.0-255,7156,11890,77,392830
6070,4.8e-05,172.31.40.0-255,66,11956,77,392830
6071,5.1e-05,172.253.118.0-255,1484,13440,77,392830
6072,5.3e-05,172.31.40.0-255,66,13506,77,392830
6073,8e-05,172.253.118.0-255,1986,15492,77,392830
6074,8.2e-05,172.31.40.0-255,66,15558,77,392830
6075,9.1e-05,172.253.118.0-255,8574,24132,77,392830
6076,9.4e-05,172.31.40.0-255,66,24198,77,392830
6077,0.000113,172.253.118.0-255,4320,28518,77,392830
6078,0.000116,172.31.40.0-255,66,28584,77,392830
6079,0.00012,172.253.118.0-255,2543,31127,77,392830
6080,0.000122,172.31.40.0-255,66,31193,77,392830
6081,0.000355,172.253.118.0-255,1484,32677,77,392830
6082,0.000361,172.31.40.0-255,66,32743,77,392830
6083,0.000365,172.253.118.0-255,2902,35645,77,392830
6084,0.000367,172.31.40.0-255,66,35711,77,392830
6085,0.000372,172.253.118.0-255,5738,41449,77,392830
6086,0.000374,172.31.40.0-255,66,41515,77,392830
6087,0.000413,172.253.118.0-255,8574,50089,77,392830
6088,0.000416,172.31.40.0-255,66,50155,77,392830
6089,0.000431,172.253.118.0-255,3961,54116,77,392830
6090,0.000433,172.31.40.0-255,66,54182,77,392830
6091,0.000448,172.253.118.0-255,4320,58502,77,392830
6092,0.000451,172.31.40.0-255,66,58568,77,392830
6093,0.00047,172.253.118.0-255,7108,65676,77,392830
6094,0.000472,172.31.40.0-255,66,65742,77,392830
6095,0.000661,172.253.118.0-255,109,65851,77,392830
6096,0.000676,172.253.118.0-255,332,66183,77,392830
6097,0.000902,172.31.40.0-255,66,66249,77,392830
6098,0.001129,172.253.118.0-255,1484,67733,77,392830
6099,0.001136,172.253.118.0-255,1484,69217,77,392830
6100,0.001139,172.31.40.0-255,66,69283,77,392830
6101,0.001157,172.253.118.0-255,1484,70767,77,392830
6102,0.001164,172.253.118.0-255,5738,76505,77,392830
6103,0.001166,172.31.40.0-255,66,76571,77,392830
6104,0.001214,172.253.118.0-255,12828,89399,77,392830
6105,0.001217,172.31.40.0-255,66,89465,77,392830
6106,0.001243,172.253.118.0-255,4320,93785,77,392830
6107,0.001245,172.31.40.0-255,66,93851,77,392830
6108,0.001269,172.253.118.0-255,6438,100289,77,392830
6109,0.001271,172.31.40.0-255,66,100355,77,392830
6110,0.001455,172.253.118.0-255,1484,101839,77,392830
6111,0.001461,172.253.118.0-255,2902,104741,77,392830
6112,0.001464,172.31.40.0-255,66,104807,77,392830
6113,0.00147,172.253.118.0-255,5738,110545,77,392830
6114,0.001472,172.31.40.0-255,66,110611,77,392830
6115,0.001486,172.253.118.0-255,4320,114931,77,392830
6116,0.001488,172.31.40.0-255,66,114997,77,392830
6117,0.001504,172.253.118.0-255,8574,123571,77,392830
6118,0.001506,172.31.40.0-255,66,123637,77,392830
6119,0.001511,172.253.118.0-255,5738,129375,77,392830
6120,0.001513,172.31.40.0-255,66,129441,77,392830
6121,0.001526,172.253.118.0-255,5020,134461,77,392830
6122,0.001528,172.31.40.0-255,66,134527,77,392830
6123,0.001586,172.253.118.0-255,1484,136011,77,392830
6124,0.001602,172.253.118.0-255,2902,138913,77,392830
6125,0.001606,172.31.40.0-255,66,138979,77,392830
6126,0.001611,172.253.118.0-255,5738,144717,77,392830
6127,0.001613,172.31.40.0-255,66,144783,77,392830
6128,0.001631,172.253.118.0-255,2902,147685,77,392830
6129,0.001634,172.31.40.0-255,66,147751,77,392830
6130,0.001655,172.253.118.0-255,9992,157743,77,392830
6131,0.001658,172.31.40.0-255,66,157809,77,392830
6132,0.001665,172.253.118.0-255,8574,166383,77,392830
6133,0.001667,172.31.40.0-255,66,166449,77,392830
6134,0.001683,172.253.118.0-255,2184,168633,77,392830
6135,0.001685,172.31.40.0-255,66,168699,77,392830
6136,0.001717,172.253.118.0-255,1484,170183,77,392830
6137,0.001721,172.253.118.0-255,2902,173085,77,392830
6138,0.001724,172.31.40.0-255,66,173151,77,392830
6139,0.001745,172.253.118.0-255,5738,178889,77,392830
6140,0.001747,172.31.40.0-255,66,178955,77,392830
6141,0.001768,172.253.118.0-255,8574,187529,77,392830
6142,0.00177,172.31.40.0-255,66,187595,77,392830
6143,0.001785,172.253.118.0-255,4320,191915,77,392830
6144,0.001787,172.31.40.0-255,66,191981,77,392830
6145,0.001813,172.253.118.0-255,5738,197719,77,392830
6146,0.001815,172.31.40.0-255,66,197785,77,392830
6147,0.001835,172.253.118.0-255,5020,202805,77,392830
6148,0.001836,172.31.40.0-255,66,202871,77,392830
6149,0.001962,172.253.118.0-255,1484,204355,77,392830
6150,0.001972,172.253.118.0-255,2902,207257,77,392830
6151,0.001974,172.31.40.0-255,66,207323,77,392830
6152,0.001994,172.253.118.0-255,4320,211643,77,392830
6153,0.001996,172.31.40.0-255,66,211709,77,392830
6154,0.002012,172.253.118.0-255,1484,213193,77,392830
6155,0.002016,172.253.118.0-255,2902,216095,77,392830
6156,0.002018,172.31.40.0-255,66,216161,77,392830
6157,0.002041,172.253.118.0-255,9992,226153,77,392830
6158,0.002067,172.253.118.0-255,2902,229055,77,392830
6159,0.002086,172.253.118.0-255,7856,236911,77,392830
6160,0.002646,172.253.118.0-255,1484,238395,77,392830
6161,0.002658,172.253.118.0-255,2902,241297,77,392830
6162,0.00266,172.253.118.0-255,1484,242781,77,392830
6163,0.002673,172.253.118.0-255,1484,244265,77,392830
6164,0.002697,172.253.118.0-255,4320,248585,77,392830
6165,0.002715,172.253.118.0-255,2902,251487,77,392830
6166,0.00274,172.253.118.0-255,7156,258643,77,392830
6167,0.002753,172.253.118.0-255,2902,261545,77,392830
6168,0.002803,172.253.118.0-255,9274,270819,77,392830
6169,0.002921,172.253.118.0-255,1484,272303,77,392830
6170,0.002926,172.253.118.0-255,2902,275205,77,392830
6171,0.00294,172.253.118.0-255,1484,276689,77,392830
6172,0.002965,172.253.118.0-255,4320,281009,77,392830
6173,0.002978,172.253.118.0-255,4320,285329,77,392830
6174,0.00298,172.253.118.0-255,1484,286813,77,392830
6175,0.002984,172.253.118.0-255,2902,289715,77,392830
6176,0.003019,172.253.118.0-255,1484,291199,77,392830
6177,0.00304,172.253.118.0-255,4320,295519,77,392830
6178,0.003066,172.253.118.0-255,9274,304793,77,392830
6179,0.003072,172.253.118.0-255,7156,311949,77,392830
6180,0.003076,172.253.118.0-255,4320,316269,77,392830
6181,0.003096,172.253.118.0-255,8574,324843,77,392830
6182,0.003114,172.253.118.0-255,1484,326327,77,392830
6183,0.003116,172.253.118.0-255,1484,327811,77,392830
6184,0.003129,172.253.118.0-255,4320,332131,77,392830
6185,0.00314,172.253.118.0-255,1484,333615,77,392830
6186,0.003155,172.253.118.0-255,5020,338635,77,392830
6187,0.00316,172.253.118.0-255,5738,344373,77,392830
6188,0.003167,172.253.118.0-255,7156,351529,77,392830
6189,0.003186,172.253.118.0-255,2902,354431,77,392830
6190,0.00319,172.253.118.0-255,2902,357333,77,392830
6191,0.003216,172.253.118.0-255,11410,368743,77,392830
6192,0.003245,172.253.118.0-255,2902,371645,77,392830
6193,0.003249,172.253.118.0-255,3602,375247,77,392830
6194,0.003272,172.253.118.0-255,7856,383103,77,392830
6195,0.003291,172.253.118.0-255,5738,388841,77,392830
6196,0.003305,172.253.118.0-255,3647,392488,77,392830
6197,0.003308,172.253.118.0-255,105,392593,77,392830
6198,0.006617,172.31.40.0-255,66,392659,77,392830
6199,0.008925,172.31.40.0-255,105,392764,77,392830
6200,0.011409,172.253.118.0-255,66,392830,77,392830
6201,0.0,172.217.194.0-255,295,295,77,399781
6202,2.4e-05,172.31.40.0-255,66,361,77,399781
6203,3.1e-05,172.217.194.0-255,1484,1845,77,399781
6204,3.5e-05,172.31.40.0-255,66,1911,77,399781
6205,4.2e-05,172.217.194.0-255,4320,6231,77,399781
6206,4.5e-05,172.31.40.0-255,66,6297,77,399781
6207,5.5e-05,172.217.194.0-255,8802,15099,77,399781
6208,5.7e-05,172.31.40.0-255,66,15165,77,399781
6209,6.2e-05,172.217.194.0-255,2902,18067,77,399781
6210,6.6e-05,172.31.40.0-255,66,18133,77,399781
6211,0.000104,172.217.194.0-255,11410,29543,77,399781
6212,0.000106,172.31.40.0-255,66,29609,77,399781
6213,0.000109,172.217.194.0-255,1125,30734,77,399781
6214,0.000111,172.31.40.0-255,66,30800,77,399781
6215,0.000115,172.217.194.0-255,1484,32284,77,399781
6216,0.000117,172.31.40.0-255,66,32350,77,399781
6217,0.000138,172.217.194.0-255,4320,36670,77,399781
6218,0.000141,172.31.40.0-255,66,36736,77,399781
6219,0.000148,172.217.194.0-255,5738,42474,77,399781
6220,0.00015,172.31.40.0-255,66,42540,77,399781
6221,0.00017,172.217.194.0-255,4320,46860,77,399781
6222,0.000172,172.31.40.0-255,66,46926,77,399781
6223,0.000179,172.217.194.0-255,6797,53723,77,399781
6224,0.000182,172.31.40.0-255,66,53789,77,399781
6225,0.000227,172.217.194.0-255,7156,60945,77,399781
6226,0.00023,172.31.40.0-255,66,61011,77,399781
6227,0.000271,172.217.194.0-255,4274,65285,77,399781
6228,0.000274,172.31.40.0-255,66,65351,77,399781
6229,0.000277,172.217.194.0-255,396,65747,77,399781
6230,0.000279,172.31.40.0-255,66,65813,77,399781
6231,0.000474,172.217.194.0-255,1484,67297,77,399781
6232,0.000478,172.31.40.0-255,66,67363,77,399781
6233,0.000484,172.217.194.0-255,2902,70265,77,399781
6234,0.000487,172.31.40.0-255,66,70331,77,399781
6235,0.000493,172.217.194.0-255,5738,76069,77,399781
6236,0.000496,172.31.40.0-255,66,76135,77,399781
6237,0.000527,172.217.194.0-255,12828,88963,77,399781
6238,0.00053,172.31.40.0-255,66,89029,77,399781
6239,0.000537,172.217.194.0-255,8574,97603,77,399781
6240,0.00054,172.31.40.0-255,66,97669,77,399781
6241,0.000571,172.217.194.0-255,2184,99853,77,399781
6242,0.000573,172.31.40.0-255,66,99919,77,399781
6243,0.000696,172.217.194.0-255,1484,101403,77,399781
6244,0.000703,172.217.194.0-255,2902,104305,77,399781
6245,0.000707,172.31.40.0-255,66,104371,77,399781
6246,0.000712,172.217.194.0-255,4320,108691,77,399781
6247,0.000715,172.31.40.0-255,66,108757,77,399781
6248,0.000733,172.217.194.0-255,1484,110241,77,399781
6249,0.00074,172.217.194.0-255,7156,117397,77,399781
6250,0.000743,172.31.40.0-255,66,117463,77,399781
6251,0.00075,172.217.194.0-255,5738,123201,77,399781
6252,0.000752,172.31.40.0-255,66,123267,77,399781
6253,0.000777,172.217.194.0-255,8574,131841,77,399781
6254,0.00078,172.31.40.0-255,66,131907,77,399781
6255,0.000784,172.217.194.0-255,2184,134091,77,399781
6256,0.000786,172.31.40.0-255,66,134157,77,399781
6257,0.000841,172.217.194.0-255,1484,135641,77,399781
6258,0.000847,172.217.194.0-255,2902,138543,77,399781
6259,0.00085,172.31.40.0-255,66,138609,77,399781
6260,0.000856,172.217.194.0-255,5738,144347,77,399781
6261,0.000858,172.31.40.0-255,66,144413,77,399781
6262,0.00087,172.217.194.0-255,1484,145897,77,399781
6263,0.000896,172.217.194.0-255,11410,157307,77,399781
6264,0.000899,172.31.40.0-255,66,157373,77,399781
6265,0.000908,172.217.194.0-255,9992,167365,77,399781
6266,0.00091,172.31.40.0-255,66,167431,77,399781
6267,0.000958,172.217.194.0-255,766,168197,77,399781
6268,0.000984,172.217.194.0-255,1484,169681,77,399781
6269,0.000987,172.217.194.0-255,1484,171165,77,399781
6270,0.000997,172.217.194.0-255,1484,172649,77,399781
6271,0.001001,172.31.40.0-255,66,172715,77,399781
6272,0.001005,172.31.40.0-255,66,172781,77,399781
6273,0.001025,172.217.194.0-255,5738,178519,77,399781
6274,0.001027,172.31.40.0-255,66,178585,77,399781
6275,0.001033,172.217.194.0-255,4320,182905,77,399781
6276,0.001034,172.31.40.0-255,66,182971,77,399781
6277,0.001058,172.217.194.0-255,8574,191545,77,399781
6278,0.001061,172.31.40.0-255,66,191611,77,399781
6279,0.001067,172.217.194.0-255,5738,197349,77,399781
6280,0.00107,172.31.40.0-255,66,197415,77,399781
6281,0.001091,172.217.194.0-255,1484,198899,77,399781
6282,0.001123,172.217.194.0-255,3602,202501,77,399781
6283,0.001126,172.31.40.0-255,66,202567,77,399781
6284,0.001149,172.217.194.0-255,4320,206887,77,399781
6285,0.001152,172.31.40.0-255,66,206953,77,399781
6286,0.001159,172.217.194.0-255,5738,212691,77,399781
6287,0.001162,172.31.40.0-255,66,212757,77,399781
6288,0.001175,172.217.194.0-255,4320,217077,77,399781
6289,0.001178,172.31.40.0-255,66,217143,77,399781
6290,0.001196,172.217.194.0-255,8574,225717,77,399781
6291,0.001199,172.31.40.0-255,66,225783,77,399781
6292,0.001232,172.217.194.0-255,8574,234357,77,399781
6293,0.001235,172.31.40.0-255,66,234423,77,399781
6294,0.001239,172.217.194.0-255,2184,236607,77,399781
6295,0.001242,172.31.40.0-255,66,236673,77,399781
6296,0.001246,172.217.194.0-255,2902,239575,77,399781
6297,0.001248,172.31.40.0-255,66,239641,77,399781
6298,0.001254,172.217.194.0-255,7156,246797,77,399781
6299,0.001257,172.31.40.0-255,66,246863,77,399781
6300,0.00127,172.217.194.0-255,8574,255437,77,399781
6301,0.001273,172.31.40.0-255,66,255503,77,399781
6302,0.001291,172.217.194.0-255,7156,262659,77,399781
6303,0.001294,172.31.40.0-255,66,262725,77,399781
6304,0.001297,172.217.194.0-255,1484,264209,77,399781
6305,0.001329,172.217.194.0-255,9274,273483,77,399781
6306,0.001333,172.31.40.0-255,66,273549,77,399781
6307,0.001339,172.217.194.0-255,5738,279287,77,399781
6308,0.001341,172.31.40.0-255,66,279353,77,399781
6309,0.001358,172.217.194.0-255,5738,285091,77,399781
6310,0.00136,172.31.40.0-255,66,285157,77,399781
6311,0.001363,172.217.194.0-255,1484,286641,77,399781
6312,0.0014,172.31.40.0-255,66,286707,77,399781
6313,0.001414,172.217.194.0-255,3602,290309,77,399781
6314,0.001417,172.31.40.0-255,66,290375,77,399781
6315,0.001449,172.217.194.0-255,1484,291859,77,399781
6316,0.001454,172.217.194.0-255,2902,294761,77,399781
6317,0.001457,172.31.40.0-255,66,294827,77,399781
6318,0.001464,172.217.194.0-255,5738,300565,77,399781
6319,0.001467,172.31.40.0-255,66,300631,77,399781
6320,0.001473,172.217.194.0-255,5738,306369,77,399781
6321,0.001475,172.31.40.0-255,66,306435,77,399781
6322,0.001502,172.217.194.0-255,12828,319263,77,399781
6323,0.001506,172.31.40.0-255,66,319329,77,399781
6324,0.001511,172.217.194.0-255,4320,323649,77,399781
6325,0.001513,172.31.40.0-255,66,323715,77,399781
6326,0.001527,172.217.194.0-255,766,324481,77,399781
6327,0.001559,172.217.194.0-255,1484,325965,77,399781
6328,0.001562,172.31.40.0-255,66,326031,77,399781
6329,0.001567,172.217.194.0-255,2902,328933,77,399781
6330,0.00157,172.31.40.0-255,66,328999,77,399781
6331,0.001575,172.217.194.0-255,4320,333319,77,399781
6332,0.001577,172.31.40.0-255,66,333385,77,399781
6333,0.001606,172.217.194.0-255,1484,334869,77,399781
6334,0.001618,172.217.194.0-255,12828,347697,77,399781
6335,0.001621,172.31.40.0-255,66,347763,77,399781
6336,0.00163,172.217.194.0-255,9992,357755,77,399781
6337,0.001633,172.31.40.0-255,66,357821,77,399781
6338,0.001683,172.217.194.0-255,2184,360005,77,399781
6339,0.001686,172.31.40.0-255,66,360071,77,399781
6340,0.001689,172.217.194.0-255,2902,362973,77,399781
6341,0.001692,172.31.40.0-255,66,363039,77,399781
6342,0.001699,172.217.194.0-255,7156,370195,77,399781
6343,0.001701,172.31.40.0-255,66,370261,77,399781
6344,0.00171,172.217.194.0-255,8574,378835,77,399781
6345,0.001712,172.31.40.0-255,66,378901,77,399781
6346,0.001741,172.217.194.0-255,7156,386057,77,399781
6347,0.001744,172.31.40.0-255,66,386123,77,399781
6348,0.001751,172.217.194.0-255,6438,392561,77,399781
6349,0.001754,172.31.40.0-255,66,392627,77,399781
6350,0.001759,172.217.194.0-255,4320,396947,77,399781
6351,0.001761,172.31.40.0-255,66,397013,77,399781
6352,0.001785,172.217.194.0-255,2360,399373,77,399781
6353,0.001787,172.31.40.0-255,66,399439,77,399781
6354,0.00179,172.217.194.0-255,105,399544,77,399781
6355,0.004464,172.31.40.0-255,66,399610,77,399781
6356,0.004497,172.31.40.0-255,105,399715,77,399781
6357,0.006466,172.217.194.0-255,66,399781,77,399781
6358,0.0,172.217.194.0-255,153,153,77,242841
6359,1.5e-05,172.31.40.0-255,66,219,77,242841
6360,2.1e-05,172.217.194.0-255,1484,1703,77,242841
6361,2.5e-05,172.31.40.0-255,66,1769,77,242841
6362,3e-05,172.217.194.0-255,2902,4671,77,242841
6363,3.4e-05,172.31.40.0-255,66,4737,77,242841
6364,4.9e-05,172.217.194.0-255,5738,10475,77,242841
6365,5.2e-05,172.31.40.0-255,66,10541,77,242841
6366,8.8e-05,172.217.194.0-255,3444,13985,77,242841
6367,9.1e-05,172.31.40.0-255,66,14051,77,242841
6368,9.7e-05,172.217.194.0-255,4320,18371,77,242841
6369,0.0001,172.31.40.0-255,66,18437,77,242841
6370,0.000107,172.217.194.0-255,7156,25593,77,242841
6371,0.00011,172.31.40.0-255,66,25659,77,242841
6372,0.000145,172.217.194.0-255,2902,28561,77,242841
6373,0.000148,172.31.40.0-255,66,28627,77,242841
6374,0.000152,172.217.194.0-255,2543,31170,77,242841
6375,0.000155,172.31.40.0-255,66,31236,77,242841
6376,0.000222,172.217.194.0-255,1484,32720,77,242841
6377,0.000225,172.31.40.0-255,66,32786,77,242841
6378,0.000254,172.217.194.0-255,2902,35688,77,242841
6379,0.000257,172.31.40.0-255,66,35754,77,242841
6380,0.000264,172.217.194.0-255,5738,41492,77,242841
6381,0.000266,172.31.40.0-255,66,41558,77,242841
6382,0.000274,172.217.194.0-255,1484,43042,77,242841
6383,0.000276,172.31.40.0-255,66,43108,77,242841
6384,0.000316,172.217.194.0-255,12469,55577,77,242841
6385,0.000318,172.31.40.0-255,66,55643,77,242841
6386,0.000324,172.217.194.0-255,4320,59963,77,242841
6387,0.000326,172.31.40.0-255,66,60029,77,242841
6388,0.000361,172.217.194.0-255,5661,65690,77,242841
6389,0.000365,172.31.40.0-255,66,65756,77,242841
6390,0.00039,172.217.194.0-255,116,65872,77,242841
6391,0.000408,172.217.194.0-255,377,66249,77,242841
6392,0.00063,172.217.194.0-255,1484,67733,77,242841
6393,0.000635,172.31.40.0-255,66,67799,77,242841
6394,0.000642,172.217.194.0-255,2902,70701,77,242841
6395,0.000645,172.31.40.0-255,66,70767,77,242841
6396,0.000657,172.217.194.0-255,5738,76505,77,242841
6397,0.00066,172.31.40.0-255,66,76571,77,242841
6398,0.000702,172.217.194.0-255,12828,89399,77,242841
6399,0.000712,172.217.194.0-255,9992,99391,77,242841
6400,0.000714,172.217.194.0-255,766,100157,77,242841
6401,0.000718,172.31.40.0-255,66,100223,77,242841
6402,0.000726,172.31.40.0-255,66,100289,77,242841
6403,0.001495,172.31.40.0-255,66,100355,77,242841
6404,0.00191,172.217.194.0-255,1484,101839,77,242841
6405,0.001921,172.217.194.0-255,2902,104741,77,242841
6406,0.001925,172.31.40.0-255,66,104807,77,242841
6407,0.001933,172.217.194.0-255,5738,110545,77,242841
6408,0.001936,172.31.40.0-255,66,110611,77,242841
6409,0.001965,172.217.194.0-255,12828,123439,77,242841
6410,0.001972,172.31.40.0-255,66,123505,77,242841
6411,0.001983,172.217.194.0-255,10692,134197,77,242841
6412,0.001984,172.31.40.0-255,66,134263,77,242841
6413,0.002057,172.217.194.0-255,1484,135747,77,242841
6414,0.002073,172.217.194.0-255,2902,138649,77,242841
6415,0.002076,172.31.40.0-255,66,138715,77,242841
6416,0.002083,172.217.194.0-255,5738,144453,77,242841
6417,0.002085,172.31.40.0-255,66,144519,77,242841
6418,0.002114,172.217.194.0-255,9992,154511,77,242841
6419,0.002116,172.31.40.0-255,66,154577,77,242841
6420,0.002143,172.217.194.0-255,2902,157479,77,242841
6421,0.002145,172.31.40.0-255,66,157545,77,242841
6422,0.002153,172.217.194.0-255,8574,166119,77,242841
6423,0.002156,172.31.40.0-255,66,166185,77,242841
6424,0.002172,172.217.194.0-255,12828,179013,77,242841
6425,0.002175,172.31.40.0-255,66,179079,77,242841
6426,0.002218,172.217.194.0-255,10692,189771,77,242841
6427,0.002221,172.31.40.0-255,66,189837,77,242841
6428,0.002231,172.217.194.0-255,12110,201947,77,242841
6429,0.002236,172.31.40.0-255,66,202013,77,242841
6430,0.002284,172.31.40.0-255,66,202079,77,242841
6431,0.002337,172.31.40.0-255,66,202145,77,242841
6432,0.002367,172.31.40.0-255,66,202211,77,242841
6433,0.002389,172.31.40.0-255,66,202277,77,242841
6434,0.002395,172.217.194.0-255,7156,209433,77,242841
6435,0.002397,172.31.40.0-255,66,209499,77,242841
6436,0.002453,172.31.40.0-255,66,209565,77,242841
6437,0.002472,172.31.40.0-255,66,209631,77,242841
6438,0.002497,172.217.194.0-255,6438,216069,77,242841
6439,0.0025,172.31.40.0-255,66,216135,77,242841
6440,0.002512,172.31.40.0-255,66,216201,77,242841
6441,0.002532,172.217.194.0-255,8574,224775,77,242841
6442,0.002538,172.31.40.0-255,66,224841,77,242841
6443,0.002543,172.217.194.0-255,4320,229161,77,242841
6444,0.002545,172.31.40.0-255,66,229227,77,242841
6445,0.002587,172.31.40.0-255,66,229293,77,242841
6446,0.002628,172.31.40.0-255,66,229359,77,242841
6447,0.00266,172.217.194.0-255,7856,237215,77,242841
6448,0.002663,172.31.40.0-255,66,237281,77,242841
6449,0.005234,172.217.194.0-255,5323,242604,77,242841
6450,0.005239,172.31.40.0-255,66,242670,77,242841
6451,0.007782,172.31.40.0-255,105,242775,77,242841
6452,0.010277,172.217.194.0-255,66,242841,77,242841
6453,0.0,74.125.68.0-255,153,153,77,258960
6454,2e-05,172.31.40.0-255,66,219,77,258960
6455,2.7e-05,74.125.68.0-255,1484,1703,77,258960
6456,3.2e-05,172.31.40.0-255,66,1769,77,258960
6457,3.8e-05,74.125.68.0-255,2902,4671,77,258960
6458,4.3e-05,172.31.40.0-255,66,4737,77,258960
6459,4.9e-05,74.125.68.0-255,4320,9057,77,258960
6460,5.2e-05,172.31.40.0-255,66,9123,77,258960
6461,5.9e-05,74.125.68.0-255,4779,13902,77,258960
6462,6.1e-05,172.31.40.0-255,66,13968,77,258960
6463,0.000183,74.125.68.0-255,1484,15452,77,258960
6464,0.000187,172.31.40.0-255,66,15518,77,258960
6465,0.000192,74.125.68.0-255,2902,18420,77,258960
6466,0.000195,172.31.40.0-255,66,18486,77,258960
6467,0.000219,74.125.68.0-255,2902,21388,77,258960
6468,0.000223,172.31.40.0-255,66,21454,77,258960
6469,0.000242,74.125.68.0-255,2902,24356,77,258960
6470,0.000245,172.31.40.0-255,66,24422,77,258960
6471,0.000252,74.125.68.0-255,6797,31219,77,258960
6472,0.000255,172.31.40.0-255,66,31285,77,258960
6473,0.00026,74.125.68.0-255,2902,34187,77,258960
6474,0.000262,172.31.40.0-255,66,34253,77,258960
6475,0.000279,74.125.68.0-255,4320,38573,77,258960
6476,0.000281,172.31.40.0-255,66,38639,77,258960
6477,0.000284,74.125.68.0-255,1484,40123,77,258960
6478,0.000287,172.31.40.0-255,66,40189,77,258960
6479,0.000321,74.125.68.0-255,5738,45927,77,258960
6480,0.000324,172.31.40.0-255,66,45993,77,258960
6481,0.000332,74.125.68.0-255,8574,54567,77,258960
6482,0.000335,172.31.40.0-255,66,54633,77,258960
6483,0.000339,74.125.68.0-255,2902,57535,77,258960
6484,0.000341,172.31.40.0-255,66,57601,77,258960
6485,0.000366,74.125.68.0-255,7856,65457,77,258960
6486,0.000369,172.31.40.0-255,66,65523,77,258960
6487,0.000371,74.125.68.0-255,363,65886,77,258960
6488,0.000405,74.125.68.0-255,136,66022,77,258960
6489,0.00051,74.125.68.0-255,1484,67506,77,258960
6490,0.000514,172.31.40.0-255,66,67572,77,258960
6491,0.000529,74.125.68.0-255,2902,70474,77,258960
6492,0.000532,172.31.40.0-255,66,70540,77,258960
6493,0.000537,74.125.68.0-255,2902,73442,77,258960
6494,0.000539,172.31.40.0-255,66,73508,77,258960
6495,0.000542,74.125.68.0-255,1484,74992,77,258960
6496,0.00056,74.125.68.0-255,2902,77894,77,258960
6497,0.000564,172.31.40.0-255,66,77960,77,258960
6498,0.000577,74.125.68.0-255,1484,79444,77,258960
6499,0.0006,74.125.68.0-255,7051,86495,77,258960
6500,0.000603,172.31.40.0-255,66,86561,77,258960
6501,0.000607,74.125.68.0-255,2902,89463,77,258960
6502,0.000609,172.31.40.0-255,66,89529,77,258960
6503,0.000654,74.125.68.0-255,5738,95267,77,258960
6504,0.000658,172.31.40.0-255,66,95333,77,258960
6505,0.000674,74.125.68.0-255,5379,100712,77,258960
6506,0.000677,172.31.40.0-255,66,100778,77,258960
6507,0.001314,74.125.68.0-255,1484,102262,77,258960
6508,0.001321,74.125.68.0-255,1484,103746,77,258960
6509,0.001324,172.31.40.0-255,66,103812,77,258960
6510,0.001343,74.125.68.0-255,1484,105296,77,258960
6511,0.001345,74.125.68.0-255,1484,106780,77,258960
6512,0.00135,172.31.40.0-255,66,106846,77,258960
6513,0.001372,74.125.68.0-255,2902,109748,77,258960
6514,0.001375,172.31.40.0-255,66,109814,77,258960
6515,0.001382,74.125.68.0-255,5738,115552,77,258960
6516,0.001384,172.31.40.0-255,66,115618,77,258960
6517,0.001428,74.125.68.0-255,11410,127028,77,258960
6518,0.00143,172.31.40.0-255,66,127094,77,258960
6519,0.001476,74.125.68.0-255,7856,134950,77,258960
6520,0.00148,172.31.40.0-255,66,135016,77,258960
6521,0.001514,74.125.68.0-255,1484,136500,77,258960
6522,0.00152,74.125.68.0-255,2902,139402,77,258960
6523,0.001522,172.31.40.0-255,66,139468,77,258960
6524,0.001544,74.125.68.0-255,5738,145206,77,258960
6525,0.001547,172.31.40.0-255,66,145272,77,258960
6526,0.00155,74.125.68.0-255,1484,146756,77,258960
6527,0.001568,74.125.68.0-255,4320,151076,77,258960
6528,0.00157,172.31.40.0-255,66,151142,77,258960
6529,0.001577,74.125.68.0-255,7156,158298,77,258960
6530,0.001579,172.31.40.0-255,66,158364,77,258960
6531,0.001605,74.125.68.0-255,4320,162684,77,258960
6532,0.001607,172.31.40.0-255,66,162750,77,258960
6533,0.001624,74.125.68.0-255,6438,169188,77,258960
6534,0.001627,172.31.40.0-255,66,169254,77,258960
6535,0.001673,74.125.68.0-255,1484,170738,77,258960
6536,0.001697,74.125.68.0-255,1484,172222,77,258960
6537,0.0017,172.31.40.0-255,66,172288,77,258960
6538,0.001716,74.125.68.0-255,1484,173772,77,258960
6539,0.001721,74.125.68.0-255,2902,176674,77,258960
6540,0.001723,172.31.40.0-255,66,176740,77,258960
6541,0.001743,74.125.68.0-255,1484,178224,77,258960
6542,0.001752,74.125.68.0-255,8574,186798,77,258960
6543,0.001758,74.125.68.0-255,5738,192536,77,258960
6544,0.001762,172.31.40.0-255,66,192602,77,258960
6545,0.001765,172.31.40.0-255,66,192668,77,258960
6546,0.001781,74.125.68.0-255,7156,199824,77,258960
6547,0.001785,172.31.40.0-255,66,199890,77,258960
6548,0.001801,74.125.68.0-255,1484,201374,77,258960
6549,0.001815,74.125.68.0-255,2184,203558,77,258960
6550,0.001819,172.31.40.0-255,66,203624,77,258960
6551,0.002218,74.125.68.0-255,1484,205108,77,258960
6552,0.002238,74.125.68.0-255,2902,208010,77,258960
6553,0.002242,172.31.40.0-255,66,208076,77,258960
6554,0.00225,74.125.68.0-255,5738,213814,77,258960
6555,0.002252,172.31.40.0-255,66,213880,77,258960
6556,0.002258,74.125.68.0-255,4320,218200,77,258960
6557,0.002261,172.31.40.0-255,66,218266,77,258960
6558,0.002263,74.125.68.0-255,1484,219750,77,258960
6559,0.004515,74.125.68.0-255,4320,224070,77,258960
6560,0.004533,172.31.40.0-255,66,224136,77,258960
6561,0.006779,74.125.68.0-255,5738,229874,77,258960
6562,0.006788,172.31.40.0-255,66,229940,77,258960
6563,0.00905,74.125.68.0-255,5738,235678,77,258960
6564,0.009065,172.31.40.0-255,66,235744,77,258960
6565,0.011333,74.125.68.0-255,5738,241482,77,258960
6566,0.011351,172.31.40.0-255,66,241548,77,258960
6567,0.013611,74.125.68.0-255,5738,247286,77,258960
6568,0.013625,172.31.40.0-255,66,247352,77,258960
6569,0.015889,74.125.68.0-255,5738,253090,77,258960
6570,0.015907,172.31.40.0-255,66,253156,77,258960
6571,0.01817,74.125.68.0-255,5738,258894,77,258960
6572,0.018187,172.31.40.0-255,66,258960,77,258960
6573,0.0,74.125.200.0-255,147,147,77,322206
6574,3.1e-05,172.31.40.0-255,66,213,77,322206
6575,3.8e-05,74.125.200.0-255,1484,1697,77,322206
6576,4.1e-05,172.31.40.0-255,66,1763,77,322206
6577,4.4e-05,74.125.200.0-255,1484,3247,77,322206
6578,4.6e-05,172.31.40.0-255,66,3313,77,322206
6579,5.8e-05,74.125.200.0-255,2902,6215,77,322206
6580,6e-05,172.31.40.0-255,66,6281,77,322206
6581,6.5e-05,74.125.200.0-255,4320,10601,77,322206
6582,6.7e-05,172.31.40.0-255,66,10667,77,322206
6583,9.3e-05,74.125.200.0-255,1484,12151,77,322206
6584,9.5e-05,172.31.40.0-255,66,12217,77,322206
6585,0.000108,74.125.200.0-255,6182,18399,77,322206
6586,0.00011,172.31.40.0-255,66,18465,77,322206
6587,0.000116,74.125.200.0-255,7156,25621,77,322206
6588,0.000118,172.31.40.0-255,66,25687,77,322206
6589,0.000153,74.125.200.0-255,5379,31066,77,322206
6590,0.000156,172.31.40.0-255,66,31132,77,322206
6591,0.000225,74.125.200.0-255,1484,32616,77,322206
6592,0.000229,172.31.40.0-255,66,32682,77,322206
6593,0.000232,74.125.200.0-255,1484,34166,77,322206
6594,0.000234,172.31.40.0-255,66,34232,77,322206
6595,0.000257,74.125.200.0-255,2902,37134,77,322206
6596,0.00026,172.31.40.0-255,66,37200,77,322206
6597,0.000267,74.125.200.0-255,5738,42938,77,322206
6598,0.000269,172.31.40.0-255,66,43004,77,322206
6599,0.000308,74.125.200.0-255,6797,49801,77,322206
6600,0.000312,172.31.40.0-255,66,49867,77,322206
6601,0.000319,74.125.200.0-255,5738,55605,77,322206
6602,0.000322,172.31.40.0-255,66,55671,77,322206
6603,0.000345,74.125.200.0-255,1484,57155,77,322206
6604,0.000348,172.31.40.0-255,66,57221,77,322206
6605,0.000359,74.125.200.0-255,5738,62959,77,322206
6606,0.000362,172.31.40.0-255,66,63025,77,322206
6607,0.000384,74.125.200.0-255,2859,65884,77,322206
6608,0.000387,172.31.40.0-255,66,65950,77,322206
6609,0.000395,74.125.200.0-255,107,66057,77,322206
6610,0.000474,74.125.200.0-255,1484,67541,77,322206
6611,0.000478,172.31.40.0-255,66,67607,77,322206
6612,0.0005,74.125.200.0-255,2902,70509,77,322206
6613,0.000503,172.31.40.0-255,66,70575,77,322206
6614,0.000531,74.125.200.0-255,4320,74895,77,322206
6615,0.000535,172.31.40.0-255,66,74961,77,322206
6616,0.000538,74.125.200.0-255,1484,76445,77,322206
6617,0.000566,74.125.200.0-255,6797,83242,77,322206
6618,0.00057,172.31.40.0-255,66,83308,77,322206
6619,0.000594,74.125.200.0-255,2902,86210,77,322206
6620,0.000598,172.31.40.0-255,66,86276,77,322206
6621,0.000618,74.125.200.0-255,5738,92014,77,322206
6622,0.000621,172.31.40.0-255,66,92080,77,322206
6623,0.00065,74.125.200.0-255,4320,96400,77,322206
6624,0.000654,172.31.40.0-255,66,96466,77,322206
6625,0.000682,74.125.200.0-255,3961,100427,77,322206
6626,0.000685,172.31.40.0-255,66,100493,77,322206
6627,0.000746,74.125.200.0-255,1484,101977,77,322206
6628,0.00075,74.125.200.0-255,1484,103461,77,322206
6629,0.000753,172.31.40.0-255,66,103527,77,322206
6630,0.00078,74.125.200.0-255,1484,105011,77,322206
6631,0.000787,74.125.200.0-255,5738,110749,77,322206
6632,0.000791,172.31.40.0-255,66,110815,77,322206
6633,0.000849,74.125.200.0-255,8574,119389,77,322206
6634,0.000853,172.31.40.0-255,66,119455,77,322206
6635,0.000862,74.125.200.0-255,9992,129447,77,322206
6636,0.000874,172.31.40.0-255,66,129513,77,322206
6637,0.00088,74.125.200.0-255,5020,134533,77,322206
6638,0.000883,172.31.40.0-255,66,134599,77,322206
6639,0.000911,74.125.200.0-255,1484,136083,77,322206
6640,0.00092,74.125.200.0-255,2902,138985,77,322206
6641,0.000923,172.31.40.0-255,66,139051,77,322206
6642,0.000926,74.125.200.0-255,1484,140535,77,322206
6643,0.000954,74.125.200.0-255,4320,144855,77,322206
6644,0.000959,172.31.40.0-255,66,144921,77,322206
6645,0.000964,74.125.200.0-255,4320,149241,77,322206
6646,0.000966,172.31.40.0-255,66,149307,77,322206
6647,0.000977,74.125.200.0-255,5738,155045,77,322206
6648,0.00098,172.31.40.0-255,66,155111,77,322206
6649,0.000982,74.125.200.0-255,1484,156595,77,322206
6650,0.00102,74.125.200.0-255,9992,166587,77,322206
6651,0.001024,172.31.40.0-255,66,166653,77,322206
6652,0.001028,74.125.200.0-255,2184,168837,77,322206
6653,0.001031,172.31.40.0-255,66,168903,77,322206
6654,0.001033,74.125.200.0-255,331,169234,77,322206
6655,0.001187,74.125.200.0-255,1484,170718,77,322206
6656,0.001193,172.31.40.0-255,66,170784,77,322206
6657,0.001198,74.125.200.0-255,1484,172268,77,322206
6658,0.001227,74.125.200.0-255,2902,175170,77,322206
6659,0.00123,172.31.40.0-255,66,175236,77,322206
6660,0.001236,74.125.200.0-255,5738,180974,77,322206
6661,0.001239,172.31.40.0-255,66,181040,77,322206
6662,0.001258,74.125.200.0-255,4320,185360,77,322206
6663,0.00126,172.31.40.0-255,66,185426,77,322206
6664,0.001287,74.125.200.0-255,5738,191164,77,322206
6665,0.00129,172.31.40.0-255,66,191230,77,322206
6666,0.001299,74.125.200.0-255,11410,202640,77,322206
6667,0.001302,172.31.40.0-255,66,202706,77,322206
6668,0.001308,74.125.200.0-255,766,203472,77,322206
6669,0.002041,74.125.200.0-255,1484,204956,77,322206
6670,0.002044,172.31.40.0-255,66,205022,77,322206
6671,0.002061,74.125.200.0-255,2902,207924,77,322206
6672,0.002063,172.31.40.0-255,66,207990,77,322206
6673,0.002065,74.125.200.0-255,1484,209474,77,322206
6674,0.002068,74.125.200.0-255,1484,210958,77,322206
6675,0.00207,172.31.40.0-255,66,211024,77,322206
6676,0.0021,74.125.200.0-255,1484,212508,77,322206
6677,0.002106,74.125.200.0-255,5738,218246,77,322206
6678,0.002109,172.31.40.0-255,66,218312,77,322206
6679,0.002128,74.125.200.0-255,4320,222632,77,322206
6680,0.00213,172.31.40.0-255,66,222698,77,322206
6681,0.00216,74.125.200.0-255,5738,228436,77,322206
6682,0.002163,172.31.40.0-255,66,228502,77,322206
6683,0.002174,74.125.200.0-255,1484,229986,77,322206
6684,0.002194,74.125.200.0-255,7856,237842,77,322206
6685,0.002196,172.31.40.0-255,66,237908,77,322206
6686,0.002235,74.125.200.0-255,1484,239392,77,322206
6687,0.002248,74.125.200.0-255,1484,240876,77,322206
6688,0.00225,172.31.40.0-255,66,240942,77,322206
6689,0.002262,74.125.200.0-255,1484,242426,77,322206
6690,0.002271,74.125.200.0-255,4320,246746,77,322206
6691,0.002273,172.31.40.0-255,66,246812,77,322206
6692,0.002276,74.125.200.0-255,1484,248296,77,322206
6693,0.002303,74.125.200.0-255,4320,252616,77,322206
6694,0.002305,172.31.40.0-255,66,252682,77,322206
6695,0.00231,74.125.200.0-255,4320,257002,77,322206
6696,0.002313,172.31.40.0-255,66,257068,77,322206
6697,0.002344,74.125.200.0-255,7156,264224,77,322206
6698,0.002347,172.31.40.0-255,66,264290,77,322206
6699,0.002352,74.125.200.0-255,4320,268610,77,322206
6700,0.002354,172.31.40.0-255,66,268676,77,322206
6701,0.002387,74.125.200.0-255,3602,272278,77,322206
6702,0.002389,172.31.40.0-255,66,272344,77,322206
6703,0.002478,74.125.200.0-255,1484,273828,77,322206
6704,0.002483,74.125.200.0-255,1484,275312,77,322206
6705,0.002486,172.31.40.0-255,66,275378,77,322206
6706,0.002511,74.125.200.0-255,1484,276862,77,322206
6707,0.002516,74.125.200.0-255,4320,281182,77,322206
6708,0.002518,172.31.40.0-255,66,281248,77,322206
6709,0.002541,74.125.200.0-255,1484,282732,77,322206
6710,0.002558,74.125.200.0-255,1484,284216,77,322206
6711,0.00256,172.31.40.0-255,66,284282,77,322206
6712,0.002584,74.125.200.0-255,4320,288602,77,322206
6713,0.002587,172.31.40.0-255,66,288668,77,322206
6714,0.005048,74.125.200.0-255,1484,290152,77,322206
6715,0.005078,74.125.200.0-255,2902,293054,77,322206
6716,0.005082,172.31.40.0-255,66,293120,77,322206
6717,0.005133,74.125.200.0-255,1484,294604,77,322206
6718,0.007588,74.125.200.0-255,4320,298924,77,322206
6719,0.007593,172.31.40.0-255,66,298990,77,322206
6720,0.010119,74.125.200.0-255,5738,304728,77,322206
6721,0.01013,172.31.40.0-255,66,304794,77,322206
6722,0.01264,74.125.200.0-255,5738,310532,77,322206
6723,0.012646,172.31.40.0-255,66,310598,77,322206
6724,0.015148,74.125.200.0-255,5738,316336,77,322206
6725,0.015156,172.31.40.0-255,66,316402,77,322206
6726,0.017692,74.125.200.0-255,5738,322140,77,322206
6727,0.017701,172.31.40.0-255,66,322206,77,322206
6728,0.0,74.125.68.0-255,150,150,77,399962
6729,2.1e-05,172.31.40.0-255,66,216,77,399962
6730,2.9e-05,74.125.68.0-255,1484,1700,77,399962
6731,3.2e-05,172.31.40.0-255,66,1766,77,399962
6732,3.7e-05,74.125.68.0-255,2902,4668,77,399962
6733,4.1e-05,172.31.40.0-255,66,4734,77,399962
6734,4.7e-05,74.125.68.0-255,5738,10472,77,399962
6735,5e-05,172.31.40.0-255,66,10538,77,399962
6736,7.3e-05,74.125.68.0-255,6247,16785,77,399962
6737,7.6e-05,172.31.40.0-255,66,16851,77,399962
6738,9.3e-05,74.125.68.0-255,1484,18335,77,399962
6739,9.6e-05,172.31.40.0-255,66,18401,77,399962
6740,0.000116,74.125.68.0-255,7156,25557,77,399962
6741,0.000118,172.31.40.0-255,66,25623,77,399962
6742,0.000144,74.125.68.0-255,4320,29943,77,399962
6743,0.000146,172.31.40.0-255,66,30009,77,399962
6744,0.000156,74.125.68.0-255,1125,31134,77,399962
6745,0.000158,172.31.40.0-255,66,31200,77,399962
6746,0.000212,74.125.68.0-255,1484,32684,77,399962
6747,0.000215,172.31.40.0-255,66,32750,77,399962
6748,0.000218,74.125.68.0-255,1484,34234,77,399962
6749,0.000219,172.31.40.0-255,66,34300,77,399962
6750,0.000247,74.125.68.0-255,1484,35784,77,399962
6751,0.00025,172.31.40.0-255,66,35850,77,399962
6752,0.000256,74.125.68.0-255,5738,41588,77,399962
6753,0.000259,172.31.40.0-255,66,41654,77,399962
6754,0.000261,74.125.68.0-255,1484,43138,77,399962
6755,0.000263,172.31.40.0-255,66,43204,77,399962
6756,0.000287,74.125.68.0-255,5379,48583,77,399962
6757,0.00029,172.31.40.0-255,66,48649,77,399962
6758,0.000322,74.125.68.0-255,8574,57223,77,399962
6759,0.000325,172.31.40.0-255,66,57289,77,399962
6760,0.00035,74.125.68.0-255,5738,63027,77,399962
6761,0.000352,172.31.40.0-255,66,63093,77,399962
6762,0.000372,74.125.68.0-255,2849,65942,77,399962
6763,0.000374,172.31.40.0-255,66,66008,77,399962
6764,0.000376,74.125.68.0-255,116,66124,77,399962
6765,0.000458,74.125.68.0-255,1484,67608,77,399962
6766,0.000461,172.31.40.0-255,66,67674,77,399962
6767,0.000474,74.125.68.0-255,2902,70576,77,399962
6768,0.000477,172.31.40.0-255,66,70642,77,399962
6769,0.000479,74.125.68.0-255,1484,72126,77,399962
6770,0.000502,74.125.68.0-255,4320,76446,77,399962
6771,0.000504,172.31.40.0-255,66,76512,77,399962
6772,0.000508,74.125.68.0-255,2902,79414,77,399962
6773,0.00051,172.31.40.0-255,66,79480,77,399962
6774,0.000547,74.125.68.0-255,9992,89472,77,399962
6775,0.00055,172.31.40.0-255,66,89538,77,399962
6776,0.000576,74.125.68.0-255,2902,92440,77,399962
6777,0.000578,172.31.40.0-255,66,92506,77,399962
6778,0.000604,74.125.68.0-255,7856,100362,77,399962
6779,0.000607,172.31.40.0-255,66,100428,77,399962
6780,0.00061,74.125.68.0-255,331,100759,77,399962
6781,0.00072,74.125.68.0-255,1484,102243,77,399962
6782,0.000723,172.31.40.0-255,66,102309,77,399962
6783,0.000729,74.125.68.0-255,2902,105211,77,399962
6784,0.000731,172.31.40.0-255,66,105277,77,399962
6785,0.000752,74.125.68.0-255,4320,109597,77,399962
6786,0.000754,172.31.40.0-255,66,109663,77,399962
6787,0.000767,74.125.68.0-255,1484,111147,77,399962
6788,0.000775,74.125.68.0-255,7156,118303,77,399962
6789,0.000776,172.31.40.0-255,66,118369,77,399962
6790,0.000822,172.31.40.0-255,66,118435,77,399962
6791,0.000851,74.125.68.0-255,2184,120619,77,399962
6792,0.000854,172.31.40.0-255,66,120685,77,399962
6793,0.000989,74.125.68.0-255,1484,122169,77,399962
6794,0.001007,74.125.68.0-255,2902,125071,77,399962
6795,0.00101,172.31.40.0-255,66,125137,77,399962
6796,0.001016,74.125.68.0-255,4320,129457,77,399962
6797,0.001019,172.31.40.0-255,66,129523,77,399962
6798,0.001059,74.125.68.0-255,8574,138097,77,399962
6799,0.001064,172.31.40.0-255,66,138163,77,399962
6800,0.001071,74.125.68.0-255,7156,145319,77,399962
6801,0.001073,172.31.40.0-255,66,145385,77,399962
6802,0.001081,74.125.68.0-255,8574,153959,77,399962
6803,0.001085,172.31.40.0-255,66,154025,77,399962
6804,0.0011,74.125.68.0-255,766,154791,77,399962
6805,0.001203,74.125.68.0-255,1484,156275,77,399962
6806,0.001206,172.31.40.0-255,66,156341,77,399962
6807,0.001212,74.125.68.0-255,2902,159243,77,399962
6808,0.001214,172.31.40.0-255,66,159309,77,399962
6809,0.001242,74.125.68.0-255,5738,165047,77,399962
6810,0.001245,172.31.40.0-255,66,165113,77,399962
6811,0.001263,74.125.68.0-255,7156,172269,77,399962
6812,0.001267,172.31.40.0-255,66,172335,77,399962
6813,0.001288,74.125.68.0-255,5738,178073,77,399962
6814,0.00129,172.31.40.0-255,66,178139,77,399962
6815,0.001313,74.125.68.0-255,4320,182459,77,399962
6816,0.001316,172.31.40.0-255,66,182525,77,399962
6817,0.001347,74.125.68.0-255,7856,190381,77,399962
6818,0.00135,172.31.40.0-255,66,190447,77,399962
6819,0.001361,74.125.68.0-255,12828,203275,77,399962
6820,0.001364,172.31.40.0-255,66,203341,77,399962
6821,0.001371,74.125.68.0-255,8574,211915,77,399962
6822,0.001374,172.31.40.0-255,66,211981,77,399962
6823,0.001395,74.125.68.0-255,4320,216301,77,399962
6824,0.001397,172.31.40.0-255,66,216367,77,399962
6825,0.001412,74.125.68.0-255,5738,222105,77,399962
6826,0.001415,172.31.40.0-255,66,222171,77,399962
6827,0.001417,74.125.68.0-255,766,222937,77,399962
6828,0.001562,74.125.68.0-255,1484,224421,77,399962
6829,0.001567,172.31.40.0-255,66,224487,77,399962
6830,0.001572,74.125.68.0-255,2902,227389,77,399962
6831,0.001574,172.31.40.0-255,66,227455,77,399962
6832,0.001594,74.125.68.0-255,2902,230357,77,399962
6833,0.001597,172.31.40.0-255,66,230423,77,399962
6834,0.001617,74.125.68.0-255,2902,233325,77,399962
6835,0.00162,172.31.40.0-255,66,233391,77,399962
6836,0.001633,74.125.68.0-255,7156,240547,77,399962
6837,0.001635,172.31.40.0-255,66,240613,77,399962
6838,0.00164,74.125.68.0-255,2902,243515,77,399962
6839,0.001641,172.31.40.0-255,66,243581,77,399962
6840,0.001669,74.125.68.0-255,5738,249319,77,399962
6841,0.001672,172.31.40.0-255,66,249385,77,399962
6842,0.001677,74.125.68.0-255,5738,255123,77,399962
6843,0.001679,172.31.40.0-255,66,255189,77,399962
6844,0.001735,74.125.68.0-255,2184,257373,77,399962
6845,0.001738,74.125.68.0-255,2902,260275,77,399962
6846,0.001742,172.31.40.0-255,66,260341,77,399962
6847,0.001745,172.31.40.0-255,66,260407,77,399962
6848,0.001755,74.125.68.0-255,1484,261891,77,399962
6849,0.00177,74.125.68.0-255,2902,264793,77,399962
6850,0.001784,74.125.68.0-255,2902,267695,77,399962
6851,0.001789,74.125.68.0-255,2902,270597,77,399962
6852,0.001793,74.125.68.0-255,4320,274917,77,399962
6853,0.001801,172.31.40.0-255,66,274983,77,399962
6854,0.001828,74.125.68.0-255,8574,283557,77,399962
6855,0.001847,74.125.68.0-255,5738,289295,77,399962
6856,0.001865,74.125.68.0-255,6438,295733,77,399962
6857,0.001867,74.125.68.0-255,1484,297217,77,399962
6858,0.001883,74.125.68.0-255,1484,298701,77,399962
6859,0.001903,74.125.68.0-255,8574,307275,77,399962
6860,0.001916,74.125.68.0-255,2902,310177,77,399962
6861,0.001921,74.125.68.0-255,4320,314497,77,399962
6862,0.001938,74.125.68.0-255,4320,318817,77,399962
6863,0.001976,74.125.68.0-255,2902,321719,77,399962
6864,0.001991,74.125.68.0-255,3602,325321,77,399962
6865,0.002013,74.125.68.0-255,1484,326805,77,399962
6866,0.002038,74.125.68.0-255,5738,332543,77,399962
6867,0.002047,74.125.68.0-255,8574,341117,77,399962
6868,0.002074,74.125.68.0-255,2902,344019,77,399962
6869,0.002099,74.125.68.0-255,9992,354011,77,399962
6870,0.00213,74.125.68.0-255,5020,359031,77,399962
6871,0.002179,74.125.68.0-255,5738,364769,77,399962
6872,0.002204,74.125.68.0-255,7156,371925,77,399962
6873,0.002233,74.125.68.0-255,7156,379081,77,399962
6874,0.002252,74.125.68.0-255,5738,384819,77,399962
6875,0.002284,74.125.68.0-255,7856,392675,77,399962
6876,0.002322,74.125.68.0-255,1484,394159,77,399962
6877,0.002356,74.125.68.0-255,5395,399554,77,399962
6878,0.006335,172.31.40.0-255,66,399620,77,399962
6879,0.008631,74.125.68.0-255,105,399725,77,399962
6880,0.008848,172.31.40.0-255,66,399791,77,399962
6881,0.008883,172.31.40.0-255,105,399896,77,399962
6882,0.011158,74.125.68.0-255,66,399962,77,399962
6883,0.0,172.217.26.0-255,215,215,77,214666
6884,1.2e-05,172.31.40.0-255,66,281,77,214666
6885,2.6e-05,172.217.26.0-255,1484,1765,77,214666
6886,3.1e-05,172.31.40.0-255,66,1831,77,214666
6887,4.7e-05,172.217.26.0-255,2902,4733,77,214666
6888,5e-05,172.31.40.0-255,66,4799,77,214666
6889,5.6e-05,172.217.26.0-255,4320,9119,77,214666
6890,5.9e-05,172.31.40.0-255,66,9185,77,214666
6891,6.3e-05,172.217.26.0-255,2902,12087,77,214666
6892,6.6e-05,172.31.40.0-255,66,12153,77,214666
6893,8.2e-05,172.217.26.0-255,1785,13938,77,214666
6894,8.5e-05,172.31.40.0-255,66,14004,77,214666
6895,9.1e-05,172.217.26.0-255,5738,19742,77,214666
6896,9.4e-05,172.31.40.0-255,66,19808,77,214666
6897,0.000128,172.217.26.0-255,4320,24128,77,214666
6898,0.00013,172.31.40.0-255,66,24194,77,214666
6899,0.000154,172.217.26.0-255,6797,30991,77,214666
6900,0.000156,172.31.40.0-255,66,31057,77,214666
6901,0.000221,172.217.26.0-255,1484,32541,77,214666
6902,0.000224,172.31.40.0-255,66,32607,77,214666
6903,0.000247,172.217.26.0-255,2902,35509,77,214666
6904,0.00025,172.31.40.0-255,66,35575,77,214666
6905,0.000256,172.217.26.0-255,5738,41313,77,214666
6906,0.000258,172.31.40.0-255,66,41379,77,214666
6907,0.000297,172.217.26.0-255,11051,52430,77,214666
6908,0.0003,172.31.40.0-255,66,52496,77,214666
6909,0.00031,172.217.26.0-255,11410,63906,77,214666
6910,0.000312,172.31.40.0-255,66,63972,77,214666
6911,0.000315,172.217.26.0-255,1431,65403,77,214666
6912,0.000317,172.31.40.0-255,66,65469,77,214666
6913,0.001054,172.217.26.0-255,117,65586,77,214666
6914,0.00106,172.31.40.0-255,66,65652,77,214666
6915,0.001168,172.217.26.0-255,1484,67136,77,214666
6916,0.001176,172.217.26.0-255,2902,70038,77,214666
6917,0.001179,172.31.40.0-255,66,70104,77,214666
6918,0.001199,172.217.26.0-255,4320,74424,77,214666
6919,0.001201,172.31.40.0-255,66,74490,77,214666
6920,0.001205,172.217.26.0-255,1484,75974,77,214666
6921,0.001226,172.217.26.0-255,8215,84189,77,214666
6922,0.001229,172.31.40.0-255,66,84255,77,214666
6923,0.001232,172.217.26.0-255,1484,85739,77,214666
6924,0.001252,172.217.26.0-255,9992,95731,77,214666
6925,0.001254,172.31.40.0-255,66,95797,77,214666
6926,0.001276,172.217.26.0-255,2902,98699,77,214666
6927,0.001279,172.31.40.0-255,66,98765,77,214666
6928,0.001282,172.217.26.0-255,1125,99890,77,214666
6929,0.001687,172.217.26.0-255,1484,101374,77,214666
6930,0.001693,172.31.40.0-255,66,101440,77,214666
6931,0.001701,172.217.26.0-255,2902,104342,77,214666
6932,0.001703,172.31.40.0-255,66,104408,77,214666
6933,0.001709,172.217.26.0-255,5738,110146,77,214666
6934,0.001711,172.31.40.0-255,66,110212,77,214666
6935,0.001746,172.217.26.0-255,12828,123040,77,214666
6936,0.001749,172.31.40.0-255,66,123106,77,214666
6937,0.00176,172.217.26.0-255,10692,133798,77,214666
6938,0.001761,172.31.40.0-255,66,133864,77,214666
6939,0.001804,172.217.26.0-255,1484,135348,77,214666
6940,0.001816,172.217.26.0-255,2902,138250,77,214666
6941,0.00182,172.31.40.0-255,66,138316,77,214666
6942,0.001827,172.217.26.0-255,5738,144054,77,214666
6943,0.001829,172.31.40.0-255,66,144120,77,214666
6944,0.001832,172.217.26.0-255,1484,145604,77,214666
6945,0.001856,172.217.26.0-255,5738,151342,77,214666
6946,0.001859,172.31.40.0-255,66,151408,77,214666
6947,0.001868,172.217.26.0-255,8574,159982,77,214666
6948,0.00187,172.31.40.0-255,66,160048,77,214666
6949,0.001937,172.217.26.0-255,2902,162950,77,214666
6950,0.00194,172.31.40.0-255,66,163016,77,214666
6951,0.001974,172.31.40.0-255,66,163082,77,214666
6952,0.001992,172.31.40.0-255,66,163148,77,214666
6953,0.001998,172.217.26.0-255,5020,168168,77,214666
6954,0.002,172.31.40.0-255,66,168234,77,214666
6955,0.003975,172.217.26.0-255,5738,173972,77,214666
6956,0.003984,172.31.40.0-255,66,174038,77,214666
6957,0.005975,172.217.26.0-255,5738,179776,77,214666
6958,0.005982,172.31.40.0-255,66,179842,77,214666
6959,0.007972,172.217.26.0-255,5738,185580,77,214666
6960,0.007977,172.31.40.0-255,66,185646,77,214666
6961,0.009971,172.217.26.0-255,5738,191384,77,214666
6962,0.00998,172.31.40.0-255,66,191450,77,214666
6963,0.011987,172.217.26.0-255,5738,197188,77,214666
6964,0.011994,172.31.40.0-255,66,197254,77,214666
6965,0.013987,172.217.26.0-255,5738,202992,77,214666
6966,0.013993,172.31.40.0-255,66,203058,77,214666
6967,0.015991,172.217.26.0-255,5738,208796,77,214666
6968,0.015998,172.31.40.0-255,66,208862,77,214666
6969,0.018008,172.217.26.0-255,5738,214600,77,214666
6970,0.018016,172.31.40.0-255,66,214666,77,214666
6971,0.0,74.125.24.0-255,153,153,77,288934
6972,2e-05,172.31.40.0-255,66,219,77,288934
6973,2.6e-05,74.125.24.0-255,1484,1703,77,288934
6974,3.1e-05,172.31.40.0-255,66,1769,77,288934
6975,3.6e-05,74.125.24.0-255,2902,4671,77,288934
6976,3.9e-05,172.31.40.0-255,66,4737,77,288934
6977,4.2e-05,74.125.24.0-255,1484,6221,77,288934
6978,4.6e-05,172.31.40.0-255,66,6287,77,288934
6979,7.7e-05,74.125.24.0-255,7156,13443,77,288934
6980,8e-05,172.31.40.0-255,66,13509,77,288934
6981,0.0001,74.125.24.0-255,2101,15610,77,288934
6982,0.000103,172.31.40.0-255,66,15676,77,288934
6983,0.00012,74.125.24.0-255,1484,17160,77,288934
6984,0.000123,172.31.40.0-255,66,17226,77,288934
6985,0.000144,74.125.24.0-255,8574,25800,77,288934
6986,0.000147,172.31.40.0-255,66,25866,77,288934
6987,0.000173,74.125.24.0-255,5379,31245,77,288934
6988,0.000176,172.31.40.0-255,66,31311,77,288934
6989,0.000202,74.125.24.0-255,1484,32795,77,288934
6990,0.000204,172.31.40.0-255,66,32861,77,288934
6991,0.00021,74.125.24.0-255,2902,35763,77,288934
6992,0.000212,172.31.40.0-255,66,35829,77,288934
6993,0.000224,74.125.24.0-255,1484,37313,77,288934
6994,0.000227,172.31.40.0-255,66,37379,77,288934
6995,0.00025,74.125.24.0-255,4320,41699,77,288934
6996,0.000252,172.31.40.0-255,66,41765,77,288934
6997,0.000269,74.125.24.0-255,2902,44667,77,288934
6998,0.000271,172.31.40.0-255,66,44733,77,288934
6999,0.000309,74.125.24.0-255,11051,55784,77,288934
7000,0.000312,172.31.40.0-255,66,55850,77,288934
7001,0.000321,74.125.24.0-255,7156,63006,77,288934
7002,0.000323,172.31.40.0-255,66,63072,77,288934
7003,0.000354,74.125.24.0-255,2869,65941,77,288934
7004,0.000357,172.31.40.0-255,66,66007,77,288934
7005,0.000375,74.125.24.0-255,117,66124,77,288934
7006,0.00039,74.125.24.0-255,331,66455,77,288934
7007,0.000599,74.125.24.0-255,1484,67939,77,288934
7008,0.000603,172.31.40.0-255,66,68005,77,288934
7009,0.000624,74.125.24.0-255,2902,70907,77,288934
7010,0.000627,172.31.40.0-255,66,70973,77,288934
7011,0.000647,74.125.24.0-255,4320,75293,77,288934
7012,0.00065,172.31.40.0-255,66,75359,77,288934
7013,0.000672,74.125.24.0-255,8574,83933,77,288934
7014,0.000675,172.31.40.0-255,66,83999,77,288934
7015,0.000693,74.125.24.0-255,1125,85124,77,288934
7016,0.000697,74.125.24.0-255,2902,88026,77,288934
7017,0.000699,172.31.40.0-255,66,88092,77,288934
7018,0.000733,74.125.24.0-255,9992,98084,77,288934
7019,0.000736,172.31.40.0-255,66,98150,77,288934
7020,0.000756,74.125.24.0-255,2543,100693,77,288934
7021,0.000759,172.31.40.0-255,66,100759,77,288934
7022,0.001164,74.125.24.0-255,1484,102243,77,288934
7023,0.001191,74.125.24.0-255,2902,105145,77,288934
7024,0.001195,172.31.40.0-255,66,105211,77,288934
7025,0.001203,74.125.24.0-255,5738,110949,77,288934
7026,0.001205,172.31.40.0-255,66,111015,77,288934
7027,0.001217,74.125.24.0-255,12828,123843,77,288934
7028,0.00122,172.31.40.0-255,66,123909,77,288934
7029,0.001262,74.125.24.0-255,8574,132483,77,288934
7030,0.001265,172.31.40.0-255,66,132549,77,288934
7031,0.001284,74.125.24.0-255,2184,134733,77,288934
7032,0.001288,172.31.40.0-255,66,134799,77,288934
7033,0.001542,172.31.40.0-255,101,134900,77,288934
7034,0.001755,74.125.24.0-255,1484,136384,77,288934
7035,0.001759,74.125.24.0-255,1484,137868,77,288934
7036,0.001763,172.31.40.0-255,66,137934,77,288934
7037,0.001777,74.125.24.0-255,1484,139418,77,288934
7038,0.00178,74.125.24.0-255,1484,140902,77,288934
7039,0.001782,172.31.40.0-255,66,140968,77,288934
7040,0.001806,74.125.24.0-255,4320,145288,77,288934
7041,0.001809,172.31.40.0-255,66,145354,77,288934
7042,0.001819,74.125.24.0-255,9992,155346,77,288934
7043,0.001821,172.31.40.0-255,66,155412,77,288934
7044,0.001835,74.125.24.0-255,2902,158314,77,288934
7045,0.001837,172.31.40.0-255,66,158380,77,288934
7046,0.001854,74.125.24.0-255,2902,161282,77,288934
7047,0.001857,172.31.40.0-255,66,161348,77,288934
7048,0.001875,74.125.24.0-255,7856,169204,77,288934
7049,0.001877,172.31.40.0-255,66,169270,77,288934
7050,0.001895,74.125.24.0-255,2902,172172,77,288934
7051,0.001898,172.31.40.0-255,66,172238,77,288934
7052,0.001932,74.125.24.0-255,8574,180812,77,288934
7053,0.001935,172.31.40.0-255,66,180878,77,288934
7054,0.001944,74.125.24.0-255,8574,189452,77,288934
7055,0.001948,172.31.40.0-255,66,189518,77,288934
7056,0.002011,74.125.24.0-255,13528,203046,77,288934
7057,0.002014,172.31.40.0-255,66,203112,77,288934
7058,0.002032,74.125.24.0-255,1484,204596,77,288934
7059,0.002037,74.125.24.0-255,2902,207498,77,288934
7060,0.002039,172.31.40.0-255,66,207564,77,288934
7061,0.002061,74.125.24.0-255,5738,213302,77,288934
7062,0.002064,172.31.40.0-255,66,213368,77,288934
7063,0.00207,74.125.24.0-255,5738,219106,77,288934
7064,0.002073,172.31.40.0-255,66,219172,77,288934
7065,0.002088,74.125.24.0-255,4320,223492,77,288934
7066,0.00209,172.31.40.0-255,66,223558,77,288934
7067,0.002125,74.125.24.0-255,7156,230714,77,288934
7068,0.002129,172.31.40.0-255,66,230780,77,288934
7069,0.002152,74.125.24.0-255,6438,237218,77,288934
7070,0.002155,172.31.40.0-255,66,237284,77,288934
7071,0.002172,74.125.24.0-255,4320,241604,77,288934
7072,0.002175,172.31.40.0-255,66,241670,77,288934
7073,0.002205,74.125.24.0-255,9992,251662,77,288934
7074,0.002208,172.31.40.0-255,66,251728,77,288934
7075,0.002216,74.125.24.0-255,1484,253212,77,288934
7076,0.002233,74.125.24.0-255,766,253978,77,288934
7077,0.002254,172.31.40.0-255,66,254044,77,288934
7078,0.004075,74.125.24.0-255,66,254110,77,288934
7079,0.004805,74.125.24.0-255,5738,259848,77,288934
7080,0.004811,172.31.40.0-255,66,259914,77,288934
7081,0.007327,74.125.24.0-255,5738,265652,77,288934
7082,0.00733,172.31.40.0-255,66,265718,77,288934
7083,0.009866,74.125.24.0-255,5738,271456,77,288934
7084,0.009873,172.31.40.0-255,66,271522,77,288934
7085,0.012428,74.125.24.0-255,5738,277260,77,288934
7086,0.012443,172.31.40.0-255,66,277326,77,288934
7087,0.015026,74.125.24.0-255,5738,283064,77,288934
7088,0.015043,172.31.40.0-255,66,283130,77,288934
7089,0.017623,74.125.24.0-255,5738,288868,77,288934
7090,0.017638,172.31.40.0-255,66,288934,77,288934
7091,0.0,74.125.24.0-255,297,297,77,127512
7092,1.7e-05,172.31.40.0-255,66,363,77,127512
7093,2.4e-05,74.125.24.0-255,1484,1847,77,127512
7094,2.8e-05,172.31.40.0-255,66,1913,77,127512
7095,3.5e-05,74.125.24.0-255,4320,6233,77,127512
7096,3.9e-05,172.31.40.0-255,66,6299,77,127512
7097,0.000161,74.125.24.0-255,8896,15195,77,127512
7098,0.000166,172.31.40.0-255,66,15261,77,127512
7099,0.000423,74.125.24.0-255,4320,19581,77,127512
7100,0.000439,172.31.40.0-255,66,19647,77,127512
7101,0.000443,74.125.24.0-255,1484,21131,77,127512
7102,0.000445,172.31.40.0-255,66,21197,77,127512
7103,0.000605,74.125.24.0-255,8574,29771,77,127512
7104,0.00061,172.31.40.0-255,66,29837,77,127512
7105,0.00063,74.125.24.0-255,1125,30962,77,127512
7106,0.000633,172.31.40.0-255,66,31028,77,127512
7107,0.000895,74.125.24.0-255,11410,42438,77,127512
7108,0.000901,172.31.40.0-255,66,42504,77,127512
7109,0.000923,74.125.24.0-255,5379,47883,77,127512
7110,0.000927,172.31.40.0-255,66,47949,77,127512
7111,0.001393,74.125.24.0-255,7156,55105,77,127512
7112,0.0014,172.31.40.0-255,66,55171,77,127512
7113,0.001426,74.125.24.0-255,9966,65137,77,127512
7114,0.001429,172.31.40.0-255,66,65203,77,127512
7115,0.001881,74.125.24.0-255,110,65313,77,127512
7116,0.001887,172.31.40.0-255,66,65379,77,127512
7117,0.001903,74.125.24.0-255,1484,66863,77,127512
7118,0.001905,172.31.40.0-255,66,66929,77,127512
7119,0.001955,172.31.40.0-255,66,66995,77,127512
7120,0.002495,74.125.24.0-255,4320,71315,77,127512
7121,0.002501,172.31.40.0-255,66,71381,77,127512
7122,0.002528,74.125.24.0-255,9633,81014,77,127512
7123,0.002531,172.31.40.0-255,66,81080,77,127512
7124,0.004574,74.125.24.0-255,5738,86818,77,127512
7125,0.004581,172.31.40.0-255,66,86884,77,127512
7126,0.006638,74.125.24.0-255,5738,92622,77,127512
7127,0.006644,172.31.40.0-255,66,92688,77,127512
7128,0.008682,74.125.24.0-255,5738,98426,77,127512
7129,0.008689,172.31.40.0-255,66,98492,77,127512
7130,0.010756,74.125.24.0-255,5738,104230,77,127512
7131,0.010764,172.31.40.0-255,66,104296,77,127512
7132,0.012816,74.125.24.0-255,5738,110034,77,127512
7133,0.012823,172.31.40.0-255,66,110100,77,127512
7134,0.014869,74.125.24.0-255,5738,115838,77,127512
7135,0.014878,172.31.40.0-255,66,115904,77,127512
7136,0.016932,74.125.24.0-255,5738,121642,77,127512
7137,0.01694,172.31.40.0-255,66,121708,77,127512
7138,0.018997,74.125.24.0-255,5738,127446,77,127512
7139,0.019005,172.31.40.0-255,66,127512,77,127512
7140,0.0,172.217.194.0-255,295,295,77,194025
7141,1.9e-05,172.31.40.0-255,66,361,77,194025
7142,2.4e-05,172.217.194.0-255,1484,1845,77,194025
7143,2.8e-05,172.31.40.0-255,66,1911,77,194025
7144,3.4e-05,172.217.194.0-255,2902,4813,77,194025
7145,3.6e-05,172.31.40.0-255,66,4879,77,194025
7146,4.3e-05,172.217.194.0-255,5738,10617,77,194025
7147,4.5e-05,172.31.40.0-255,66,10683,77,194025
7148,7.7e-05,172.217.194.0-255,3213,13896,77,194025
7149,7.9e-05,172.31.40.0-255,66,13962,77,194025
7150,0.000114,172.217.194.0-255,1484,15446,77,194025
7151,0.000117,172.31.40.0-255,66,15512,77,194025
7152,0.000136,172.217.194.0-255,2902,18414,77,194025
7153,0.000138,172.31.40.0-255,66,18480,77,194025
7154,0.000143,172.217.194.0-255,5738,24218,77,194025
7155,0.000145,172.31.40.0-255,66,24284,77,194025
7156,0.000169,172.217.194.0-255,1484,25768,77,194025
7157,0.000171,172.31.40.0-255,66,25834,77,194025
7158,0.000197,172.217.194.0-255,11051,36885,77,194025
7159,0.000199,172.31.40.0-255,66,36951,77,194025
7160,0.000242,172.217.194.0-255,9992,46943,77,194025
7161,0.000245,172.31.40.0-255,66,47009,77,194025
7162,0.000259,172.217.194.0-255,1125,48134,77,194025
7163,0.000261,172.31.40.0-255,66,48200,77,194025
7164,0.000527,172.217.194.0-255,1484,49684,77,194025
7165,0.000531,172.31.40.0-255,66,49750,77,194025
7166,0.000536,172.217.194.0-255,1484,51234,77,194025
7167,0.000537,172.31.40.0-255,66,51300,77,194025
7168,0.000553,172.217.194.0-255,1484,52784,77,194025
7169,0.000555,172.31.40.0-255,66,52850,77,194025
7170,0.000562,172.217.194.0-255,5738,58588,77,194025
7171,0.000563,172.31.40.0-255,66,58654,77,194025
7172,0.000567,172.217.194.0-255,2902,61556,77,194025
7173,0.000575,172.31.40.0-255,66,61622,77,194025
7174,0.000624,172.217.194.0-255,2902,64524,77,194025
7175,0.000642,172.31.40.0-255,66,64590,77,194025
7176,0.000646,172.217.194.0-255,1705,66295,77,194025
7177,0.00065,172.31.40.0-255,66,66361,77,194025
7178,0.000698,172.217.194.0-255,1484,67845,77,194025
7179,0.000702,172.217.194.0-255,1484,69329,77,194025
7180,0.000716,172.217.194.0-255,1484,70813,77,194025
7181,0.000723,172.217.194.0-255,5738,76551,77,194025
7182,0.000728,172.31.40.0-255,66,76617,77,194025
7183,0.000763,172.217.194.0-255,2902,79519,77,194025
7184,0.000778,172.31.40.0-255,66,79585,77,194025
7185,0.000793,172.217.194.0-255,9992,89577,77,194025
7186,0.0008,172.217.194.0-255,5738,95315,77,194025
7187,0.000805,172.31.40.0-255,66,95381,77,194025
7188,0.00085,172.217.194.0-255,5020,100401,77,194025
7189,0.000858,172.31.40.0-255,66,100467,77,194025
7190,0.001366,172.217.194.0-255,1484,101951,77,194025
7191,0.001384,172.217.194.0-255,2902,104853,77,194025
7192,0.001387,172.31.40.0-255,66,104919,77,194025
7193,0.001411,172.217.194.0-255,5738,110657,77,194025
7194,0.001413,172.31.40.0-255,66,110723,77,194025
7195,0.001444,172.217.194.0-255,9070,119793,77,194025
7196,0.001446,172.31.40.0-255,66,119859,77,194025
7197,0.001453,172.217.194.0-255,7156,127015,77,194025
7198,0.001455,172.31.40.0-255,66,127081,77,194025
7199,0.001469,172.217.194.0-255,2902,129983,77,194025
7200,0.001471,172.31.40.0-255,66,130049,77,194025
7201,0.001532,172.31.40.0-255,66,130115,77,194025
7202,0.001982,172.217.194.0-255,1484,131599,77,194025
7203,0.001992,172.217.194.0-255,2902,134501,77,194025
7204,0.001996,172.31.40.0-255,66,134567,77,194025
7205,0.002025,172.217.194.0-255,5738,140305,77,194025
7206,0.002028,172.31.40.0-255,66,140371,77,194025
7207,0.002036,172.217.194.0-255,7156,147527,77,194025
7208,0.002038,172.31.40.0-255,66,147593,77,194025
7209,0.004026,172.217.194.0-255,5738,153331,77,194025
7210,0.004033,172.31.40.0-255,66,153397,77,194025
7211,0.006036,172.217.194.0-255,5738,159135,77,194025
7212,0.00604,172.31.40.0-255,66,159201,77,194025
7213,0.008032,172.217.194.0-255,5738,164939,77,194025
7214,0.008037,172.31.40.0-255,66,165005,77,194025
7215,0.010066,172.217.194.0-255,5738,170743,77,194025
7216,0.010072,172.31.40.0-255,66,170809,77,194025
7217,0.012117,172.217.194.0-255,5738,176547,77,194025
7218,0.012124,172.31.40.0-255,66,176613,77,194025
7219,0.014124,172.217.194.0-255,5738,182351,77,194025
7220,0.014132,172.31.40.0-255,66,182417,77,194025
7221,0.016133,172.217.194.0-255,5738,188155,77,194025
7222,0.01614,172.31.40.0-255,66,188221,77,194025
7223,0.018132,172.217.194.0-255,5738,193959,77,194025
7224,0.01814,172.31.40.0-255,66,194025,77,194025
7225,0.0,172.31.40.0-255,105,105,77,459
7226,0.000233,172.31.40.0-255,90,195,77,459
7227,0.000243,172.31.40.0-255,66,261,77,459
7228,0.002761,172.217.194.0-255,66,327,77,459
7229,0.002884,172.217.194.0-255,66,393,77,459
7230,0.002908,172.31.40.0-255,66,459,77,459
7231,0.0,172.217.194.0-255,150,150,77,133485
7232,2.3e-05,172.31.40.0-255,66,216,77,133485
7233,3e-05,172.217.194.0-255,1484,1700,77,133485
7234,3.4e-05,172.31.40.0-255,66,1766,77,133485
7235,4e-05,172.217.194.0-255,2902,4668,77,133485
7236,4.3e-05,172.31.40.0-255,66,4734,77,133485
7237,5.1e-05,172.217.194.0-255,7156,11890,77,133485
7238,5.4e-05,172.31.40.0-255,66,11956,77,133485
7239,0.000105,172.217.194.0-255,2902,14858,77,133485
7240,0.000108,172.31.40.0-255,66,14924,77,133485
7241,0.000127,172.217.194.0-255,3440,18364,77,133485
7242,0.000129,172.31.40.0-255,66,18430,77,133485
7243,0.000159,172.217.194.0-255,7156,25586,77,133485
7244,0.000161,172.31.40.0-255,66,25652,77,133485
7245,0.000197,172.217.194.0-255,5379,31031,77,133485
7246,0.0002,172.31.40.0-255,66,31097,77,133485
7247,0.000248,172.217.194.0-255,8574,39671,77,133485
7248,0.000251,172.31.40.0-255,66,39737,77,133485
7249,0.000272,172.217.194.0-255,4320,44057,77,133485
7250,0.000274,172.31.40.0-255,66,44123,77,133485
7251,0.000343,172.217.194.0-255,4320,48443,77,133485
7252,0.000348,172.31.40.0-255,66,48509,77,133485
7253,0.000383,172.31.40.0-255,66,48575,77,133485
7254,0.000502,172.217.194.0-255,1377,49952,77,133485
7255,0.000506,172.31.40.0-255,66,50018,77,133485
7256,0.000509,172.217.194.0-255,434,50452,77,133485
7257,0.000511,172.31.40.0-255,66,50518,77,133485
7258,0.000529,172.217.194.0-255,2902,53420,77,133485
7259,0.000531,172.31.40.0-255,66,53486,77,133485
7260,0.000551,172.217.194.0-255,1484,54970,77,133485
7261,0.000553,172.31.40.0-255,66,55036,77,133485
7262,0.000561,172.217.194.0-255,7156,62192,77,133485
7263,0.000574,172.31.40.0-255,66,62258,77,133485
7264,0.000583,172.217.194.0-255,1484,63742,77,133485
7265,0.000633,172.217.194.0-255,4320,68062,77,133485
7266,0.000656,172.217.194.0-255,12828,80890,77,133485
7267,0.00066,172.31.40.0-255,66,80956,77,133485
7268,0.000665,172.31.40.0-255,66,81022,77,133485
7269,0.000673,172.217.194.0-255,1484,82506,77,133485
7270,0.000776,172.217.194.0-255,2184,84690,77,133485
7271,0.000782,172.31.40.0-255,66,84756,77,133485
7272,0.000825,172.31.40.0-255,66,84822,77,133485
7273,0.000991,172.217.194.0-255,8574,93396,77,133485
7274,0.001005,172.31.40.0-255,66,93462,77,133485
7275,0.001017,172.217.194.0-255,2184,95646,77,133485
7276,0.001034,172.31.40.0-255,66,95712,77,133485
7277,0.001086,172.217.194.0-255,2902,98614,77,133485
7278,0.001091,172.31.40.0-255,66,98680,77,133485
7279,0.001182,172.31.40.0-255,66,98746,77,133485
7280,0.001396,172.217.194.0-255,4320,103066,77,133485
7281,0.001401,172.31.40.0-255,66,103132,77,133485
7282,0.001463,172.31.40.0-255,66,103198,77,133485
7283,0.001625,172.217.194.0-255,5738,108936,77,133485
7284,0.001629,172.31.40.0-255,66,109002,77,133485
7285,0.001675,172.31.40.0-255,66,109068,77,133485
7286,0.001898,172.217.194.0-255,4320,113388,77,133485
7287,0.001903,172.31.40.0-255,66,113454,77,133485
7288,0.001953,172.31.40.0-255,66,113520,77,133485
7289,0.00199,172.31.40.0-255,66,113586,77,133485
7290,0.00242,172.217.194.0-255,6438,120024,77,133485
7291,0.002424,172.31.40.0-255,66,120090,77,133485
7292,0.002467,172.217.194.0-255,4320,124410,77,133485
7293,0.002476,172.31.40.0-255,66,124476,77,133485
7294,0.002515,172.31.40.0-255,66,124542,77,133485
7295,0.002618,172.31.40.0-255,66,124608,77,133485
7296,0.003015,172.217.194.0-255,8574,133182,77,133485
7297,0.00302,172.31.40.0-255,66,133248,77,133485
7298,0.003086,172.31.40.0-255,66,133314,77,133485
7299,0.004409,172.31.40.0-255,105,133419,77,133485
7300,0.006319,172.217.194.0-255,66,133485,77,133485
7301,0.0,172.217.194.0-255,146,146,77,202928
7302,2.2e-05,172.31.40.0-255,66,212,77,202928
7303,3e-05,172.217.194.0-255,1484,1696,77,202928
7304,3.5e-05,172.31.40.0-255,66,1762,77,202928
7305,5e-05,172.217.194.0-255,2902,4664,77,202928
7306,5.5e-05,172.31.40.0-255,66,4730,77,202928
7307,6.2e-05,172.217.194.0-255,7156,11886,77,202928
7308,6.5e-05,172.31.40.0-255,66,11952,77,202928
7309,6.9e-05,172.217.194.0-255,2050,14002,77,202928
7310,7.2e-05,172.31.40.0-255,66,14068,77,202928
7311,7.5e-05,172.217.194.0-255,1484,15552,77,202928
7312,7.7e-05,172.31.40.0-255,66,15618,77,202928
7313,8.2e-05,172.217.194.0-255,2902,18520,77,202928
7314,8.5e-05,172.31.40.0-255,66,18586,77,202928
7315,8.9e-05,172.217.194.0-255,2902,21488,77,202928
7316,9.1e-05,172.31.40.0-255,66,21554,77,202928
7317,0.000114,172.217.194.0-255,2902,24456,77,202928
7318,0.000121,172.31.40.0-255,66,24522,77,202928
7319,0.000128,172.217.194.0-255,6797,31319,77,202928
7320,0.000131,172.31.40.0-255,66,31385,77,202928
7321,0.000176,172.217.194.0-255,1484,32869,77,202928
7322,0.000179,172.31.40.0-255,66,32935,77,202928
7323,0.000186,172.217.194.0-255,2902,35837,77,202928
7324,0.000188,172.31.40.0-255,66,35903,77,202928
7325,0.000219,172.217.194.0-255,5738,41641,77,202928
7326,0.000222,172.31.40.0-255,66,41707,77,202928
7327,0.000228,172.217.194.0-255,4320,46027,77,202928
7328,0.00023,172.31.40.0-255,66,46093,77,202928
7329,0.000248,172.217.194.0-255,2543,48636,77,202928
7330,0.000254,172.31.40.0-255,66,48702,77,202928
7331,0.001335,172.217.194.0-255,1484,50186,77,202928
7332,0.001342,172.31.40.0-255,66,50252,77,202928
7333,0.001353,172.217.194.0-255,2902,53154,77,202928
7334,0.001355,172.31.40.0-255,66,53220,77,202928
7335,0.001368,172.217.194.0-255,5738,58958,77,202928
7336,0.00137,172.31.40.0-255,66,59024,77,202928
7337,0.001398,172.217.194.0-255,6797,65821,77,202928
7338,0.001401,172.31.40.0-255,66,65887,77,202928
7339,0.001426,172.217.194.0-255,1484,67371,77,202928
7340,0.001441,172.217.194.0-255,2902,70273,77,202928
7341,0.001443,172.31.40.0-255,66,70339,77,202928
7342,0.001448,172.217.194.0-255,2902,73241,77,202928
7343,0.001449,172.31.40.0-255,66,73307,77,202928
7344,0.001475,172.217.194.0-255,2902,76209,77,202928
7345,0.001477,172.31.40.0-255,66,76275,77,202928
7346,0.001485,172.217.194.0-255,7378,83653,77,202928
7347,0.001487,172.31.40.0-255,66,83719,77,202928
7348,0.001528,172.217.194.0-255,4320,88039,77,202928
7349,0.001531,172.31.40.0-255,66,88105,77,202928
7350,0.001555,172.217.194.0-255,11410,99515,77,202928
7351,0.001558,172.31.40.0-255,66,99581,77,202928
7352,0.001561,172.217.194.0-255,1125,100706,77,202928
7353,0.001913,172.217.194.0-255,1484,102190,77,202928
7354,0.001918,172.31.40.0-255,66,102256,77,202928
7355,0.001924,172.217.194.0-255,2902,105158,77,202928
7356,0.001926,172.31.40.0-255,66,105224,77,202928
7357,0.001954,172.217.194.0-255,4320,109544,77,202928
7358,0.001956,172.31.40.0-255,66,109610,77,202928
7359,0.001981,172.217.194.0-255,1484,111094,77,202928
7360,0.001994,172.217.194.0-255,12828,123922,77,202928
7361,0.001997,172.31.40.0-255,66,123988,77,202928
7362,0.002006,172.217.194.0-255,10142,134130,77,202928
7363,0.002009,172.31.40.0-255,66,134196,77,202928
7364,0.00204,172.217.194.0-255,5738,139934,77,202928
7365,0.002042,172.31.40.0-255,66,140000,77,202928
7366,0.002071,172.217.194.0-255,4320,144320,77,202928
7367,0.002073,172.31.40.0-255,66,144386,77,202928
7368,0.002082,172.217.194.0-255,11410,155796,77,202928
7369,0.002088,172.31.40.0-255,66,155862,77,202928
7370,0.002091,172.217.194.0-255,1484,157346,77,202928
7371,0.002122,172.217.194.0-255,10692,168038,77,202928
7372,0.002124,172.31.40.0-255,66,168104,77,202928
7373,0.004759,172.217.194.0-255,5738,173842,77,202928
7374,0.004762,172.31.40.0-255,66,173908,77,202928
7375,0.007364,172.217.194.0-255,5738,179646,77,202928
7376,0.007371,172.31.40.0-255,66,179712,77,202928
7377,0.010004,172.217.194.0-255,5738,185450,77,202928
7378,0.010013,172.31.40.0-255,66,185516,77,202928
7379,0.012624,172.217.194.0-255,5738,191254,77,202928
7380,0.012632,172.31.40.0-255,66,191320,77,202928
7381,0.015267,172.217.194.0-255,5738,197058,77,202928
7382,0.015276,172.31.40.0-255,66,197124,77,202928
7383,0.017884,172.217.194.0-255,5738,202862,77,202928
7384,0.017893,172.31.40.0-255,66,202928,77,202928
7385,0.0,172.217.27.0-255,297,297,77,232500
7386,2.5e-05,172.31.40.0-255,66,363,77,232500
7387,3.2e-05,172.217.27.0-255,1484,1847,77,232500
7388,3.6e-05,172.31.40.0-255,66,1913,77,232500
7389,3.9e-05,172.217.27.0-255,1484,3397,77,232500
7390,4.1e-05,172.31.40.0-255,66,3463,77,232500
7391,5.5e-05,172.217.27.0-255,2902,6365,77,232500
7392,5.8e-05,172.31.40.0-255,66,6431,77,232500
7393,6.6e-05,172.217.27.0-255,5738,12169,77,232500
7394,6.9e-05,172.31.40.0-255,66,12235,77,232500
7395,7.8e-05,172.217.27.0-255,8992,21227,77,232500
7396,8.1e-05,172.31.40.0-255,66,21293,77,232500
7397,9e-05,172.217.27.0-255,9633,30926,77,232500
7398,9.4e-05,172.31.40.0-255,66,30992,77,232500
7399,0.00019,172.217.27.0-255,1484,32476,77,232500
7400,0.000193,172.31.40.0-255,66,32542,77,232500
7401,0.000198,172.217.27.0-255,2902,35444,77,232500
7402,0.0002,172.31.40.0-255,66,35510,77,232500
7403,0.000221,172.217.27.0-255,5738,41248,77,232500
7404,0.000228,172.31.40.0-255,66,41314,77,232500
7405,0.000269,172.217.27.0-255,9633,50947,77,232500
7406,0.000272,172.31.40.0-255,66,51013,77,232500
7407,0.000281,172.217.27.0-255,9992,61005,77,232500
7408,0.000283,172.31.40.0-255,66,61071,77,232500
7409,0.000293,172.217.27.0-255,3961,65032,77,232500
7410,0.000296,172.31.40.0-255,66,65098,77,232500
7411,0.000319,172.217.27.0-255,394,65492,77,232500
7412,0.000322,172.31.40.0-255,66,65558,77,232500
7413,0.000578,172.217.27.0-255,349,65907,77,232500
7414,0.000584,172.31.40.0-255,66,65973,77,232500
7415,0.000726,172.217.27.0-255,1484,67457,77,232500
7416,0.000731,172.31.40.0-255,66,67523,77,232500
7417,0.000737,172.217.27.0-255,2902,70425,77,232500
7418,0.00074,172.31.40.0-255,66,70491,77,232500
7419,0.000772,172.217.27.0-255,4320,74811,77,232500
7420,0.000776,172.31.40.0-255,66,74877,77,232500
7421,0.000779,172.217.27.0-255,1484,76361,77,232500
7422,0.000813,172.217.27.0-255,8215,84576,77,232500
7423,0.000815,172.31.40.0-255,66,84642,77,232500
7424,0.000818,172.217.27.0-255,1484,86126,77,232500
7425,0.000856,172.217.27.0-255,12828,98954,77,232500
7426,0.000859,172.31.40.0-255,66,99020,77,232500
7427,0.000862,172.217.27.0-255,1125,100145,77,232500
7428,0.001033,172.217.27.0-255,1484,101629,77,232500
7429,0.001037,172.31.40.0-255,66,101695,77,232500
7430,0.00105,172.217.27.0-255,1484,103179,77,232500
7431,0.001058,172.217.27.0-255,2902,106081,77,232500
7432,0.001061,172.31.40.0-255,66,106147,77,232500
7433,0.001106,172.217.27.0-255,5738,111885,77,232500
7434,0.00111,172.31.40.0-255,66,111951,77,232500
7435,0.001153,172.217.27.0-255,5738,117689,77,232500
7436,0.001156,172.31.40.0-255,66,117755,77,232500
7437,0.001185,172.217.27.0-255,4320,122075,77,232500
7438,0.001188,172.31.40.0-255,66,122141,77,232500
7439,0.001198,172.217.27.0-255,11410,133551,77,232500
7440,0.001204,172.31.40.0-255,66,133617,77,232500
7441,0.001207,172.217.27.0-255,766,134383,77,232500
7442,0.001344,172.31.40.0-255,101,134484,77,232500
7443,0.00143,172.217.27.0-255,1484,135968,77,232500
7444,0.001445,172.217.27.0-255,2902,138870,77,232500
7445,0.001448,172.31.40.0-255,66,138936,77,232500
7446,0.001451,172.217.27.0-255,1484,140420,77,232500
7447,0.001455,172.217.27.0-255,2902,143322,77,232500
7448,0.001457,172.31.40.0-255,66,143388,77,232500
7449,0.001487,172.217.27.0-255,5738,149126,77,232500
7450,0.00149,172.31.40.0-255,66,149192,77,232500
7451,0.001523,172.217.27.0-255,12828,162020,77,232500
7452,0.001527,172.31.40.0-255,66,162086,77,232500
7453,0.001563,172.217.27.0-255,6438,168524,77,232500
7454,0.001566,172.31.40.0-255,66,168590,77,232500
7455,0.002948,172.217.27.0-255,66,168656,77,232500
7456,0.003186,172.217.27.0-255,5738,174394,77,232500
7457,0.003192,172.31.40.0-255,66,174460,77,232500
7458,0.004814,172.217.27.0-255,5738,180198,77,232500
7459,0.00482,172.31.40.0-255,66,180264,77,232500
7460,0.006449,172.217.27.0-255,5738,186002,77,232500
7461,0.006456,172.31.40.0-255,66,186068,77,232500
7462,0.008089,172.217.27.0-255,5738,191806,77,232500
7463,0.008094,172.31.40.0-255,66,191872,77,232500
7464,0.009716,172.217.27.0-255,5738,197610,77,232500
7465,0.009721,172.31.40.0-255,66,197676,77,232500
7466,0.011349,172.217.27.0-255,5738,203414,77,232500
7467,0.011356,172.31.40.0-255,66,203480,77,232500
7468,0.012989,172.217.27.0-255,5738,209218,77,232500
7469,0.012997,172.31.40.0-255,66,209284,77,232500
7470,0.014628,172.217.27.0-255,5738,215022,77,232500
7471,0.014636,172.31.40.0-255,66,215088,77,232500
7472,0.016267,172.217.27.0-255,5738,220826,77,232500
7473,0.016274,172.31.40.0-255,66,220892,77,232500
7474,0.017914,172.217.27.0-255,5738,226630,77,232500
7475,0.017922,172.31.40.0-255,66,226696,77,232500
7476,0.019539,172.217.27.0-255,5738,232434,77,232500
7477,0.019546,172.31.40.0-255,66,232500,77,232500
7478,0.0,74.125.130.0-255,153,153,77,243154
7479,1.7e-05,172.31.40.0-255,66,219,77,243154
7480,2.3e-05,74.125.130.0-255,1484,1703,77,243154
7481,2.8e-05,172.31.40.0-255,66,1769,77,243154
7482,3.1e-05,74.125.130.0-255,1484,3253,77,243154
7483,3.4e-05,172.31.40.0-255,66,3319,77,243154
7484,6.2e-05,74.125.130.0-255,1484,4803,77,243154
7485,6.6e-05,172.31.40.0-255,66,4869,77,243154
7486,7.4e-05,74.125.130.0-255,5738,10607,77,243154
7487,7.6e-05,172.31.40.0-255,66,10673,77,243154
7488,8.1e-05,74.125.130.0-255,3427,14100,77,243154
7489,8.4e-05,172.31.40.0-255,66,14166,77,243154
7490,0.000639,74.125.130.0-255,1484,15650,77,243154
7491,0.000646,172.31.40.0-255,66,15716,77,243154
7492,0.000656,74.125.130.0-255,2902,18618,77,243154
7493,0.000658,172.31.40.0-255,66,18684,77,243154
7494,0.000696,74.125.130.0-255,5738,24422,77,243154
7495,0.000699,172.31.40.0-255,66,24488,77,243154
7496,0.000733,74.125.130.0-255,6797,31285,77,243154
7497,0.000735,172.31.40.0-255,66,31351,77,243154
7498,0.000742,74.125.130.0-255,4320,35671,77,243154
7499,0.000745,172.31.40.0-255,66,35737,77,243154
7500,0.000772,74.125.130.0-255,5738,41475,77,243154
7501,0.000776,172.31.40.0-255,66,41541,77,243154
7502,0.000836,74.125.130.0-255,11410,52951,77,243154
7503,0.00084,172.31.40.0-255,66,53017,77,243154
7504,0.000846,74.125.130.0-255,4320,57337,77,243154
7505,0.000848,172.31.40.0-255,66,57403,77,243154
7506,0.000867,74.125.130.0-255,7856,65259,77,243154
7507,0.00087,172.31.40.0-255,66,65325,77,243154
7508,0.000905,74.125.130.0-255,378,65703,77,243154
7509,0.000908,172.31.40.0-255,66,65769,77,243154
7510,0.000953,74.125.130.0-255,365,66134,77,243154
7511,0.001063,74.125.130.0-255,1484,67618,77,243154
7512,0.001069,172.31.40.0-255,66,67684,77,243154
7513,0.001075,74.125.130.0-255,2902,70586,77,243154
7514,0.001077,172.31.40.0-255,66,70652,77,243154
7515,0.001097,74.125.130.0-255,4320,74972,77,243154
7516,0.0011,172.31.40.0-255,66,75038,77,243154
7517,0.00112,74.125.130.0-255,1484,76522,77,243154
7518,0.001124,74.125.130.0-255,1484,78006,77,243154
7519,0.001126,172.31.40.0-255,66,78072,77,243154
7520,0.001134,74.125.130.0-255,8574,86646,77,243154
7521,0.001137,172.31.40.0-255,66,86712,77,243154
7522,0.001161,74.125.130.0-255,1484,88196,77,243154
7523,0.001177,74.125.130.0-255,8574,96770,77,243154
7524,0.001181,172.31.40.0-255,66,96836,77,243154
7525,0.001196,74.125.130.0-255,1484,98320,77,243154
7526,0.00121,74.125.130.0-255,2184,100504,77,243154
7527,0.001213,172.31.40.0-255,66,100570,77,243154
7528,0.001532,74.125.130.0-255,1484,102054,77,243154
7529,0.00154,74.125.130.0-255,2902,104956,77,243154
7530,0.001546,172.31.40.0-255,66,105022,77,243154
7531,0.00155,74.125.130.0-255,1484,106506,77,243154
7532,0.001569,74.125.130.0-255,2902,109408,77,243154
7533,0.001572,172.31.40.0-255,66,109474,77,243154
7534,0.001577,74.125.130.0-255,2902,112376,77,243154
7535,0.001579,172.31.40.0-255,66,112442,77,243154
7536,0.001591,74.125.130.0-255,2902,115344,77,243154
7537,0.001594,172.31.40.0-255,66,115410,77,243154
7538,0.001597,74.125.130.0-255,1484,116894,77,243154
7539,0.001617,74.125.130.0-255,8574,125468,77,243154
7540,0.00162,172.31.40.0-255,66,125534,77,243154
7541,0.00163,74.125.130.0-255,1484,127018,77,243154
7542,0.001665,74.125.130.0-255,2902,129920,77,243154
7543,0.001669,172.31.40.0-255,66,129986,77,243154
7544,0.001693,74.125.130.0-255,5020,135006,77,243154
7545,0.001696,172.31.40.0-255,66,135072,77,243154
7546,0.001734,74.125.130.0-255,1484,136556,77,243154
7547,0.001748,74.125.130.0-255,2902,139458,77,243154
7548,0.00175,172.31.40.0-255,66,139524,77,243154
7549,0.001767,74.125.130.0-255,4320,143844,77,243154
7550,0.00177,172.31.40.0-255,66,143910,77,243154
7551,0.001792,74.125.130.0-255,2902,146812,77,243154
7552,0.001795,172.31.40.0-255,66,146878,77,243154
7553,0.001812,74.125.130.0-255,5738,152616,77,243154
7554,0.001814,172.31.40.0-255,66,152682,77,243154
7555,0.001821,74.125.130.0-255,5738,158420,77,243154
7556,0.001824,172.31.40.0-255,66,158486,77,243154
7557,0.001826,74.125.130.0-255,1484,159970,77,243154
7558,0.001845,74.125.130.0-255,5738,165708,77,243154
7559,0.001847,172.31.40.0-255,66,165774,77,243154
7560,0.00185,74.125.130.0-255,1484,167258,77,243154
7561,0.001867,74.125.130.0-255,2184,169442,77,243154
7562,0.001869,172.31.40.0-255,66,169508,77,243154
7563,0.001976,74.125.130.0-255,1484,170992,77,243154
7564,0.00199,74.125.130.0-255,2902,173894,77,243154
7565,0.001994,172.31.40.0-255,66,173960,77,243154
7566,0.002005,74.125.130.0-255,1484,175444,77,243154
7567,0.002022,74.125.130.0-255,4320,179764,77,243154
7568,0.002025,172.31.40.0-255,66,179830,77,243154
7569,0.00203,74.125.130.0-255,4320,184150,77,243154
7570,0.002032,172.31.40.0-255,66,184216,77,243154
7571,0.002038,74.125.130.0-255,5738,189954,77,243154
7572,0.002041,172.31.40.0-255,66,190020,77,243154
7573,0.002065,74.125.130.0-255,2902,192922,77,243154
7574,0.002068,172.31.40.0-255,66,192988,77,243154
7575,0.002093,74.125.130.0-255,8574,201562,77,243154
7576,0.002096,172.31.40.0-255,66,201628,77,243154
7577,0.0021,74.125.130.0-255,2184,203812,77,243154
7578,0.002102,172.31.40.0-255,66,203878,77,243154
7579,0.004382,74.125.130.0-255,4320,208198,77,243154
7580,0.004388,172.31.40.0-255,66,208264,77,243154
7581,0.004407,74.125.130.0-255,1484,209748,77,243154
7582,0.006647,74.125.130.0-255,4320,214068,77,243154
7583,0.006654,172.31.40.0-255,66,214134,77,243154
7584,0.008908,74.125.130.0-255,5738,219872,77,243154
7585,0.008916,172.31.40.0-255,66,219938,77,243154
7586,0.011174,74.125.130.0-255,5738,225676,77,243154
7587,0.011181,172.31.40.0-255,66,225742,77,243154
7588,0.01344,74.125.130.0-255,5738,231480,77,243154
7589,0.013448,172.31.40.0-255,66,231546,77,243154
7590,0.015708,74.125.130.0-255,5738,237284,77,243154
7591,0.015718,172.31.40.0-255,66,237350,77,243154
7592,0.017983,74.125.130.0-255,5738,243088,77,243154
7593,0.017995,172.31.40.0-255,66,243154,77,243154
7594,0.0,172.217.194.0-255,152,152,77,384453
7595,3.2e-05,172.31.40.0-255,66,218,77,384453
7596,3.9e-05,172.217.194.0-255,1484,1702,77,384453
7597,4.3e-05,172.31.40.0-255,66,1768,77,384453
7598,4.7e-05,172.217.194.0-255,2902,4670,77,384453
7599,5e-05,172.31.40.0-255,66,4736,77,384453
7600,5.8e-05,172.217.194.0-255,7156,11892,77,384453
7601,6e-05,172.31.40.0-255,66,11958,77,384453
7602,6.4e-05,172.217.194.0-255,1978,13936,77,384453
7603,6.7e-05,172.31.40.0-255,66,14002,77,384453
7604,0.000112,172.217.194.0-255,1484,15486,77,384453
7605,0.000115,172.31.40.0-255,66,15552,77,384453
7606,0.000142,172.217.194.0-255,2902,18454,77,384453
7607,0.000147,172.31.40.0-255,66,18520,77,384453
7608,0.000153,172.217.194.0-255,5738,24258,77,384453
7609,0.000155,172.31.40.0-255,66,24324,77,384453
7610,0.000172,172.217.194.0-255,6797,31121,77,384453
7611,0.000175,172.31.40.0-255,66,31187,77,384453
7612,0.000373,172.217.194.0-255,1484,32671,77,384453
7613,0.000377,172.31.40.0-255,66,32737,77,384453
7614,0.000382,172.217.194.0-255,2902,35639,77,384453
7615,0.000385,172.31.40.0-255,66,35705,77,384453
7616,0.000404,172.217.194.0-255,5738,41443,77,384453
7617,0.00041,172.31.40.0-255,66,41509,77,384453
7618,0.000414,172.217.194.0-255,1484,42993,77,384453
7619,0.000417,172.31.40.0-255,66,43059,77,384453
7620,0.000437,172.217.194.0-255,5379,48438,77,384453
7621,0.000441,172.31.40.0-255,66,48504,77,384453
7622,0.000477,172.217.194.0-255,2902,51406,77,384453
7623,0.000481,172.31.40.0-255,66,51472,77,384453
7624,0.000486,172.217.194.0-255,4320,55792,77,384453
7625,0.000488,172.31.40.0-255,66,55858,77,384453
7626,0.000502,172.217.194.0-255,1484,57342,77,384453
7627,0.000526,172.217.194.0-255,7156,64498,77,384453
7628,0.00053,172.31.40.0-255,66,64564,77,384453
7629,0.000533,172.217.194.0-255,1125,65689,77,384453
7630,0.000781,172.217.194.0-255,649,66338,77,384453
7631,0.000785,172.31.40.0-255,66,66404,77,384453
7632,0.000892,172.217.194.0-255,1484,67888,77,384453
7633,0.000917,172.217.194.0-255,2902,70790,77,384453
7634,0.00092,172.31.40.0-255,66,70856,77,384453
7635,0.000926,172.217.194.0-255,4320,75176,77,384453
7636,0.000928,172.31.40.0-255,66,75242,77,384453
7637,0.000948,172.217.194.0-255,1484,76726,77,384453
7638,0.000955,172.217.194.0-255,7156,83882,77,384453
7639,0.000958,172.31.40.0-255,66,83948,77,384453
7640,0.00099,172.217.194.0-255,7156,91104,77,384453
7641,0.000993,172.31.40.0-255,66,91170,77,384453
7642,0.001013,172.217.194.0-255,7156,98326,77,384453
7643,0.001015,172.31.40.0-255,66,98392,77,384453
7644,0.001019,172.217.194.0-255,2184,100576,77,384453
7645,0.001021,172.31.40.0-255,66,100642,77,384453
7646,0.001371,172.217.194.0-255,1484,102126,77,384453
7647,0.001379,172.217.194.0-255,2902,105028,77,384453
7648,0.001383,172.31.40.0-255,66,105094,77,384453
7649,0.001389,172.217.194.0-255,4320,109414,77,384453
7650,0.001391,172.31.40.0-255,66,109480,77,384453
7651,0.001407,172.217.194.0-255,1484,110964,77,384453
7652,0.001412,172.217.194.0-255,4320,115284,77,384453
7653,0.001414,172.31.40.0-255,66,115350,77,384453
7654,0.001431,172.217.194.0-255,8574,123924,77,384453
7655,0.001433,172.31.40.0-255,66,123990,77,384453
7656,0.001439,172.217.194.0-255,5738,129728,77,384453
7657,0.001441,172.31.40.0-255,66,129794,77,384453
7658,0.001465,172.217.194.0-255,5020,134814,77,384453
7659,0.001468,172.31.40.0-255,66,134880,77,384453
7660,0.00151,172.217.194.0-255,1484,136364,77,384453
7661,0.001516,172.217.194.0-255,2902,139266,77,384453
7662,0.001519,172.31.40.0-255,66,139332,77,384453
7663,0.001525,172.217.194.0-255,5738,145070,77,384453
7664,0.001527,172.31.40.0-255,66,145136,77,384453
7665,0.001542,172.217.194.0-255,2902,148038,77,384453
7666,0.001545,172.31.40.0-255,66,148104,77,384453
7667,0.001565,172.217.194.0-255,4320,152424,77,384453
7668,0.001567,172.31.40.0-255,66,152490,77,384453
7669,0.001573,172.217.194.0-255,4320,156810,77,384453
7670,0.001576,172.31.40.0-255,66,156876,77,384453
7671,0.001595,172.217.194.0-255,9992,166868,77,384453
7672,0.0016,172.31.40.0-255,66,166934,77,384453
7673,0.001604,172.217.194.0-255,2184,169118,77,384453
7674,0.001606,172.31.40.0-255,66,169184,77,384453
7675,0.001637,172.217.194.0-255,1484,170668,77,384453
7676,0.001642,172.217.194.0-255,2902,173570,77,384453
7677,0.001645,172.31.40.0-255,66,173636,77,384453
7678,0.00167,172.217.194.0-255,5738,179374,77,384453
7679,0.001674,172.31.40.0-255,66,179440,77,384453
7680,0.001678,172.217.194.0-255,4320,183760,77,384453
7681,0.00168,172.31.40.0-255,66,183826,77,384453
7682,0.001708,172.217.194.0-255,8574,192400,77,384453
7683,0.001713,172.31.40.0-255,66,192466,77,384453
7684,0.001722,172.217.194.0-255,10692,203158,77,384453
7685,0.001724,172.31.40.0-255,66,203224,77,384453
7686,0.001751,172.217.194.0-255,7156,210380,77,384453
7687,0.001753,172.31.40.0-255,66,210446,77,384453
7688,0.0018,172.217.194.0-255,5738,216184,77,384453
7689,0.001804,172.31.40.0-255,66,216250,77,384453
7690,0.001819,172.31.40.0-255,66,216316,77,384453
7691,0.001825,172.217.194.0-255,6438,222754,77,384453
7692,0.001828,172.31.40.0-255,66,222820,77,384453
7693,0.001834,172.217.194.0-255,7156,229976,77,384453
7694,0.001836,172.31.40.0-255,66,230042,77,384453
7695,0.001861,172.217.194.0-255,7156,237198,77,384453
7696,0.001865,172.31.40.0-255,66,237264,77,384453
7697,0.001894,172.217.194.0-255,8574,245838,77,384453
7698,0.001898,172.31.40.0-255,66,245904,77,384453
7699,0.001907,172.217.194.0-255,9992,255896,77,384453
7700,0.001909,172.31.40.0-255,66,255962,77,384453
7701,0.001937,172.217.194.0-255,766,256728,77,384453
7702,0.001949,172.217.194.0-255,11410,268138,77,384453
7703,0.001953,172.31.40.0-255,66,268204,77,384453
7704,0.002001,172.217.194.0-255,12828,281032,77,384453
7705,0.002007,172.31.40.0-255,66,281098,77,384453
7706,0.002035,172.217.194.0-255,9274,290372,77,384453
7707,0.002038,172.31.40.0-255,66,290438,77,384453
7708,0.002055,172.217.194.0-255,1484,291922,77,384453
7709,0.002068,172.217.194.0-255,2902,294824,77,384453
7710,0.00207,172.31.40.0-255,66,294890,77,384453
7711,0.002073,172.217.194.0-255,1484,296374,77,384453
7712,0.002098,172.217.194.0-255,4320,300694,77,384453
7713,0.002101,172.31.40.0-255,66,300760,77,384453
7714,0.002108,172.217.194.0-255,7156,307916,77,384453
7715,0.00211,172.31.40.0-255,66,307982,77,384453
7716,0.002115,172.217.194.0-255,4320,312302,77,384453
7717,0.002117,172.31.40.0-255,66,312368,77,384453
7718,0.00214,172.217.194.0-255,9992,322360,77,384453
7719,0.002143,172.31.40.0-255,66,322426,77,384453
7720,0.00216,172.217.194.0-255,2184,324610,77,384453
7721,0.002162,172.31.40.0-255,66,324676,77,384453
7722,0.002167,172.217.194.0-255,2902,327578,77,384453
7723,0.002168,172.31.40.0-255,66,327644,77,384453
7724,0.002193,172.217.194.0-255,7156,334800,77,384453
7725,0.002196,172.31.40.0-255,66,334866,77,384453
7726,0.002203,172.217.194.0-255,7156,342022,77,384453
7727,0.002205,172.31.40.0-255,66,342088,77,384453
7728,0.00223,172.217.194.0-255,2902,344990,77,384453
7729,0.002233,172.31.40.0-255,66,345056,77,384453
7730,0.002256,172.217.194.0-255,5738,350794,77,384453
7731,0.002259,172.31.40.0-255,66,350860,77,384453
7732,0.002286,172.217.194.0-255,7856,358716,77,384453
7733,0.002289,172.31.40.0-255,66,358782,77,384453
7734,0.00232,172.217.194.0-255,7156,365938,77,384453
7735,0.002323,172.31.40.0-255,66,366004,77,384453
7736,0.00233,172.217.194.0-255,8574,374578,77,384453
7737,0.002332,172.31.40.0-255,66,374644,77,384453
7738,0.002362,172.31.40.0-255,66,374710,77,384453
7739,0.002376,172.217.194.0-255,1484,376194,77,384453
7740,0.002379,172.217.194.0-255,766,376960,77,384453
7741,0.002381,172.31.40.0-255,66,377026,77,384453
7742,0.004664,172.217.194.0-255,4320,381346,77,384453
7743,0.004669,172.31.40.0-255,66,381412,77,384453
7744,0.004687,172.217.194.0-255,1484,382896,77,384453
7745,0.006965,172.217.194.0-255,1153,384049,77,384453
7746,0.006975,172.31.40.0-255,66,384115,77,384453
7747,0.010468,172.31.40.0-255,101,384216,77,384453
7748,0.012726,172.217.194.0-255,66,384282,77,384453
7749,0.01292,172.31.40.0-255,105,384387,77,384453
7750,0.015222,172.217.194.0-255,66,384453,77,384453
7751,0.0,74.125.200.0-255,153,153,77,243948
7752,2.5e-05,172.31.40.0-255,66,219,77,243948
7753,3.2e-05,74.125.200.0-255,1484,1703,77,243948
7754,3.7e-05,172.31.40.0-255,66,1769,77,243948
7755,4e-05,74.125.200.0-255,1484,3253,77,243948
7756,4.3e-05,172.31.40.0-255,66,3319,77,243948
7757,5.7e-05,74.125.200.0-255,2902,6221,77,243948
7758,6e-05,172.31.40.0-255,66,6287,77,243948
7759,6.6e-05,74.125.200.0-255,5738,12025,77,243948
7760,6.9e-05,172.31.40.0-255,66,12091,77,243948
7761,7.2e-05,74.125.200.0-255,1484,13575,77,243948
7762,7.4e-05,172.31.40.0-255,66,13641,77,243948
7763,0.000101,74.125.200.0-255,693,14334,77,243948
7764,0.000107,172.31.40.0-255,66,14400,77,243948
7765,0.000249,74.125.200.0-255,1484,15884,77,243948
7766,0.000254,172.31.40.0-255,66,15950,77,243948
7767,0.000301,74.125.200.0-255,2902,18852,77,243948
7768,0.000305,172.31.40.0-255,66,18918,77,243948
7769,0.000308,74.125.200.0-255,1484,20402,77,243948
7770,0.00031,172.31.40.0-255,66,20468,77,243948
7771,0.000315,74.125.200.0-255,2902,23370,77,243948
7772,0.000321,172.31.40.0-255,66,23436,77,243948
7773,0.000362,74.125.200.0-255,5738,29174,77,243948
7774,0.000365,172.31.40.0-255,66,29240,77,243948
7775,0.000368,74.125.200.0-255,1484,30724,77,243948
7776,0.00037,172.31.40.0-255,66,30790,77,243948
7777,0.000416,74.125.200.0-255,1484,32274,77,243948
7778,0.000418,172.31.40.0-255,66,32340,77,243948
7779,0.000444,74.125.200.0-255,8215,40555,77,243948
7780,0.000446,172.31.40.0-255,66,40621,77,243948
7781,0.000452,74.125.200.0-255,5738,46359,77,243948
7782,0.000454,172.31.40.0-255,66,46425,77,243948
7783,0.000477,74.125.200.0-255,4320,50745,77,243948
7784,0.000479,172.31.40.0-255,66,50811,77,243948
7785,0.000507,74.125.200.0-255,4320,55131,77,243948
7786,0.00051,172.31.40.0-255,66,55197,77,243948
7787,0.000545,74.125.200.0-255,7156,62353,77,243948
7788,0.000548,172.31.40.0-255,66,62419,77,243948
7789,0.000551,74.125.200.0-255,1484,63903,77,243948
7790,0.000556,74.125.200.0-255,2184,66087,77,243948
7791,0.000557,172.31.40.0-255,66,66153,77,243948
7792,0.000586,74.125.200.0-255,442,66595,77,243948
7793,0.000692,74.125.200.0-255,1484,68079,77,243948
7794,0.000695,172.31.40.0-255,66,68145,77,243948
7795,0.0007,74.125.200.0-255,2902,71047,77,243948
7796,0.000702,172.31.40.0-255,66,71113,77,243948
7797,0.000706,74.125.200.0-255,2902,74015,77,243948
7798,0.000708,172.31.40.0-255,66,74081,77,243948
7799,0.000745,74.125.200.0-255,4320,78401,77,243948
7800,0.000748,172.31.40.0-255,66,78467,77,243948
7801,0.000775,74.125.200.0-255,5738,84205,77,243948
7802,0.000778,172.31.40.0-255,66,84271,77,243948
7803,0.000796,74.125.200.0-255,2902,87173,77,243948
7804,0.000798,172.31.40.0-255,66,87239,77,243948
7805,0.000802,74.125.200.0-255,2902,90141,77,243948
7806,0.000803,172.31.40.0-255,66,90207,77,243948
7807,0.000851,74.125.200.0-255,5738,95945,77,243948
7808,0.000853,172.31.40.0-255,66,96011,77,243948
7809,0.00087,74.125.200.0-255,5287,101298,77,243948
7810,0.000872,172.31.40.0-255,66,101364,77,243948
7811,0.000999,74.125.200.0-255,1484,102848,77,243948
7812,0.001005,74.125.200.0-255,2902,105750,77,243948
7813,0.001008,172.31.40.0-255,66,105816,77,243948
7814,0.001032,74.125.200.0-255,5738,111554,77,243948
7815,0.001034,172.31.40.0-255,66,111620,77,243948
7816,0.001077,74.125.200.0-255,2902,114522,77,243948
7817,0.00108,172.31.40.0-255,66,114588,77,243948
7818,0.001113,74.125.200.0-255,9992,124580,77,243948
7819,0.001116,172.31.40.0-255,66,124646,77,243948
7820,0.001121,74.125.200.0-255,4320,128966,77,243948
7821,0.001123,172.31.40.0-255,66,129032,77,243948
7822,0.001128,74.125.200.0-255,4320,133352,77,243948
7823,0.001133,172.31.40.0-255,66,133418,77,243948
7824,0.00116,74.125.200.0-255,2184,135602,77,243948
7825,0.001163,172.31.40.0-255,66,135668,77,243948
7826,0.001185,74.125.200.0-255,1484,137152,77,243948
7827,0.001202,74.125.200.0-255,2902,140054,77,243948
7828,0.001204,172.31.40.0-255,66,140120,77,243948
7829,0.001207,74.125.200.0-255,1484,141604,77,243948
7830,0.00121,74.125.200.0-255,1484,143088,77,243948
7831,0.001211,172.31.40.0-255,66,143154,77,243948
7832,0.001232,74.125.200.0-255,1484,144638,77,243948
7833,0.001238,74.125.200.0-255,5738,150376,77,243948
7834,0.00124,172.31.40.0-255,66,150442,77,243948
7835,0.001262,74.125.200.0-255,2902,153344,77,243948
7836,0.001264,172.31.40.0-255,66,153410,77,243948
7837,0.001298,74.125.200.0-255,9992,163402,77,243948
7838,0.0013,172.31.40.0-255,66,163468,77,243948
7839,0.001326,74.125.200.0-255,6438,169906,77,243948
7840,0.001329,172.31.40.0-255,66,169972,77,243948
7841,0.001678,74.125.200.0-255,1484,171456,77,243948
7842,0.0017,74.125.200.0-255,2902,174358,77,243948
7843,0.001703,172.31.40.0-255,66,174424,77,243948
7844,0.001731,74.125.200.0-255,1484,175908,77,243948
7845,0.001736,74.125.200.0-255,2902,178810,77,243948
7846,0.001738,172.31.40.0-255,66,178876,77,243948
7847,0.001765,74.125.200.0-255,4320,183196,77,243948
7848,0.001767,172.31.40.0-255,66,183262,77,243948
7849,0.001798,74.125.200.0-255,1484,184746,77,243948
7850,0.001801,74.125.200.0-255,1484,186230,77,243948
7851,0.001803,172.31.40.0-255,66,186296,77,243948
7852,0.001808,74.125.200.0-255,2902,189198,77,243948
7853,0.001809,172.31.40.0-255,66,189264,77,243948
7854,0.001815,74.125.200.0-255,5738,195002,77,243948
7855,0.001817,172.31.40.0-255,66,195068,77,243948
7856,0.00182,74.125.200.0-255,1484,196552,77,243948
7857,0.001877,74.125.200.0-255,2902,199454,77,243948
7858,0.001881,172.31.40.0-255,66,199520,77,243948
7859,0.001907,74.125.200.0-255,5020,204540,77,243948
7860,0.00191,172.31.40.0-255,66,204606,77,243948
7861,0.004242,74.125.200.0-255,5738,210344,77,243948
7862,0.004249,172.31.40.0-255,66,210410,77,243948
7863,0.006572,74.125.200.0-255,1484,211894,77,243948
7864,0.006591,74.125.200.0-255,4320,216214,77,243948
7865,0.006594,172.31.40.0-255,66,216280,77,243948
7866,0.008927,74.125.200.0-255,4320,220600,77,243948
7867,0.008934,172.31.40.0-255,66,220666,77,243948
7868,0.008967,74.125.200.0-255,1484,222150,77,243948
7869,0.011274,74.125.200.0-255,4320,226470,77,243948
7870,0.011283,172.31.40.0-255,66,226536,77,243948
7871,0.013617,74.125.200.0-255,5738,232274,77,243948
7872,0.013626,172.31.40.0-255,66,232340,77,243948
7873,0.015967,74.125.200.0-255,5738,238078,77,243948
7874,0.015978,172.31.40.0-255,66,238144,77,243948
7875,0.018322,74.125.200.0-255,5738,243882,77,243948
7876,0.018332,172.31.40.0-255,66,243948,77,243948
7877,0.0,172.217.194.0-255,150,150,77,338711
7878,2e-05,172.31.40.0-255,66,216,77,338711
7879,2.6e-05,172.217.194.0-255,1484,1700,77,338711
7880,3.1e-05,172.31.40.0-255,66,1766,77,338711
7881,3.5e-05,172.217.194.0-255,2902,4668,77,338711
7882,3.8e-05,172.31.40.0-255,66,4734,77,338711
7883,4.5e-05,172.217.194.0-255,7156,11890,77,338711
7884,4.7e-05,172.31.40.0-255,66,11956,77,338711
7885,8.2e-05,172.217.194.0-255,2037,13993,77,338711
7886,8.5e-05,172.31.40.0-255,66,14059,77,338711
7887,0.000102,172.217.194.0-255,2902,16961,77,338711
7888,0.000104,172.31.40.0-255,66,17027,77,338711
7889,0.000116,172.217.194.0-255,1484,18511,77,338711
7890,0.000118,172.31.40.0-255,66,18577,77,338711
7891,0.000132,172.217.194.0-255,5738,24315,77,338711
7892,0.000134,172.31.40.0-255,66,24381,77,338711
7893,0.000137,172.217.194.0-255,1484,25865,77,338711
7894,0.000138,172.31.40.0-255,66,25931,77,338711
7895,0.000161,172.217.194.0-255,5379,31310,77,338711
7896,0.000165,172.31.40.0-255,66,31376,77,338711
7897,0.000236,172.217.194.0-255,1484,32860,77,338711
7898,0.00024,172.31.40.0-255,66,32926,77,338711
7899,0.000245,172.217.194.0-255,2902,35828,77,338711
7900,0.000246,172.31.40.0-255,66,35894,77,338711
7901,0.000269,172.217.194.0-255,5738,41632,77,338711
7902,0.000271,172.31.40.0-255,66,41698,77,338711
7903,0.000307,172.217.194.0-255,9992,51690,77,338711
7904,0.000309,172.31.40.0-255,66,51756,77,338711
7905,0.000326,172.217.194.0-255,2543,54299,77,338711
7906,0.000328,172.31.40.0-255,66,54365,77,338711
7907,0.000342,172.217.194.0-255,2902,57267,77,338711
7908,0.000344,172.31.40.0-255,66,57333,77,338711
7909,0.000365,172.217.194.0-255,5738,63071,77,338711
7910,0.000367,172.31.40.0-255,66,63137,77,338711
7911,0.000382,172.217.194.0-255,2844,65981,77,338711
7912,0.000384,172.31.40.0-255,66,66047,77,338711
7913,0.000386,172.217.194.0-255,384,66431,77,338711
7914,0.000699,172.217.194.0-255,1484,67915,77,338711
7915,0.000704,172.31.40.0-255,66,67981,77,338711
7916,0.000709,172.217.194.0-255,2902,70883,77,338711
7917,0.000711,172.31.40.0-255,66,70949,77,338711
7918,0.000713,172.217.194.0-255,1484,72433,77,338711
7919,0.000733,172.217.194.0-255,4320,76753,77,338711
7920,0.000735,172.31.40.0-255,66,76819,77,338711
7921,0.000772,172.217.194.0-255,12828,89647,77,338711
7922,0.000775,172.31.40.0-255,66,89713,77,338711
7923,0.000793,172.217.194.0-255,2902,92615,77,338711
7924,0.000795,172.31.40.0-255,66,92681,77,338711
7925,0.000809,172.217.194.0-255,7856,100537,77,338711
7926,0.000812,172.31.40.0-255,66,100603,77,338711
7927,0.001273,172.217.194.0-255,1484,102087,77,338711
7928,0.00128,172.217.194.0-255,2902,104989,77,338711
7929,0.001284,172.31.40.0-255,66,105055,77,338711
7930,0.001288,172.217.194.0-255,2902,107957,77,338711
7931,0.00129,172.31.40.0-255,66,108023,77,338711
7932,0.001307,172.217.194.0-255,2902,110925,77,338711
7933,0.001308,172.31.40.0-255,66,110991,77,338711
7934,0.001312,172.217.194.0-255,2902,113893,77,338711
7935,0.001314,172.31.40.0-255,66,113959,77,338711
7936,0.001316,172.217.194.0-255,1484,115443,77,338711
7937,0.001343,172.217.194.0-255,8574,124017,77,338711
7938,0.001345,172.31.40.0-255,66,124083,77,338711
7939,0.001364,172.217.194.0-255,2902,126985,77,338711
7940,0.001366,172.31.40.0-255,66,127051,77,338711
7941,0.001383,172.217.194.0-255,7856,134907,77,338711
7942,0.001385,172.31.40.0-255,66,134973,77,338711
7943,0.001581,172.217.194.0-255,1484,136457,77,338711
7944,0.001584,172.217.194.0-255,2902,139359,77,338711
7945,0.001586,172.31.40.0-255,66,139425,77,338711
7946,0.001602,172.217.194.0-255,4320,143745,77,338711
7947,0.001604,172.31.40.0-255,66,143811,77,338711
7948,0.001616,172.217.194.0-255,1484,145295,77,338711
7949,0.001623,172.217.194.0-255,5738,151033,77,338711
7950,0.001625,172.31.40.0-255,66,151099,77,338711
7951,0.001639,172.217.194.0-255,1484,152583,77,338711
7952,0.001665,172.217.194.0-255,11410,163993,77,338711
7953,0.001666,172.31.40.0-255,66,164059,77,338711
7954,0.001672,172.217.194.0-255,5020,169079,77,338711
7955,0.001673,172.31.40.0-255,66,169145,77,338711
7956,0.001831,172.217.194.0-255,1484,170629,77,338711
7957,0.001848,172.217.194.0-255,2902,173531,77,338711
7958,0.00185,172.31.40.0-255,66,173597,77,338711
7959,0.001856,172.217.194.0-255,5738,179335,77,338711
7960,0.001858,172.31.40.0-255,66,179401,77,338711
7961,0.001872,172.217.194.0-255,4320,183721,77,338711
7962,0.001875,172.31.40.0-255,66,183787,77,338711
7963,0.001891,172.217.194.0-255,1484,185271,77,338711
7964,0.001898,172.217.194.0-255,7156,192427,77,338711
7965,0.0019,172.31.40.0-255,66,192493,77,338711
7966,0.001925,172.217.194.0-255,5738,198231,77,338711
7967,0.001927,172.31.40.0-255,66,198297,77,338711
7968,0.001932,172.217.194.0-255,5020,203317,77,338711
7969,0.001934,172.31.40.0-255,66,203383,77,338711
7970,0.002124,172.217.194.0-255,1484,204867,77,338711
7971,0.002146,172.217.194.0-255,2902,207769,77,338711
7972,0.002148,172.31.40.0-255,66,207835,77,338711
7973,0.002151,172.217.194.0-255,1484,209319,77,338711
7974,0.00217,172.217.194.0-255,4320,213639,77,338711
7975,0.002172,172.31.40.0-255,66,213705,77,338711
7976,0.002178,172.217.194.0-255,5738,219443,77,338711
7977,0.002181,172.31.40.0-255,66,219509,77,338711
7978,0.00221,172.217.194.0-255,12828,232337,77,338711
7979,0.002213,172.31.40.0-255,66,232403,77,338711
7980,0.00223,172.217.194.0-255,5738,238141,77,338711
7981,0.002233,172.31.40.0-255,66,238207,77,338711
7982,0.002265,172.217.194.0-255,6438,244645,77,338711
7983,0.002267,172.31.40.0-255,66,244711,77,338711
7984,0.002284,172.217.194.0-255,12828,257539,77,338711
7985,0.002287,172.31.40.0-255,66,257605,77,338711
7986,0.002299,172.217.194.0-255,13528,271133,77,338711
7987,0.002302,172.31.40.0-255,66,271199,77,338711
7988,0.002307,172.217.194.0-255,4320,275519,77,338711
7989,0.00231,172.31.40.0-255,66,275585,77,338711
7990,0.002341,172.217.194.0-255,9992,285577,77,338711
7991,0.002344,172.31.40.0-255,66,285643,77,338711
7992,0.002359,172.31.40.0-255,66,285709,77,338711
7993,0.002379,172.217.194.0-255,5738,291447,77,338711
7994,0.002382,172.31.40.0-255,66,291513,77,338711
7995,0.002409,172.217.194.0-255,7856,299369,77,338711
7996,0.002412,172.31.40.0-255,66,299435,77,338711
7997,0.004749,172.217.194.0-255,5738,305173,77,338711
7998,0.004766,172.31.40.0-255,66,305239,77,338711
7999,0.007117,172.217.194.0-255,5738,310977,77,338711
8000,0.007124,172.31.40.0-255,66,311043,77,338711
8001,0.00946,172.217.194.0-255,4320,315363,77,338711
8002,0.009465,172.31.40.0-255,66,315429,77,338711
8003,0.009484,172.217.194.0-255,1484,316913,77,338711
8004,0.011814,172.217.194.0-255,4320,321233,77,338711
8005,0.011822,172.31.40.0-255,66,321299,77,338711
8006,0.014164,172.217.194.0-255,5738,327037,77,338711
8007,0.014172,172.31.40.0-255,66,327103,77,338711
8008,0.016504,172.217.194.0-255,5738,332841,77,338711
8009,0.016511,172.31.40.0-255,66,332907,77,338711
8010,0.018885,172.217.194.0-255,5738,338645,77,338711
8011,0.018893,172.31.40.0-255,66,338711,77,338711
8012,0.0,172.31.40.0-255,105,105,77,276
8013,0.001791,157.240.7.0-255,105,210,77,276
8014,0.001802,172.31.40.0-255,66,276,77,276
8015,0.0,74.125.24.0-255,146,146,77,349111
8016,3.2e-05,172.31.40.0-255,66,212,77,349111
8017,4e-05,74.125.24.0-255,1484,1696,77,349111
8018,4.5e-05,172.31.40.0-255,66,1762,77,349111
8019,5.9e-05,74.125.24.0-255,2902,4664,77,349111
8020,6.3e-05,172.31.40.0-255,66,4730,77,349111
8021,7.1e-05,74.125.24.0-255,7156,11886,77,349111
8022,7.4e-05,172.31.40.0-255,66,11952,77,349111
8023,7.8e-05,74.125.24.0-255,2031,13983,77,349111
8024,8e-05,172.31.40.0-255,66,14049,77,349111
8025,8.5e-05,74.125.24.0-255,2902,16951,77,349111
8026,8.8e-05,172.31.40.0-255,66,17017,77,349111
8027,9.5e-05,74.125.24.0-255,7156,24173,77,349111
8028,9.8e-05,172.31.40.0-255,66,24239,77,349111
8029,0.000137,172.31.40.0-255,66,24305,77,349111
8030,0.000141,74.125.24.0-255,2902,27207,77,349111
8031,0.000143,172.31.40.0-255,66,27273,77,349111
8032,0.000187,74.125.24.0-255,12110,39383,77,349111
8033,0.000191,172.31.40.0-255,66,39449,77,349111
8034,0.000232,74.125.24.0-255,9940,49389,77,349111
8035,0.000235,172.31.40.0-255,66,49455,77,349111
8036,0.000238,74.125.24.0-255,113,49568,77,349111
8037,0.00024,172.31.40.0-255,66,49634,77,349111
8038,0.000288,74.125.24.0-255,1484,51118,77,349111
8039,0.00029,172.31.40.0-255,66,51184,77,349111
8040,0.000295,74.125.24.0-255,2902,54086,77,349111
8041,0.000297,172.31.40.0-255,66,54152,77,349111
8042,0.0003,74.125.24.0-255,1484,55636,77,349111
8043,0.000302,172.31.40.0-255,66,55702,77,349111
8044,0.000338,74.125.24.0-255,2902,58604,77,349111
8045,0.000341,172.31.40.0-255,66,58670,77,349111
8046,0.00035,74.125.24.0-255,9633,68303,77,349111
8047,0.000352,172.31.40.0-255,66,68369,77,349111
8048,0.000385,74.125.24.0-255,11410,79779,77,349111
8049,0.000387,172.31.40.0-255,66,79845,77,349111
8050,0.000414,74.125.24.0-255,3961,83806,77,349111
8051,0.000416,172.31.40.0-255,66,83872,77,349111
8052,0.000442,74.125.24.0-255,1484,85356,77,349111
8053,0.000449,74.125.24.0-255,2902,88258,77,349111
8054,0.000451,172.31.40.0-255,66,88324,77,349111
8055,0.000482,74.125.24.0-255,5738,94062,77,349111
8056,0.000485,172.31.40.0-255,66,94128,77,349111
8057,0.000504,74.125.24.0-255,5738,99866,77,349111
8058,0.000507,172.31.40.0-255,66,99932,77,349111
8059,0.000539,74.125.24.0-255,7156,107088,77,349111
8060,0.000542,172.31.40.0-255,66,107154,77,349111
8061,0.000552,74.125.24.0-255,10692,117846,77,349111
8062,0.000555,172.31.40.0-255,66,117912,77,349111
8063,0.000581,74.125.24.0-255,1484,119396,77,349111
8064,0.000604,74.125.24.0-255,2902,122298,77,349111
8065,0.000606,172.31.40.0-255,66,122364,77,349111
8066,0.000613,74.125.24.0-255,5738,128102,77,349111
8067,0.000616,172.31.40.0-255,66,128168,77,349111
8068,0.000657,74.125.24.0-255,4320,132488,77,349111
8069,0.000659,172.31.40.0-255,66,132554,77,349111
8070,0.000682,74.125.24.0-255,5738,138292,77,349111
8071,0.000685,172.31.40.0-255,66,138358,77,349111
8072,0.000696,74.125.24.0-255,12828,151186,77,349111
8073,0.000699,172.31.40.0-255,66,151252,77,349111
8074,0.000724,74.125.24.0-255,452,151704,77,349111
8075,0.000735,74.125.24.0-255,9992,161696,77,349111
8076,0.000737,172.31.40.0-255,66,161762,77,349111
8077,0.000772,74.125.24.0-255,4320,166082,77,349111
8078,0.000774,172.31.40.0-255,66,166148,77,349111
8079,0.000796,172.31.40.0-255,66,166214,77,349111
8080,0.000801,74.125.24.0-255,3602,169816,77,349111
8081,0.000804,172.31.40.0-255,66,169882,77,349111
8082,0.00081,74.125.24.0-255,4320,174202,77,349111
8083,0.000812,172.31.40.0-255,66,174268,77,349111
8084,0.000822,74.125.24.0-255,9992,184260,77,349111
8085,0.000824,172.31.40.0-255,66,184326,77,349111
8086,0.000829,74.125.24.0-255,4320,188646,77,349111
8087,0.000831,172.31.40.0-255,66,188712,77,349111
8088,0.000862,74.125.24.0-255,5738,194450,77,349111
8089,0.000865,172.31.40.0-255,66,194516,77,349111
8090,0.000869,74.125.24.0-255,2902,197418,77,349111
8091,0.000871,172.31.40.0-255,66,197484,77,349111
8092,0.000913,172.31.40.0-255,66,197550,77,349111
8093,0.00093,74.125.24.0-255,12828,210378,77,349111
8094,0.000933,172.31.40.0-255,66,210444,77,349111
8095,0.000941,74.125.24.0-255,7856,218300,77,349111
8096,0.000943,172.31.40.0-255,66,218366,77,349111
8097,0.000986,74.125.24.0-255,8574,226940,77,349111
8098,0.000988,172.31.40.0-255,66,227006,77,349111
8099,0.001004,172.31.40.0-255,66,227072,77,349111
8100,0.001026,74.125.24.0-255,2902,229974,77,349111
8101,0.001029,172.31.40.0-255,66,230040,77,349111
8102,0.001032,74.125.24.0-255,1484,231524,77,349111
8103,0.001064,74.125.24.0-255,5020,236544,77,349111
8104,0.001094,74.125.24.0-255,8574,245118,77,349111
8105,0.001098,74.125.24.0-255,1484,246602,77,349111
8106,0.001122,74.125.24.0-255,8574,255176,77,349111
8107,0.001148,74.125.24.0-255,1484,256660,77,349111
8108,0.001191,74.125.24.0-255,13528,270188,77,349111
8109,0.001247,172.31.40.0-255,66,270254,77,349111
8110,0.001454,74.125.24.0-255,1484,271738,77,349111
8111,0.001471,74.125.24.0-255,2902,274640,77,349111
8112,0.001474,172.31.40.0-255,66,274706,77,349111
8113,0.00148,74.125.24.0-255,2902,277608,77,349111
8114,0.001506,74.125.24.0-255,2902,280510,77,349111
8115,0.00151,74.125.24.0-255,2902,283412,77,349111
8116,0.001519,172.31.40.0-255,66,283478,77,349111
8117,0.001538,74.125.24.0-255,9992,293470,77,349111
8118,0.001545,74.125.24.0-255,5738,299208,77,349111
8119,0.001551,172.31.40.0-255,66,299274,77,349111
8120,0.00157,74.125.24.0-255,4320,303594,77,349111
8121,0.001573,74.125.24.0-255,766,304360,77,349111
8122,0.001584,172.31.40.0-255,66,304426,77,349111
8123,0.001834,74.125.24.0-255,1484,305910,77,349111
8124,0.00184,74.125.24.0-255,2902,308812,77,349111
8125,0.001844,172.31.40.0-255,66,308878,77,349111
8126,0.001851,74.125.24.0-255,5738,314616,77,349111
8127,0.001874,74.125.24.0-255,5738,320354,77,349111
8128,0.001885,172.31.40.0-255,66,320420,77,349111
8129,0.001898,74.125.24.0-255,7156,327576,77,349111
8130,0.001912,74.125.24.0-255,9992,337568,77,349111
8131,0.001932,172.31.40.0-255,66,337634,77,349111
8132,0.001943,74.125.24.0-255,5738,343372,77,349111
8133,0.001948,172.31.40.0-255,66,343438,77,349111
8134,0.001975,74.125.24.0-255,5331,348769,77,349111
8135,0.001979,74.125.24.0-255,105,348874,77,349111
8136,0.001992,172.31.40.0-255,66,348940,77,349111
8137,0.010152,172.31.40.0-255,105,349045,77,349111
8138,0.01238,74.125.24.0-255,66,349111,77,349111
8139,0.0,74.125.24.0-255,153,153,77,233909
8140,2.3e-05,172.31.40.0-255,66,219,77,233909
8141,3e-05,74.125.24.0-255,1484,1703,77,233909
8142,3.4e-05,172.31.40.0-255,66,1769,77,233909
8143,4e-05,74.125.24.0-255,2902,4671,77,233909
8144,4.4e-05,172.31.40.0-255,66,4737,77,233909
8145,4.9e-05,74.125.24.0-255,4320,9057,77,233909
8146,5.3e-05,172.31.40.0-255,66,9123,77,233909
8147,8.1e-05,74.125.24.0-255,4936,14059,77,233909
8148,8.4e-05,172.31.40.0-255,66,14125,77,233909
8149,0.000116,74.125.24.0-255,5738,19863,77,233909
8150,0.000118,172.31.40.0-255,66,19929,77,233909
8151,0.000158,74.125.24.0-255,11410,31339,77,233909
8152,0.000162,172.31.40.0-255,66,31405,77,233909
8153,0.000173,74.125.24.0-255,12828,44233,77,233909
8154,0.000175,172.31.40.0-255,66,44299,77,233909
8155,0.00018,74.125.24.0-255,3602,47901,77,233909
8156,0.000182,172.31.40.0-255,66,47967,77,233909
8157,0.000413,74.125.24.0-255,1484,49451,77,233909
8158,0.000419,172.31.40.0-255,66,49517,77,233909
8159,0.000426,74.125.24.0-255,2902,52419,77,233909
8160,0.000428,172.31.40.0-255,66,52485,77,233909
8161,0.000435,74.125.24.0-255,5738,58223,77,233909
8162,0.000438,172.31.40.0-255,66,58289,77,233909
8163,0.000445,74.125.24.0-255,7123,65412,77,233909
8164,0.000447,172.31.40.0-255,66,65478,77,233909
8165,0.000485,74.125.24.0-255,1484,66962,77,233909
8166,0.000488,172.31.40.0-255,66,67028,77,233909
8167,0.000494,74.125.24.0-255,2902,69930,77,233909
8168,0.000497,172.31.40.0-255,66,69996,77,233909
8169,0.000511,74.125.24.0-255,4320,74316,77,233909
8170,0.000513,172.31.40.0-255,66,74382,77,233909
8171,0.000533,74.125.24.0-255,1484,75866,77,233909
8172,0.000547,74.125.24.0-255,12828,88694,77,233909
8173,0.00055,172.31.40.0-255,66,88760,77,233909
8174,0.000559,74.125.24.0-255,8574,97334,77,233909
8175,0.000561,172.31.40.0-255,66,97400,77,233909
8176,0.000597,74.125.24.0-255,2184,99584,77,233909
8177,0.0006,172.31.40.0-255,66,99650,77,233909
8178,0.000793,172.31.40.0-255,101,99751,77,233909
8179,0.000843,74.125.24.0-255,1484,101235,77,233909
8180,0.00085,74.125.24.0-255,2902,104137,77,233909
8181,0.000852,172.31.40.0-255,66,104203,77,233909
8182,0.000884,74.125.24.0-255,2902,107105,77,233909
8183,0.000886,172.31.40.0-255,66,107171,77,233909
8184,0.000907,74.125.24.0-255,2902,110073,77,233909
8185,0.000909,172.31.40.0-255,66,110139,77,233909
8186,0.000916,74.125.24.0-255,6480,116619,77,233909
8187,0.000919,172.31.40.0-255,66,116685,77,233909
8188,0.001013,74.125.24.0-255,1484,118169,77,233909
8189,0.001031,74.125.24.0-255,2902,121071,77,233909
8190,0.001034,172.31.40.0-255,66,121137,77,233909
8191,0.001039,74.125.24.0-255,2902,124039,77,233909
8192,0.001041,172.31.40.0-255,66,124105,77,233909
8193,0.001076,74.125.24.0-255,7156,131261,77,233909
8194,0.001079,172.31.40.0-255,66,131327,77,233909
8195,0.001093,172.31.40.0-255,66,131393,77,233909
8196,0.001111,74.125.24.0-255,1484,132877,77,233909
8197,0.001118,74.125.24.0-255,3602,136479,77,233909
8198,0.001121,172.31.40.0-255,66,136545,77,233909
8199,0.001249,74.125.24.0-255,1484,138029,77,233909
8200,0.001254,74.125.24.0-255,2902,140931,77,233909
8201,0.001258,172.31.40.0-255,66,140997,77,233909
8202,0.001282,74.125.24.0-255,5738,146735,77,233909
8203,0.001285,172.31.40.0-255,66,146801,77,233909
8204,0.001292,74.125.24.0-255,8574,155375,77,233909
8205,0.001295,172.31.40.0-255,66,155441,77,233909
8206,0.001318,74.125.24.0-255,4320,159761,77,233909
8207,0.001321,172.31.40.0-255,66,159827,77,233909
8208,0.001328,74.125.24.0-255,7156,166983,77,233909
8209,0.00133,172.31.40.0-255,66,167049,77,233909
8210,0.001373,172.31.40.0-255,66,167115,77,233909
8211,0.001391,74.125.24.0-255,6438,173553,77,233909
8212,0.001394,172.31.40.0-255,66,173619,77,233909
8213,0.001405,74.125.24.0-255,12828,186447,77,233909
8214,0.001408,172.31.40.0-255,66,186513,77,233909
8215,0.001434,74.125.24.0-255,2184,188697,77,233909
8216,0.001437,172.31.40.0-255,66,188763,77,233909
8217,0.002797,74.125.24.0-255,66,188829,77,233909
8218,0.003481,74.125.24.0-255,4320,193149,77,233909
8219,0.003488,172.31.40.0-255,66,193215,77,233909
8220,0.003509,74.125.24.0-255,1484,194699,77,233909
8221,0.005561,74.125.24.0-255,4320,199019,77,233909
8222,0.005564,172.31.40.0-255,66,199085,77,233909
8223,0.007621,74.125.24.0-255,5738,204823,77,233909
8224,0.007626,172.31.40.0-255,66,204889,77,233909
8225,0.009726,74.125.24.0-255,5738,210627,77,233909
8226,0.009735,172.31.40.0-255,66,210693,77,233909
8227,0.011772,74.125.24.0-255,5738,216431,77,233909
8228,0.011781,172.31.40.0-255,66,216497,77,233909
8229,0.013853,74.125.24.0-255,5738,222235,77,233909
8230,0.013861,172.31.40.0-255,66,222301,77,233909
8231,0.015939,74.125.24.0-255,5738,228039,77,233909
8232,0.015944,172.31.40.0-255,66,228105,77,233909
8233,0.017985,74.125.24.0-255,5738,233843,77,233909
8234,0.017994,172.31.40.0-255,66,233909,77,233909
8235,0.0,172.217.194.0-255,296,296,77,141225
8236,3.4e-05,172.31.40.0-255,66,362,77,141225
8237,4e-05,172.217.194.0-255,1484,1846,77,141225
8238,4.5e-05,172.31.40.0-255,66,1912,77,141225
8239,6.1e-05,172.217.194.0-255,4320,6232,77,141225
8240,6.5e-05,172.31.40.0-255,66,6298,77,141225
8241,0.000109,172.217.194.0-255,2902,9200,77,141225
8242,0.000112,172.31.40.0-255,66,9266,77,141225
8243,0.00015,172.217.194.0-255,4320,13586,77,141225
8244,0.000154,172.31.40.0-255,66,13652,77,141225
8245,0.000184,172.217.194.0-255,4775,18427,77,141225
8246,0.000187,172.31.40.0-255,66,18493,77,141225
8247,0.000306,172.217.194.0-255,7156,25649,77,141225
8248,0.00031,172.31.40.0-255,66,25715,77,141225
8249,0.00033,172.217.194.0-255,5379,31094,77,141225
8250,0.000334,172.31.40.0-255,66,31160,77,141225
8251,0.0005,172.217.194.0-255,5738,36898,77,141225
8252,0.000505,172.31.40.0-255,66,36964,77,141225
8253,0.000538,172.217.194.0-255,11051,48015,77,141225
8254,0.000541,172.31.40.0-255,66,48081,77,141225
8255,0.000785,172.217.194.0-255,11410,59491,77,141225
8256,0.00079,172.31.40.0-255,66,59557,77,141225
8257,0.000819,172.217.194.0-255,6001,65558,77,141225
8258,0.000824,172.31.40.0-255,66,65624,77,141225
8259,0.001105,172.217.194.0-255,11410,77034,77,141225
8260,0.001111,172.31.40.0-255,66,77100,77,141225
8261,0.001134,172.217.194.0-255,7156,84256,77,141225
8262,0.001138,172.31.40.0-255,66,84322,77,141225
8263,0.001397,172.217.194.0-255,5738,90060,77,141225
8264,0.001404,172.31.40.0-255,66,90126,77,141225
8265,0.001437,172.217.194.0-255,9274,99400,77,141225
8266,0.001441,172.31.40.0-255,66,99466,77,141225
8267,0.00163,172.217.194.0-255,1484,100950,77,141225
8268,0.001663,172.31.40.0-255,66,101016,77,141225
8269,0.002191,172.217.194.0-255,4320,105336,77,141225
8270,0.002243,172.217.194.0-255,2184,107520,77,141225
8271,0.005033,172.31.40.0-255,66,107586,77,141225
8272,0.005237,172.31.40.0-255,101,107687,77,141225
8273,0.007287,172.217.194.0-255,4320,112007,77,141225
8274,0.007291,172.31.40.0-255,66,112073,77,141225
8275,0.007318,172.217.194.0-255,1484,113557,77,141225
8276,0.007467,172.217.194.0-255,66,113623,77,141225
8277,0.009603,172.217.194.0-255,4320,117943,77,141225
8278,0.009609,172.31.40.0-255,66,118009,77,141225
8279,0.011883,172.217.194.0-255,5738,123747,77,141225
8280,0.011892,172.31.40.0-255,66,123813,77,141225
8281,0.01417,172.217.194.0-255,5738,129551,77,141225
8282,0.014177,172.31.40.0-255,66,129617,77,141225
8283,0.01651,172.217.194.0-255,5738,135355,77,141225
8284,0.016523,172.31.40.0-255,66,135421,77,141225
8285,0.018832,172.217.194.0-255,5738,141159,77,141225
8286,0.01884,172.31.40.0-255,66,141225,77,141225
8287,0.0,172.217.194.0-255,152,152,77,376390
8288,2.6e-05,172.31.40.0-255,66,218,77,376390
8289,3.3e-05,172.217.194.0-255,1484,1702,77,376390
8290,3.8e-05,172.31.40.0-255,66,1768,77,376390
8291,4.4e-05,172.217.194.0-255,2902,4670,77,376390
8292,4.8e-05,172.31.40.0-255,66,4736,77,376390
8293,6.1e-05,172.217.194.0-255,4320,9056,77,376390
8294,6.5e-05,172.31.40.0-255,66,9122,77,376390
8295,7.5e-05,172.217.194.0-255,12090,21212,77,376390
8296,7.8e-05,172.31.40.0-255,66,21278,77,376390
8297,8.7e-05,172.217.194.0-255,9633,30911,77,376390
8298,9e-05,172.31.40.0-255,66,30977,77,376390
8299,0.000133,172.217.194.0-255,9992,40969,77,376390
8300,0.000136,172.31.40.0-255,66,41035,77,376390
8301,0.000143,172.217.194.0-255,6797,47832,77,376390
8302,0.000146,172.31.40.0-255,66,47898,77,376390
8303,0.000182,172.217.194.0-255,11410,59308,77,376390
8304,0.000185,172.31.40.0-255,66,59374,77,376390
8305,0.000219,172.217.194.0-255,5652,65026,77,376390
8306,0.000221,172.31.40.0-255,66,65092,77,376390
8307,0.000245,172.217.194.0-255,434,65526,77,376390
8308,0.000247,172.31.40.0-255,66,65592,77,376390
8309,0.000563,172.217.194.0-255,1484,67076,77,376390
8310,0.000568,172.31.40.0-255,66,67142,77,376390
8311,0.00059,172.217.194.0-255,2902,70044,77,376390
8312,0.000597,172.217.194.0-255,5738,75782,77,376390
8313,0.000603,172.31.40.0-255,66,75848,77,376390
8314,0.000606,172.31.40.0-255,66,75914,77,376390
8315,0.000638,172.217.194.0-255,12828,88742,77,376390
8316,0.000641,172.31.40.0-255,66,88808,77,376390
8317,0.00065,172.217.194.0-255,9992,98800,77,376390
8318,0.000653,172.31.40.0-255,66,98866,77,376390
8319,0.000708,172.217.194.0-255,766,99632,77,376390
8320,0.000936,172.217.194.0-255,1484,101116,77,376390
8321,0.00094,172.31.40.0-255,66,101182,77,376390
8322,0.000945,172.217.194.0-255,1484,102666,77,376390
8323,0.000971,172.217.194.0-255,1484,104150,77,376390
8324,0.000973,172.31.40.0-255,66,104216,77,376390
8325,0.000977,172.217.194.0-255,1484,105700,77,376390
8326,0.001008,172.217.194.0-255,4320,110020,77,376390
8327,0.001011,172.31.40.0-255,66,110086,77,376390
8328,0.001047,172.217.194.0-255,12828,122914,77,376390
8329,0.001051,172.31.40.0-255,66,122980,77,376390
8330,0.001063,172.217.194.0-255,1484,124464,77,376390
8331,0.001093,172.217.194.0-255,8726,133190,77,376390
8332,0.001096,172.31.40.0-255,66,133256,77,376390
8333,0.001125,172.217.194.0-255,11410,144666,77,376390
8334,0.001128,172.31.40.0-255,66,144732,77,376390
8335,0.001135,172.217.194.0-255,7156,151888,77,376390
8336,0.001138,172.31.40.0-255,66,151954,77,376390
8337,0.00116,172.217.194.0-255,7156,159110,77,376390
8338,0.001163,172.31.40.0-255,66,159176,77,376390
8339,0.001172,172.217.194.0-255,7856,167032,77,376390
8340,0.001175,172.31.40.0-255,66,167098,77,376390
8341,0.001325,172.217.194.0-255,1484,168582,77,376390
8342,0.001332,172.217.194.0-255,2902,171484,77,376390
8343,0.001335,172.31.40.0-255,66,171550,77,376390
8344,0.001338,172.217.194.0-255,1484,173034,77,376390
8345,0.001363,172.217.194.0-255,4320,177354,77,376390
8346,0.001371,172.217.194.0-255,7156,184510,77,376390
8347,0.001375,172.31.40.0-255,66,184576,77,376390
8348,0.001377,172.31.40.0-255,66,184642,77,376390
8349,0.001405,172.217.194.0-255,5738,190380,77,376390
8350,0.001408,172.31.40.0-255,66,190446,77,376390
8351,0.001419,172.217.194.0-255,10692,201138,77,376390
8352,0.001421,172.31.40.0-255,66,201204,77,376390
8353,0.001429,172.217.194.0-255,7156,208360,77,376390
8354,0.001431,172.31.40.0-255,66,208426,77,376390
8355,0.001452,172.217.194.0-255,4320,212746,77,376390
8356,0.001454,172.31.40.0-255,66,212812,77,376390
8357,0.001463,172.217.194.0-255,8574,221386,77,376390
8358,0.001465,172.31.40.0-255,66,221452,77,376390
8359,0.001505,172.217.194.0-255,9992,231444,77,376390
8360,0.001509,172.31.40.0-255,66,231510,77,376390
8361,0.001513,172.217.194.0-255,3602,235112,77,376390
8362,0.001515,172.31.40.0-255,66,235178,77,376390
8363,0.00152,172.217.194.0-255,4320,239498,77,376390
8364,0.001522,172.31.40.0-255,66,239564,77,376390
8365,0.001528,172.217.194.0-255,4320,243884,77,376390
8366,0.001531,172.31.40.0-255,66,243950,77,376390
8367,0.001561,172.217.194.0-255,5738,249688,77,376390
8368,0.001564,172.31.40.0-255,66,249754,77,376390
8369,0.001584,172.217.194.0-255,12828,262582,77,376390
8370,0.001587,172.31.40.0-255,66,262648,77,376390
8371,0.001618,172.217.194.0-255,5738,268386,77,376390
8372,0.001621,172.31.40.0-255,66,268452,77,376390
8373,0.001624,172.217.194.0-255,766,269218,77,376390
8374,0.00169,172.217.194.0-255,1484,270702,77,376390
8375,0.001694,172.31.40.0-255,66,270768,77,376390
8376,0.001726,172.217.194.0-255,2902,273670,77,376390
8377,0.001729,172.31.40.0-255,66,273736,77,376390
8378,0.001736,172.217.194.0-255,5738,279474,77,376390
8379,0.001738,172.31.40.0-255,66,279540,77,376390
8380,0.001779,172.217.194.0-255,4320,283860,77,376390
8381,0.001782,172.31.40.0-255,66,283926,77,376390
8382,0.001807,172.217.194.0-255,8574,292500,77,376390
8383,0.00181,172.31.40.0-255,66,292566,77,376390
8384,0.001819,172.217.194.0-255,10692,303258,77,376390
8385,0.001826,172.31.40.0-255,66,303324,77,376390
8386,0.001829,172.217.194.0-255,1484,304808,77,376390
8387,0.001834,172.217.194.0-255,2902,307710,77,376390
8388,0.001836,172.31.40.0-255,66,307776,77,376390
8389,0.001842,172.217.194.0-255,5738,313514,77,376390
8390,0.001844,172.31.40.0-255,66,313580,77,376390
8391,0.001855,172.217.194.0-255,12828,326408,77,376390
8392,0.001858,172.31.40.0-255,66,326474,77,376390
8393,0.001862,172.217.194.0-255,2902,329376,77,376390
8394,0.001865,172.31.40.0-255,66,329442,77,376390
8395,0.001911,172.217.194.0-255,9274,338716,77,376390
8396,0.001919,172.31.40.0-255,66,338782,77,376390
8397,0.00193,172.217.194.0-255,12828,351610,77,376390
8398,0.001933,172.31.40.0-255,66,351676,77,376390
8399,0.001942,172.217.194.0-255,11410,363086,77,376390
8400,0.001944,172.31.40.0-255,66,363152,77,376390
8401,0.001954,172.217.194.0-255,12110,375262,77,376390
8402,0.001957,172.31.40.0-255,66,375328,77,376390
8403,0.002017,172.31.40.0-255,66,375394,77,376390
8404,0.002035,172.31.40.0-255,66,375460,77,376390
8405,0.002039,172.217.194.0-255,105,375565,77,376390
8406,0.00207,172.217.194.0-255,129,375694,77,376390
8407,0.004689,172.31.40.0-255,105,375799,77,376390
8408,0.004728,172.31.40.0-255,105,375904,77,376390
8409,0.005005,172.31.40.0-255,90,375994,77,376390
8410,0.005016,172.31.40.0-255,66,376060,77,376390
8411,0.007129,172.217.194.0-255,66,376126,77,376390
8412,0.007163,172.217.194.0-255,66,376192,77,376390
8413,0.007442,172.217.194.0-255,66,376258,77,376390
8414,0.007469,172.217.194.0-255,66,376324,77,376390
8415,0.007479,172.31.40.0-255,66,376390,77,376390
8416,0.0,74.125.200.0-255,153,153,77,208979
8417,2.3e-05,172.31.40.0-255,66,219,77,208979
8418,3.1e-05,74.125.200.0-255,1484,1703,77,208979
8419,3.5e-05,172.31.40.0-255,66,1769,77,208979
8420,4e-05,74.125.200.0-255,2902,4671,77,208979
8421,4.3e-05,172.31.40.0-255,66,4737,77,208979
8422,5.5e-05,74.125.200.0-255,1484,6221,77,208979
8423,5.8e-05,172.31.40.0-255,66,6287,77,208979
8424,6.3e-05,74.125.200.0-255,2902,9189,77,208979
8425,6.6e-05,172.31.40.0-255,66,9255,77,208979
8426,6.9e-05,74.125.200.0-255,1484,10739,77,208979
8427,7.2e-05,172.31.40.0-255,66,10805,77,208979
8428,0.000103,74.125.200.0-255,4774,15579,77,208979
8429,0.000116,172.31.40.0-255,66,15645,77,208979
8430,0.000123,74.125.200.0-255,5738,21383,77,208979
8431,0.000126,172.31.40.0-255,66,21449,77,208979
8432,0.000133,74.125.200.0-255,7156,28605,77,208979
8433,0.000136,172.31.40.0-255,66,28671,77,208979
8434,0.00014,74.125.200.0-255,2543,31214,77,208979
8435,0.000142,172.31.40.0-255,66,31280,77,208979
8436,0.000232,74.125.200.0-255,1484,32764,77,208979
8437,0.000236,172.31.40.0-255,66,32830,77,208979
8438,0.000264,74.125.200.0-255,2902,35732,77,208979
8439,0.000268,172.31.40.0-255,66,35798,77,208979
8440,0.000275,74.125.200.0-255,5738,41536,77,208979
8441,0.000277,172.31.40.0-255,66,41602,77,208979
8442,0.000306,74.125.200.0-255,7156,48758,77,208979
8443,0.000309,172.31.40.0-255,66,48824,77,208979
8444,0.000345,74.125.200.0-255,8574,57398,77,208979
8445,0.000349,172.31.40.0-255,66,57464,77,208979
8446,0.000374,74.125.200.0-255,1484,58948,77,208979
8447,0.000376,172.31.40.0-255,66,59014,77,208979
8448,0.000397,74.125.200.0-255,2902,61916,77,208979
8449,0.0004,172.31.40.0-255,66,61982,77,208979
8450,0.000424,74.125.200.0-255,1484,63466,77,208979
8451,0.000438,74.125.200.0-255,2184,65650,77,208979
8452,0.000441,172.31.40.0-255,66,65716,77,208979
8453,0.000472,74.125.200.0-255,400,66116,77,208979
8454,0.000515,74.125.200.0-255,110,66226,77,208979
8455,0.000531,74.125.200.0-255,332,66558,77,208979
8456,0.000726,74.125.200.0-255,1484,68042,77,208979
8457,0.000731,172.31.40.0-255,66,68108,77,208979
8458,0.000737,74.125.200.0-255,2902,71010,77,208979
8459,0.00074,172.31.40.0-255,66,71076,77,208979
8460,0.000743,74.125.200.0-255,1484,72560,77,208979
8461,0.000753,74.125.200.0-255,2902,75462,77,208979
8462,0.000755,172.31.40.0-255,66,75528,77,208979
8463,0.000793,74.125.200.0-255,5738,81266,77,208979
8464,0.000796,172.31.40.0-255,66,81332,77,208979
8465,0.000802,74.125.200.0-255,4320,85652,77,208979
8466,0.000804,172.31.40.0-255,66,85718,77,208979
8467,0.000834,74.125.200.0-255,5738,91456,77,208979
8468,0.000837,172.31.40.0-255,66,91522,77,208979
8469,0.000848,74.125.200.0-255,1484,93006,77,208979
8470,0.000866,74.125.200.0-255,7856,100862,77,208979
8471,0.000869,172.31.40.0-255,66,100928,77,208979
8472,0.001583,74.125.200.0-255,1484,102412,77,208979
8473,0.001591,74.125.200.0-255,2902,105314,77,208979
8474,0.001594,172.31.40.0-255,66,105380,77,208979
8475,0.0016,74.125.200.0-255,2902,108282,77,208979
8476,0.001602,172.31.40.0-255,66,108348,77,208979
8477,0.001636,74.125.200.0-255,4320,112668,77,208979
8478,0.001643,172.31.40.0-255,66,112734,77,208979
8479,0.001652,74.125.200.0-255,8574,121308,77,208979
8480,0.001654,172.31.40.0-255,66,121374,77,208979
8481,0.001657,74.125.200.0-255,1484,122858,77,208979
8482,0.001695,74.125.200.0-255,7156,130014,77,208979
8483,0.001698,172.31.40.0-255,66,130080,77,208979
8484,0.001728,74.125.200.0-255,2902,132982,77,208979
8485,0.00173,172.31.40.0-255,66,133048,77,208979
8486,0.00176,74.125.200.0-255,2184,135232,77,208979
8487,0.001763,172.31.40.0-255,66,135298,77,208979
8488,0.001891,74.125.200.0-255,1484,136782,77,208979
8489,0.001908,74.125.200.0-255,2902,139684,77,208979
8490,0.001912,172.31.40.0-255,66,139750,77,208979
8491,0.001917,74.125.200.0-255,2902,142652,77,208979
8492,0.001919,172.31.40.0-255,66,142718,77,208979
8493,0.001948,74.125.200.0-255,1484,144202,77,208979
8494,0.001962,74.125.200.0-255,4320,148522,77,208979
8495,0.001965,172.31.40.0-255,66,148588,77,208979
8496,0.001995,74.125.200.0-255,4320,152908,77,208979
8497,0.001998,172.31.40.0-255,66,152974,77,208979
8498,0.002002,74.125.200.0-255,2902,155876,77,208979
8499,0.002004,172.31.40.0-255,66,155942,77,208979
8500,0.002016,74.125.200.0-255,12828,168770,77,208979
8501,0.002019,172.31.40.0-255,66,168836,77,208979
8502,0.002022,74.125.200.0-255,766,169602,77,208979
8503,0.002063,172.31.40.0-255,101,169703,77,208979
8504,0.004293,74.125.200.0-255,4320,174023,77,208979
8505,0.004299,172.31.40.0-255,66,174089,77,208979
8506,0.004333,74.125.200.0-255,1484,175573,77,208979
8507,0.006588,74.125.200.0-255,4320,179893,77,208979
8508,0.006595,172.31.40.0-255,66,179959,77,208979
8509,0.008892,74.125.200.0-255,5738,185697,77,208979
8510,0.008899,172.31.40.0-255,66,185763,77,208979
8511,0.011196,74.125.200.0-255,5738,191501,77,208979
8512,0.011204,172.31.40.0-255,66,191567,77,208979
8513,0.01349,74.125.200.0-255,5738,197305,77,208979
8514,0.013498,172.31.40.0-255,66,197371,77,208979
8515,0.015797,74.125.200.0-255,5738,203109,77,208979
8516,0.015808,172.31.40.0-255,66,203175,77,208979
8517,0.018097,74.125.200.0-255,5738,208913,77,208979
8518,0.018106,172.31.40.0-255,66,208979,77,208979
8519,0.0,74.125.130.0-255,153,153,77,244845
8520,2.1e-05,172.31.40.0-255,66,219,77,244845
8521,2.9e-05,74.125.130.0-255,1484,1703,77,244845
8522,3.3e-05,172.31.40.0-255,66,1769,77,244845
8523,5.2e-05,74.125.130.0-255,2902,4671,77,244845
8524,5.5e-05,172.31.40.0-255,66,4737,77,244845
8525,8.8e-05,74.125.130.0-255,4320,9057,77,244845
8526,9.1e-05,172.31.40.0-255,66,9123,77,244845
8527,9.5e-05,74.125.130.0-255,1484,10607,77,244845
8528,9.7e-05,172.31.40.0-255,66,10673,77,244845
8529,0.000102,74.125.130.0-255,2902,13575,77,244845
8530,0.000105,172.31.40.0-255,66,13641,77,244845
8531,0.000146,74.125.130.0-255,6383,20024,77,244845
8532,0.000149,172.31.40.0-255,66,20090,77,244845
8533,0.000152,74.125.130.0-255,1484,21574,77,244845
8534,0.000154,172.31.40.0-255,66,21640,77,244845
8535,0.000172,74.125.130.0-255,5738,27378,77,244845
8536,0.000175,172.31.40.0-255,66,27444,77,244845
8537,0.000194,74.125.130.0-255,3961,31405,77,244845
8538,0.000197,172.31.40.0-255,66,31471,77,244845
8539,0.000321,74.125.130.0-255,1484,32955,77,244845
8540,0.000326,172.31.40.0-255,66,33021,77,244845
8541,0.000331,74.125.130.0-255,2902,35923,77,244845
8542,0.000334,172.31.40.0-255,66,35989,77,244845
8543,0.000379,74.125.130.0-255,1484,37473,77,244845
8544,0.000381,172.31.40.0-255,66,37539,77,244845
8545,0.000386,74.125.130.0-255,2902,40441,77,244845
8546,0.000388,172.31.40.0-255,66,40507,77,244845
8547,0.000394,74.125.130.0-255,5738,46245,77,244845
8548,0.000397,172.31.40.0-255,66,46311,77,244845
8549,0.000401,74.125.130.0-255,2543,48854,77,244845
8550,0.000404,172.31.40.0-255,66,48920,77,244845
8551,0.000441,74.125.130.0-255,2902,51822,77,244845
8552,0.000444,172.31.40.0-255,66,51888,77,244845
8553,0.000465,74.125.130.0-255,4320,56208,77,244845
8554,0.000467,172.31.40.0-255,66,56274,77,244845
8555,0.000502,74.125.130.0-255,1484,57758,77,244845
8556,0.000517,74.125.130.0-255,2902,60660,77,244845
8557,0.000519,172.31.40.0-255,66,60726,77,244845
8558,0.000558,74.125.130.0-255,4320,65046,77,244845
8559,0.000561,172.31.40.0-255,66,65112,77,244845
8560,0.000573,74.125.130.0-255,1378,66490,77,244845
8561,0.000728,74.125.130.0-255,115,66605,77,244845
8562,0.001169,172.31.40.0-255,66,66671,77,244845
8563,0.001493,74.125.130.0-255,1484,68155,77,244845
8564,0.001503,74.125.130.0-255,2902,71057,77,244845
8565,0.001507,172.31.40.0-255,66,71123,77,244845
8566,0.001512,74.125.130.0-255,1484,72607,77,244845
8567,0.00153,74.125.130.0-255,2902,75509,77,244845
8568,0.001532,172.31.40.0-255,66,75575,77,244845
8569,0.001569,74.125.130.0-255,4320,79895,77,244845
8570,0.001572,172.31.40.0-255,66,79961,77,244845
8571,0.001605,74.125.130.0-255,5738,85699,77,244845
8572,0.001607,172.31.40.0-255,66,85765,77,244845
8573,0.00161,74.125.130.0-255,1484,87249,77,244845
8574,0.001614,74.125.130.0-255,1484,88733,77,244845
8575,0.001616,172.31.40.0-255,66,88799,77,244845
8576,0.001633,74.125.130.0-255,1484,90283,77,244845
8577,0.00164,74.125.130.0-255,5738,96021,77,244845
8578,0.001643,172.31.40.0-255,66,96087,77,244845
8579,0.001676,74.125.130.0-255,5020,101107,77,244845
8580,0.001679,172.31.40.0-255,66,101173,77,244845
8581,0.001849,74.125.130.0-255,1484,102657,77,244845
8582,0.001856,74.125.130.0-255,2902,105559,77,244845
8583,0.001859,172.31.40.0-255,66,105625,77,244845
8584,0.001863,74.125.130.0-255,1484,107109,77,244845
8585,0.001879,74.125.130.0-255,2902,110011,77,244845
8586,0.001881,172.31.40.0-255,66,110077,77,244845
8587,0.001907,74.125.130.0-255,5738,115815,77,244845
8588,0.001909,172.31.40.0-255,66,115881,77,244845
8589,0.001933,74.125.130.0-255,8574,124455,77,244845
8590,0.001935,172.31.40.0-255,66,124521,77,244845
8591,0.001959,74.125.130.0-255,9992,134513,77,244845
8592,0.001963,172.31.40.0-255,66,134579,77,244845
8593,0.001968,74.125.130.0-255,3602,138181,77,244845
8594,0.001971,172.31.40.0-255,66,138247,77,244845
8595,0.001991,74.125.130.0-255,4320,142567,77,244845
8596,0.001993,172.31.40.0-255,66,142633,77,244845
8597,0.002012,74.125.130.0-255,1484,144117,77,244845
8598,0.002036,74.125.130.0-255,8574,152691,77,244845
8599,0.002039,172.31.40.0-255,66,152757,77,244845
8600,0.002043,74.125.130.0-255,2902,155659,77,244845
8601,0.002045,172.31.40.0-255,66,155725,77,244845
8602,0.002065,74.125.130.0-255,8574,164299,77,244845
8603,0.002068,172.31.40.0-255,66,164365,77,244845
8604,0.002098,74.125.130.0-255,5020,169385,77,244845
8605,0.002101,172.31.40.0-255,66,169451,77,244845
8606,0.002121,74.125.130.0-255,5738,175189,77,244845
8607,0.002124,172.31.40.0-255,66,175255,77,244845
8608,0.002148,74.125.130.0-255,7156,182411,77,244845
8609,0.002151,172.31.40.0-255,66,182477,77,244845
8610,0.002173,74.125.130.0-255,4320,186797,77,244845
8611,0.002176,172.31.40.0-255,66,186863,77,244845
8612,0.002194,74.125.130.0-255,2902,189765,77,244845
8613,0.002196,172.31.40.0-255,66,189831,77,244845
8614,0.002219,74.125.130.0-255,8574,198405,77,244845
8615,0.002222,172.31.40.0-255,66,198471,77,244845
8616,0.002227,74.125.130.0-255,2902,201373,77,244845
8617,0.002229,172.31.40.0-255,66,201439,77,244845
8618,0.002253,74.125.130.0-255,2184,203623,77,244845
8619,0.002273,172.31.40.0-255,66,203689,77,244845
8620,0.004452,74.125.130.0-255,2902,206591,77,244845
8621,0.00446,172.31.40.0-255,66,206657,77,244845
8622,0.004488,74.125.130.0-255,2902,209559,77,244845
8623,0.004491,172.31.40.0-255,66,209625,77,244845
8624,0.006681,74.125.130.0-255,2902,212527,77,244845
8625,0.00669,172.31.40.0-255,66,212593,77,244845
8626,0.006718,74.125.130.0-255,2902,215495,77,244845
8627,0.00672,172.31.40.0-255,66,215561,77,244845
8628,0.008917,74.125.130.0-255,2902,218463,77,244845
8629,0.008922,172.31.40.0-255,66,218529,77,244845
8630,0.00897,74.125.130.0-255,2902,221431,77,244845
8631,0.008972,172.31.40.0-255,66,221497,77,244845
8632,0.01116,74.125.130.0-255,2902,224399,77,244845
8633,0.011168,172.31.40.0-255,66,224465,77,244845
8634,0.01119,74.125.130.0-255,2902,227367,77,244845
8635,0.011192,172.31.40.0-255,66,227433,77,244845
8636,0.013401,74.125.130.0-255,5738,233171,77,244845
8637,0.013409,172.31.40.0-255,66,233237,77,244845
8638,0.015647,74.125.130.0-255,5738,238975,77,244845
8639,0.015655,172.31.40.0-255,66,239041,77,244845
8640,0.017888,74.125.130.0-255,5738,244779,77,244845
8641,0.0179,172.31.40.0-255,66,244845,77,244845
8642,0.0,172.253.118.0-255,150,150,77,369015
8643,1.8e-05,172.31.40.0-255,66,216,77,369015
8644,2.4e-05,172.253.118.0-255,1484,1700,77,369015
8645,2.8e-05,172.31.40.0-255,66,1766,77,369015
8646,3.3e-05,172.253.118.0-255,2902,4668,77,369015
8647,3.7e-05,172.31.40.0-255,66,4734,77,369015
8648,4.3e-05,172.253.118.0-255,7156,11890,77,369015
8649,4.6e-05,172.31.40.0-255,66,11956,77,369015
8650,7e-05,172.253.118.0-255,9992,21948,77,369015
8651,7.4e-05,172.31.40.0-255,66,22014,77,369015
8652,0.000102,172.253.118.0-255,2023,24037,77,369015
8653,0.000104,172.31.40.0-255,66,24103,77,369015
8654,0.000111,172.253.118.0-255,6797,30900,77,369015
8655,0.000114,172.31.40.0-255,66,30966,77,369015
8656,0.000166,172.253.118.0-255,1484,32450,77,369015
8657,0.000169,172.31.40.0-255,66,32516,77,369015
8658,0.000174,172.253.118.0-255,2902,35418,77,369015
8659,0.000176,172.31.40.0-255,66,35484,77,369015
8660,0.000194,172.253.118.0-255,5738,41222,77,369015
8661,0.000196,172.31.40.0-255,66,41288,77,369015
8662,0.000227,172.253.118.0-255,7156,48444,77,369015
8663,0.00023,172.31.40.0-255,66,48510,77,369015
8664,0.000258,172.253.118.0-255,6797,55307,77,369015
8665,0.00026,172.31.40.0-255,66,55373,77,369015
8666,0.000269,172.253.118.0-255,8574,63947,77,369015
8667,0.000271,172.31.40.0-255,66,64013,77,369015
8668,0.000303,172.253.118.0-255,1466,65479,77,369015
8669,0.000305,172.31.40.0-255,66,65545,77,369015
8670,0.000389,172.253.118.0-255,1484,67029,77,369015
8671,0.000393,172.31.40.0-255,66,67095,77,369015
8672,0.000399,172.253.118.0-255,2902,69997,77,369015
8673,0.000401,172.31.40.0-255,66,70063,77,369015
8674,0.000448,172.253.118.0-255,5738,75801,77,369015
8675,0.000451,172.31.40.0-255,66,75867,77,369015
8676,0.000458,172.253.118.0-255,6797,82664,77,369015
8677,0.000461,172.31.40.0-255,66,82730,77,369015
8678,0.000464,172.253.118.0-255,1484,84214,77,369015
8679,0.000491,172.253.118.0-255,12828,97042,77,369015
8680,0.000493,172.31.40.0-255,66,97108,77,369015
8681,0.000498,172.253.118.0-255,2543,99651,77,369015
8682,0.0005,172.31.40.0-255,66,99717,77,369015
8683,0.000535,172.253.118.0-255,1484,101201,77,369015
8684,0.000541,172.253.118.0-255,2902,104103,77,369015
8685,0.000543,172.31.40.0-255,66,104169,77,369015
8686,0.000569,172.253.118.0-255,5738,109907,77,369015
8687,0.000572,172.31.40.0-255,66,109973,77,369015
8688,0.00059,172.253.118.0-255,2902,112875,77,369015
8689,0.000593,172.31.40.0-255,66,112941,77,369015
8690,0.000615,172.253.118.0-255,3660,116601,77,369015
8691,0.000618,172.31.40.0-255,66,116667,77,369015
8692,0.000637,172.253.118.0-255,2902,119569,77,369015
8693,0.00064,172.31.40.0-255,66,119635,77,369015
8694,0.000663,172.253.118.0-255,4320,123955,77,369015
8695,0.000666,172.31.40.0-255,66,124021,77,369015
8696,0.000669,172.253.118.0-255,1484,125505,77,369015
8697,0.000693,172.253.118.0-255,7156,132661,77,369015
8698,0.000695,172.253.118.0-255,1484,134145,77,369015
8699,0.000699,172.31.40.0-255,66,134211,77,369015
8700,0.000719,172.253.118.0-255,2902,137113,77,369015
8701,0.000721,172.31.40.0-255,66,137179,77,369015
8702,0.000727,172.253.118.0-255,5738,142917,77,369015
8703,0.00073,172.31.40.0-255,66,142983,77,369015
8704,0.000741,172.253.118.0-255,1484,144467,77,369015
8705,0.000764,172.253.118.0-255,6438,150905,77,369015
8706,0.000779,172.31.40.0-255,66,150971,77,369015
8707,0.000797,172.253.118.0-255,1484,152455,77,369015
8708,0.000814,172.253.118.0-255,2902,155357,77,369015
8709,0.000819,172.253.118.0-255,4320,159677,77,369015
8710,0.000832,172.253.118.0-255,1484,161161,77,369015
8711,0.000847,172.253.118.0-255,5738,166899,77,369015
8712,0.000852,172.31.40.0-255,66,166965,77,369015
8713,0.000879,172.253.118.0-255,7156,174121,77,369015
8714,0.000885,172.253.118.0-255,5738,179859,77,369015
8715,0.000897,172.31.40.0-255,66,179925,77,369015
8716,0.000903,172.253.118.0-255,4320,184245,77,369015
8717,0.000912,172.31.40.0-255,66,184311,77,369015
8718,0.000915,172.253.118.0-255,766,185077,77,369015
8719,0.000973,172.253.118.0-255,1484,186561,77,369015
8720,0.000979,172.31.40.0-255,66,186627,77,369015
8721,0.000988,172.253.118.0-255,2902,189529,77,369015
8722,0.000993,172.253.118.0-255,4320,193849,77,369015
8723,0.000996,172.31.40.0-255,66,193915,77,369015
8724,0.001004,172.253.118.0-255,1484,195399,77,369015
8725,0.00101,172.253.118.0-255,5738,201137,77,369015
8726,0.001025,172.253.118.0-255,4320,205457,77,369015
8727,0.001035,172.31.40.0-255,66,205523,77,369015
8728,0.001061,172.253.118.0-255,2902,208425,77,369015
8729,0.001074,172.31.40.0-255,66,208491,77,369015
8730,0.001089,172.253.118.0-255,10692,219183,77,369015
8731,0.001107,172.31.40.0-255,66,219249,77,369015
8732,0.001169,172.253.118.0-255,1484,220733,77,369015
8733,0.001183,172.253.118.0-255,2902,223635,77,369015
8734,0.001198,172.31.40.0-255,66,223701,77,369015
8735,0.001206,172.253.118.0-255,2902,226603,77,369015
8736,0.001218,172.253.118.0-255,2902,229505,77,369015
8737,0.001224,172.253.118.0-255,5738,235243,77,369015
8738,0.001234,172.253.118.0-255,1484,236727,77,369015
8739,0.001238,172.31.40.0-255,66,236793,77,369015
8740,0.001247,172.253.118.0-255,4320,241113,77,369015
8741,0.001251,172.31.40.0-255,66,241179,77,369015
8742,0.001267,172.253.118.0-255,9992,251171,77,369015
8743,0.001276,172.253.118.0-255,2184,253355,77,369015
8744,0.001329,172.31.40.0-255,66,253421,77,369015
8745,0.001425,172.253.118.0-255,1484,254905,77,369015
8746,0.001444,172.253.118.0-255,2902,257807,77,369015
8747,0.001451,172.253.118.0-255,5738,263545,77,369015
8748,0.001456,172.31.40.0-255,66,263611,77,369015
8749,0.001478,172.253.118.0-255,7156,270767,77,369015
8750,0.00151,172.31.40.0-255,66,270833,77,369015
8751,0.001535,172.253.118.0-255,9274,280107,77,369015
8752,0.001543,172.253.118.0-255,9992,290099,77,369015
8753,0.001548,172.31.40.0-255,66,290165,77,369015
8754,0.001571,172.253.118.0-255,7156,297321,77,369015
8755,0.001577,172.31.40.0-255,66,297387,77,369015
8756,0.001607,172.253.118.0-255,9274,306661,77,369015
8757,0.001611,172.253.118.0-255,2902,309563,77,369015
8758,0.001614,172.253.118.0-255,1484,311047,77,369015
8759,0.001618,172.31.40.0-255,66,311113,77,369015
8760,0.001638,172.253.118.0-255,2902,314015,77,369015
8761,0.001645,172.253.118.0-255,7156,321171,77,369015
8762,0.001657,172.253.118.0-255,1484,322655,77,369015
8763,0.001662,172.31.40.0-255,66,322721,77,369015
8764,0.001686,172.253.118.0-255,11410,334131,77,369015
8765,0.001692,172.31.40.0-255,66,334197,77,369015
8766,0.001714,172.253.118.0-255,6438,340635,77,369015
8767,0.001719,172.253.118.0-255,4320,344955,77,369015
8768,0.001728,172.31.40.0-255,66,345021,77,369015
8769,0.00174,172.253.118.0-255,8574,353595,77,369015
8770,0.001777,172.253.118.0-255,9992,363587,77,369015
8771,0.001791,172.253.118.0-255,766,364353,77,369015
8772,0.001823,172.253.118.0-255,4320,368673,77,369015
8773,0.001864,172.253.118.0-255,105,368778,77,369015
8774,0.007422,172.31.40.0-255,66,368844,77,369015
8775,0.010157,172.31.40.0-255,105,368949,77,369015
8776,0.012687,172.253.118.0-255,66,369015,77,369015
8777,0.0,172.217.194.0-255,150,150,77,412068
8778,2.3e-05,172.31.40.0-255,66,216,77,412068
8779,2.9e-05,172.217.194.0-255,1484,1700,77,412068
8780,3.3e-05,172.31.40.0-255,66,1766,77,412068
8781,3.6e-05,172.217.194.0-255,1484,3250,77,412068
8782,4e-05,172.31.40.0-255,66,3316,77,412068
8783,4.6e-05,172.217.194.0-255,2902,6218,77,412068
8784,4.9e-05,172.31.40.0-255,66,6284,77,412068
8785,5.6e-05,172.217.194.0-255,5738,12022,77,412068
8786,5.9e-05,172.31.40.0-255,66,12088,77,412068
8787,9.7e-05,172.217.194.0-255,7692,19780,77,412068
8788,0.000101,172.31.40.0-255,66,19846,77,412068
8789,0.00011,172.217.194.0-255,8574,28420,77,412068
8790,0.000112,172.31.40.0-255,66,28486,77,412068
8791,0.000121,172.217.194.0-255,8574,37060,77,412068
8792,0.000124,172.31.40.0-255,66,37126,77,412068
8793,0.000159,172.217.194.0-255,9992,47118,77,412068
8794,0.000161,172.31.40.0-255,66,47184,77,412068
8795,0.000164,172.217.194.0-255,766,47950,77,412068
8796,0.000166,172.31.40.0-255,66,48016,77,412068
8797,0.000204,172.217.194.0-255,1484,49500,77,412068
8798,0.000207,172.31.40.0-255,66,49566,77,412068
8799,0.000211,172.217.194.0-255,2902,52468,77,412068
8800,0.000213,172.31.40.0-255,66,52534,77,412068
8801,0.00022,172.217.194.0-255,5738,58272,77,412068
8802,0.000222,172.31.40.0-255,66,58338,77,412068
8803,0.000228,172.217.194.0-255,4320,62658,77,412068
8804,0.00023,172.31.40.0-255,66,62724,77,412068
8805,0.000243,172.217.194.0-255,2841,65565,77,412068
8806,0.000246,172.31.40.0-255,66,65631,77,412068
8807,0.000273,172.217.194.0-255,2902,68533,77,412068
8808,0.000276,172.31.40.0-255,66,68599,77,412068
8809,0.000297,172.217.194.0-255,4320,72919,77,412068
8810,0.000306,172.217.194.0-255,8574,81493,77,412068
8811,0.000329,172.217.194.0-255,11410,92903,77,412068
8812,0.00035,172.217.194.0-255,5738,98641,77,412068
8813,0.000353,172.217.194.0-255,1079,99720,77,412068
8814,0.000392,172.217.194.0-255,1484,101204,77,412068
8815,0.000397,172.217.194.0-255,2902,104106,77,412068
8816,0.0004,172.217.194.0-255,1484,105590,77,412068
8817,0.000414,172.217.194.0-255,4320,109910,77,412068
8818,0.000428,172.217.194.0-255,4320,114230,77,412068
8819,0.00045,172.217.194.0-255,8574,122804,77,412068
8820,0.000459,172.217.194.0-255,9992,132796,77,412068
8821,0.000462,172.217.194.0-255,217,133013,77,412068
8822,0.000503,172.217.194.0-255,1484,134497,77,412068
8823,0.000524,172.217.194.0-255,4320,138817,77,412068
8824,0.000529,172.217.194.0-255,2902,141719,77,412068
8825,0.000547,172.217.194.0-255,5738,147457,77,412068
8826,0.000553,172.217.194.0-255,5738,153195,77,412068
8827,0.000596,172.217.194.0-255,2902,156097,77,412068
8828,0.00062,172.217.194.0-255,10692,166789,77,412068
8829,0.000674,172.31.40.0-255,66,166855,77,412068
8830,0.000693,172.217.194.0-255,1484,168339,77,412068
8831,0.000709,172.217.194.0-255,2902,171241,77,412068
8832,0.000726,172.31.40.0-255,66,171307,77,412068
8833,0.000733,172.217.194.0-255,5738,177045,77,412068
8834,0.000735,172.217.194.0-255,1484,178529,77,412068
8835,0.000742,172.31.40.0-255,66,178595,77,412068
8836,0.000763,172.217.194.0-255,11410,190005,77,412068
8837,0.000813,172.217.194.0-255,7156,197161,77,412068
8838,0.000826,172.31.40.0-255,66,197227,77,412068
8839,0.000833,172.217.194.0-255,1484,198711,77,412068
8840,0.000837,172.217.194.0-255,2184,200895,77,412068
8841,0.000841,172.217.194.0-255,2902,203797,77,412068
8842,0.000847,172.31.40.0-255,66,203863,77,412068
8843,0.000856,172.217.194.0-255,2902,206765,77,412068
8844,0.000861,172.217.194.0-255,5738,212503,77,412068
8845,0.000873,172.217.194.0-255,1484,213987,77,412068
8846,0.000891,172.31.40.0-255,66,214053,77,412068
8847,0.000905,172.217.194.0-255,5738,219791,77,412068
8848,0.000921,172.217.194.0-255,5738,225529,77,412068
8849,0.000934,172.31.40.0-255,66,225595,77,412068
8850,0.000948,172.217.194.0-255,4320,229915,77,412068
8851,0.000954,172.217.194.0-255,5020,234935,77,412068
8852,0.000977,172.31.40.0-255,66,235001,77,412068
8853,0.001289,172.217.194.0-255,1484,236485,77,412068
8854,0.001295,172.217.194.0-255,2902,239387,77,412068
8855,0.001303,172.31.40.0-255,66,239453,77,412068
8856,0.001318,172.217.194.0-255,5738,245191,77,412068
8857,0.00134,172.217.194.0-255,4320,249511,77,412068
8858,0.001343,172.217.194.0-255,1484,250995,77,412068
8859,0.001349,172.31.40.0-255,66,251061,77,412068
8860,0.001375,172.217.194.0-255,9992,261053,77,412068
8861,0.001383,172.217.194.0-255,7856,268909,77,412068
8862,0.001399,172.31.40.0-255,66,268975,77,412068
8863,0.001427,172.217.194.0-255,1484,270459,77,412068
8864,0.001431,172.217.194.0-255,1484,271943,77,412068
8865,0.001447,172.217.194.0-255,1484,273427,77,412068
8866,0.001452,172.217.194.0-255,4320,277747,77,412068
8867,0.001458,172.31.40.0-255,66,277813,77,412068
8868,0.001475,172.217.194.0-255,1484,279297,77,412068
8869,0.001486,172.217.194.0-255,8574,287871,77,412068
8870,0.001502,172.31.40.0-255,66,287937,77,412068
8871,0.001521,172.217.194.0-255,1484,289421,77,412068
8872,0.00155,172.217.194.0-255,13528,302949,77,412068
8873,0.001578,172.217.194.0-255,11410,314359,77,412068
8874,0.001585,172.31.40.0-255,66,314425,77,412068
8875,0.001608,172.217.194.0-255,4320,318745,77,412068
8876,0.001617,172.217.194.0-255,9992,328737,77,412068
8877,0.001623,172.31.40.0-255,66,328803,77,412068
8878,0.001636,172.217.194.0-255,5738,334541,77,412068
8879,0.001653,172.217.194.0-255,2184,336725,77,412068
8880,0.001661,172.217.194.0-255,8574,345299,77,412068
8881,0.001672,172.31.40.0-255,66,345365,77,412068
8882,0.001679,172.217.194.0-255,8574,353939,77,412068
8883,0.001684,172.31.40.0-255,66,354005,77,412068
8884,0.001699,172.217.194.0-255,9992,363997,77,412068
8885,0.001705,172.217.194.0-255,6438,370435,77,412068
8886,0.001737,172.217.194.0-255,4320,374755,77,412068
8887,0.001743,172.31.40.0-255,66,374821,77,412068
8888,0.001759,172.217.194.0-255,5738,380559,77,412068
8889,0.0018,172.217.194.0-255,5738,386297,77,412068
8890,0.001817,172.217.194.0-255,5738,392035,77,412068
8891,0.001828,172.217.194.0-255,12110,404145,77,412068
8892,0.001834,172.217.194.0-255,5738,409883,77,412068
8893,0.001841,172.31.40.0-255,66,409949,77,412068
8894,0.001857,172.217.194.0-255,1777,411726,77,412068
8895,0.00186,172.217.194.0-255,105,411831,77,412068
8896,0.00188,172.31.40.0-255,66,411897,77,412068
8897,0.004086,172.31.40.0-255,105,412002,77,412068
8898,0.006083,172.217.194.0-255,66,412068,77,412068
8899,0.0,172.217.194.0-255,153,153,77,198530
8900,1.1e-05,172.31.40.0-255,66,219,77,198530
8901,1.6e-05,172.217.194.0-255,1484,1703,77,198530
8902,2e-05,172.31.40.0-255,66,1769,77,198530
8903,2.4e-05,172.217.194.0-255,1484,3253,77,198530
8904,2.6e-05,172.31.40.0-255,66,3319,77,198530
8905,5.1e-05,172.217.194.0-255,1484,4803,77,198530
8906,5.3e-05,172.31.40.0-255,66,4869,77,198530
8907,5.9e-05,172.217.194.0-255,4320,9189,77,198530
8908,6.2e-05,172.31.40.0-255,66,9255,77,198530
8909,7.9e-05,172.217.194.0-255,1484,10739,77,198530
8910,8.2e-05,172.31.40.0-255,66,10805,77,198530
8911,0.000111,172.217.194.0-255,7706,18511,77,198530
8912,0.000114,172.31.40.0-255,66,18577,77,198530
8913,0.000123,172.217.194.0-255,9992,28569,77,198530
8914,0.000125,172.31.40.0-255,66,28635,77,198530
8915,0.000149,172.217.194.0-255,2543,31178,77,198530
8916,0.000151,172.31.40.0-255,66,31244,77,198530
8917,0.000156,172.217.194.0-255,2902,34146,77,198530
8918,0.000158,172.31.40.0-255,66,34212,77,198530
8919,0.000172,172.217.194.0-255,2902,37114,77,198530
8920,0.000174,172.31.40.0-255,66,37180,77,198530
8921,0.000195,172.217.194.0-255,4320,41500,77,198530
8922,0.000198,172.31.40.0-255,66,41566,77,198530
8923,0.000205,172.217.194.0-255,6797,48363,77,198530
8924,0.000207,172.31.40.0-255,66,48429,77,198530
8925,0.000248,172.31.40.0-255,66,48495,77,198530
8926,0.000251,172.217.194.0-255,1125,49620,77,198530
8927,0.000253,172.31.40.0-255,66,49686,77,198530
8928,0.00047,172.217.194.0-255,645,50331,77,198530
8929,0.000475,172.31.40.0-255,66,50397,77,198530
8930,0.000566,172.217.194.0-255,1484,51881,77,198530
8931,0.000573,172.217.194.0-255,2902,54783,77,198530
8932,0.000575,172.31.40.0-255,66,54849,77,198530
8933,0.000603,172.217.194.0-255,5738,60587,77,198530
8934,0.000607,172.31.40.0-255,66,60653,77,198530
8935,0.000614,172.217.194.0-255,7156,67809,77,198530
8936,0.000617,172.31.40.0-255,66,67875,77,198530
8937,0.000661,172.31.40.0-255,66,67941,77,198530
8938,0.000665,172.217.194.0-255,2184,70125,77,198530
8939,0.000667,172.31.40.0-255,66,70191,77,198530
8940,0.000725,172.31.40.0-255,101,70292,77,198530
8941,0.000745,172.217.194.0-255,1484,71776,77,198530
8942,0.00075,172.217.194.0-255,2902,74678,77,198530
8943,0.000753,172.31.40.0-255,66,74744,77,198530
8944,0.000792,172.217.194.0-255,5738,80482,77,198530
8945,0.000796,172.31.40.0-255,66,80548,77,198530
8946,0.000803,172.217.194.0-255,5738,86286,77,198530
8947,0.000805,172.31.40.0-255,66,86352,77,198530
8948,0.000838,172.217.194.0-255,7156,93508,77,198530
8949,0.000841,172.31.40.0-255,66,93574,77,198530
8950,0.000846,172.217.194.0-255,4320,97894,77,198530
8951,0.000849,172.31.40.0-255,66,97960,77,198530
8952,0.000867,172.217.194.0-255,5738,103698,77,198530
8953,0.00087,172.31.40.0-255,66,103764,77,198530
8954,0.000904,172.217.194.0-255,13528,117292,77,198530
8955,0.000908,172.31.40.0-255,66,117358,77,198530
8956,0.000924,172.31.40.0-255,66,117424,77,198530
8957,0.000931,172.217.194.0-255,6438,123862,77,198530
8958,0.000934,172.31.40.0-255,66,123928,77,198530
8959,0.001538,172.217.194.0-255,1484,125412,77,198530
8960,0.001547,172.217.194.0-255,2902,128314,77,198530
8961,0.001553,172.31.40.0-255,66,128380,77,198530
8962,0.00156,172.217.194.0-255,5738,134118,77,198530
8963,0.001563,172.31.40.0-255,66,134184,77,198530
8964,0.001598,172.217.194.0-255,12828,147012,77,198530
8965,0.001601,172.31.40.0-255,66,147078,77,198530
8966,0.001611,172.217.194.0-255,10692,157770,77,198530
8967,0.001614,172.31.40.0-255,66,157836,77,198530
8968,0.003008,172.217.194.0-255,66,157902,77,198530
8969,0.003915,172.217.194.0-255,5738,163640,77,198530
8970,0.003928,172.31.40.0-255,66,163706,77,198530
8971,0.006222,172.217.194.0-255,5738,169444,77,198530
8972,0.006228,172.31.40.0-255,66,169510,77,198530
8973,0.008548,172.217.194.0-255,5738,175248,77,198530
8974,0.008555,172.31.40.0-255,66,175314,77,198530
8975,0.010906,172.217.194.0-255,5738,181052,77,198530
8976,0.010915,172.31.40.0-255,66,181118,77,198530
8977,0.013216,172.217.194.0-255,5738,186856,77,198530
8978,0.013226,172.31.40.0-255,66,186922,77,198530
8979,0.015561,172.217.194.0-255,5738,192660,77,198530
8980,0.015567,172.31.40.0-255,66,192726,77,198530
8981,0.017872,172.217.194.0-255,5738,198464,77,198530
8982,0.017878,172.31.40.0-255,66,198530,77,198530
8983,0.0,172.217.194.0-255,153,153,77,344593
8984,2.4e-05,172.31.40.0-255,66,219,77,344593
8985,3.1e-05,172.217.194.0-255,1484,1703,77,344593
8986,3.7e-05,172.31.40.0-255,66,1769,77,344593
8987,4.3e-05,172.217.194.0-255,2902,4671,77,344593
8988,4.6e-05,172.31.40.0-255,66,4737,77,344593
8989,5e-05,172.217.194.0-255,1484,6221,77,344593
8990,5.3e-05,172.31.40.0-255,66,6287,77,344593
8991,8e-05,172.217.194.0-255,4320,10607,77,344593
8992,8.3e-05,172.31.40.0-255,66,10673,77,344593
8993,8.6e-05,172.217.194.0-255,1484,12157,77,344593
8994,8.8e-05,172.31.40.0-255,66,12223,77,344593
8995,0.000108,172.217.194.0-255,2109,14332,77,344593
8996,0.00011,172.31.40.0-255,66,14398,77,344593
8997,0.000178,172.217.194.0-255,1484,15882,77,344593
8998,0.000181,172.31.40.0-255,66,15948,77,344593
8999,0.000196,172.217.194.0-255,2902,18850,77,344593
9000,0.000199,172.31.40.0-255,66,18916,77,344593
9001,0.000207,172.217.194.0-255,5738,24654,77,344593
9002,0.000209,172.31.40.0-255,66,24720,77,344593
9003,0.000259,172.217.194.0-255,13887,38607,77,344593
9004,0.000262,172.31.40.0-255,66,38673,77,344593
9005,0.000265,172.217.194.0-255,1484,40157,77,344593
9006,0.000267,172.31.40.0-255,66,40223,77,344593
9007,0.000286,172.217.194.0-255,5738,45961,77,344593
9008,0.000289,172.31.40.0-255,66,46027,77,344593
9009,0.000327,172.217.194.0-255,11410,57437,77,344593
9010,0.000331,172.31.40.0-255,66,57503,77,344593
9011,0.000339,172.217.194.0-255,7856,65359,77,344593
9012,0.000342,172.31.40.0-255,66,65425,77,344593
9013,0.000344,172.217.194.0-255,409,65834,77,344593
9014,0.000347,172.31.40.0-255,66,65900,77,344593
9015,0.000384,172.217.194.0-255,1484,67384,77,344593
9016,0.000401,172.217.194.0-255,2902,70286,77,344593
9017,0.000421,172.217.194.0-255,5738,76024,77,344593
9018,0.000436,172.217.194.0-255,2902,78926,77,344593
9019,0.000456,172.217.194.0-255,7156,86082,77,344593
9020,0.000474,172.217.194.0-255,2902,88984,77,344593
9021,0.00048,172.217.194.0-255,4320,93304,77,344593
9022,0.000506,172.217.194.0-255,6438,99742,77,344593
9023,0.000509,172.217.194.0-255,365,100107,77,344593
9024,0.000592,172.31.40.0-255,66,100173,77,344593
9025,0.000745,172.217.194.0-255,1484,101657,77,344593
9026,0.000749,172.217.194.0-255,1484,103141,77,344593
9027,0.000756,172.31.40.0-255,66,103207,77,344593
9028,0.000777,172.217.194.0-255,1484,104691,77,344593
9029,0.000784,172.217.194.0-255,5738,110429,77,344593
9030,0.000796,172.217.194.0-255,12828,123257,77,344593
9031,0.000803,172.31.40.0-255,66,123323,77,344593
9032,0.000832,172.217.194.0-255,10143,133466,77,344593
9033,0.000845,172.31.40.0-255,66,133532,77,344593
9034,0.000881,172.217.194.0-255,1484,135016,77,344593
9035,0.000886,172.217.194.0-255,2902,137918,77,344593
9036,0.000901,172.31.40.0-255,66,137984,77,344593
9037,0.000913,172.217.194.0-255,5738,143722,77,344593
9038,0.000928,172.31.40.0-255,66,143788,77,344593
9039,0.000938,172.217.194.0-255,2902,146690,77,344593
9040,0.000941,172.217.194.0-255,1484,148174,77,344593
9041,0.000955,172.31.40.0-255,66,148240,77,344593
9042,0.000968,172.217.194.0-255,2902,151142,77,344593
9043,0.000975,172.217.194.0-255,7156,158298,77,344593
9044,0.00102,172.31.40.0-255,66,158364,77,344593
9045,0.001035,172.217.194.0-255,9274,167638,77,344593
9046,0.001059,172.31.40.0-255,66,167704,77,344593
9047,0.001384,172.217.194.0-255,1484,169188,77,344593
9048,0.001404,172.217.194.0-255,2902,172090,77,344593
9049,0.001408,172.31.40.0-255,66,172156,77,344593
9050,0.001415,172.217.194.0-255,5738,177894,77,344593
9051,0.00143,172.217.194.0-255,4320,182214,77,344593
9052,0.001434,172.31.40.0-255,66,182280,77,344593
9053,0.001449,172.217.194.0-255,1484,183764,77,344593
9054,0.001453,172.217.194.0-255,1484,185248,77,344593
9055,0.00146,172.31.40.0-255,66,185314,77,344593
9056,0.001488,172.217.194.0-255,11410,196724,77,344593
9057,0.001495,172.217.194.0-255,5020,201744,77,344593
9058,0.001513,172.31.40.0-255,66,201810,77,344593
9059,0.001644,172.217.194.0-255,1484,203294,77,344593
9060,0.001651,172.217.194.0-255,2902,206196,77,344593
9061,0.001658,172.31.40.0-255,66,206262,77,344593
9062,0.00168,172.217.194.0-255,5738,212000,77,344593
9063,0.001683,172.31.40.0-255,66,212066,77,344593
9064,0.001689,172.217.194.0-255,7156,219222,77,344593
9065,0.001694,172.217.194.0-255,2902,222124,77,344593
9066,0.001712,172.217.194.0-255,8574,230698,77,344593
9067,0.001715,172.31.40.0-255,66,230764,77,344593
9068,0.001719,172.31.40.0-255,66,230830,77,344593
9069,0.001737,172.217.194.0-255,2902,233732,77,344593
9070,0.001741,172.217.194.0-255,2184,235916,77,344593
9071,0.001756,172.31.40.0-255,66,235982,77,344593
9072,0.001933,172.217.194.0-255,1484,237466,77,344593
9073,0.001939,172.217.194.0-255,2902,240368,77,344593
9074,0.001943,172.31.40.0-255,66,240434,77,344593
9075,0.001946,172.217.194.0-255,1484,241918,77,344593
9076,0.001964,172.217.194.0-255,4320,246238,77,344593
9077,0.001975,172.31.40.0-255,66,246304,77,344593
9078,0.001997,172.217.194.0-255,11410,257714,77,344593
9079,0.002016,172.31.40.0-255,66,257780,77,344593
9080,0.00202,172.217.194.0-255,1484,259264,77,344593
9081,0.002042,172.217.194.0-255,9992,269256,77,344593
9082,0.00205,172.217.194.0-255,8574,277830,77,344593
9083,0.002058,172.31.40.0-255,66,277896,77,344593
9084,0.002076,172.217.194.0-255,2184,280080,77,344593
9085,0.002087,172.217.194.0-255,11410,291490,77,344593
9086,0.002094,172.217.194.0-255,5738,297228,77,344593
9087,0.002104,172.31.40.0-255,66,297294,77,344593
9088,0.002118,172.217.194.0-255,6438,303732,77,344593
9089,0.002123,172.31.40.0-255,66,303798,77,344593
9090,0.002166,172.31.40.0-255,101,303899,77,344593
9091,0.004201,172.217.194.0-255,5738,309637,77,344593
9092,0.004209,172.31.40.0-255,66,309703,77,344593
9093,0.00423,172.217.194.0-255,66,309769,77,344593
9094,0.00631,172.217.194.0-255,5738,315507,77,344593
9095,0.006313,172.31.40.0-255,66,315573,77,344593
9096,0.00842,172.217.194.0-255,5738,321311,77,344593
9097,0.008424,172.31.40.0-255,66,321377,77,344593
9098,0.010508,172.217.194.0-255,5738,327115,77,344593
9099,0.010522,172.31.40.0-255,66,327181,77,344593
9100,0.012612,172.217.194.0-255,5738,332919,77,344593
9101,0.015433,172.31.40.0-255,66,332985,77,344593
9102,0.017538,172.217.194.0-255,5738,338723,77,344593
9103,0.017555,172.31.40.0-255,66,338789,77,344593
9104,0.019741,172.217.194.0-255,5738,344527,77,344593
9105,0.019751,172.31.40.0-255,66,344593,77,344593
9106,0.0,172.253.118.0-255,150,150,77,215352
9107,1.8e-05,172.31.40.0-255,66,216,77,215352
9108,2.4e-05,172.253.118.0-255,1484,1700,77,215352
9109,2.9e-05,172.31.40.0-255,66,1766,77,215352
9110,3.4e-05,172.253.118.0-255,2902,4668,77,215352
9111,3.7e-05,172.31.40.0-255,66,4734,77,215352
9112,4.2e-05,172.253.118.0-255,2902,7636,77,215352
9113,4.5e-05,172.31.40.0-255,66,7702,77,215352
9114,5.1e-05,172.253.118.0-255,4320,12022,77,215352
9115,5.3e-05,172.31.40.0-255,66,12088,77,215352
9116,5.8e-05,172.253.118.0-255,2902,14990,77,215352
9117,6.1e-05,172.31.40.0-255,66,15056,77,215352
9118,9.5e-05,172.253.118.0-255,6324,21380,77,215352
9119,9.8e-05,172.31.40.0-255,66,21446,77,215352
9120,0.000104,172.253.118.0-255,5738,27184,77,215352
9121,0.000106,172.31.40.0-255,66,27250,77,215352
9122,0.000109,172.253.118.0-255,1484,28734,77,215352
9123,0.000111,172.31.40.0-255,66,28800,77,215352
9124,0.000131,172.253.118.0-255,2543,31343,77,215352
9125,0.000133,172.31.40.0-255,66,31409,77,215352
9126,0.000209,172.253.118.0-255,1484,32893,77,215352
9127,0.000213,172.31.40.0-255,66,32959,77,215352
9128,0.000227,172.253.118.0-255,2902,35861,77,215352
9129,0.00023,172.31.40.0-255,66,35927,77,215352
9130,0.000235,172.253.118.0-255,4320,40247,77,215352
9131,0.000237,172.31.40.0-255,66,40313,77,215352
9132,0.000255,172.253.118.0-255,1484,41797,77,215352
9133,0.000257,172.31.40.0-255,66,41863,77,215352
9134,0.000263,172.253.118.0-255,4320,46183,77,215352
9135,0.000265,172.31.40.0-255,66,46249,77,215352
9136,0.000286,172.253.118.0-255,9633,55882,77,215352
9137,0.000288,172.31.40.0-255,66,55948,77,215352
9138,0.000296,172.253.118.0-255,5738,61686,77,215352
9139,0.000299,172.31.40.0-255,66,61752,77,215352
9140,0.000314,172.253.118.0-255,2902,64654,77,215352
9141,0.000316,172.31.40.0-255,66,64720,77,215352
9142,0.000319,172.253.118.0-255,1125,65845,77,215352
9143,0.000612,172.253.118.0-255,645,66490,77,215352
9144,0.000618,172.31.40.0-255,66,66556,77,215352
9145,0.000704,172.253.118.0-255,1484,68040,77,215352
9146,0.000709,172.253.118.0-255,2902,70942,77,215352
9147,0.000712,172.31.40.0-255,66,71008,77,215352
9148,0.000734,172.253.118.0-255,5738,76746,77,215352
9149,0.000736,172.31.40.0-255,66,76812,77,215352
9150,0.000739,172.253.118.0-255,1484,78296,77,215352
9151,0.000761,172.253.118.0-255,4320,82616,77,215352
9152,0.000763,172.31.40.0-255,66,82682,77,215352
9153,0.000766,172.253.118.0-255,577,83259,77,215352
9154,0.00082,172.253.118.0-255,1484,84743,77,215352
9155,0.000823,172.31.40.0-255,66,84809,77,215352
9156,0.000843,172.253.118.0-255,2902,87711,77,215352
9157,0.000845,172.31.40.0-255,66,87777,77,215352
9158,0.000848,172.253.118.0-255,1484,89261,77,215352
9159,0.000863,172.253.118.0-255,4320,93581,77,215352
9160,0.000865,172.31.40.0-255,66,93647,77,215352
9161,0.000894,172.253.118.0-255,6797,100444,77,215352
9162,0.000897,172.31.40.0-255,66,100510,77,215352
9163,0.001094,172.253.118.0-255,1484,101994,77,215352
9164,0.001099,172.253.118.0-255,1484,103478,77,215352
9165,0.001102,172.31.40.0-255,66,103544,77,215352
9166,0.001121,172.253.118.0-255,1484,105028,77,215352
9167,0.001128,172.253.118.0-255,5738,110766,77,215352
9168,0.001131,172.31.40.0-255,66,110832,77,215352
9169,0.001149,172.253.118.0-255,1484,112316,77,215352
9170,0.001167,172.253.118.0-255,8574,120890,77,215352
9171,0.00117,172.31.40.0-255,66,120956,77,215352
9172,0.001188,172.253.118.0-255,2902,123858,77,215352
9173,0.001193,172.31.40.0-255,66,123924,77,215352
9174,0.001205,172.253.118.0-255,5738,129662,77,215352
9175,0.001207,172.31.40.0-255,66,129728,77,215352
9176,0.001228,172.253.118.0-255,5020,134748,77,215352
9177,0.00123,172.31.40.0-255,66,134814,77,215352
9178,0.001589,172.253.118.0-255,1484,136298,77,215352
9179,0.001594,172.253.118.0-255,2902,139200,77,215352
9180,0.001597,172.253.118.0-255,2902,142102,77,215352
9181,0.001627,172.31.40.0-255,66,142168,77,215352
9182,0.001635,172.31.40.0-255,66,142234,77,215352
9183,0.001643,172.253.118.0-255,7156,149390,77,215352
9184,0.001645,172.31.40.0-255,66,149456,77,215352
9185,0.001648,172.253.118.0-255,1484,150940,77,215352
9186,0.001672,172.253.118.0-255,12828,163768,77,215352
9187,0.001675,172.31.40.0-255,66,163834,77,215352
9188,0.001702,172.253.118.0-255,5020,168854,77,215352
9189,0.001705,172.31.40.0-255,66,168920,77,215352
9190,0.003957,172.253.118.0-255,5738,174658,77,215352
9191,0.003965,172.31.40.0-255,66,174724,77,215352
9192,0.006204,172.253.118.0-255,5738,180462,77,215352
9193,0.00621,172.31.40.0-255,66,180528,77,215352
9194,0.008447,172.253.118.0-255,5738,186266,77,215352
9195,0.008453,172.31.40.0-255,66,186332,77,215352
9196,0.01071,172.253.118.0-255,5738,192070,77,215352
9197,0.010724,172.31.40.0-255,66,192136,77,215352
9198,0.012984,172.253.118.0-255,5738,197874,77,215352
9199,0.012993,172.31.40.0-255,66,197940,77,215352
9200,0.015267,172.253.118.0-255,5738,203678,77,215352
9201,0.015284,172.31.40.0-255,66,203744,77,215352
9202,0.017552,172.253.118.0-255,5738,209482,77,215352
9203,0.017568,172.31.40.0-255,66,209548,77,215352
9204,0.019827,172.253.118.0-255,5738,215286,77,215352
9205,0.019841,172.31.40.0-255,66,215352,77,215352
9206,0.0,74.125.24.0-255,150,150,77,398063
9207,2.2e-05,172.31.40.0-255,66,216,77,398063
9208,2.9e-05,74.125.24.0-255,1484,1700,77,398063
9209,3.4e-05,172.31.40.0-255,66,1766,77,398063
9210,4.8e-05,74.125.24.0-255,2902,4668,77,398063
9211,5.2e-05,172.31.40.0-255,66,4734,77,398063
9212,6e-05,74.125.24.0-255,7156,11890,77,398063
9213,6.2e-05,172.31.40.0-255,66,11956,77,398063
9214,6.7e-05,74.125.24.0-255,2090,14046,77,398063
9215,7e-05,172.31.40.0-255,66,14112,77,398063
9216,0.000115,74.125.24.0-255,1484,15596,77,398063
9217,0.000118,172.31.40.0-255,66,15662,77,398063
9218,0.000128,74.125.24.0-255,2902,18564,77,398063
9219,0.000131,172.31.40.0-255,66,18630,77,398063
9220,0.000134,74.125.24.0-255,1484,20114,77,398063
9221,0.000136,172.31.40.0-255,66,20180,77,398063
9222,0.000173,74.125.24.0-255,4320,24500,77,398063
9223,0.000176,172.31.40.0-255,66,24566,77,398063
9224,0.000182,74.125.24.0-255,4320,28886,77,398063
9225,0.000184,172.31.40.0-255,66,28952,77,398063
9226,0.000213,74.125.24.0-255,2543,31495,77,398063
9227,0.000215,172.31.40.0-255,66,31561,77,398063
9228,0.000259,74.125.24.0-255,1484,33045,77,398063
9229,0.000262,172.31.40.0-255,66,33111,77,398063
9230,0.000286,74.125.24.0-255,2902,36013,77,398063
9231,0.000288,172.31.40.0-255,66,36079,77,398063
9232,0.000291,74.125.24.0-255,1484,37563,77,398063
9233,0.000293,172.31.40.0-255,66,37629,77,398063
9234,0.000332,74.125.24.0-255,4320,41949,77,398063
9235,0.000335,172.31.40.0-255,66,42015,77,398063
9236,0.000342,74.125.24.0-255,6797,48812,77,398063
9237,0.000345,172.31.40.0-255,66,48878,77,398063
9238,0.000356,74.125.24.0-255,7156,56034,77,398063
9239,0.000358,172.31.40.0-255,66,56100,77,398063
9240,0.000368,74.125.24.0-255,9947,66047,77,398063
9241,0.00037,172.31.40.0-255,66,66113,77,398063
9242,0.000779,74.125.24.0-255,110,66223,77,398063
9243,0.00082,74.125.24.0-255,1484,67707,77,398063
9244,0.000826,172.31.40.0-255,66,67773,77,398063
9245,0.000854,74.125.24.0-255,2902,70675,77,398063
9246,0.000856,172.31.40.0-255,66,70741,77,398063
9247,0.000865,74.125.24.0-255,7156,77897,77,398063
9248,0.000867,172.31.40.0-255,66,77963,77,398063
9249,0.000874,74.125.24.0-255,5738,83701,77,398063
9250,0.000876,172.31.40.0-255,66,83767,77,398063
9251,0.00091,74.125.24.0-255,4320,88087,77,398063
9252,0.000913,172.31.40.0-255,66,88153,77,398063
9253,0.000917,74.125.24.0-255,1484,89637,77,398063
9254,0.000949,74.125.24.0-255,10956,100593,77,398063
9255,0.000953,172.31.40.0-255,66,100659,77,398063
9256,0.001252,74.125.24.0-255,1484,102143,77,398063
9257,0.001257,74.125.24.0-255,1484,103627,77,398063
9258,0.00126,172.31.40.0-255,66,103693,77,398063
9259,0.001276,74.125.24.0-255,1484,105177,77,398063
9260,0.001287,74.125.24.0-255,5738,110915,77,398063
9261,0.001289,172.31.40.0-255,66,110981,77,398063
9262,0.001296,74.125.24.0-255,5738,116719,77,398063
9263,0.001298,172.31.40.0-255,66,116785,77,398063
9264,0.001339,74.125.24.0-255,7156,123941,77,398063
9265,0.001342,172.31.40.0-255,66,124007,77,398063
9266,0.001352,74.125.24.0-255,10141,134148,77,398063
9267,0.001358,172.31.40.0-255,66,134214,77,398063
9268,0.001362,74.125.24.0-255,1484,135698,77,398063
9269,0.001367,74.125.24.0-255,2902,138600,77,398063
9270,0.001369,172.31.40.0-255,66,138666,77,398063
9271,0.001404,74.125.24.0-255,5738,144404,77,398063
9272,0.001407,172.31.40.0-255,66,144470,77,398063
9273,0.001418,74.125.24.0-255,12828,157298,77,398063
9274,0.001421,172.31.40.0-255,66,157364,77,398063
9275,0.001433,74.125.24.0-255,8574,165938,77,398063
9276,0.001435,172.31.40.0-255,66,166004,77,398063
9277,0.001459,74.125.24.0-255,1484,167488,77,398063
9278,0.001466,74.125.24.0-255,766,168254,77,398063
9279,0.001469,172.31.40.0-255,66,168320,77,398063
9280,0.001893,74.125.24.0-255,1484,169804,77,398063
9281,0.001898,74.125.24.0-255,2902,172706,77,398063
9282,0.0019,74.125.24.0-255,1484,174190,77,398063
9283,0.001905,172.31.40.0-255,66,174256,77,398063
9284,0.001917,74.125.24.0-255,4320,178576,77,398063
9285,0.001923,172.31.40.0-255,66,178642,77,398063
9286,0.00193,74.125.24.0-255,5738,184380,77,398063
9287,0.001932,172.31.40.0-255,66,184446,77,398063
9288,0.001978,74.125.24.0-255,12828,197274,77,398063
9289,0.001982,172.31.40.0-255,66,197340,77,398063
9290,0.001988,74.125.24.0-255,5020,202360,77,398063
9291,0.00199,172.31.40.0-255,66,202426,77,398063
9292,0.002136,74.125.24.0-255,1484,203910,77,398063
9293,0.002141,74.125.24.0-255,2902,206812,77,398063
9294,0.002144,172.31.40.0-255,66,206878,77,398063
9295,0.002151,74.125.24.0-255,5738,212616,77,398063
9296,0.002153,172.31.40.0-255,66,212682,77,398063
9297,0.002195,74.125.24.0-255,8574,221256,77,398063
9298,0.002199,172.31.40.0-255,66,221322,77,398063
9299,0.002239,74.125.24.0-255,7156,228478,77,398063
9300,0.002242,172.31.40.0-255,66,228544,77,398063
9301,0.002275,74.125.24.0-255,7856,236400,77,398063
9302,0.002278,172.31.40.0-255,66,236466,77,398063
9303,0.002455,74.125.24.0-255,1484,237950,77,398063
9304,0.00246,74.125.24.0-255,1484,239434,77,398063
9305,0.002463,172.31.40.0-255,66,239500,77,398063
9306,0.00249,74.125.24.0-255,1484,240984,77,398063
9307,0.002496,74.125.24.0-255,5738,246722,77,398063
9308,0.002499,172.31.40.0-255,66,246788,77,398063
9309,0.002522,74.125.24.0-255,12828,259616,77,398063
9310,0.002525,172.31.40.0-255,66,259682,77,398063
9311,0.002532,74.125.24.0-255,5738,265420,77,398063
9312,0.002534,172.31.40.0-255,66,265486,77,398063
9313,0.002559,74.125.24.0-255,5020,270506,77,398063
9314,0.002562,172.31.40.0-255,66,270572,77,398063
9315,0.00307,74.125.24.0-255,1484,272056,77,398063
9316,0.003086,74.125.24.0-255,2902,274958,77,398063
9317,0.00309,172.31.40.0-255,66,275024,77,398063
9318,0.003097,74.125.24.0-255,5738,280762,77,398063
9319,0.0031,172.31.40.0-255,66,280828,77,398063
9320,0.003143,74.125.24.0-255,12828,293656,77,398063
9321,0.003146,172.31.40.0-255,66,293722,77,398063
9322,0.003152,74.125.24.0-255,4320,298042,77,398063
9323,0.003154,172.31.40.0-255,66,298108,77,398063
9324,0.003194,74.125.24.0-255,6438,304546,77,398063
9325,0.003198,172.31.40.0-255,66,304612,77,398063
9326,0.003262,74.125.24.0-255,1484,306096,77,398063
9327,0.003279,74.125.24.0-255,2902,308998,77,398063
9328,0.003283,172.31.40.0-255,66,309064,77,398063
9329,0.00329,74.125.24.0-255,5738,314802,77,398063
9330,0.003292,172.31.40.0-255,66,314868,77,398063
9331,0.003341,74.125.24.0-255,12828,327696,77,398063
9332,0.003344,172.31.40.0-255,66,327762,77,398063
9333,0.003355,74.125.24.0-255,11410,339172,77,398063
9334,0.003357,172.31.40.0-255,66,339238,77,398063
9335,0.003389,74.125.24.0-255,766,340004,77,398063
9336,0.003401,74.125.24.0-255,12828,352832,77,398063
9337,0.003404,172.31.40.0-255,66,352898,77,398063
9338,0.003427,172.31.40.0-255,66,352964,77,398063
9339,0.003453,74.125.24.0-255,3602,356566,77,398063
9340,0.003456,172.31.40.0-255,66,356632,77,398063
9341,0.003479,74.125.24.0-255,1484,358116,77,398063
9342,0.003502,74.125.24.0-255,2902,361018,77,398063
9343,0.003505,172.31.40.0-255,66,361084,77,398063
9344,0.003538,74.125.24.0-255,4320,365404,77,398063
9345,0.003541,172.31.40.0-255,66,365470,77,398063
9346,0.003549,74.125.24.0-255,9992,375462,77,398063
9347,0.003557,172.31.40.0-255,66,375528,77,398063
9348,0.003562,74.125.24.0-255,4320,379848,77,398063
9349,0.003565,172.31.40.0-255,66,379914,77,398063
9350,0.003567,74.125.24.0-255,1484,381398,77,398063
9351,0.003612,74.125.24.0-255,4320,385718,77,398063
9352,0.003615,172.31.40.0-255,66,385784,77,398063
9353,0.003627,74.125.24.0-255,5020,390804,77,398063
9354,0.00363,172.31.40.0-255,66,390870,77,398063
9355,0.003681,74.125.24.0-255,1484,392354,77,398063
9356,0.003695,74.125.24.0-255,2902,395256,77,398063
9357,0.003698,172.31.40.0-255,66,395322,77,398063
9358,0.003735,74.125.24.0-255,2333,397655,77,398063
9359,0.003738,172.31.40.0-255,66,397721,77,398063
9360,0.00379,74.125.24.0-255,105,397826,77,398063
9361,0.010872,172.31.40.0-255,66,397892,77,398063
9362,0.010925,172.31.40.0-255,105,397997,77,398063
9363,0.013526,74.125.24.0-255,66,398063,77,398063
9364,0.0,172.217.194.0-255,152,152,77,219753
9365,2.3e-05,172.31.40.0-255,66,218,77,219753
9366,3e-05,172.217.194.0-255,1484,1702,77,219753
9367,3.5e-05,172.31.40.0-255,66,1768,77,219753
9368,4.1e-05,172.217.194.0-255,2902,4670,77,219753
9369,4.9e-05,172.31.40.0-255,66,4736,77,219753
9370,5.8e-05,172.217.194.0-255,7156,11892,77,219753
9371,6.1e-05,172.31.40.0-255,66,11958,77,219753
9372,6.4e-05,172.217.194.0-255,2065,14023,77,219753
9373,6.7e-05,172.31.40.0-255,66,14089,77,219753
9374,0.000432,172.217.194.0-255,1484,15573,77,219753
9375,0.000437,172.31.40.0-255,66,15639,77,219753
9376,0.000443,172.217.194.0-255,2902,18541,77,219753
9377,0.000446,172.31.40.0-255,66,18607,77,219753
9378,0.000449,172.217.194.0-255,1484,20091,77,219753
9379,0.000455,172.31.40.0-255,66,20157,77,219753
9380,0.000482,172.217.194.0-255,4320,24477,77,219753
9381,0.000484,172.31.40.0-255,66,24543,77,219753
9382,0.000493,172.217.194.0-255,4320,28863,77,219753
9383,0.000494,172.31.40.0-255,66,28929,77,219753
9384,0.000518,172.217.194.0-255,2543,31472,77,219753
9385,0.000521,172.31.40.0-255,66,31538,77,219753
9386,0.000543,172.217.194.0-255,1484,33022,77,219753
9387,0.000545,172.31.40.0-255,66,33088,77,219753
9388,0.000568,172.217.194.0-255,1484,34572,77,219753
9389,0.00057,172.31.40.0-255,66,34638,77,219753
9390,0.000577,172.217.194.0-255,7156,41794,77,219753
9391,0.000579,172.31.40.0-255,66,41860,77,219753
9392,0.000592,172.217.194.0-255,1484,43344,77,219753
9393,0.000597,172.31.40.0-255,66,43410,77,219753
9394,0.000624,172.217.194.0-255,11051,54461,77,219753
9395,0.000627,172.31.40.0-255,66,54527,77,219753
9396,0.000636,172.217.194.0-255,11328,65855,77,219753
9397,0.000638,172.31.40.0-255,66,65921,77,219753
9398,0.000667,172.217.194.0-255,121,66042,77,219753
9399,0.000683,172.217.194.0-255,377,66419,77,219753
9400,0.000951,172.217.194.0-255,1484,67903,77,219753
9401,0.000955,172.31.40.0-255,66,67969,77,219753
9402,0.00096,172.217.194.0-255,2902,70871,77,219753
9403,0.000962,172.31.40.0-255,66,70937,77,219753
9404,0.000964,172.217.194.0-255,1484,72421,77,219753
9405,0.00099,172.217.194.0-255,4320,76741,77,219753
9406,0.000992,172.31.40.0-255,66,76807,77,219753
9407,0.001024,172.217.194.0-255,12828,89635,77,219753
9408,0.001026,172.31.40.0-255,66,89701,77,219753
9409,0.001034,172.217.194.0-255,7156,96857,77,219753
9410,0.001035,172.31.40.0-255,66,96923,77,219753
9411,0.001053,172.217.194.0-255,3602,100525,77,219753
9412,0.001059,172.31.40.0-255,66,100591,77,219753
9413,0.00109,172.217.194.0-255,1484,102075,77,219753
9414,0.001107,172.217.194.0-255,2902,104977,77,219753
9415,0.00111,172.31.40.0-255,66,105043,77,219753
9416,0.001116,172.217.194.0-255,5738,110781,77,219753
9417,0.001118,172.31.40.0-255,66,110847,77,219753
9418,0.001147,172.217.194.0-255,7156,118003,77,219753
9419,0.00115,172.31.40.0-255,66,118069,77,219753
9420,0.001156,172.217.194.0-255,5738,123807,77,219753
9421,0.001158,172.31.40.0-255,66,123873,77,219753
9422,0.00119,172.217.194.0-255,8574,132447,77,219753
9423,0.001193,172.31.40.0-255,66,132513,77,219753
9424,0.001197,172.217.194.0-255,2184,134697,77,219753
9425,0.001198,172.31.40.0-255,66,134763,77,219753
9426,0.00123,172.217.194.0-255,1484,136247,77,219753
9427,0.001234,172.217.194.0-255,2902,139149,77,219753
9428,0.001237,172.31.40.0-255,66,139215,77,219753
9429,0.001264,172.217.194.0-255,5738,144953,77,219753
9430,0.001267,172.31.40.0-255,66,145019,77,219753
9431,0.00127,172.217.194.0-255,1484,146503,77,219753
9432,0.001299,172.217.194.0-255,11410,157913,77,219753
9433,0.001302,172.31.40.0-255,66,157979,77,219753
9434,0.001311,172.217.194.0-255,9992,167971,77,219753
9435,0.001314,172.31.40.0-255,66,168037,77,219753
9436,0.001319,172.217.194.0-255,766,168803,77,219753
9437,0.002033,172.31.40.0-255,66,168869,77,219753
9438,0.003311,172.217.194.0-255,4320,173189,77,219753
9439,0.003318,172.31.40.0-255,66,173255,77,219753
9440,0.004023,172.217.194.0-255,1484,174739,77,219753
9441,0.005301,172.217.194.0-255,4320,179059,77,219753
9442,0.005304,172.31.40.0-255,66,179125,77,219753
9443,0.007307,172.217.194.0-255,5738,184863,77,219753
9444,0.007313,172.31.40.0-255,66,184929,77,219753
9445,0.00931,172.217.194.0-255,5738,190667,77,219753
9446,0.009317,172.31.40.0-255,66,190733,77,219753
9447,0.01132,172.217.194.0-255,5738,196471,77,219753
9448,0.011327,172.31.40.0-255,66,196537,77,219753
9449,0.013341,172.217.194.0-255,5738,202275,77,219753
9450,0.013348,172.31.40.0-255,66,202341,77,219753
9451,0.015356,172.217.194.0-255,5738,208079,77,219753
9452,0.015364,172.31.40.0-255,66,208145,77,219753
9453,0.017386,172.217.194.0-255,5738,213883,77,219753
9454,0.017396,172.31.40.0-255,66,213949,77,219753
9455,0.019398,172.217.194.0-255,5738,219687,77,219753
9456,0.019406,172.31.40.0-255,66,219753,77,219753
9457,0.0,172.217.194.0-255,153,153,77,202718
9458,2.2e-05,172.31.40.0-255,66,219,77,202718
9459,2.9e-05,172.217.194.0-255,1484,1703,77,202718
9460,3.4e-05,172.31.40.0-255,66,1769,77,202718
9461,4e-05,172.217.194.0-255,2902,4671,77,202718
9462,4.4e-05,172.31.40.0-255,66,4737,77,202718
9463,4.7e-05,172.217.194.0-255,1484,6221,77,202718
9464,5e-05,172.31.40.0-255,66,6287,77,202718
9465,7.8e-05,172.217.194.0-255,2902,9189,77,202718
9466,8.1e-05,172.31.40.0-255,66,9255,77,202718
9467,8.9e-05,172.217.194.0-255,5738,14993,77,202718
9468,9.1e-05,172.31.40.0-255,66,15059,77,202718
9469,0.000106,172.217.194.0-255,699,15758,77,202718
9470,0.000108,172.31.40.0-255,66,15824,77,202718
9471,0.000114,172.217.194.0-255,4320,20144,77,202718
9472,0.000116,172.31.40.0-255,66,20210,77,202718
9473,0.000148,172.217.194.0-255,1484,21694,77,202718
9474,0.00015,172.31.40.0-255,66,21760,77,202718
9475,0.000177,172.217.194.0-255,9633,31393,77,202718
9476,0.00018,172.31.40.0-255,66,31459,77,202718
9477,0.00034,172.217.194.0-255,1484,32943,77,202718
9478,0.000344,172.31.40.0-255,66,33009,77,202718
9479,0.00035,172.217.194.0-255,2902,35911,77,202718
9480,0.000352,172.31.40.0-255,66,35977,77,202718
9481,0.00039,172.217.194.0-255,4320,40297,77,202718
9482,0.000393,172.31.40.0-255,66,40363,77,202718
9483,0.000407,172.217.194.0-255,1484,41847,77,202718
9484,0.000409,172.31.40.0-255,66,41913,77,202718
9485,0.000418,172.217.194.0-255,9633,51546,77,202718
9486,0.000421,172.31.40.0-255,66,51612,77,202718
9487,0.000424,172.217.194.0-255,1484,53096,77,202718
9488,0.000426,172.31.40.0-255,66,53162,77,202718
9489,0.000454,172.217.194.0-255,8574,61736,77,202718
9490,0.000461,172.217.194.0-255,4249,65985,77,202718
9491,0.000486,172.217.194.0-255,366,66351,77,202718
9492,0.000541,172.217.194.0-255,1484,67835,77,202718
9493,0.000546,172.217.194.0-255,1484,69319,77,202718
9494,0.000559,172.217.194.0-255,2902,72221,77,202718
9495,0.000565,172.217.194.0-255,5738,77959,77,202718
9496,0.000577,172.217.194.0-255,1484,79443,77,202718
9497,0.000596,172.31.40.0-255,66,79509,77,202718
9498,0.000606,172.217.194.0-255,3413,82922,77,202718
9499,0.000617,172.31.40.0-255,66,82988,77,202718
9500,0.000669,172.217.194.0-255,1484,84472,77,202718
9501,0.000689,172.217.194.0-255,2902,87374,77,202718
9502,0.000694,172.217.194.0-255,2902,90276,77,202718
9503,0.000706,172.31.40.0-255,66,90342,77,202718
9504,0.00071,172.217.194.0-255,2902,93244,77,202718
9505,0.000715,172.217.194.0-255,2902,96146,77,202718
9506,0.000727,172.217.194.0-255,4320,100466,77,202718
9507,0.00073,172.31.40.0-255,66,100532,77,202718
9508,0.000748,172.217.194.0-255,4320,104852,77,202718
9509,0.000765,172.217.194.0-255,8574,113426,77,202718
9510,0.000773,172.31.40.0-255,66,113492,77,202718
9511,0.000787,172.217.194.0-255,1484,114976,77,202718
9512,0.000791,172.217.194.0-255,2184,117160,77,202718
9513,0.000809,172.31.40.0-255,66,117226,77,202718
9514,0.001546,172.217.194.0-255,1484,118710,77,202718
9515,0.001552,172.217.194.0-255,2902,121612,77,202718
9516,0.001555,172.31.40.0-255,66,121678,77,202718
9517,0.001561,172.217.194.0-255,2902,124580,77,202718
9518,0.001574,172.217.194.0-255,2902,127482,77,202718
9519,0.001579,172.217.194.0-255,4320,131802,77,202718
9520,0.001596,172.31.40.0-255,66,131868,77,202718
9521,0.001608,172.217.194.0-255,7156,139024,77,202718
9522,0.001613,172.31.40.0-255,66,139090,77,202718
9523,0.001624,172.217.194.0-255,4320,143410,77,202718
9524,0.001644,172.31.40.0-255,66,143476,77,202718
9525,0.001657,172.217.194.0-255,7856,151332,77,202718
9526,0.001677,172.31.40.0-255,66,151398,77,202718
9527,0.002214,172.217.194.0-255,1484,152882,77,202718
9528,0.002225,172.217.194.0-255,2902,155784,77,202718
9529,0.002229,172.31.40.0-255,66,155850,77,202718
9530,0.002237,172.217.194.0-255,5738,161588,77,202718
9531,0.002256,172.217.194.0-255,1484,163072,77,202718
9532,0.002284,172.217.194.0-255,11410,174482,77,202718
9533,0.002294,172.217.194.0-255,1484,175966,77,202718
9534,0.002326,172.217.194.0-255,9274,185240,77,202718
9535,0.008394,172.31.40.0-255,66,185306,77,202718
9536,0.010903,172.217.194.0-255,5738,191044,77,202718
9537,0.010914,172.31.40.0-255,66,191110,77,202718
9538,0.01341,172.217.194.0-255,5738,196848,77,202718
9539,0.016034,172.31.40.0-255,66,196914,77,202718
9540,0.018568,172.217.194.0-255,5738,202652,77,202718
9541,0.018583,172.31.40.0-255,66,202718,77,202718
9542,0.0,172.31.40.0-255,105,105,77,105
9543,0.0,172.31.40.0-255,105,105,77,105
9544,0.0,172.217.194.0-255,152,152,77,398152
9545,2.2e-05,172.31.40.0-255,66,218,77,398152
9546,2.9e-05,172.217.194.0-255,1484,1702,77,398152
9547,3.4e-05,172.31.40.0-255,66,1768,77,398152
9548,3.9e-05,172.217.194.0-255,2902,4670,77,398152
9549,5e-05,172.31.40.0-255,66,4736,77,398152
9550,5.8e-05,172.217.194.0-255,7156,11892,77,398152
9551,6.2e-05,172.31.40.0-255,66,11958,77,398152
9552,6.5e-05,172.217.194.0-255,2036,13994,77,398152
9553,6.8e-05,172.31.40.0-255,66,14060,77,398152
9554,0.0003,172.217.194.0-255,1484,15544,77,398152
9555,0.000305,172.31.40.0-255,66,15610,77,398152
9556,0.000312,172.217.194.0-255,2902,18512,77,398152
9557,0.000315,172.31.40.0-255,66,18578,77,398152
9558,0.00035,172.217.194.0-255,5738,24316,77,398152
9559,0.000353,172.31.40.0-255,66,24382,77,398152
9560,0.000357,172.217.194.0-255,1484,25866,77,398152
9561,0.000359,172.31.40.0-255,66,25932,77,398152
9562,0.000395,172.217.194.0-255,5379,31311,77,398152
9563,0.000398,172.31.40.0-255,66,31377,77,398152
9564,0.000426,172.217.194.0-255,1484,32861,77,398152
9565,0.000429,172.31.40.0-255,66,32927,77,398152
9566,0.000433,172.217.194.0-255,1484,34411,77,398152
9567,0.000434,172.31.40.0-255,66,34477,77,398152
9568,0.000466,172.217.194.0-255,1484,35961,77,398152
9569,0.000469,172.31.40.0-255,66,36027,77,398152
9570,0.000475,172.217.194.0-255,5738,41765,77,398152
9571,0.000477,172.31.40.0-255,66,41831,77,398152
9572,0.00048,172.217.194.0-255,1484,43315,77,398152
9573,0.000487,172.31.40.0-255,66,43381,77,398152
9574,0.000529,172.217.194.0-255,12469,55850,77,398152
9575,0.000532,172.31.40.0-255,66,55916,77,398152
9576,0.000537,172.217.194.0-255,4320,60236,77,398152
9577,0.000541,172.217.194.0-255,1484,61720,77,398152
9578,0.000563,172.217.194.0-255,3961,65681,77,398152
9579,0.000577,172.217.194.0-255,367,66048,77,398152
9580,0.000587,172.31.40.0-255,66,66114,77,398152
9581,0.000595,172.217.194.0-255,376,66490,77,398152
9582,0.000818,172.217.194.0-255,1484,67974,77,398152
9583,0.000822,172.31.40.0-255,66,68040,77,398152
9584,0.000828,172.217.194.0-255,2902,70942,77,398152
9585,0.000834,172.31.40.0-255,66,71008,77,398152
9586,0.000867,172.217.194.0-255,5738,76746,77,398152
9587,0.000872,172.217.194.0-255,2902,79648,77,398152
9588,0.000891,172.217.194.0-255,8574,88222,77,398152
9589,0.0009,172.31.40.0-255,66,88288,77,398152
9590,0.000912,172.217.194.0-255,1484,89772,77,398152
9591,0.000927,172.217.194.0-255,9992,99764,77,398152
9592,0.00094,172.217.194.0-255,766,100530,77,398152
9593,0.000952,172.217.194.0-255,2902,103432,77,398152
9594,0.000967,172.31.40.0-255,66,103498,77,398152
9595,0.000973,172.217.194.0-255,4320,107818,77,398152
9596,0.000978,172.31.40.0-255,66,107884,77,398152
9597,0.001002,172.217.194.0-255,8574,116458,77,398152
9598,0.001037,172.217.194.0-255,7156,123614,77,398152
9599,0.001055,172.217.194.0-255,1484,125098,77,398152
9600,0.001065,172.217.194.0-255,9274,134372,77,398152
9601,0.001077,172.31.40.0-255,66,134438,77,398152
9602,0.0017,172.217.194.0-255,1484,135922,77,398152
9603,0.001713,172.217.194.0-255,2902,138824,77,398152
9604,0.001717,172.31.40.0-255,66,138890,77,398152
9605,0.001721,172.217.194.0-255,1484,140374,77,398152
9606,0.001749,172.217.194.0-255,4320,144694,77,398152
9607,0.001752,172.31.40.0-255,66,144760,77,398152
9608,0.00176,172.217.194.0-255,8574,153334,77,398152
9609,0.001787,172.217.194.0-255,4320,157654,77,398152
9610,0.001796,172.217.194.0-255,10692,168346,77,398152
9611,0.001816,172.31.40.0-255,101,168447,77,398152
9612,0.001824,172.217.194.0-255,8574,177021,77,398152
9613,0.001841,172.31.40.0-255,66,177087,77,398152
9614,0.001848,172.217.194.0-255,2902,179989,77,398152
9615,0.001862,172.217.194.0-255,12828,192817,77,398152
9616,0.001867,172.31.40.0-255,66,192883,77,398152
9617,0.001899,172.217.194.0-255,9274,202157,77,398152
9618,0.001912,172.31.40.0-255,66,202223,77,398152
9619,0.002088,172.217.194.0-255,1484,203707,77,398152
9620,0.002093,172.217.194.0-255,2902,206609,77,398152
9621,0.002104,172.31.40.0-255,66,206675,77,398152
9622,0.002109,172.217.194.0-255,2902,209577,77,398152
9623,0.002114,172.31.40.0-255,66,209643,77,398152
9624,0.002128,172.217.194.0-255,2902,212545,77,398152
9625,0.002134,172.217.194.0-255,5738,218283,77,398152
9626,0.002166,172.217.194.0-255,12828,231111,77,398152
9627,0.002171,172.217.194.0-255,2902,234013,77,398152
9628,0.002187,172.217.194.0-255,2184,236197,77,398152
9629,0.002196,172.31.40.0-255,66,236263,77,398152
9630,0.00227,172.217.194.0-255,1484,237747,77,398152
9631,0.002276,172.217.194.0-255,2902,240649,77,398152
9632,0.002291,172.31.40.0-255,66,240715,77,398152
9633,0.002325,172.217.194.0-255,5738,246453,77,398152
9634,0.002332,172.217.194.0-255,5738,252191,77,398152
9635,0.002338,172.31.40.0-255,66,252257,77,398152
9636,0.00237,172.217.194.0-255,5738,257995,77,398152
9637,0.00239,172.217.194.0-255,7156,265151,77,398152
9638,0.002396,172.217.194.0-255,2902,268053,77,398152
9639,0.002426,172.217.194.0-255,7156,275209,77,398152
9640,0.002459,172.217.194.0-255,10692,285901,77,398152
9641,0.002469,172.217.194.0-255,11410,297311,77,398152
9642,0.002497,172.217.194.0-255,6438,303749,77,398152
9643,0.00254,172.217.194.0-255,1484,305233,77,398152
9644,0.002582,172.217.194.0-255,2902,308135,77,398152
9645,0.00259,172.217.194.0-255,5738,313873,77,398152
9646,0.002597,172.217.194.0-255,5738,319611,77,398152
9647,0.002615,172.217.194.0-255,5738,325349,77,398152
9648,0.002654,172.217.194.0-255,4320,329669,77,398152
9649,0.002673,172.217.194.0-255,4320,333989,77,398152
9650,0.002694,172.217.194.0-255,3602,337591,77,398152
9651,0.002697,172.217.194.0-255,1484,339075,77,398152
9652,0.002718,172.217.194.0-255,2902,341977,77,398152
9653,0.002723,172.217.194.0-255,2902,344879,77,398152
9654,0.002736,172.217.194.0-255,2902,347781,77,398152
9655,0.002752,172.217.194.0-255,2902,350683,77,398152
9656,0.002766,172.217.194.0-255,2902,353585,77,398152
9657,0.002784,172.217.194.0-255,2902,356487,77,398152
9658,0.002794,172.217.194.0-255,9992,366479,77,398152
9659,0.002813,172.217.194.0-255,4320,370799,77,398152
9660,0.002817,172.217.194.0-255,766,371565,77,398152
9661,0.002819,172.217.194.0-255,1484,373049,77,398152
9662,0.002859,172.217.194.0-255,4320,377369,77,398152
9663,0.002883,172.217.194.0-255,8574,385943,77,398152
9664,0.00289,172.217.194.0-255,3602,389545,77,398152
9665,0.002915,172.217.194.0-255,8199,397744,77,398152
9666,0.002931,172.217.194.0-255,105,397849,77,398152
9667,0.003351,172.31.40.0-255,66,397915,77,398152
9668,0.004127,172.217.194.0-255,66,397981,77,398152
9669,0.005309,172.31.40.0-255,105,398086,77,398152
9670,0.00757,172.217.194.0-255,66,398152,77,398152
9671,0.0,172.31.40.0-255,105,105,77,210
9672,0.002197,157.240.13.0-255,105,210,77,210
9673,0.0,74.125.24.0-255,153,153,77,181201
9674,2.1e-05,172.31.40.0-255,66,219,77,181201
9675,3e-05,74.125.24.0-255,1484,1703,77,181201
9676,3.4e-05,172.31.40.0-255,66,1769,77,181201
9677,4.2e-05,74.125.24.0-255,2902,4671,77,181201
9678,4.6e-05,172.31.40.0-255,66,4737,77,181201
9679,5.4e-05,74.125.24.0-255,7156,11893,77,181201
9680,5.7e-05,172.31.40.0-255,66,11959,77,181201
9681,6.2e-05,74.125.24.0-255,3446,15405,77,181201
9682,6.5e-05,172.31.40.0-255,66,15471,77,181201
9683,7.4e-05,74.125.24.0-255,8574,24045,77,181201
9684,7.7e-05,172.31.40.0-255,66,24111,77,181201
9685,9.8e-05,74.125.24.0-255,4320,28431,77,181201
9686,0.000101,172.31.40.0-255,66,28497,77,181201
9687,0.000105,74.125.24.0-255,2543,31040,77,181201
9688,0.000107,172.31.40.0-255,66,31106,77,181201
9689,0.000137,74.125.24.0-255,1484,32590,77,181201
9690,0.00014,172.31.40.0-255,66,32656,77,181201
9691,0.000144,74.125.24.0-255,2902,35558,77,181201
9692,0.000147,172.31.40.0-255,66,35624,77,181201
9693,0.000151,74.125.24.0-255,2902,38526,77,181201
9694,0.000153,172.31.40.0-255,66,38592,77,181201
9695,0.000176,74.125.24.0-255,2902,41494,77,181201
9696,0.000179,172.31.40.0-255,66,41560,77,181201
9697,0.000183,74.125.24.0-255,2902,44462,77,181201
9698,0.000185,172.31.40.0-255,66,44528,77,181201
9699,0.000203,74.125.24.0-255,7156,51684,77,181201
9700,0.000206,172.31.40.0-255,66,51750,77,181201
9701,0.00022,74.125.24.0-255,3961,55711,77,181201
9702,0.000223,172.31.40.0-255,66,55777,77,181201
9703,0.000239,74.125.24.0-255,4320,60097,77,181201
9704,0.000241,172.31.40.0-255,66,60163,77,181201
9705,0.000262,74.125.24.0-255,5691,65854,77,181201
9706,0.000264,172.31.40.0-255,66,65920,77,181201
9707,0.000712,74.125.24.0-255,109,66029,77,181201
9708,0.00073,74.125.24.0-255,330,66359,77,181201
9709,0.000918,74.125.24.0-255,1484,67843,77,181201
9710,0.000923,172.31.40.0-255,66,67909,77,181201
9711,0.000928,74.125.24.0-255,2902,70811,77,181201
9712,0.000931,172.31.40.0-255,66,70877,77,181201
9713,0.000936,74.125.24.0-255,4320,75197,77,181201
9714,0.000938,172.31.40.0-255,66,75263,77,181201
9715,0.000958,74.125.24.0-255,1484,76747,77,181201
9716,0.000966,74.125.24.0-255,7156,83903,77,181201
9717,0.000968,172.31.40.0-255,66,83969,77,181201
9718,0.000973,74.125.24.0-255,2902,86871,77,181201
9719,0.000975,172.31.40.0-255,66,86937,77,181201
9720,0.001007,74.125.24.0-255,11410,98347,77,181201
9721,0.00101,172.31.40.0-255,66,98413,77,181201
9722,0.001015,74.125.24.0-255,2184,100597,77,181201
9723,0.001017,172.31.40.0-255,66,100663,77,181201
9724,0.001733,74.125.24.0-255,1484,102147,77,181201
9725,0.001744,74.125.24.0-255,2902,105049,77,181201
9726,0.001748,172.31.40.0-255,66,105115,77,181201
9727,0.001756,74.125.24.0-255,5738,110853,77,181201
9728,0.001758,172.31.40.0-255,66,110919,77,181201
9729,0.001761,74.125.24.0-255,1484,112403,77,181201
9730,0.001797,74.125.24.0-255,9992,122395,77,181201
9731,0.001799,172.31.40.0-255,66,122461,77,181201
9732,0.001808,74.125.24.0-255,9992,132453,77,181201
9733,0.001811,172.31.40.0-255,66,132519,77,181201
9734,0.001824,74.125.24.0-255,2184,134703,77,181201
9735,0.001826,172.31.40.0-255,66,134769,77,181201
9736,0.003922,74.125.24.0-255,5738,140507,77,181201
9737,0.003928,172.31.40.0-255,66,140573,77,181201
9738,0.005998,74.125.24.0-255,5738,146311,77,181201
9739,0.006003,172.31.40.0-255,66,146377,77,181201
9740,0.00806,74.125.24.0-255,5738,152115,77,181201
9741,0.008068,172.31.40.0-255,66,152181,77,181201
9742,0.010141,74.125.24.0-255,5738,157919,77,181201
9743,0.010149,172.31.40.0-255,66,157985,77,181201
9744,0.012246,74.125.24.0-255,5738,163723,77,181201
9745,0.012255,172.31.40.0-255,66,163789,77,181201
9746,0.014326,74.125.24.0-255,5738,169527,77,181201
9747,0.014335,172.31.40.0-255,66,169593,77,181201
9748,0.01642,74.125.24.0-255,5738,175331,77,181201
9749,0.016428,172.31.40.0-255,66,175397,77,181201
9750,0.018516,74.125.24.0-255,5738,181135,77,181201
9751,0.018524,172.31.40.0-255,66,181201,77,181201
9752,0.0,172.217.194.0-255,153,153,77,290800
9753,2.4e-05,172.31.40.0-255,66,219,77,290800
9754,3.2e-05,172.217.194.0-255,1484,1703,77,290800
9755,3.6e-05,172.31.40.0-255,66,1769,77,290800
9756,4.2e-05,172.217.194.0-255,2902,4671,77,290800
9757,5.3e-05,172.31.40.0-255,66,4737,77,290800
9758,6.1e-05,172.217.194.0-255,7156,11893,77,290800
9759,6.4e-05,172.31.40.0-255,66,11959,77,290800
9760,7.1e-05,172.217.194.0-255,5738,17697,77,290800
9761,7.4e-05,172.31.40.0-255,66,17763,77,290800
9762,0.000115,172.217.194.0-255,6366,24129,77,290800
9763,0.000118,172.31.40.0-255,66,24195,77,290800
9764,0.000126,172.217.194.0-255,6797,30992,77,290800
9765,0.000128,172.31.40.0-255,66,31058,77,290800
9766,0.000251,172.217.194.0-255,1484,32542,77,290800
9767,0.000255,172.31.40.0-255,66,32608,77,290800
9768,0.000286,172.217.194.0-255,2902,35510,77,290800
9769,0.000289,172.31.40.0-255,66,35576,77,290800
9770,0.000295,172.217.194.0-255,5738,41314,77,290800
9771,0.000298,172.31.40.0-255,66,41380,77,290800
9772,0.000301,172.217.194.0-255,1484,42864,77,290800
9773,0.000308,172.31.40.0-255,66,42930,77,290800
9774,0.000341,172.217.194.0-255,9633,52563,77,290800
9775,0.000356,172.217.194.0-255,12756,65319,77,290800
9776,0.000359,172.217.194.0-255,100,65419,77,290800
9777,0.000364,172.31.40.0-255,66,65485,77,290800
9778,0.000372,172.31.40.0-255,66,65551,77,290800
9779,0.000374,172.31.40.0-255,66,65617,77,290800
9780,0.000429,172.217.194.0-255,1484,67101,77,290800
9781,0.000433,172.31.40.0-255,66,67167,77,290800
9782,0.000459,172.217.194.0-255,1484,68651,77,290800
9783,0.000462,172.31.40.0-255,66,68717,77,290800
9784,0.000468,172.217.194.0-255,4320,73037,77,290800
9785,0.00047,172.31.40.0-255,66,73103,77,290800
9786,0.000483,172.217.194.0-255,8574,81677,77,290800
9787,0.000486,172.31.40.0-255,66,81743,77,290800
9788,0.000507,172.217.194.0-255,1484,83227,77,290800
9789,0.000522,172.217.194.0-255,9992,93219,77,290800
9790,0.000525,172.31.40.0-255,66,93285,77,290800
9791,0.000555,172.217.194.0-255,6737,100022,77,290800
9792,0.000558,172.31.40.0-255,66,100088,77,290800
9793,0.001125,172.217.194.0-255,1484,101572,77,290800
9794,0.001132,172.217.194.0-255,2902,104474,77,290800
9795,0.001136,172.31.40.0-255,66,104540,77,290800
9796,0.001167,172.217.194.0-255,5738,110278,77,290800
9797,0.001171,172.31.40.0-255,66,110344,77,290800
9798,0.00118,172.217.194.0-255,9992,120336,77,290800
9799,0.001188,172.31.40.0-255,66,120402,77,290800
9800,0.00121,172.217.194.0-255,4320,124722,77,290800
9801,0.001213,172.31.40.0-255,66,124788,77,290800
9802,0.001245,172.217.194.0-255,7156,131944,77,290800
9803,0.001248,172.31.40.0-255,66,132010,77,290800
9804,0.001252,172.217.194.0-255,2184,134194,77,290800
9805,0.001256,172.31.40.0-255,66,134260,77,290800
9806,0.001868,172.217.194.0-255,1484,135744,77,290800
9807,0.001886,172.217.194.0-255,2902,138646,77,290800
9808,0.001891,172.31.40.0-255,66,138712,77,290800
9809,0.001928,172.217.194.0-255,5738,144450,77,290800
9810,0.00193,172.31.40.0-255,66,144516,77,290800
9811,0.001938,172.217.194.0-255,7156,151672,77,290800
9812,0.00194,172.31.40.0-255,66,151738,77,290800
9813,0.001957,172.217.194.0-255,5738,157476,77,290800
9814,0.001964,172.31.40.0-255,66,157542,77,290800
9815,0.001976,172.217.194.0-255,10692,168234,77,290800
9816,0.001978,172.31.40.0-255,66,168300,77,290800
9817,0.002223,172.217.194.0-255,1484,169784,77,290800
9818,0.002228,172.217.194.0-255,1484,171268,77,290800
9819,0.002232,172.31.40.0-255,66,171334,77,290800
9820,0.002256,172.217.194.0-255,1484,172818,77,290800
9821,0.002263,172.217.194.0-255,5738,178556,77,290800
9822,0.002265,172.31.40.0-255,66,178622,77,290800
9823,0.002296,172.217.194.0-255,5738,184360,77,290800
9824,0.002309,172.31.40.0-255,66,184426,77,290800
9825,0.002335,172.217.194.0-255,5738,190164,77,290800
9826,0.002338,172.31.40.0-255,66,190230,77,290800
9827,0.00235,172.217.194.0-255,12110,202340,77,290800
9828,0.002352,172.31.40.0-255,66,202406,77,290800
9829,0.002355,172.217.194.0-255,1484,203890,77,290800
9830,0.002406,172.31.40.0-255,66,203956,77,290800
9831,0.002428,172.31.40.0-255,66,204022,77,290800
9832,0.002454,172.217.194.0-255,7156,211178,77,290800
9833,0.002457,172.31.40.0-255,66,211244,77,290800
9834,0.002485,172.217.194.0-255,1484,212728,77,290800
9835,0.0025,172.217.194.0-255,9992,222720,77,290800
9836,0.002503,172.31.40.0-255,66,222786,77,290800
9837,0.002513,172.217.194.0-255,9992,232778,77,290800
9838,0.002516,172.31.40.0-255,66,232844,77,290800
9839,0.002569,172.217.194.0-255,5020,237864,77,290800
9840,0.002572,172.31.40.0-255,66,237930,77,290800
9841,0.002593,172.31.40.0-255,66,237996,77,290800
9842,0.002603,172.217.194.0-255,11410,249406,77,290800
9843,0.002607,172.31.40.0-255,66,249472,77,290800
9844,0.002614,172.217.194.0-255,6438,255910,77,290800
9845,0.002616,172.31.40.0-255,66,255976,77,290800
9846,0.005142,172.217.194.0-255,5738,261714,77,290800
9847,0.005149,172.31.40.0-255,66,261780,77,290800
9848,0.007676,172.217.194.0-255,5738,267518,77,290800
9849,0.007683,172.31.40.0-255,66,267584,77,290800
9850,0.01021,172.217.194.0-255,5738,273322,77,290800
9851,0.010227,172.31.40.0-255,66,273388,77,290800
9852,0.012781,172.217.194.0-255,5738,279126,77,290800
9853,0.012793,172.31.40.0-255,66,279192,77,290800
9854,0.01533,172.217.194.0-255,5738,284930,77,290800
9855,0.015344,172.31.40.0-255,66,284996,77,290800
9856,0.017885,172.217.194.0-255,5738,290734,77,290800
9857,0.017893,172.31.40.0-255,66,290800,77,290800
9858,0.0,216.58.221.0-255,152,152,77,118610
9859,3.2e-05,172.31.40.0-255,66,218,77,118610
9860,4e-05,216.58.221.0-255,1484,1702,77,118610
9861,4.5e-05,172.31.40.0-255,66,1768,77,118610
9862,6.2e-05,216.58.221.0-255,2902,4670,77,118610
9863,6.6e-05,172.31.40.0-255,66,4736,77,118610
9864,7.4e-05,216.58.221.0-255,7156,11892,77,118610
9865,7.8e-05,172.31.40.0-255,66,11958,77,118610
9866,8.2e-05,216.58.221.0-255,2137,14095,77,118610
9867,8.5e-05,172.31.40.0-255,66,14161,77,118610
9868,0.000475,216.58.221.0-255,1484,15645,77,118610
9869,0.000481,172.31.40.0-255,66,15711,77,118610
9870,0.000488,216.58.221.0-255,2902,18613,77,118610
9871,0.000491,172.31.40.0-255,66,18679,77,118610
9872,0.000501,216.58.221.0-255,2902,21581,77,118610
9873,0.000504,172.31.40.0-255,66,21647,77,118610
9874,0.000509,216.58.221.0-255,4320,25967,77,118610
9875,0.000511,172.31.40.0-255,66,26033,77,118610
9876,0.000546,216.58.221.0-255,5379,31412,77,118610
9877,0.000549,172.31.40.0-255,66,31478,77,118610
9878,0.000687,216.58.221.0-255,1484,32962,77,118610
9879,0.000691,172.31.40.0-255,66,33028,77,118610
9880,0.000696,216.58.221.0-255,2902,35930,77,118610
9881,0.000698,172.31.40.0-255,66,35996,77,118610
9882,0.000705,216.58.221.0-255,5738,41734,77,118610
9883,0.000713,172.31.40.0-255,66,41800,77,118610
9884,0.000739,216.58.221.0-255,4320,46120,77,118610
9885,0.000743,172.31.40.0-255,66,46186,77,118610
9886,0.000765,216.58.221.0-255,2543,48729,77,118610
9887,0.000772,172.31.40.0-255,66,48795,77,118610
9888,0.000893,216.58.221.0-255,1484,50279,77,118610
9889,0.000897,172.31.40.0-255,66,50345,77,118610
9890,0.000902,216.58.221.0-255,2902,53247,77,118610
9891,0.000907,216.58.221.0-255,1484,54731,77,118610
9892,0.000923,172.31.40.0-255,66,54797,77,118610
9893,0.00094,216.58.221.0-255,4320,59117,77,118610
9894,0.000945,216.58.221.0-255,2902,62019,77,118610
9895,0.000961,216.58.221.0-255,4289,66308,77,118610
9896,0.000978,172.31.40.0-255,66,66374,77,118610
9897,0.002929,216.58.221.0-255,5738,72112,77,118610
9898,0.002942,172.31.40.0-255,66,72178,77,118610
9899,0.004888,216.58.221.0-255,5738,77916,77,118610
9900,0.004894,172.31.40.0-255,66,77982,77,118610
9901,0.006832,216.58.221.0-255,5738,83720,77,118610
9902,0.006837,172.31.40.0-255,66,83786,77,118610
9903,0.008793,216.58.221.0-255,5738,89524,77,118610
9904,0.008804,172.31.40.0-255,66,89590,77,118610
9905,0.010748,216.58.221.0-255,5738,95328,77,118610
9906,0.010761,172.31.40.0-255,66,95394,77,118610
9907,0.012708,216.58.221.0-255,5738,101132,77,118610
9908,0.012718,172.31.40.0-255,66,101198,77,118610
9909,0.014668,216.58.221.0-255,5738,106936,77,118610
9910,0.014681,172.31.40.0-255,66,107002,77,118610
9911,0.016631,216.58.221.0-255,5738,112740,77,118610
9912,0.016641,172.31.40.0-255,66,112806,77,118610
9913,0.018583,216.58.221.0-255,5738,118544,77,118610
9914,0.018591,172.31.40.0-255,66,118610,77,118610
9915,0.0,74.125.24.0-255,153,153,77,182066
9916,1.8e-05,172.31.40.0-255,66,219,77,182066
9917,2.5e-05,74.125.24.0-255,1484,1703,77,182066
9918,2.9e-05,172.31.40.0-255,66,1769,77,182066
9919,3.6e-05,74.125.24.0-255,2902,4671,77,182066
9920,4.6e-05,172.31.40.0-255,66,4737,77,182066
9921,5.5e-05,74.125.24.0-255,7156,11893,77,182066
9922,5.8e-05,172.31.40.0-255,66,11959,77,182066
9923,0.000109,74.125.24.0-255,2034,13993,77,182066
9924,0.000113,172.31.40.0-255,66,14059,77,182066
9925,0.000172,74.125.24.0-255,1484,15543,77,182066
9926,0.000175,172.31.40.0-255,66,15609,77,182066
9927,0.00018,74.125.24.0-255,2902,18511,77,182066
9928,0.000182,172.31.40.0-255,66,18577,77,182066
9929,0.000212,74.125.24.0-255,5738,24315,77,182066
9930,0.000218,172.31.40.0-255,66,24381,77,182066
9931,0.000226,74.125.24.0-255,5738,30119,77,182066
9932,0.000229,172.31.40.0-255,66,30185,77,182066
9933,0.000263,74.125.24.0-255,2543,32728,77,182066
9934,0.000265,172.31.40.0-255,66,32794,77,182066
9935,0.00027,74.125.24.0-255,2902,35696,77,182066
9936,0.000273,172.31.40.0-255,66,35762,77,182066
9937,0.000306,74.125.24.0-255,7156,42918,77,182066
9938,0.00031,172.31.40.0-255,66,42984,77,182066
9939,0.000317,74.125.24.0-255,5379,48363,77,182066
9940,0.00032,172.31.40.0-255,66,48429,77,182066
9941,0.000359,74.125.24.0-255,2902,51331,77,182066
9942,0.000362,172.31.40.0-255,66,51397,77,182066
9943,0.000384,74.125.24.0-255,1484,52881,77,182066
9944,0.000386,172.31.40.0-255,66,52947,77,182066
9945,0.000413,74.125.24.0-255,5738,58685,77,182066
9946,0.000416,172.31.40.0-255,66,58751,77,182066
9947,0.000424,74.125.24.0-255,7076,65827,77,182066
9948,0.000428,172.31.40.0-255,66,65893,77,182066
9949,0.000452,74.125.24.0-255,407,66300,77,182066
9950,0.000774,74.125.24.0-255,1484,67784,77,182066
9951,0.00078,172.31.40.0-255,66,67850,77,182066
9952,0.000786,74.125.24.0-255,2902,70752,77,182066
9953,0.000789,172.31.40.0-255,66,70818,77,182066
9954,0.000823,74.125.24.0-255,5738,76556,77,182066
9955,0.000826,172.31.40.0-255,66,76622,77,182066
9956,0.000839,74.125.24.0-255,12828,89450,77,182066
9957,0.000842,172.31.40.0-255,66,89516,77,182066
9958,0.000865,74.125.24.0-255,2902,92418,77,182066
9959,0.000867,172.31.40.0-255,66,92484,77,182066
9960,0.000898,74.125.24.0-255,7856,100340,77,182066
9961,0.000901,172.31.40.0-255,66,100406,77,182066
9962,0.001148,74.125.24.0-255,1484,101890,77,182066
9963,0.001155,74.125.24.0-255,2902,104792,77,182066
9964,0.001158,172.31.40.0-255,66,104858,77,182066
9965,0.001165,74.125.24.0-255,4320,109178,77,182066
9966,0.001167,172.31.40.0-255,66,109244,77,182066
9967,0.001205,74.125.24.0-255,1484,110728,77,182066
9968,0.001216,74.125.24.0-255,12828,123556,77,182066
9969,0.001219,172.31.40.0-255,66,123622,77,182066
9970,0.001225,74.125.24.0-255,4320,127942,77,182066
9971,0.001228,172.31.40.0-255,66,128008,77,182066
9972,0.001273,74.125.24.0-255,6438,134446,77,182066
9973,0.001276,172.31.40.0-255,66,134512,77,182066
9974,0.002325,74.125.24.0-255,1484,135996,77,182066
9975,0.002331,74.125.24.0-255,1484,137480,77,182066
9976,0.002335,172.31.40.0-255,66,137546,77,182066
9977,0.003627,74.125.24.0-255,2902,140448,77,182066
9978,0.003633,172.31.40.0-255,66,140514,77,182066
9979,0.004654,74.125.24.0-255,2902,143416,77,182066
9980,0.004658,172.31.40.0-255,66,143482,77,182066
9981,0.005945,74.125.24.0-255,2902,146384,77,182066
9982,0.005952,172.31.40.0-255,66,146450,77,182066
9983,0.006979,74.125.24.0-255,2902,149352,77,182066
9984,0.006982,172.31.40.0-255,66,149418,77,182066
9985,0.008278,74.125.24.0-255,2902,152320,77,182066
9986,0.008285,172.31.40.0-255,66,152386,77,182066
9987,0.009289,74.125.24.0-255,2902,155288,77,182066
9988,0.009296,172.31.40.0-255,66,155354,77,182066
9989,0.010618,74.125.24.0-255,2902,158256,77,182066
9990,0.010627,172.31.40.0-255,66,158322,77,182066
9991,0.011613,74.125.24.0-255,2902,161224,77,182066
9992,0.01162,172.31.40.0-255,66,161290,77,182066
9993,0.012946,74.125.24.0-255,2902,164192,77,182066
9994,0.012954,172.31.40.0-255,66,164258,77,182066
9995,0.013936,74.125.24.0-255,2902,167160,77,182066
9996,0.013943,172.31.40.0-255,66,167226,77,182066
9997,0.01528,74.125.24.0-255,2902,170128,77,182066
9998,0.015288,172.31.40.0-255,66,170194,77,182066
9999,0.016246,74.125.24.0-255,2902,173096,77,182066
10000,0.016255,172.31.40.0-255,66,173162,77,182066
10001,0.017605,74.125.24.0-255,2902,176064,77,182066
10002,0.017614,172.31.40.0-255,66,176130,77,182066
10003,0.018561,74.125.24.0-255,2902,179032,77,182066
10004,0.018568,172.31.40.0-255,66,179098,77,182066
10005,0.019926,74.125.24.0-255,2902,182000,77,182066
10006,0.019934,172.31.40.0-255,66,182066,77,182066
10007,0.0,172.217.194.0-255,153,153,77,152468
10008,2.2e-05,172.31.40.0-255,66,219,77,152468
10009,3e-05,172.217.194.0-255,1484,1703,77,152468
10010,3.4e-05,172.31.40.0-255,66,1769,77,152468
10011,4.7e-05,172.217.194.0-255,2902,4671,77,152468
10012,5.1e-05,172.31.40.0-255,66,4737,77,152468
10013,5.7e-05,172.217.194.0-255,5738,10475,77,152468
10014,6e-05,172.31.40.0-255,66,10541,77,152468
10015,9.4e-05,172.217.194.0-255,3454,13995,77,152468
10016,9.7e-05,172.31.40.0-255,66,14061,77,152468
10017,0.00021,172.217.194.0-255,1484,15545,77,152468
10018,0.000215,172.31.40.0-255,66,15611,77,152468
10019,0.00022,172.217.194.0-255,2902,18513,77,152468
10020,0.000222,172.31.40.0-255,66,18579,77,152468
10021,0.000242,172.217.194.0-255,5738,24317,77,152468
10022,0.000249,172.31.40.0-255,66,24383,77,152468
10023,0.000299,172.217.194.0-255,5738,30121,77,152468
10024,0.000302,172.31.40.0-255,66,30187,77,152468
10025,0.000329,172.217.194.0-255,3961,34148,77,152468
10026,0.000331,172.31.40.0-255,66,34214,77,152468
10027,0.000389,172.217.194.0-255,4320,38534,77,152468
10028,0.000393,172.31.40.0-255,66,38600,77,152468
10029,0.000419,172.217.194.0-255,12828,51428,77,152468
10030,0.000422,172.31.40.0-255,66,51494,77,152468
10031,0.00057,172.217.194.0-255,7156,58650,77,152468
10032,0.000575,172.31.40.0-255,66,58716,77,152468
10033,0.000609,172.217.194.0-255,6438,65154,77,152468
10034,0.000613,172.31.40.0-255,66,65220,77,152468
10035,0.000665,172.217.194.0-255,343,65563,77,152468
10036,0.000668,172.31.40.0-255,66,65629,77,152468
10037,0.000671,172.217.194.0-255,431,66060,77,152468
10038,0.000674,172.31.40.0-255,66,66126,77,152468
10039,0.000856,172.217.194.0-255,1484,67610,77,152468
10040,0.000863,172.217.194.0-255,2902,70512,77,152468
10041,0.000867,172.31.40.0-255,66,70578,77,152468
10042,0.000897,172.217.194.0-255,5738,76316,77,152468
10043,0.000899,172.31.40.0-255,66,76382,77,152468
10044,0.000928,172.217.194.0-255,1484,77866,77,152468
10045,0.00096,172.217.194.0-255,11410,89276,77,152468
10046,0.000964,172.31.40.0-255,66,89342,77,152468
10047,0.001065,172.217.194.0-255,4320,93662,77,152468
10048,0.001069,172.31.40.0-255,66,93728,77,152468
10049,0.001099,172.217.194.0-255,6438,100166,77,152468
10050,0.001102,172.31.40.0-255,66,100232,77,152468
10051,0.00312,172.217.194.0-255,5738,105970,77,152468
10052,0.003127,172.31.40.0-255,66,106036,77,152468
10053,0.005166,172.217.194.0-255,5738,111774,77,152468
10054,0.00517,172.31.40.0-255,66,111840,77,152468
10055,0.007196,172.217.194.0-255,5738,117578,77,152468
10056,0.007203,172.31.40.0-255,66,117644,77,152468
10057,0.009234,172.217.194.0-255,5738,123382,77,152468
10058,0.009242,172.31.40.0-255,66,123448,77,152468
10059,0.011287,172.217.194.0-255,5738,129186,77,152468
10060,0.011295,172.31.40.0-255,66,129252,77,152468
10061,0.013343,172.217.194.0-255,5738,134990,77,152468
10062,0.01335,172.31.40.0-255,66,135056,77,152468
10063,0.015376,172.217.194.0-255,5738,140794,77,152468
10064,0.015383,172.31.40.0-255,66,140860,77,152468
10065,0.017416,172.217.194.0-255,5738,146598,77,152468
10066,0.017424,172.31.40.0-255,66,146664,77,152468
10067,0.019517,172.217.194.0-255,5738,152402,77,152468
10068,0.019524,172.31.40.0-255,66,152468,77,152468
10069,0.0,74.125.68.0-255,153,153,77,235468
10070,1.5e-05,172.31.40.0-255,66,219,77,235468
10071,3.1e-05,74.125.68.0-255,1484,1703,77,235468
10072,3.5e-05,172.31.40.0-255,66,1769,77,235468
10073,6.3e-05,74.125.68.0-255,2902,4671,77,235468
10074,7.1e-05,172.31.40.0-255,66,4737,77,235468
10075,7.4e-05,74.125.68.0-255,1484,6221,77,235468
10076,7.7e-05,172.31.40.0-255,66,6287,77,235468
10077,8.3e-05,74.125.68.0-255,2902,9189,77,235468
10078,8.5e-05,172.31.40.0-255,66,9255,77,235468
10079,0.00011,74.125.68.0-255,2902,12157,77,235468
10080,0.000112,172.31.40.0-255,66,12223,77,235468
10081,0.000142,74.125.68.0-255,3439,15662,77,235468
10082,0.000145,172.31.40.0-255,66,15728,77,235468
10083,0.000152,74.125.68.0-255,7156,22884,77,235468
10084,0.000155,172.31.40.0-255,66,22950,77,235468
10085,0.000163,74.125.68.0-255,8215,31165,77,235468
10086,0.000166,172.31.40.0-255,66,31231,77,235468
10087,0.00029,74.125.68.0-255,1484,32715,77,235468
10088,0.000295,172.31.40.0-255,66,32781,77,235468
10089,0.00033,74.125.68.0-255,2902,35683,77,235468
10090,0.000333,172.31.40.0-255,66,35749,77,235468
10091,0.000363,74.125.68.0-255,4320,40069,77,235468
10092,0.000366,172.31.40.0-255,66,40135,77,235468
10093,0.000372,74.125.68.0-255,5738,45873,77,235468
10094,0.000375,172.31.40.0-255,66,45939,77,235468
10095,0.000378,74.125.68.0-255,1484,47423,77,235468
10096,0.000384,172.31.40.0-255,66,47489,77,235468
10097,0.000424,74.125.68.0-255,8215,55704,77,235468
10098,0.000428,172.31.40.0-255,66,55770,77,235468
10099,0.000437,74.125.68.0-255,9907,65677,77,235468
10100,0.00044,172.31.40.0-255,66,65743,77,235468
10101,0.000443,74.125.68.0-255,131,65874,77,235468
10102,0.000503,74.125.68.0-255,1484,67358,77,235468
10103,0.000506,172.31.40.0-255,66,67424,77,235468
10104,0.000531,74.125.68.0-255,2902,70326,77,235468
10105,0.000534,172.31.40.0-255,66,70392,77,235468
10106,0.000539,74.125.68.0-255,2902,73294,77,235468
10107,0.000541,172.31.40.0-255,66,73360,77,235468
10108,0.000561,74.125.68.0-255,2902,76262,77,235468
10109,0.000563,172.31.40.0-255,66,76328,77,235468
10110,0.00058,74.125.68.0-255,1484,77812,77,235468
10111,0.000604,74.125.68.0-255,5080,82892,77,235468
10112,0.000607,172.31.40.0-255,66,82958,77,235468
10113,0.000961,74.125.68.0-255,1484,84442,77,235468
10114,0.000987,74.125.68.0-255,2902,87344,77,235468
10115,0.000991,172.31.40.0-255,66,87410,77,235468
10116,0.000994,74.125.68.0-255,1484,88894,77,235468
10117,0.001017,74.125.68.0-255,2902,91796,77,235468
10118,0.001019,172.31.40.0-255,66,91862,77,235468
10119,0.001044,74.125.68.0-255,4320,96182,77,235468
10120,0.001046,172.31.40.0-255,66,96248,77,235468
10121,0.001073,74.125.68.0-255,1484,97732,77,235468
10122,0.001081,74.125.68.0-255,7156,104888,77,235468
10123,0.001083,172.31.40.0-255,66,104954,77,235468
10124,0.001126,74.125.68.0-255,4320,109274,77,235468
10125,0.001133,74.125.68.0-255,5738,115012,77,235468
10126,0.001136,74.125.68.0-255,2184,117196,77,235468
10127,0.001147,172.31.40.0-255,66,117262,77,235468
10128,0.00115,172.31.40.0-255,66,117328,77,235468
10129,0.001153,172.31.40.0-255,66,117394,77,235468
10130,0.001295,74.125.68.0-255,1484,118878,77,235468
10131,0.001314,74.125.68.0-255,2902,121780,77,235468
10132,0.001318,172.31.40.0-255,66,121846,77,235468
10133,0.001351,74.125.68.0-255,5738,127584,77,235468
10134,0.001353,172.31.40.0-255,66,127650,77,235468
10135,0.001357,74.125.68.0-255,1484,129134,77,235468
10136,0.001402,74.125.68.0-255,2902,132036,77,235468
10137,0.001406,172.31.40.0-255,66,132102,77,235468
10138,0.00143,74.125.68.0-255,5738,137840,77,235468
10139,0.001433,172.31.40.0-255,66,137906,77,235468
10140,0.001437,74.125.68.0-255,2902,140808,77,235468
10141,0.001439,172.31.40.0-255,66,140874,77,235468
10142,0.001476,74.125.68.0-255,9992,150866,77,235468
10143,0.00148,172.31.40.0-255,66,150932,77,235468
10144,0.001483,74.125.68.0-255,766,151698,77,235468
10145,0.001792,74.125.68.0-255,1484,153182,77,235468
10146,0.001797,74.125.68.0-255,2902,156084,77,235468
10147,0.001803,74.125.68.0-255,5738,161822,77,235468
10148,0.001808,172.31.40.0-255,66,161888,77,235468
10149,0.001812,172.31.40.0-255,66,161954,77,235468
10150,0.001814,172.31.40.0-255,66,162020,77,235468
10151,0.001834,74.125.68.0-255,5738,167758,77,235468
10152,0.001837,172.31.40.0-255,66,167824,77,235468
10153,0.001844,74.125.68.0-255,7156,174980,77,235468
10154,0.001847,172.31.40.0-255,66,175046,77,235468
10155,0.001853,74.125.68.0-255,5738,180784,77,235468
10156,0.001855,172.31.40.0-255,66,180850,77,235468
10157,0.00189,74.125.68.0-255,5020,185870,77,235468
10158,0.001893,172.31.40.0-255,66,185936,77,235468
10159,0.003884,74.125.68.0-255,5738,191674,77,235468
10160,0.003892,172.31.40.0-255,66,191740,77,235468
10161,0.005892,74.125.68.0-255,5738,197478,77,235468
10162,0.005896,172.31.40.0-255,66,197544,77,235468
10163,0.007884,74.125.68.0-255,4320,201864,77,235468
10164,0.007887,172.31.40.0-255,66,201930,77,235468
10165,0.007914,74.125.68.0-255,1484,203414,77,235468
10166,0.009878,74.125.68.0-255,4320,207734,77,235468
10167,0.009885,172.31.40.0-255,66,207800,77,235468
10168,0.011909,74.125.68.0-255,5738,213538,77,235468
10169,0.011916,172.31.40.0-255,66,213604,77,235468
10170,0.013942,74.125.68.0-255,5738,219342,77,235468
10171,0.013949,172.31.40.0-255,66,219408,77,235468
10172,0.015949,74.125.68.0-255,4320,223728,77,235468
10173,0.015955,172.31.40.0-255,66,223794,77,235468
10174,0.01598,74.125.68.0-255,1484,225278,77,235468
10175,0.017954,74.125.68.0-255,4320,229598,77,235468
10176,0.017963,172.31.40.0-255,66,229664,77,235468
10177,0.019967,74.125.68.0-255,5738,235402,77,235468
10178,0.019974,172.31.40.0-255,66,235468,77,235468
10179,0.0,172.217.194.0-255,149,149,77,252799
10180,2.1e-05,172.31.40.0-255,66,215,77,252799
10181,2.8e-05,172.217.194.0-255,1484,1699,77,252799
10182,3.3e-05,172.31.40.0-255,66,1765,77,252799
10183,4.9e-05,172.217.194.0-255,2902,4667,77,252799
10184,5.3e-05,172.31.40.0-255,66,4733,77,252799
10185,6.1e-05,172.217.194.0-255,7156,11889,77,252799
10186,6.6e-05,172.31.40.0-255,66,11955,77,252799
10187,7.1e-05,172.217.194.0-255,4320,16275,77,252799
10188,7.4e-05,172.31.40.0-255,66,16341,77,252799
10189,0.00011,172.217.194.0-255,11927,28268,77,252799
10190,0.000114,172.31.40.0-255,66,28334,77,252799
10191,0.000118,172.217.194.0-255,2543,30877,77,252799
10192,0.000121,172.31.40.0-255,66,30943,77,252799
10193,0.000202,172.217.194.0-255,1484,32427,77,252799
10194,0.000205,172.31.40.0-255,66,32493,77,252799
10195,0.00021,172.217.194.0-255,2902,35395,77,252799
10196,0.000212,172.31.40.0-255,66,35461,77,252799
10197,0.000219,172.217.194.0-255,5738,41199,77,252799
10198,0.000226,172.31.40.0-255,66,41265,77,252799
10199,0.000262,172.217.194.0-255,12828,54093,77,252799
10200,0.000266,172.31.40.0-255,66,54159,77,252799
10201,0.000275,172.217.194.0-255,8574,62733,77,252799
10202,0.000277,172.31.40.0-255,66,62799,77,252799
10203,0.000322,172.217.194.0-255,2794,65593,77,252799
10204,0.000325,172.31.40.0-255,66,65659,77,252799
10205,0.000404,172.217.194.0-255,1484,67143,77,252799
10206,0.000408,172.31.40.0-255,66,67209,77,252799
10207,0.000436,172.217.194.0-255,2902,70111,77,252799
10208,0.000439,172.31.40.0-255,66,70177,77,252799
10209,0.000451,172.217.194.0-255,1484,71661,77,252799
10210,0.000454,172.31.40.0-255,66,71727,77,252799
10211,0.000483,172.217.194.0-255,4320,76047,77,252799
10212,0.000486,172.31.40.0-255,66,76113,77,252799
10213,0.000491,172.217.194.0-255,2902,79015,77,252799
10214,0.000494,172.31.40.0-255,66,79081,77,252799
10215,0.000523,172.217.194.0-255,4320,83401,77,252799
10216,0.000525,172.31.40.0-255,66,83467,77,252799
10217,0.000532,172.217.194.0-255,5738,89205,77,252799
10218,0.000536,172.31.40.0-255,66,89271,77,252799
10219,0.000561,172.217.194.0-255,2902,92173,77,252799
10220,0.000563,172.31.40.0-255,66,92239,77,252799
10221,0.000593,172.217.194.0-255,7856,100095,77,252799
10222,0.000597,172.31.40.0-255,66,100161,77,252799
10223,0.000624,172.217.194.0-255,1484,101645,77,252799
10224,0.000629,172.217.194.0-255,1484,103129,77,252799
10225,0.000631,172.31.40.0-255,66,103195,77,252799
10226,0.000654,172.217.194.0-255,1484,104679,77,252799
10227,0.000661,172.217.194.0-255,5738,110417,77,252799
10228,0.000663,172.31.40.0-255,66,110483,77,252799
10229,0.000692,172.217.194.0-255,7156,117639,77,252799
10230,0.000696,172.31.40.0-255,66,117705,77,252799
10231,0.000703,172.217.194.0-255,7156,124861,77,252799
10232,0.000705,172.31.40.0-255,66,124927,77,252799
10233,0.000736,172.217.194.0-255,7156,132083,77,252799
10234,0.000739,172.31.40.0-255,66,132149,77,252799
10235,0.000744,172.217.194.0-255,2184,134333,77,252799
10236,0.000746,172.31.40.0-255,66,134399,77,252799
10237,0.000769,172.217.194.0-255,4320,138719,77,252799
10238,0.000772,172.31.40.0-255,66,138785,77,252799
10239,0.000807,172.217.194.0-255,9992,148777,77,252799
10240,0.00081,172.31.40.0-255,66,148843,77,252799
10241,0.000866,172.217.194.0-255,9992,158835,77,252799
10242,0.000869,172.31.40.0-255,66,158901,77,252799
10243,0.000903,172.217.194.0-255,5738,164639,77,252799
10244,0.000906,172.31.40.0-255,66,164705,77,252799
10245,0.00091,172.217.194.0-255,2008,166713,77,252799
10246,0.000912,172.31.40.0-255,66,166779,77,252799
10247,0.000929,172.31.40.0-255,66,166845,77,252799
10248,0.000932,172.217.194.0-255,1484,168329,77,252799
10249,0.000936,172.217.194.0-255,2902,171231,77,252799
10250,0.000939,172.31.40.0-255,66,171297,77,252799
10251,0.000942,172.217.194.0-255,1484,172781,77,252799
10252,0.000973,172.217.194.0-255,4320,177101,77,252799
10253,0.000977,172.31.40.0-255,66,177167,77,252799
10254,0.00098,172.217.194.0-255,1484,178651,77,252799
10255,0.001005,172.217.194.0-255,11410,190061,77,252799
10256,0.001007,172.31.40.0-255,66,190127,77,252799
10257,0.001046,172.217.194.0-255,10692,200819,77,252799
10258,0.00105,172.31.40.0-255,66,200885,77,252799
10259,0.002054,172.217.194.0-255,1484,202369,77,252799
10260,0.002061,172.217.194.0-255,2902,205271,77,252799
10261,0.002066,172.31.40.0-255,66,205337,77,252799
10262,0.002072,172.217.194.0-255,5738,211075,77,252799
10263,0.002074,172.31.40.0-255,66,211141,77,252799
10264,0.002102,172.217.194.0-255,5738,216879,77,252799
10265,0.002104,172.31.40.0-255,66,216945,77,252799
10266,0.002108,172.217.194.0-255,1484,218429,77,252799
10267,0.002154,172.31.40.0-255,66,218495,77,252799
10268,0.002157,172.217.194.0-255,766,219261,77,252799
10269,0.003026,172.31.40.0-255,66,219327,77,252799
10270,0.004803,172.217.194.0-255,4320,223647,77,252799
10271,0.004811,172.31.40.0-255,66,223713,77,252799
10272,0.005612,172.217.194.0-255,1484,225197,77,252799
10273,0.007431,172.217.194.0-255,4320,229517,77,252799
10274,0.007435,172.31.40.0-255,66,229583,77,252799
10275,0.010062,172.217.194.0-255,5738,235321,77,252799
10276,0.010068,172.31.40.0-255,66,235387,77,252799
10277,0.012705,172.217.194.0-255,5738,241125,77,252799
10278,0.012714,172.31.40.0-255,66,241191,77,252799
10279,0.015332,172.217.194.0-255,5738,246929,77,252799
10280,0.015344,172.31.40.0-255,66,246995,77,252799
10281,0.017955,172.217.194.0-255,5738,252733,77,252799
10282,0.017967,172.31.40.0-255,66,252799,77,252799
10283,0.0,74.125.200.0-255,152,152,77,221073
10284,2.3e-05,172.31.40.0-255,66,218,77,221073
10285,3e-05,74.125.200.0-255,1484,1702,77,221073
10286,3.4e-05,172.31.40.0-255,66,1768,77,221073
10287,7.1e-05,74.125.200.0-255,1484,3252,77,221073
10288,7.5e-05,172.31.40.0-255,66,3318,77,221073
10289,0.000112,74.125.200.0-255,2902,6220,77,221073
10290,0.000115,172.31.40.0-255,66,6286,77,221073
10291,0.000134,74.125.200.0-255,2902,9188,77,221073
10292,0.000136,172.31.40.0-255,66,9254,77,221073
10293,0.000171,74.125.200.0-255,1484,10738,77,221073
10294,0.000173,172.31.40.0-255,66,10804,77,221073
10295,0.000188,74.125.200.0-255,1484,12288,77,221073
10296,0.00019,172.31.40.0-255,66,12354,77,221073
10297,0.000205,74.125.200.0-255,1484,13838,77,221073
10298,0.000208,172.31.40.0-255,66,13904,77,221073
10299,0.00021,74.125.200.0-255,693,14597,77,221073
10300,0.000212,172.31.40.0-255,66,14663,77,221073
10301,0.000309,74.125.200.0-255,1484,16147,77,221073
10302,0.000313,172.31.40.0-255,66,16213,77,221073
10303,0.000352,74.125.200.0-255,2902,19115,77,221073
10304,0.000355,172.31.40.0-255,66,19181,77,221073
10305,0.000362,74.125.200.0-255,5738,24919,77,221073
10306,0.000364,172.31.40.0-255,66,24985,77,221073
10307,0.000368,74.125.200.0-255,2902,27887,77,221073
10308,0.000372,172.31.40.0-255,66,27953,77,221073
10309,0.000415,74.125.200.0-255,3961,31914,77,221073
10310,0.000418,172.31.40.0-255,66,31980,77,221073
10311,0.00045,74.125.200.0-255,1484,33464,77,221073
10312,0.000453,172.31.40.0-255,66,33530,77,221073
10313,0.000467,74.125.200.0-255,2902,36432,77,221073
10314,0.000469,172.31.40.0-255,66,36498,77,221073
10315,0.000496,74.125.200.0-255,4320,40818,77,221073
10316,0.000507,172.31.40.0-255,66,40884,77,221073
10317,0.000533,74.125.200.0-255,1484,42368,77,221073
10318,0.000551,74.125.200.0-255,5738,48106,77,221073
10319,0.000563,172.31.40.0-255,66,48172,77,221073
10320,0.00057,74.125.200.0-255,1125,49297,77,221073
10321,0.000661,74.125.200.0-255,1484,50781,77,221073
10322,0.000681,74.125.200.0-255,2902,53683,77,221073
10323,0.000684,172.31.40.0-255,66,53749,77,221073
10324,0.000692,172.31.40.0-255,66,53815,77,221073
10325,0.000704,74.125.200.0-255,2902,56717,77,221073
10326,0.000718,74.125.200.0-255,2902,59619,77,221073
10327,0.000726,172.31.40.0-255,66,59685,77,221073
10328,0.000733,74.125.200.0-255,1484,61169,77,221073
10329,0.000764,74.125.200.0-255,2902,64071,77,221073
10330,0.000779,74.125.200.0-255,2543,66614,77,221073
10331,0.000783,172.31.40.0-255,66,66680,77,221073
10332,0.000787,172.31.40.0-255,66,66746,77,221073
10333,0.000948,74.125.200.0-255,1484,68230,77,221073
10334,0.000964,74.125.200.0-255,2902,71132,77,221073
10335,0.000967,74.125.200.0-255,1484,72616,77,221073
10336,0.000983,74.125.200.0-255,1484,74100,77,221073
10337,0.000994,74.125.200.0-255,1484,75584,77,221073
10338,0.001029,74.125.200.0-255,1484,77068,77,221073
10339,0.001054,74.125.200.0-255,2902,79970,77,221073
10340,0.001085,74.125.200.0-255,2902,82872,77,221073
10341,0.001118,74.125.200.0-255,3961,86833,77,221073
10342,0.001121,74.125.200.0-255,1484,88317,77,221073
10343,0.001134,74.125.200.0-255,1484,89801,77,221073
10344,0.001155,74.125.200.0-255,2902,92703,77,221073
10345,0.001169,74.125.200.0-255,1484,94187,77,221073
10346,0.001183,74.125.200.0-255,5738,99925,77,221073
10347,0.001197,74.125.200.0-255,1484,101409,77,221073
10348,0.001218,74.125.200.0-255,8574,109983,77,221073
10349,0.001229,74.125.200.0-255,2902,112885,77,221073
10350,0.001272,74.125.200.0-255,1484,114369,77,221073
10351,0.001288,74.125.200.0-255,3602,117971,77,221073
10352,0.001347,74.125.200.0-255,1484,119455,77,221073
10353,0.001363,74.125.200.0-255,2902,122357,77,221073
10354,0.001387,74.125.200.0-255,5738,128095,77,221073
10355,0.001425,74.125.200.0-255,1484,129579,77,221073
10356,0.001446,74.125.200.0-255,2902,132481,77,221073
10357,0.001466,74.125.200.0-255,2902,135383,77,221073
10358,0.001481,74.125.200.0-255,2902,138285,77,221073
10359,0.001499,74.125.200.0-255,2902,141187,77,221073
10360,0.001516,74.125.200.0-255,2902,144089,77,221073
10361,0.001541,74.125.200.0-255,7156,151245,77,221073
10362,0.001544,74.125.200.0-255,766,152011,77,221073
10363,0.001631,74.125.200.0-255,1484,153495,77,221073
10364,0.001651,74.125.200.0-255,2902,156397,77,221073
10365,0.001671,74.125.200.0-255,1484,157881,77,221073
10366,0.001686,74.125.200.0-255,4320,162201,77,221073
10367,0.001689,74.125.200.0-255,1484,163685,77,221073
10368,0.001702,74.125.200.0-255,1484,165169,77,221073
10369,0.001705,74.125.200.0-255,1484,166653,77,221073
10370,0.001723,74.125.200.0-255,2902,169555,77,221073
10371,0.001748,74.125.200.0-255,4320,173875,77,221073
10372,0.001766,74.125.200.0-255,2902,176777,77,221073
10373,0.001769,74.125.200.0-255,1484,178261,77,221073
10374,0.001793,74.125.200.0-255,7156,185417,77,221073
10375,0.001816,74.125.200.0-255,766,186183,77,221073
10376,0.005782,172.31.40.0-255,66,186249,77,221073
10377,0.007864,74.125.200.0-255,5738,191987,77,221073
10378,0.007872,172.31.40.0-255,66,192053,77,221073
10379,0.009913,74.125.200.0-255,5738,197791,77,221073
10380,0.010049,172.31.40.0-255,66,197857,77,221073
10381,0.012135,74.125.200.0-255,5738,203595,77,221073
10382,0.012143,172.31.40.0-255,66,203661,77,221073
10383,0.014197,74.125.200.0-255,5738,209399,77,221073
10384,0.014209,172.31.40.0-255,66,209465,77,221073
10385,0.016257,74.125.200.0-255,5738,215203,77,221073
10386,0.016268,172.31.40.0-255,66,215269,77,221073
10387,0.018324,74.125.200.0-255,5738,221007,77,221073
10388,0.018332,172.31.40.0-255,66,221073,77,221073
10389,0.0,74.125.130.0-255,147,147,77,418071
10390,1.4e-05,172.31.40.0-255,66,213,77,418071
10391,3.5e-05,74.125.130.0-255,1484,1697,77,418071
10392,3.9e-05,172.31.40.0-255,66,1763,77,418071
10393,5.9e-05,74.125.130.0-255,2902,4665,77,418071
10394,6.2e-05,172.31.40.0-255,66,4731,77,418071
10395,9.6e-05,74.125.130.0-255,2902,7633,77,418071
10396,9.9e-05,172.31.40.0-255,66,7699,77,418071
10397,0.000122,74.125.130.0-255,1484,9183,77,418071
10398,0.000126,172.31.40.0-255,66,9249,77,418071
10399,0.000129,74.125.130.0-255,1484,10733,77,418071
10400,0.000131,172.31.40.0-255,66,10799,77,418071
10401,0.000156,74.125.130.0-255,1484,12283,77,418071
10402,0.000159,172.31.40.0-255,66,12349,77,418071
10403,0.000177,74.125.130.0-255,1484,13833,77,418071
10404,0.000179,172.31.40.0-255,66,13899,77,418071
10405,0.000182,74.125.130.0-255,565,14464,77,418071
10406,0.000185,172.31.40.0-255,66,14530,77,418071
10407,0.000211,74.125.130.0-255,1484,16014,77,418071
10408,0.000214,172.31.40.0-255,66,16080,77,418071
10409,0.000228,74.125.130.0-255,2902,18982,77,418071
10410,0.00023,172.31.40.0-255,66,19048,77,418071
10411,0.000233,74.125.130.0-255,1484,20532,77,418071
10412,0.000236,172.31.40.0-255,66,20598,77,418071
10413,0.00026,74.125.130.0-255,2902,23500,77,418071
10414,0.000264,172.31.40.0-255,66,23566,77,418071
10415,0.000287,74.125.130.0-255,1484,25050,77,418071
10416,0.000289,172.31.40.0-255,66,25116,77,418071
10417,0.000317,74.125.130.0-255,6797,31913,77,418071
10418,0.000319,172.31.40.0-255,66,31979,77,418071
10419,0.000447,74.125.130.0-255,1484,33463,77,418071
10420,0.000451,172.31.40.0-255,66,33529,77,418071
10421,0.000485,74.125.130.0-255,2902,36431,77,418071
10422,0.000488,172.31.40.0-255,66,36497,77,418071
10423,0.000493,74.125.130.0-255,2902,39399,77,418071
10424,0.000495,172.31.40.0-255,66,39465,77,418071
10425,0.0005,74.125.130.0-255,4320,43785,77,418071
10426,0.000503,172.31.40.0-255,66,43851,77,418071
10427,0.000535,74.125.130.0-255,4320,48171,77,418071
10428,0.000538,172.31.40.0-255,66,48237,77,418071
10429,0.000555,74.125.130.0-255,2543,50780,77,418071
10430,0.000558,172.31.40.0-255,66,50846,77,418071
10431,0.000583,74.125.130.0-255,7156,58002,77,418071
10432,0.000586,172.31.40.0-255,66,58068,77,418071
10433,0.000591,74.125.130.0-255,4320,62388,77,418071
10434,0.000594,172.31.40.0-255,66,62454,77,418071
10435,0.000635,74.125.130.0-255,4252,66706,77,418071
10436,0.000637,172.31.40.0-255,66,66772,77,418071
10437,0.000669,74.125.130.0-255,99,66871,77,418071
10438,0.000804,74.125.130.0-255,1484,68355,77,418071
10439,0.000808,172.31.40.0-255,66,68421,77,418071
10440,0.000813,74.125.130.0-255,2902,71323,77,418071
10441,0.000815,172.31.40.0-255,66,71389,77,418071
10442,0.000842,74.125.130.0-255,4320,75709,77,418071
10443,0.000845,172.31.40.0-255,66,75775,77,418071
10444,0.00085,74.125.130.0-255,2902,78677,77,418071
10445,0.000852,172.31.40.0-255,66,78743,77,418071
10446,0.000866,74.125.130.0-255,2902,81645,77,418071
10447,0.000869,172.31.40.0-255,66,81711,77,418071
10448,0.000886,74.125.130.0-255,5738,87449,77,418071
10449,0.000889,172.31.40.0-255,66,87515,77,418071
10450,0.000913,74.125.130.0-255,5738,93253,77,418071
10451,0.000917,172.31.40.0-255,66,93319,77,418071
10452,0.000921,74.125.130.0-255,2902,96221,77,418071
10453,0.000922,172.31.40.0-255,66,96287,77,418071
10454,0.000927,74.125.130.0-255,4320,100607,77,418071
10455,0.000929,172.31.40.0-255,66,100673,77,418071
10456,0.000932,74.125.130.0-255,766,101439,77,418071
10457,0.001034,74.125.130.0-255,362,101801,77,418071
10458,0.001073,74.125.130.0-255,1484,103285,77,418071
10459,0.001077,172.31.40.0-255,66,103351,77,418071
10460,0.001112,74.125.130.0-255,1484,104835,77,418071
10461,0.00113,74.125.130.0-255,2902,107737,77,418071
10462,0.001133,172.31.40.0-255,66,107803,77,418071
10463,0.001156,74.125.130.0-255,4320,112123,77,418071
10464,0.001159,172.31.40.0-255,66,112189,77,418071
10465,0.001166,74.125.130.0-255,5738,117927,77,418071
10466,0.001168,172.31.40.0-255,66,117993,77,418071
10467,0.001214,74.125.130.0-255,7156,125149,77,418071
10468,0.001217,172.31.40.0-255,66,125215,77,418071
10469,0.001243,74.125.130.0-255,1484,126699,77,418071
10470,0.001273,74.125.130.0-255,2902,129601,77,418071
10471,0.001278,172.31.40.0-255,66,129667,77,418071
10472,0.001299,74.125.130.0-255,5738,135405,77,418071
10473,0.001302,172.31.40.0-255,66,135471,77,418071
10474,0.00136,74.125.130.0-255,766,136237,77,418071
10475,0.001502,74.125.130.0-255,1484,137721,77,418071
10476,0.001506,172.31.40.0-255,66,137787,77,418071
10477,0.001511,74.125.130.0-255,2902,140689,77,418071
10478,0.001513,172.31.40.0-255,66,140755,77,418071
10479,0.001536,74.125.130.0-255,4320,145075,77,418071
10480,0.001538,172.31.40.0-255,66,145141,77,418071
10481,0.001559,74.125.130.0-255,1484,146625,77,418071
10482,0.001572,74.125.130.0-255,1484,148109,77,418071
10483,0.001575,172.31.40.0-255,66,148175,77,418071
10484,0.001594,74.125.130.0-255,1484,149659,77,418071
10485,0.001604,74.125.130.0-255,1484,151143,77,418071
10486,0.001606,172.31.40.0-255,66,151209,77,418071
10487,0.001668,74.125.130.0-255,2902,154111,77,418071
10488,0.001672,172.31.40.0-255,66,154177,77,418071
10489,0.001678,74.125.130.0-255,4320,158497,77,418071
10490,0.00168,172.31.40.0-255,66,158563,77,418071
10491,0.001684,74.125.130.0-255,2902,161465,77,418071
10492,0.001686,172.31.40.0-255,66,161531,77,418071
10493,0.001718,74.125.130.0-255,5738,167269,77,418071
10494,0.001721,74.125.130.0-255,2902,170171,77,418071
10495,0.001725,172.31.40.0-255,66,170237,77,418071
10496,0.001728,172.31.40.0-255,66,170303,77,418071
10497,0.001745,74.125.130.0-255,766,171069,77,418071
10498,0.001889,74.125.130.0-255,1484,172553,77,418071
10499,0.001893,172.31.40.0-255,66,172619,77,418071
10500,0.001898,74.125.130.0-255,2902,175521,77,418071
10501,0.001901,172.31.40.0-255,66,175587,77,418071
10502,0.001953,74.125.130.0-255,5738,181325,77,418071
10503,0.001956,172.31.40.0-255,66,181391,77,418071
10504,0.001963,74.125.130.0-255,5738,187129,77,418071
10505,0.001965,172.31.40.0-255,66,187195,77,418071
10506,0.001985,74.125.130.0-255,7156,194351,77,418071
10507,0.001989,172.31.40.0-255,66,194417,77,418071
10508,0.00201,74.125.130.0-255,4320,198737,77,418071
10509,0.002013,172.31.40.0-255,66,198803,77,418071
10510,0.00204,74.125.130.0-255,6438,205241,77,418071
10511,0.002042,172.31.40.0-255,66,205307,77,418071
10512,0.00213,74.125.130.0-255,1484,206791,77,418071
10513,0.002144,74.125.130.0-255,2902,209693,77,418071
10514,0.002148,172.31.40.0-255,66,209759,77,418071
10515,0.002165,74.125.130.0-255,1484,211243,77,418071
10516,0.002169,74.125.130.0-255,1484,212727,77,418071
10517,0.002171,172.31.40.0-255,66,212793,77,418071
10518,0.002194,74.125.130.0-255,1484,214277,77,418071
10519,0.002201,74.125.130.0-255,5738,220015,77,418071
10520,0.002203,172.31.40.0-255,66,220081,77,418071
10521,0.002231,74.125.130.0-255,9992,230073,77,418071
10522,0.002247,74.125.130.0-255,2902,232975,77,418071
10523,0.002257,172.31.40.0-255,66,233041,77,418071
10524,0.002281,74.125.130.0-255,7856,240897,77,418071
10525,0.002284,74.125.130.0-255,1484,242381,77,418071
10526,0.00229,172.31.40.0-255,66,242447,77,418071
10527,0.002326,74.125.130.0-255,1484,243931,77,418071
10528,0.002352,74.125.130.0-255,1484,245415,77,418071
10529,0.002363,172.31.40.0-255,66,245481,77,418071
10530,0.00239,74.125.130.0-255,1484,246965,77,418071
10531,0.002425,74.125.130.0-255,2902,249867,77,418071
10532,0.002428,172.31.40.0-255,66,249933,77,418071
10533,0.002432,74.125.130.0-255,1484,251417,77,418071
10534,0.002451,74.125.130.0-255,2902,254319,77,418071
10535,0.002479,74.125.130.0-255,2902,257221,77,418071
10536,0.002498,74.125.130.0-255,2902,260123,77,418071
10537,0.002521,74.125.130.0-255,1484,261607,77,418071
10538,0.002576,74.125.130.0-255,1484,263091,77,418071
10539,0.002598,74.125.130.0-255,2902,265993,77,418071
10540,0.002631,74.125.130.0-255,1484,267477,77,418071
10541,0.00265,74.125.130.0-255,4320,271797,77,418071
10542,0.002675,74.125.130.0-255,2184,273981,77,418071
10543,0.002774,74.125.130.0-255,1484,275465,77,418071
10544,0.002779,74.125.130.0-255,2902,278367,77,418071
10545,0.002796,74.125.130.0-255,1484,279851,77,418071
10546,0.002811,74.125.130.0-255,4320,284171,77,418071
10547,0.002835,74.125.130.0-255,5738,289909,77,418071
10548,0.002839,74.125.130.0-255,1484,291393,77,418071
10549,0.002853,74.125.130.0-255,1484,292877,77,418071
10550,0.002873,74.125.130.0-255,7156,300033,77,418071
10551,0.002878,74.125.130.0-255,4320,304353,77,418071
10552,0.002899,74.125.130.0-255,3602,307955,77,418071
10553,0.003094,74.125.130.0-255,1484,309439,77,418071
10554,0.003099,74.125.130.0-255,1484,310923,77,418071
10555,0.003112,74.125.130.0-255,1484,312407,77,418071
10556,0.003131,74.125.130.0-255,5738,318145,77,418071
10557,0.003149,74.125.130.0-255,5738,323883,77,418071
10558,0.003168,74.125.130.0-255,1484,325367,77,418071
10559,0.003182,74.125.130.0-255,2902,328269,77,418071
10560,0.003204,74.125.130.0-255,2902,331171,77,418071
10561,0.003207,74.125.130.0-255,1484,332655,77,418071
10562,0.003214,74.125.130.0-255,7156,339811,77,418071
10563,0.003229,74.125.130.0-255,1484,341295,77,418071
10564,0.003231,74.125.130.0-255,766,342061,77,418071
10565,0.003256,74.125.130.0-255,1484,343545,77,418071
10566,0.003274,74.125.130.0-255,1484,345029,77,418071
10567,0.003277,74.125.130.0-255,1484,346513,77,418071
10568,0.003307,74.125.130.0-255,1484,347997,77,418071
10569,0.003313,74.125.130.0-255,5738,353735,77,418071
10570,0.003365,74.125.130.0-255,5738,359473,77,418071
10571,0.0034,74.125.130.0-255,7156,366629,77,418071
10572,0.003411,74.125.130.0-255,9274,375903,77,418071
10573,0.003416,74.125.130.0-255,4320,380223,77,418071
10574,0.003442,74.125.130.0-255,4320,384543,77,418071
10575,0.00346,74.125.130.0-255,2902,387445,77,418071
10576,0.003479,74.125.130.0-255,2902,390347,77,418071
10577,0.003484,74.125.130.0-255,4320,394667,77,418071
10578,0.003488,74.125.130.0-255,2902,397569,77,418071
10579,0.003491,74.125.130.0-255,1484,399053,77,418071
10580,0.003507,74.125.130.0-255,1484,400537,77,418071
10581,0.003529,74.125.130.0-255,2902,403439,77,418071
10582,0.00355,74.125.130.0-255,6438,409877,77,418071
10583,0.003553,74.125.130.0-255,1484,411361,77,418071
10584,0.003576,74.125.130.0-255,4320,415681,77,418071
10585,0.003593,74.125.130.0-255,1951,417632,77,418071
10586,0.003596,74.125.130.0-255,97,417729,77,418071
10587,0.003642,74.125.130.0-255,105,417834,77,418071
10588,0.007371,172.31.40.0-255,66,417900,77,418071
10589,0.009326,172.31.40.0-255,105,418005,77,418071
10590,0.011649,74.125.130.0-255,66,418071,77,418071
10591,0.0,74.125.24.0-255,150,150,77,339203
10592,2.4e-05,172.31.40.0-255,66,216,77,339203
10593,3e-05,74.125.24.0-255,1484,1700,77,339203
10594,3.5e-05,172.31.40.0-255,66,1766,77,339203
10595,4e-05,74.125.24.0-255,2902,4668,77,339203
10596,5.6e-05,172.31.40.0-255,66,4734,77,339203
10597,6.4e-05,74.125.24.0-255,7156,11890,77,339203
10598,6.7e-05,172.31.40.0-255,66,11956,77,339203
10599,7.3e-05,74.125.24.0-255,3557,15513,77,339203
10600,7.6e-05,172.31.40.0-255,66,15579,77,339203
10601,8.2e-05,74.125.24.0-255,4320,19899,77,339203
10602,8.5e-05,172.31.40.0-255,66,19965,77,339203
10603,9.4e-05,74.125.24.0-255,9992,29957,77,339203
10604,9.7e-05,172.31.40.0-255,66,30023,77,339203
10605,9.9e-05,74.125.24.0-255,1125,31148,77,339203
10606,0.000101,172.31.40.0-255,66,31214,77,339203
10607,0.000163,74.125.24.0-255,1484,32698,77,339203
10608,0.000166,172.31.40.0-255,66,32764,77,339203
10609,0.000178,74.125.24.0-255,2902,35666,77,339203
10610,0.000181,172.31.40.0-255,66,35732,77,339203
10611,0.000184,74.125.24.0-255,1484,37216,77,339203
10612,0.000186,172.31.40.0-255,66,37282,77,339203
10613,0.000209,74.125.24.0-255,4320,41602,77,339203
10614,0.000212,172.31.40.0-255,66,41668,77,339203
10615,0.000217,74.125.24.0-255,4320,45988,77,339203
10616,0.00022,172.31.40.0-255,66,46054,77,339203
10617,0.000245,74.125.24.0-255,7156,53210,77,339203
10618,0.000248,172.31.40.0-255,66,53276,77,339203
10619,0.000273,74.125.24.0-255,5379,58655,77,339203
10620,0.000277,172.31.40.0-255,66,58721,77,339203
10621,0.000284,74.125.24.0-255,7067,65788,77,339203
10622,0.000287,172.31.40.0-255,66,65854,77,339203
10623,0.000289,74.125.24.0-255,134,65988,77,339203
10624,0.000293,74.125.24.0-255,349,66337,77,339203
10625,0.000635,74.125.24.0-255,1484,67821,77,339203
10626,0.000641,172.31.40.0-255,66,67887,77,339203
10627,0.000648,74.125.24.0-255,2902,70789,77,339203
10628,0.000651,172.31.40.0-255,66,70855,77,339203
10629,0.000657,74.125.24.0-255,5738,76593,77,339203
10630,0.00066,172.31.40.0-255,66,76659,77,339203
10631,0.000664,74.125.24.0-255,2902,79561,77,339203
10632,0.000666,172.31.40.0-255,66,79627,77,339203
10633,0.000686,74.125.24.0-255,4320,83947,77,339203
10634,0.000688,172.31.40.0-255,66,84013,77,339203
10635,0.000697,74.125.24.0-255,8574,92587,77,339203
10636,0.00071,172.31.40.0-255,66,92653,77,339203
10637,0.000723,74.125.24.0-255,5738,98391,77,339203
10638,0.000726,74.125.24.0-255,2184,100575,77,339203
10639,0.00074,172.31.40.0-255,66,100641,77,339203
10640,0.0011,74.125.24.0-255,1484,102125,77,339203
10641,0.001105,74.125.24.0-255,1484,103609,77,339203
10642,0.001108,172.31.40.0-255,66,103675,77,339203
10643,0.001128,74.125.24.0-255,1484,105159,77,339203
10644,0.001136,74.125.24.0-255,5738,110897,77,339203
10645,0.001138,172.31.40.0-255,66,110963,77,339203
10646,0.00115,74.125.24.0-255,12828,123791,77,339203
10647,0.001152,172.31.40.0-255,66,123857,77,339203
10648,0.001161,74.125.24.0-255,8574,132431,77,339203
10649,0.001163,172.31.40.0-255,66,132497,77,339203
10650,0.001176,74.125.24.0-255,1484,133981,77,339203
10651,0.001194,74.125.24.0-255,766,134747,77,339203
10652,0.001197,172.31.40.0-255,66,134813,77,339203
10653,0.001244,74.125.24.0-255,1484,136297,77,339203
10654,0.00127,74.125.24.0-255,2902,139199,77,339203
10655,0.001274,172.31.40.0-255,66,139265,77,339203
10656,0.001304,74.125.24.0-255,2902,142167,77,339203
10657,0.001306,172.31.40.0-255,66,142233,77,339203
10658,0.001329,74.125.24.0-255,2902,145135,77,339203
10659,0.001331,172.31.40.0-255,66,145201,77,339203
10660,0.001342,74.125.24.0-255,12828,158029,77,339203
10661,0.001348,74.125.24.0-255,5738,163767,77,339203
10662,0.001351,172.31.40.0-255,66,163833,77,339203
10663,0.00138,74.125.24.0-255,5020,168853,77,339203
10664,0.001387,74.125.24.0-255,5738,174591,77,339203
10665,0.00139,74.125.24.0-255,1484,176075,77,339203
10666,0.001394,172.31.40.0-255,66,176141,77,339203
10667,0.001429,74.125.24.0-255,11410,187551,77,339203
10668,0.00144,74.125.24.0-255,12828,200379,77,339203
10669,0.001459,172.31.40.0-255,66,200445,77,339203
10670,0.001463,74.125.24.0-255,2184,202629,77,339203
10671,0.001468,172.31.40.0-255,66,202695,77,339203
10672,0.001736,74.125.24.0-255,1484,204179,77,339203
10673,0.001743,74.125.24.0-255,2902,207081,77,339203
10674,0.001746,172.31.40.0-255,66,207147,77,339203
10675,0.001751,74.125.24.0-255,2902,210049,77,339203
10676,0.001758,172.31.40.0-255,66,210115,77,339203
10677,0.001767,74.125.24.0-255,2902,213017,77,339203
10678,0.001772,172.31.40.0-255,66,213083,77,339203
10679,0.001784,74.125.24.0-255,7156,220239,77,339203
10680,0.001802,74.125.24.0-255,5738,225977,77,339203
10681,0.001805,74.125.24.0-255,1484,227461,77,339203
10682,0.00182,172.31.40.0-255,66,227527,77,339203
10683,0.001829,74.125.24.0-255,9274,236801,77,339203
10684,0.001833,172.31.40.0-255,66,236867,77,339203
10685,0.001861,74.125.24.0-255,1484,238351,77,339203
10686,0.001865,74.125.24.0-255,1484,239835,77,339203
10687,0.001869,172.31.40.0-255,66,239901,77,339203
10688,0.001888,74.125.24.0-255,1484,241385,77,339203
10689,0.001894,74.125.24.0-255,5738,247123,77,339203
10690,0.001899,172.31.40.0-255,66,247189,77,339203
10691,0.001908,74.125.24.0-255,4320,251509,77,339203
10692,0.001913,172.31.40.0-255,66,251575,77,339203
10693,0.001939,74.125.24.0-255,8574,260149,77,339203
10694,0.001942,74.125.24.0-255,1484,261633,77,339203
10695,0.001959,74.125.24.0-255,5738,267371,77,339203
10696,0.001965,172.31.40.0-255,66,267437,77,339203
10697,0.001977,74.125.24.0-255,3602,271039,77,339203
10698,0.002001,172.31.40.0-255,66,271105,77,339203
10699,0.002047,74.125.24.0-255,1484,272589,77,339203
10700,0.002063,74.125.24.0-255,2902,275491,77,339203
10701,0.002078,74.125.24.0-255,5738,281229,77,339203
10702,0.002084,172.31.40.0-255,66,281295,77,339203
10703,0.002126,74.125.24.0-255,11410,292705,77,339203
10704,0.002141,172.31.40.0-255,66,292771,77,339203
10705,0.004239,74.125.24.0-255,5738,298509,77,339203
10706,0.004249,172.31.40.0-255,66,298575,77,339203
10707,0.006373,74.125.24.0-255,5738,304313,77,339203
10708,0.006387,172.31.40.0-255,66,304379,77,339203
10709,0.008472,74.125.24.0-255,5738,310117,77,339203
10710,0.008483,172.31.40.0-255,66,310183,77,339203
10711,0.010593,74.125.24.0-255,5738,315921,77,339203
10712,0.010597,172.31.40.0-255,66,315987,77,339203
10713,0.012689,74.125.24.0-255,5738,321725,77,339203
10714,0.012696,172.31.40.0-255,66,321791,77,339203
10715,0.014827,74.125.24.0-255,5738,327529,77,339203
10716,0.014837,172.31.40.0-255,66,327595,77,339203
10717,0.016918,74.125.24.0-255,5738,333333,77,339203
10718,0.016933,172.31.40.0-255,66,333399,77,339203
10719,0.01905,74.125.24.0-255,5738,339137,77,339203
10720,0.019062,172.31.40.0-255,66,339203,77,339203
10721,0.0,172.31.40.0-255,105,105,77,459
10722,0.000235,172.31.40.0-255,90,195,77,459
10723,0.000244,172.31.40.0-255,66,261,77,459
10724,0.002822,74.125.24.0-255,66,327,77,459
10725,0.002846,74.125.24.0-255,66,393,77,459
10726,0.002866,172.31.40.0-255,66,459,77,459
10727,0.0,74.125.24.0-255,153,153,77,209061
10728,1.9e-05,172.31.40.0-255,66,219,77,209061
10729,2.6e-05,74.125.24.0-255,1484,1703,77,209061
10730,2.9e-05,172.31.40.0-255,66,1769,77,209061
10731,3.4e-05,74.125.24.0-255,2902,4671,77,209061
10732,3.7e-05,172.31.40.0-255,66,4737,77,209061
10733,4.4e-05,74.125.24.0-255,7156,11893,77,209061
10734,4.7e-05,172.31.40.0-255,66,11959,77,209061
10735,4.9e-05,74.125.24.0-255,1484,13443,77,209061
10736,5.2e-05,172.31.40.0-255,66,13509,77,209061
10737,9.9e-05,172.31.40.0-255,66,13575,77,209061
10738,0.000103,74.125.24.0-255,2543,16118,77,209061
10739,0.000105,172.31.40.0-255,66,16184,77,209061
10740,0.000462,74.125.24.0-255,1484,17668,77,209061
10741,0.000466,172.31.40.0-255,66,17734,77,209061
10742,0.000472,74.125.24.0-255,2902,20636,77,209061
10743,0.000473,172.31.40.0-255,66,20702,77,209061
10744,0.000486,74.125.24.0-255,4320,25022,77,209061
10745,0.000488,172.31.40.0-255,66,25088,77,209061
10746,0.000508,74.125.24.0-255,1484,26572,77,209061
10747,0.00051,172.31.40.0-255,66,26638,77,209061
10748,0.000512,74.125.24.0-255,1484,28122,77,209061
10749,0.000514,172.31.40.0-255,66,28188,77,209061
10750,0.000554,74.125.24.0-255,11051,39239,77,209061
10751,0.000558,74.125.24.0-255,2902,42141,77,209061
10752,0.000561,172.31.40.0-255,66,42207,77,209061
10753,0.000564,172.31.40.0-255,66,42273,77,209061
10754,0.000591,74.125.24.0-255,8490,50763,77,209061
10755,0.0006,172.31.40.0-255,66,50829,77,209061
10756,0.000851,74.125.24.0-255,380,51209,77,209061
10757,0.000855,172.31.40.0-255,66,51275,77,209061
10758,0.001006,74.125.24.0-255,1484,52759,77,209061
10759,0.001014,74.125.24.0-255,2902,55661,77,209061
10760,0.001017,172.31.40.0-255,66,55727,77,209061
10761,0.001024,74.125.24.0-255,4320,60047,77,209061
10762,0.001027,172.31.40.0-255,66,60113,77,209061
10763,0.001044,74.125.24.0-255,1484,61597,77,209061
10764,0.00105,74.125.24.0-255,4320,65917,77,209061
10765,0.001052,172.31.40.0-255,66,65983,77,209061
10766,0.001077,74.125.24.0-255,8215,74198,77,209061
10767,0.00108,172.31.40.0-255,66,74264,77,209061
10768,0.001132,74.125.24.0-255,11051,85315,77,209061
10769,0.001135,172.31.40.0-255,66,85381,77,209061
10770,0.00163,74.125.24.0-255,1484,86865,77,209061
10771,0.00164,74.125.24.0-255,2902,89767,77,209061
10772,0.001644,172.31.40.0-255,66,89833,77,209061
10773,0.001652,74.125.24.0-255,5738,95571,77,209061
10774,0.001654,172.31.40.0-255,66,95637,77,209061
10775,0.00166,74.125.24.0-255,4320,99957,77,209061
10776,0.001662,172.31.40.0-255,66,100023,77,209061
10777,0.001665,74.125.24.0-255,1484,101507,77,209061
10778,0.001702,74.125.24.0-255,9992,111499,77,209061
10779,0.001705,172.31.40.0-255,66,111565,77,209061
10780,0.00171,74.125.24.0-255,2902,114467,77,209061
10781,0.001712,172.31.40.0-255,66,114533,77,209061
10782,0.00173,74.125.24.0-255,5020,119553,77,209061
10783,0.001733,172.31.40.0-255,66,119619,77,209061
10784,0.002163,74.125.24.0-255,1484,121103,77,209061
10785,0.002172,74.125.24.0-255,2902,124005,77,209061
10786,0.002176,172.31.40.0-255,66,124071,77,209061
10787,0.002184,74.125.24.0-255,4320,128391,77,209061
10788,0.002186,172.31.40.0-255,66,128457,77,209061
10789,0.002203,74.125.24.0-255,1484,129941,77,209061
10790,0.002209,74.125.24.0-255,4320,134261,77,209061
10791,0.002212,172.31.40.0-255,66,134327,77,209061
10792,0.002233,74.125.24.0-255,8574,142901,77,209061
10793,0.002236,172.31.40.0-255,66,142967,77,209061
10794,0.002241,74.125.24.0-255,4320,147287,77,209061
10795,0.002244,172.31.40.0-255,66,147353,77,209061
10796,0.00229,172.31.40.0-255,66,147419,77,209061
10797,0.002296,74.125.24.0-255,5738,153157,77,209061
10798,0.002299,172.31.40.0-255,66,153223,77,209061
10799,0.002312,74.125.24.0-255,4320,157543,77,209061
10800,0.002314,172.31.40.0-255,66,157609,77,209061
10801,0.002318,74.125.24.0-255,1484,159093,77,209061
10802,0.002344,74.125.24.0-255,9274,168367,77,209061
10803,0.002347,172.31.40.0-255,66,168433,77,209061
10804,0.004814,74.125.24.0-255,5738,174171,77,209061
10805,0.00482,172.31.40.0-255,66,174237,77,209061
10806,0.007157,74.125.24.0-255,5738,179975,77,209061
10807,0.007165,172.31.40.0-255,66,180041,77,209061
10808,0.009555,74.125.24.0-255,5738,185779,77,209061
10809,0.009563,172.31.40.0-255,66,185845,77,209061
10810,0.011943,74.125.24.0-255,5738,191583,77,209061
10811,0.011951,172.31.40.0-255,66,191649,77,209061
10812,0.014354,74.125.24.0-255,5738,197387,77,209061
10813,0.014364,172.31.40.0-255,66,197453,77,209061
10814,0.01675,74.125.24.0-255,5738,203191,77,209061
10815,0.016759,172.31.40.0-255,66,203257,77,209061
10816,0.019128,74.125.24.0-255,5738,208995,77,209061
10817,0.019138,172.31.40.0-255,66,209061,77,209061
10818,0.0,172.217.27.0-255,146,146,77,234088
10819,1.5e-05,172.31.40.0-255,66,212,77,234088
10820,2.3e-05,172.217.27.0-255,1484,1696,77,234088
10821,2.7e-05,172.31.40.0-255,66,1762,77,234088
10822,3.3e-05,172.217.27.0-255,2902,4664,77,234088
10823,3.7e-05,172.31.40.0-255,66,4730,77,234088
10824,4e-05,172.217.27.0-255,1484,6214,77,234088
10825,4.2e-05,172.31.40.0-255,66,6280,77,234088
10826,5e-05,172.217.27.0-255,5738,12018,77,234088
10827,5.3e-05,172.31.40.0-255,66,12084,77,234088
10828,0.0001,172.217.27.0-255,2126,14210,77,234088
10829,0.000103,172.31.40.0-255,66,14276,77,234088
10830,0.000362,172.217.27.0-255,1484,15760,77,234088
10831,0.000369,172.31.40.0-255,66,15826,77,234088
10832,0.000375,172.217.27.0-255,2902,18728,77,234088
10833,0.000377,172.31.40.0-255,66,18794,77,234088
10834,0.000384,172.217.27.0-255,4320,23114,77,234088
10835,0.000387,172.31.40.0-255,66,23180,77,234088
10836,0.000407,172.217.27.0-255,1484,24664,77,234088
10837,0.000409,172.31.40.0-255,66,24730,77,234088
10838,0.000413,172.217.27.0-255,1484,26214,77,234088
10839,0.000415,172.31.40.0-255,66,26280,77,234088
10840,0.000433,172.217.27.0-255,5379,31659,77,234088
10841,0.000436,172.31.40.0-255,66,31725,77,234088
10842,0.000449,172.217.27.0-255,1484,33209,77,234088
10843,0.000451,172.31.40.0-255,66,33275,77,234088
10844,0.000471,172.217.27.0-255,5738,39013,77,234088
10845,0.000475,172.31.40.0-255,66,39079,77,234088
10846,0.000483,172.217.27.0-255,9633,48712,77,234088
10847,0.000486,172.31.40.0-255,66,48778,77,234088
10848,0.000687,172.217.27.0-255,1484,50262,77,234088
10849,0.000691,172.217.27.0-255,2902,53164,77,234088
10850,0.000702,172.31.40.0-255,66,53230,77,234088
10851,0.000706,172.31.40.0-255,66,53296,77,234088
10852,0.000713,172.217.27.0-255,5738,59034,77,234088
10853,0.000715,172.31.40.0-255,66,59100,77,234088
10854,0.000719,172.217.27.0-255,1484,60584,77,234088
10855,0.000743,172.217.27.0-255,5379,65963,77,234088
10856,0.000746,172.31.40.0-255,66,66029,77,234088
10857,0.000749,172.217.27.0-255,395,66424,77,234088
10858,0.000905,172.217.27.0-255,116,66540,77,234088
10859,0.001006,172.217.27.0-255,1484,68024,77,234088
10860,0.00101,172.31.40.0-255,66,68090,77,234088
10861,0.001015,172.217.27.0-255,2902,70992,77,234088
10862,0.001017,172.31.40.0-255,66,71058,77,234088
10863,0.001021,172.217.27.0-255,2902,73960,77,234088
10864,0.001023,172.31.40.0-255,66,74026,77,234088
10865,0.001027,172.217.27.0-255,1484,75510,77,234088
10866,0.001049,172.217.27.0-255,2902,78412,77,234088
10867,0.001052,172.31.40.0-255,66,78478,77,234088
10868,0.001084,172.217.27.0-255,5379,83857,77,234088
10869,0.001087,172.31.40.0-255,66,83923,77,234088
10870,0.001094,172.217.27.0-255,5738,89661,77,234088
10871,0.001096,172.31.40.0-255,66,89727,77,234088
10872,0.001138,172.217.27.0-255,2902,92629,77,234088
10873,0.001141,172.31.40.0-255,66,92695,77,234088
10874,0.00116,172.217.27.0-255,4320,97015,77,234088
10875,0.001162,172.31.40.0-255,66,97081,77,234088
10876,0.001186,172.217.27.0-255,3961,101042,77,234088
10877,0.001189,172.31.40.0-255,66,101108,77,234088
10878,0.001237,172.217.27.0-255,1484,102592,77,234088
10879,0.001258,172.217.27.0-255,2902,105494,77,234088
10880,0.001261,172.31.40.0-255,66,105560,77,234088
10881,0.001267,172.217.27.0-255,5738,111298,77,234088
10882,0.001269,172.31.40.0-255,66,111364,77,234088
10883,0.001274,172.217.27.0-255,2902,114266,77,234088
10884,0.001276,172.31.40.0-255,66,114332,77,234088
10885,0.001312,172.217.27.0-255,9992,124324,77,234088
10886,0.001315,172.31.40.0-255,66,124390,77,234088
10887,0.001373,172.217.27.0-255,8574,132964,77,234088
10888,0.001377,172.31.40.0-255,66,133030,77,234088
10889,0.001396,172.217.27.0-255,2184,135214,77,234088
10890,0.001398,172.31.40.0-255,66,135280,77,234088
10891,0.001461,172.217.27.0-255,1484,136764,77,234088
10892,0.001466,172.217.27.0-255,2902,139666,77,234088
10893,0.001469,172.31.40.0-255,66,139732,77,234088
10894,0.001473,172.217.27.0-255,2902,142634,77,234088
10895,0.001476,172.31.40.0-255,66,142700,77,234088
10896,0.001489,172.217.27.0-255,2902,145602,77,234088
10897,0.001492,172.31.40.0-255,66,145668,77,234088
10898,0.001496,172.217.27.0-255,2902,148570,77,234088
10899,0.001498,172.31.40.0-255,66,148636,77,234088
10900,0.001518,172.217.27.0-255,9992,158628,77,234088
10901,0.00152,172.31.40.0-255,66,158694,77,234088
10902,0.001528,172.217.27.0-255,8574,167268,77,234088
10903,0.001531,172.31.40.0-255,66,167334,77,234088
10904,0.001563,172.217.27.0-255,2184,169518,77,234088
10905,0.001566,172.31.40.0-255,66,169584,77,234088
10906,0.003155,172.217.27.0-255,2902,172486,77,234088
10907,0.003162,172.31.40.0-255,66,172552,77,234088
10908,0.003183,172.217.27.0-255,2902,175454,77,234088
10909,0.003185,172.31.40.0-255,66,175520,77,234088
10910,0.004782,172.217.27.0-255,2902,178422,77,234088
10911,0.004785,172.31.40.0-255,66,178488,77,234088
10912,0.004804,172.217.27.0-255,2902,181390,77,234088
10913,0.004806,172.31.40.0-255,66,181456,77,234088
10914,0.006398,172.217.27.0-255,2902,184358,77,234088
10915,0.0064,172.31.40.0-255,66,184424,77,234088
10916,0.006432,172.217.27.0-255,2902,187326,77,234088
10917,0.006435,172.31.40.0-255,66,187392,77,234088
10918,0.008032,172.217.27.0-255,2902,190294,77,234088
10919,0.008039,172.31.40.0-255,66,190360,77,234088
10920,0.008065,172.217.27.0-255,2902,193262,77,234088
10921,0.008068,172.31.40.0-255,66,193328,77,234088
10922,0.009707,172.217.27.0-255,5738,199066,77,234088
10923,0.009715,172.31.40.0-255,66,199132,77,234088
10924,0.01135,172.217.27.0-255,5738,204870,77,234088
10925,0.011358,172.31.40.0-255,66,204936,77,234088
10926,0.013022,172.217.27.0-255,5738,210674,77,234088
10927,0.013029,172.31.40.0-255,66,210740,77,234088
10928,0.014653,172.217.27.0-255,5738,216478,77,234088
10929,0.014667,172.31.40.0-255,66,216544,77,234088
10930,0.01631,172.217.27.0-255,5738,222282,77,234088
10931,0.016318,172.31.40.0-255,66,222348,77,234088
10932,0.017949,172.217.27.0-255,5738,228086,77,234088
10933,0.017955,172.31.40.0-255,66,228152,77,234088
10934,0.019585,172.217.27.0-255,2902,231054,77,234088
10935,0.01959,172.31.40.0-255,66,231120,77,234088
10936,0.019611,172.217.27.0-255,2902,234022,77,234088
10937,0.019613,172.31.40.0-255,66,234088,77,234088
10938,0.0,172.253.118.0-255,146,146,77,130835
10939,2.4e-05,172.31.40.0-255,66,212,77,130835
10940,3.1e-05,172.253.118.0-255,1484,1696,77,130835
10941,3.6e-05,172.31.40.0-255,66,1762,77,130835
10942,4.9e-05,172.253.118.0-255,2902,4664,77,130835
10943,5.2e-05,172.31.40.0-255,66,4730,77,130835
10944,5.7e-05,172.253.118.0-255,2902,7632,77,130835
10945,6e-05,172.31.40.0-255,66,7698,77,130835
10946,6.8e-05,172.253.118.0-255,7156,14854,77,130835
10947,7e-05,172.31.40.0-255,66,14920,77,130835
10948,0.000126,172.253.118.0-255,3418,18338,77,130835
10949,0.000131,172.31.40.0-255,66,18404,77,130835
10950,0.000142,172.253.118.0-255,12469,30873,77,130835
10951,0.000144,172.31.40.0-255,66,30939,77,130835
10952,0.000248,172.253.118.0-255,1484,32423,77,130835
10953,0.000252,172.31.40.0-255,66,32489,77,130835
10954,0.000256,172.253.118.0-255,1484,33973,77,130835
10955,0.000258,172.31.40.0-255,66,34039,77,130835
10956,0.00029,172.253.118.0-255,1484,35523,77,130835
10957,0.000293,172.31.40.0-255,66,35589,77,130835
10958,0.0003,172.253.118.0-255,5738,41327,77,130835
10959,0.000302,172.31.40.0-255,66,41393,77,130835
10960,0.000322,172.253.118.0-255,5738,47131,77,130835
10961,0.000324,172.31.40.0-255,66,47197,77,130835
10962,0.000327,172.253.118.0-255,1125,48322,77,130835
10963,0.000329,172.31.40.0-255,66,48388,77,130835
10964,0.00134,172.253.118.0-255,1484,49872,77,130835
10965,0.001347,172.31.40.0-255,66,49938,77,130835
10966,0.001356,172.253.118.0-255,2902,52840,77,130835
10967,0.001358,172.31.40.0-255,66,52906,77,130835
10968,0.001371,172.253.118.0-255,5738,58644,77,130835
10969,0.001373,172.31.40.0-255,66,58710,77,130835
10970,0.001419,172.253.118.0-255,13887,72597,77,130835
10971,0.001422,172.31.40.0-255,66,72663,77,130835
10972,0.001428,172.253.118.0-255,5738,78401,77,130835
10973,0.001431,172.31.40.0-255,66,78467,77,130835
10974,0.001482,172.253.118.0-255,7156,85623,77,130835
10975,0.001485,172.31.40.0-255,66,85689,77,130835
10976,0.001518,172.31.40.0-255,66,85755,77,130835
10977,0.003589,172.253.118.0-255,5738,91493,77,130835
10978,0.003595,172.31.40.0-255,66,91559,77,130835
10979,0.005684,172.253.118.0-255,5738,97297,77,130835
10980,0.005692,172.31.40.0-255,66,97363,77,130835
10981,0.00777,172.253.118.0-255,4320,101683,77,130835
10982,0.007776,172.31.40.0-255,66,101749,77,130835
10983,0.007805,172.253.118.0-255,1484,103233,77,130835
10984,0.00986,172.253.118.0-255,4320,107553,77,130835
10985,0.009868,172.31.40.0-255,66,107619,77,130835
10986,0.011954,172.253.118.0-255,5738,113357,77,130835
10987,0.012009,172.31.40.0-255,66,113423,77,130835
10988,0.014088,172.253.118.0-255,5738,119161,77,130835
10989,0.014096,172.31.40.0-255,66,119227,77,130835
10990,0.016189,172.253.118.0-255,5738,124965,77,130835
10991,0.016199,172.31.40.0-255,66,125031,77,130835
10992,0.018287,172.253.118.0-255,5738,130769,77,130835
10993,0.018295,172.31.40.0-255,66,130835,77,130835
10994,0.0,172.31.40.0-255,105,105,77,459
10995,0.00022,172.31.40.0-255,90,195,77,459
10996,0.000231,172.31.40.0-255,66,261,77,459
10997,0.002482,74.125.68.0-255,66,327,77,459
10998,0.002497,74.125.68.0-255,66,393,77,459
10999,0.002513,172.31.40.0-255,66,459,77,459
11000,0.0,172.217.194.0-255,153,153,77,337743
11001,2.4e-05,172.31.40.0-255,66,219,77,337743
11002,3.1e-05,172.217.194.0-255,1484,1703,77,337743
11003,3.5e-05,172.31.40.0-255,66,1769,77,337743
11004,3.9e-05,172.217.194.0-255,1484,3253,77,337743
11005,4.2e-05,172.31.40.0-255,66,3319,77,337743
11006,5.7e-05,172.217.194.0-255,4320,7639,77,337743
11007,6e-05,172.31.40.0-255,66,7705,77,337743
11008,9.9e-05,172.217.194.0-255,6282,13987,77,337743
11009,0.000103,172.31.40.0-255,66,14053,77,337743
11010,0.000263,172.217.194.0-255,1484,15537,77,337743
11011,0.000268,172.31.40.0-255,66,15603,77,337743
11012,0.000274,172.217.194.0-255,2902,18505,77,337743
11013,0.000276,172.31.40.0-255,66,18571,77,337743
11014,0.000283,172.217.194.0-255,5738,24309,77,337743
11015,0.000293,172.31.40.0-255,66,24375,77,337743
11016,0.000299,172.217.194.0-255,4320,28695,77,337743
11017,0.000301,172.31.40.0-255,66,28761,77,337743
11018,0.000342,172.217.194.0-255,2543,31304,77,337743
11019,0.000346,172.31.40.0-255,66,31370,77,337743
11020,0.000402,172.217.194.0-255,1484,32854,77,337743
11021,0.000405,172.31.40.0-255,66,32920,77,337743
11022,0.000411,172.217.194.0-255,2902,35822,77,337743
11023,0.000413,172.31.40.0-255,66,35888,77,337743
11024,0.000444,172.217.194.0-255,5738,41626,77,337743
11025,0.000451,172.31.40.0-255,66,41692,77,337743
11026,0.000455,172.217.194.0-255,2902,44594,77,337743
11027,0.000457,172.31.40.0-255,66,44660,77,337743
11028,0.000492,172.217.194.0-255,11051,55711,77,337743
11029,0.000496,172.31.40.0-255,66,55777,77,337743
11030,0.000505,172.217.194.0-255,9926,65703,77,337743
11031,0.000508,172.31.40.0-255,66,65769,77,337743
11032,0.00051,172.217.194.0-255,394,66163,77,337743
11033,0.000838,172.217.194.0-255,1484,67647,77,337743
11034,0.000843,172.31.40.0-255,66,67713,77,337743
11035,0.000849,172.217.194.0-255,2902,70615,77,337743
11036,0.000852,172.31.40.0-255,66,70681,77,337743
11037,0.000863,172.217.194.0-255,5738,76419,77,337743
11038,0.000865,172.31.40.0-255,66,76485,77,337743
11039,0.0009,172.217.194.0-255,12828,89313,77,337743
11040,0.000903,172.31.40.0-255,66,89379,77,337743
11041,0.000914,172.217.194.0-255,10692,100071,77,337743
11042,0.000916,172.31.40.0-255,66,100137,77,337743
11043,0.001431,172.217.194.0-255,1484,101621,77,337743
11044,0.001439,172.217.194.0-255,2902,104523,77,337743
11045,0.001443,172.31.40.0-255,66,104589,77,337743
11046,0.001449,172.217.194.0-255,2902,107491,77,337743
11047,0.001451,172.31.40.0-255,66,107557,77,337743
11048,0.001487,172.217.194.0-255,2902,110459,77,337743
11049,0.00149,172.31.40.0-255,66,110525,77,337743
11050,0.001497,172.217.194.0-255,5738,116263,77,337743
11051,0.001499,172.31.40.0-255,66,116329,77,337743
11052,0.00151,172.217.194.0-255,12828,129157,77,337743
11053,0.001514,172.31.40.0-255,66,129223,77,337743
11054,0.001519,172.217.194.0-255,5020,134243,77,337743
11055,0.001522,172.31.40.0-255,66,134309,77,337743
11056,0.001674,172.217.194.0-255,1484,135793,77,337743
11057,0.001682,172.217.194.0-255,2902,138695,77,337743
11058,0.001686,172.31.40.0-255,66,138761,77,337743
11059,0.00169,172.217.194.0-255,1484,140245,77,337743
11060,0.001717,172.217.194.0-255,4320,144565,77,337743
11061,0.001719,172.31.40.0-255,66,144631,77,337743
11062,0.001726,172.217.194.0-255,5738,150369,77,337743
11063,0.001729,172.31.40.0-255,66,150435,77,337743
11064,0.001772,172.217.194.0-255,12828,163263,77,337743
11065,0.001775,172.31.40.0-255,66,163329,77,337743
11066,0.001782,172.217.194.0-255,5020,168349,77,337743
11067,0.001784,172.31.40.0-255,66,168415,77,337743
11068,0.001811,172.217.194.0-255,5738,174153,77,337743
11069,0.001814,172.31.40.0-255,66,174219,77,337743
11070,0.00182,172.217.194.0-255,5738,179957,77,337743
11071,0.001822,172.31.40.0-255,66,180023,77,337743
11072,0.001863,172.217.194.0-255,12828,192851,77,337743
11073,0.001866,172.31.40.0-255,66,192917,77,337743
11074,0.001903,172.217.194.0-255,4320,197237,77,337743
11075,0.001906,172.31.40.0-255,66,197303,77,337743
11076,0.001938,172.217.194.0-255,5020,202323,77,337743
11077,0.001941,172.31.40.0-255,66,202389,77,337743
11078,0.001944,172.217.194.0-255,1484,203873,77,337743
11079,0.001948,172.217.194.0-255,2902,206775,77,337743
11080,0.001951,172.31.40.0-255,66,206841,77,337743
11081,0.001979,172.217.194.0-255,5738,212579,77,337743
11082,0.001982,172.31.40.0-255,66,212645,77,337743
11083,0.001984,172.217.194.0-255,1484,214129,77,337743
11084,0.00199,172.217.194.0-255,4320,218449,77,337743
11085,0.001992,172.31.40.0-255,66,218515,77,337743
11086,0.00202,172.217.194.0-255,4320,222835,77,337743
11087,0.002023,172.31.40.0-255,66,222901,77,337743
11088,0.002052,172.217.194.0-255,11410,234311,77,337743
11089,0.002055,172.31.40.0-255,66,234377,77,337743
11090,0.002075,172.217.194.0-255,2184,236561,77,337743
11091,0.002077,172.31.40.0-255,66,236627,77,337743
11092,0.002134,172.217.194.0-255,1484,238111,77,337743
11093,0.002149,172.217.194.0-255,2902,241013,77,337743
11094,0.002153,172.31.40.0-255,66,241079,77,337743
11095,0.002159,172.217.194.0-255,5738,246817,77,337743
11096,0.002161,172.31.40.0-255,66,246883,77,337743
11097,0.002182,172.217.194.0-255,5738,252621,77,337743
11098,0.002188,172.31.40.0-255,66,252687,77,337743
11099,0.002231,172.217.194.0-255,12828,265515,77,337743
11100,0.002234,172.31.40.0-255,66,265581,77,337743
11101,0.00224,172.217.194.0-255,5020,270601,77,337743
11102,0.002242,172.31.40.0-255,66,270667,77,337743
11103,0.002277,172.217.194.0-255,1484,272151,77,337743
11104,0.002297,172.217.194.0-255,2902,275053,77,337743
11105,0.0023,172.31.40.0-255,66,275119,77,337743
11106,0.002306,172.217.194.0-255,5738,280857,77,337743
11107,0.002308,172.31.40.0-255,66,280923,77,337743
11108,0.002331,172.217.194.0-255,7156,288079,77,337743
11109,0.002334,172.31.40.0-255,66,288145,77,337743
11110,0.002351,172.217.194.0-255,4320,292465,77,337743
11111,0.002353,172.31.40.0-255,66,292531,77,337743
11112,0.002377,172.217.194.0-255,4320,296851,77,337743
11113,0.00238,172.31.40.0-255,66,296917,77,337743
11114,0.004666,172.217.194.0-255,1484,298401,77,337743
11115,0.004686,172.217.194.0-255,1484,299885,77,337743
11116,0.00469,172.31.40.0-255,66,299951,77,337743
11117,0.004707,172.217.194.0-255,2902,302853,77,337743
11118,0.004712,172.31.40.0-255,66,302919,77,337743
11119,0.007036,172.217.194.0-255,5738,308657,77,337743
11120,0.007042,172.31.40.0-255,66,308723,77,337743
11121,0.009372,172.217.194.0-255,5738,314461,77,337743
11122,0.009383,172.31.40.0-255,66,314527,77,337743
11123,0.011717,172.217.194.0-255,5738,320265,77,337743
11124,0.011732,172.31.40.0-255,66,320331,77,337743
11125,0.014024,172.217.194.0-255,5738,326069,77,337743
11126,0.014031,172.31.40.0-255,66,326135,77,337743
11127,0.016344,172.217.194.0-255,5738,331873,77,337743
11128,0.016352,172.31.40.0-255,66,331939,77,337743
11129,0.018674,172.217.194.0-255,5738,337677,77,337743
11130,0.018683,172.31.40.0-255,66,337743,77,337743
11131,0.0,172.217.194.0-255,296,296,77,358744
11132,4.7e-05,172.31.40.0-255,66,362,77,358744
11133,5.3e-05,172.217.194.0-255,1484,1846,77,358744
11134,5.9e-05,172.31.40.0-255,66,1912,77,358744
11135,6.5e-05,172.217.194.0-255,4320,6232,77,358744
11136,7.6e-05,172.31.40.0-255,66,6298,77,358744
11137,8.2e-05,172.217.194.0-255,5738,12036,77,358744
11138,8.5e-05,172.31.40.0-255,66,12102,77,358744
11139,8.9e-05,172.217.194.0-255,1771,13873,77,358744
11140,9.2e-05,172.31.40.0-255,66,13939,77,358744
11141,0.000146,172.217.194.0-255,1484,15423,77,358744
11142,0.000149,172.31.40.0-255,66,15489,77,358744
11143,0.000169,172.217.194.0-255,2902,18391,77,358744
11144,0.000172,172.31.40.0-255,66,18457,77,358744
11145,0.000199,172.217.194.0-255,4320,22777,77,358744
11146,0.000203,172.31.40.0-255,66,22843,77,358744
11147,0.000206,172.217.194.0-255,1484,24327,77,358744
11148,0.000208,172.31.40.0-255,66,24393,77,358744
11149,0.000236,172.217.194.0-255,4320,28713,77,358744
11150,0.000239,172.31.40.0-255,66,28779,77,358744
11151,0.00025,172.217.194.0-255,2543,31322,77,358744
11152,0.000253,172.31.40.0-255,66,31388,77,358744
11153,0.00035,172.217.194.0-255,1484,32872,77,358744
11154,0.000356,172.31.40.0-255,66,32938,77,358744
11155,0.000386,172.217.194.0-255,2902,35840,77,358744
11156,0.00039,172.31.40.0-255,66,35906,77,358744
11157,0.000394,172.217.194.0-255,2902,38808,77,358744
11158,0.000396,172.31.40.0-255,66,38874,77,358744
11159,0.000445,172.217.194.0-255,2902,41776,77,358744
11160,0.000449,172.31.40.0-255,66,41842,77,358744
11161,0.000456,172.217.194.0-255,6797,48639,77,358744
11162,0.000458,172.31.40.0-255,66,48705,77,358744
11163,0.000472,172.217.194.0-255,9992,58697,77,358744
11164,0.000476,172.31.40.0-255,66,58763,77,358744
11165,0.000509,172.217.194.0-255,7047,65810,77,358744
11166,0.000513,172.31.40.0-255,66,65876,77,358744
11167,0.000541,172.217.194.0-255,119,65995,77,358744
11168,0.000561,172.217.194.0-255,384,66379,77,358744
11169,0.000761,172.217.194.0-255,1484,67863,77,358744
11170,0.000765,172.31.40.0-255,66,67929,77,358744
11171,0.000779,172.217.194.0-255,2902,70831,77,358744
11172,0.000783,172.31.40.0-255,66,70897,77,358744
11173,0.000809,172.217.194.0-255,1484,72381,77,358744
11174,0.000812,172.217.194.0-255,1484,73865,77,358744
11175,0.000815,172.31.40.0-255,66,73931,77,358744
11176,0.000843,172.217.194.0-255,4320,78251,77,358744
11177,0.000846,172.31.40.0-255,66,78317,77,358744
11178,0.000852,172.217.194.0-255,5738,84055,77,358744
11179,0.000854,172.31.40.0-255,66,84121,77,358744
11180,0.000889,172.217.194.0-255,7156,91277,77,358744
11181,0.000892,172.31.40.0-255,66,91343,77,358744
11182,0.000931,172.217.194.0-255,8574,99917,77,358744
11183,0.000934,172.31.40.0-255,66,99983,77,358744
11184,0.000958,172.217.194.0-255,766,100749,77,358744
11185,0.001164,172.217.194.0-255,1484,102233,77,358744
11186,0.001167,172.31.40.0-255,66,102299,77,358744
11187,0.001198,172.217.194.0-255,2902,105201,77,358744
11188,0.001201,172.31.40.0-255,66,105267,77,358744
11189,0.001207,172.217.194.0-255,5738,111005,77,358744
11190,0.001208,172.31.40.0-255,66,111071,77,358744
11191,0.001212,172.217.194.0-255,2902,113973,77,358744
11192,0.001219,172.31.40.0-255,66,114039,77,358744
11193,0.001223,172.217.194.0-255,2902,116941,77,358744
11194,0.001224,172.31.40.0-255,66,117007,77,358744
11195,0.001262,172.217.194.0-255,7156,124163,77,358744
11196,0.001266,172.31.40.0-255,66,124229,77,358744
11197,0.001303,172.217.194.0-255,7156,131385,77,358744
11198,0.001306,172.31.40.0-255,66,131451,77,358744
11199,0.001324,172.217.194.0-255,2902,134353,77,358744
11200,0.001327,172.31.40.0-255,66,134419,77,358744
11201,0.001329,172.217.194.0-255,766,135185,77,358744
11202,0.001473,172.31.40.0-255,66,135251,77,358744
11203,0.001557,172.217.194.0-255,1484,136735,77,358744
11204,0.001565,172.217.194.0-255,2902,139637,77,358744
11205,0.001568,172.31.40.0-255,66,139703,77,358744
11206,0.001571,172.217.194.0-255,1484,141187,77,358744
11207,0.0016,172.217.194.0-255,4320,145507,77,358744
11208,0.001602,172.31.40.0-255,66,145573,77,358744
11209,0.00161,172.217.194.0-255,8574,154147,77,358744
11210,0.001611,172.31.40.0-255,66,154213,77,358744
11211,0.00164,172.217.194.0-255,4320,158533,77,358744
11212,0.001643,172.31.40.0-255,66,158599,77,358744
11213,0.001649,172.217.194.0-255,7156,165755,77,358744
11214,0.001651,172.31.40.0-255,66,165821,77,358744
11215,0.001674,172.217.194.0-255,3602,169423,77,358744
11216,0.001677,172.31.40.0-255,66,169489,77,358744
11217,0.001762,172.217.194.0-255,1484,170973,77,358744
11218,0.001768,172.217.194.0-255,2902,173875,77,358744
11219,0.001771,172.31.40.0-255,66,173941,77,358744
11220,0.00178,172.217.194.0-255,5738,179679,77,358744
11221,0.001782,172.31.40.0-255,66,179745,77,358744
11222,0.001803,172.217.194.0-255,4320,184065,77,358744
11223,0.001807,172.31.40.0-255,66,184131,77,358744
11224,0.001843,172.217.194.0-255,8574,192705,77,358744
11225,0.001846,172.31.40.0-255,66,192771,77,358744
11226,0.001858,172.217.194.0-255,10692,203463,77,358744
11227,0.00186,172.31.40.0-255,66,203529,77,358744
11228,0.001869,172.217.194.0-255,11410,214939,77,358744
11229,0.001872,172.31.40.0-255,66,215005,77,358744
11230,0.001894,172.217.194.0-255,2902,217907,77,358744
11231,0.001897,172.31.40.0-255,66,217973,77,358744
11232,0.001938,172.31.40.0-255,66,218039,77,358744
11233,0.001945,172.217.194.0-255,7856,225895,77,358744
11234,0.001948,172.31.40.0-255,66,225961,77,358744
11235,0.00195,172.217.194.0-255,1484,227445,77,358744
11236,0.001986,172.217.194.0-255,7156,234601,77,358744
11237,0.00199,172.31.40.0-255,66,234667,77,358744
11238,0.001999,172.217.194.0-255,8574,243241,77,358744
11239,0.002001,172.31.40.0-255,66,243307,77,358744
11240,0.002034,172.217.194.0-255,8574,251881,77,358744
11241,0.002042,172.31.40.0-255,66,251947,77,358744
11242,0.00205,172.217.194.0-255,8574,260521,77,358744
11243,0.002052,172.31.40.0-255,66,260587,77,358744
11244,0.002102,172.217.194.0-255,9274,269861,77,358744
11245,0.002106,172.31.40.0-255,66,269927,77,358744
11246,0.002123,172.31.40.0-255,66,269993,77,358744
11247,0.002137,172.217.194.0-255,11410,281403,77,358744
11248,0.002141,172.31.40.0-255,66,281469,77,358744
11249,0.002172,172.217.194.0-255,2902,284371,77,358744
11250,0.002175,172.31.40.0-255,66,284437,77,358744
11251,0.002215,172.31.40.0-255,66,284503,77,358744
11252,0.002217,172.217.194.0-255,1484,285987,77,358744
11253,0.002221,172.217.194.0-255,2902,288889,77,358744
11254,0.002223,172.31.40.0-255,66,288955,77,358744
11255,0.002228,172.217.194.0-255,5738,294693,77,358744
11256,0.00223,172.31.40.0-255,66,294759,77,358744
11257,0.002234,172.217.194.0-255,4320,299079,77,358744
11258,0.002236,172.31.40.0-255,66,299145,77,358744
11259,0.002241,172.217.194.0-255,4320,303465,77,358744
11260,0.002243,172.31.40.0-255,66,303531,77,358744
11261,0.002281,172.217.194.0-255,7156,310687,77,358744
11262,0.002285,172.31.40.0-255,66,310753,77,358744
11263,0.002293,172.217.194.0-255,7856,318609,77,358744
11264,0.002295,172.31.40.0-255,66,318675,77,358744
11265,0.002415,172.217.194.0-255,1484,320159,77,358744
11266,0.002421,172.217.194.0-255,2902,323061,77,358744
11267,0.002427,172.31.40.0-255,66,323127,77,358744
11268,0.002456,172.217.194.0-255,5738,328865,77,358744
11269,0.002459,172.31.40.0-255,66,328931,77,358744
11270,0.002465,172.217.194.0-255,5738,334669,77,358744
11271,0.002467,172.31.40.0-255,66,334735,77,358744
11272,0.002489,172.217.194.0-255,7156,341891,77,358744
11273,0.002492,172.31.40.0-255,66,341957,77,358744
11274,0.002499,172.217.194.0-255,8574,350531,77,358744
11275,0.002501,172.31.40.0-255,66,350597,77,358744
11276,0.002538,172.217.194.0-255,7739,358336,77,358744
11277,0.002542,172.31.40.0-255,66,358402,77,358744
11278,0.002564,172.217.194.0-255,105,358507,77,358744
11279,0.00419,172.31.40.0-255,66,358573,77,358744
11280,0.004226,172.31.40.0-255,105,358678,77,358744
11281,0.006845,172.217.194.0-255,66,358744,77,358744
11282,0.0,74.125.68.0-255,150,150,77,256704
11283,2.2e-05,172.31.40.0-255,66,216,77,256704
11284,3.2e-05,74.125.68.0-255,1484,1700,77,256704
11285,3.6e-05,172.31.40.0-255,66,1766,77,256704
11286,4.2e-05,74.125.68.0-255,2902,4668,77,256704
11287,4.6e-05,172.31.40.0-255,66,4734,77,256704
11288,4.9e-05,74.125.68.0-255,1484,6218,77,256704
11289,5.1e-05,172.31.40.0-255,66,6284,77,256704
11290,5.6e-05,74.125.68.0-255,2902,9186,77,256704
11291,5.9e-05,172.31.40.0-255,66,9252,77,256704
11292,8.6e-05,74.125.68.0-255,4938,14190,77,256704
11293,9e-05,172.31.40.0-255,66,14256,77,256704
11294,0.000128,74.125.68.0-255,1484,15740,77,256704
11295,0.000131,172.31.40.0-255,66,15806,77,256704
11296,0.000135,74.125.68.0-255,2902,18708,77,256704
11297,0.000137,172.31.40.0-255,66,18774,77,256704
11298,0.000153,74.125.68.0-255,2902,21676,77,256704
11299,0.000155,172.31.40.0-255,66,21742,77,256704
11300,0.000175,74.125.68.0-255,2902,24644,77,256704
11301,0.000178,172.31.40.0-255,66,24710,77,256704
11302,0.000186,74.125.68.0-255,6797,31507,77,256704
11303,0.000188,172.31.40.0-255,66,31573,77,256704
11304,0.000239,74.125.68.0-255,1484,33057,77,256704
11305,0.000242,172.31.40.0-255,66,33123,77,256704
11306,0.000247,74.125.68.0-255,2902,36025,77,256704
11307,0.000249,172.31.40.0-255,66,36091,77,256704
11308,0.000266,74.125.68.0-255,5738,41829,77,256704
11309,0.00027,172.31.40.0-255,66,41895,77,256704
11310,0.000303,74.125.68.0-255,5738,47633,77,256704
11311,0.000306,172.31.40.0-255,66,47699,77,256704
11312,0.000366,74.125.68.0-255,1125,48824,77,256704
11313,0.000369,172.31.40.0-255,66,48890,77,256704
11314,0.000883,74.125.68.0-255,1484,50374,77,256704
11315,0.000889,74.125.68.0-255,1484,51858,77,256704
11316,0.000892,172.31.40.0-255,66,51924,77,256704
11317,0.000898,74.125.68.0-255,2902,54826,77,256704
11318,0.0009,172.31.40.0-255,66,54892,77,256704
11319,0.000914,74.125.68.0-255,4320,59212,77,256704
11320,0.000916,172.31.40.0-255,66,59278,77,256704
11321,0.00093,74.125.68.0-255,1484,60762,77,256704
11322,0.000933,74.125.68.0-255,1484,62246,77,256704
11323,0.000936,172.31.40.0-255,66,62312,77,256704
11324,0.000949,74.125.68.0-255,3961,66273,77,256704
11325,0.000952,172.31.40.0-255,66,66339,77,256704
11326,0.000999,74.125.68.0-255,1484,67823,77,256704
11327,0.001015,74.125.68.0-255,2902,70725,77,256704
11328,0.001017,172.31.40.0-255,66,70791,77,256704
11329,0.001044,74.125.68.0-255,5738,76529,77,256704
11330,0.001046,172.31.40.0-255,66,76595,77,256704
11331,0.001058,74.125.68.0-255,1484,78079,77,256704
11332,0.001062,74.125.68.0-255,2902,80981,77,256704
11333,0.001064,172.31.40.0-255,66,81047,77,256704
11334,0.001099,74.125.68.0-255,6797,87844,77,256704
11335,0.001101,172.31.40.0-255,66,87910,77,256704
11336,0.001108,74.125.68.0-255,7156,95066,77,256704
11337,0.00111,172.31.40.0-255,66,95132,77,256704
11338,0.001142,74.125.68.0-255,5379,100511,77,256704
11339,0.001146,172.31.40.0-255,66,100577,77,256704
11340,0.001169,74.125.68.0-255,649,101226,77,256704
11341,0.001369,74.125.68.0-255,1484,102710,77,256704
11342,0.001373,172.31.40.0-255,66,102776,77,256704
11343,0.001378,74.125.68.0-255,2902,105678,77,256704
11344,0.00138,172.31.40.0-255,66,105744,77,256704
11345,0.001392,74.125.68.0-255,1484,107228,77,256704
11346,0.001413,74.125.68.0-255,1484,108712,77,256704
11347,0.001416,172.31.40.0-255,66,108778,77,256704
11348,0.001422,74.125.68.0-255,4320,113098,77,256704
11349,0.001424,172.31.40.0-255,66,113164,77,256704
11350,0.00143,74.125.68.0-255,5738,118902,77,256704
11351,0.001432,172.31.40.0-255,66,118968,77,256704
11352,0.001445,74.125.68.0-255,2902,121870,77,256704
11353,0.001447,172.31.40.0-255,66,121936,77,256704
11354,0.001455,74.125.68.0-255,7156,129092,77,256704
11355,0.001458,172.31.40.0-255,66,129158,77,256704
11356,0.001502,74.125.68.0-255,6438,135596,77,256704
11357,0.001505,172.31.40.0-255,66,135662,77,256704
11358,0.001538,74.125.68.0-255,4320,139982,77,256704
11359,0.001542,172.31.40.0-255,66,140048,77,256704
11360,0.001561,74.125.68.0-255,2902,142950,77,256704
11361,0.001563,172.31.40.0-255,66,143016,77,256704
11362,0.001566,74.125.68.0-255,1484,144500,77,256704
11363,0.001584,74.125.68.0-255,2902,147402,77,256704
11364,0.001588,172.31.40.0-255,66,147468,77,256704
11365,0.001599,74.125.68.0-255,5738,153206,77,256704
11366,0.001602,172.31.40.0-255,66,153272,77,256704
11367,0.001606,74.125.68.0-255,2902,156174,77,256704
11368,0.001608,172.31.40.0-255,66,156240,77,256704
11369,0.001625,74.125.68.0-255,1484,157724,77,256704
11370,0.001646,74.125.68.0-255,8574,166298,77,256704
11371,0.001649,172.31.40.0-255,66,166364,77,256704
11372,0.001654,74.125.68.0-255,3602,169966,77,256704
11373,0.001656,172.31.40.0-255,66,170032,77,256704
11374,0.001702,74.125.68.0-255,1484,171516,77,256704
11375,0.00172,74.125.68.0-255,2902,174418,77,256704
11376,0.001722,172.31.40.0-255,66,174484,77,256704
11377,0.001727,74.125.68.0-255,2902,177386,77,256704
11378,0.001729,172.31.40.0-255,66,177452,77,256704
11379,0.001741,74.125.68.0-255,2902,180354,77,256704
11380,0.001743,172.31.40.0-255,66,180420,77,256704
11381,0.001761,74.125.68.0-255,2902,183322,77,256704
11382,0.001763,172.31.40.0-255,66,183388,77,256704
11383,0.00179,74.125.68.0-255,7156,190544,77,256704
11384,0.001793,172.31.40.0-255,66,190610,77,256704
11385,0.001803,74.125.68.0-255,9992,200602,77,256704
11386,0.001813,172.31.40.0-255,66,200668,77,256704
11387,0.001824,74.125.68.0-255,1484,202152,77,256704
11388,0.001828,74.125.68.0-255,2184,204336,77,256704
11389,0.001849,172.31.40.0-255,66,204402,77,256704
11390,0.003784,74.125.68.0-255,1484,205886,77,256704
11391,0.003821,74.125.68.0-255,4320,210206,77,256704
11392,0.003826,172.31.40.0-255,66,210272,77,256704
11393,0.005799,74.125.68.0-255,5738,216010,77,256704
11394,0.005803,172.31.40.0-255,66,216076,77,256704
11395,0.007784,74.125.68.0-255,5738,221814,77,256704
11396,0.007791,172.31.40.0-255,66,221880,77,256704
11397,0.009801,74.125.68.0-255,5738,227618,77,256704
11398,0.009808,172.31.40.0-255,66,227684,77,256704
11399,0.011789,74.125.68.0-255,5738,233422,77,256704
11400,0.011799,172.31.40.0-255,66,233488,77,256704
11401,0.013785,74.125.68.0-255,5738,239226,77,256704
11402,0.013792,172.31.40.0-255,66,239292,77,256704
11403,0.015777,74.125.68.0-255,5738,245030,77,256704
11404,0.015785,172.31.40.0-255,66,245096,77,256704
11405,0.017766,74.125.68.0-255,5738,250834,77,256704
11406,0.017775,172.31.40.0-255,66,250900,77,256704
11407,0.019766,74.125.68.0-255,5738,256638,77,256704
11408,0.019773,172.31.40.0-255,66,256704,77,256704
11409,0.0,172.217.27.0-255,159,159,77,198348
11410,1.5e-05,172.31.40.0-255,66,225,77,198348
11411,2.1e-05,172.217.27.0-255,1484,1709,77,198348
11412,2.6e-05,172.31.40.0-255,66,1775,77,198348
11413,3.3e-05,172.217.27.0-255,2902,4677,77,198348
11414,3.7e-05,172.31.40.0-255,66,4743,77,198348
11415,4.4e-05,172.217.27.0-255,7156,11899,77,198348
11416,4.7e-05,172.31.40.0-255,66,11965,77,198348
11417,5.1e-05,172.217.27.0-255,2039,14004,77,198348
11418,5.5e-05,172.31.40.0-255,66,14070,77,198348
11419,5.9e-05,172.217.27.0-255,2902,16972,77,198348
11420,6.3e-05,172.31.40.0-255,66,17038,77,198348
11421,6.9e-05,172.217.27.0-255,5738,22776,77,198348
11422,7.2e-05,172.31.40.0-255,66,22842,77,198348
11423,9.9e-05,172.217.27.0-255,1484,24326,77,198348
11424,0.000102,172.31.40.0-255,66,24392,77,198348
11425,0.000109,172.217.27.0-255,6797,31189,77,198348
11426,0.000112,172.31.40.0-255,66,31255,77,198348
11427,0.000217,172.217.27.0-255,1484,32739,77,198348
11428,0.000221,172.31.40.0-255,66,32805,77,198348
11429,0.000226,172.217.27.0-255,2902,35707,77,198348
11430,0.000228,172.31.40.0-255,66,35773,77,198348
11431,0.000235,172.217.27.0-255,5738,41511,77,198348
11432,0.000238,172.31.40.0-255,66,41577,77,198348
11433,0.000242,172.217.27.0-255,2902,44479,77,198348
11434,0.000245,172.31.40.0-255,66,44545,77,198348
11435,0.000279,172.217.27.0-255,5379,49924,77,198348
11436,0.000282,172.31.40.0-255,66,49990,77,198348
11437,0.000291,172.217.27.0-255,8574,58564,77,198348
11438,0.000293,172.31.40.0-255,66,58630,77,198348
11439,0.000296,172.217.27.0-255,1484,60114,77,198348
11440,0.000298,172.31.40.0-255,66,60180,77,198348
11441,0.000315,172.217.27.0-255,5648,65828,77,198348
11442,0.000318,172.31.40.0-255,66,65894,77,198348
11443,0.000626,172.217.27.0-255,134,66028,77,198348
11444,0.000785,172.217.27.0-255,1484,67512,77,198348
11445,0.00079,172.31.40.0-255,66,67578,77,198348
11446,0.000796,172.217.27.0-255,2902,70480,77,198348
11447,0.000798,172.31.40.0-255,66,70546,77,198348
11448,0.000803,172.217.27.0-255,2902,73448,77,198348
11449,0.000805,172.31.40.0-255,66,73514,77,198348
11450,0.000822,172.217.27.0-255,2902,76416,77,198348
11451,0.000824,172.31.40.0-255,66,76482,77,198348
11452,0.00083,172.217.27.0-255,4320,80802,77,198348
11453,0.000832,172.31.40.0-255,66,80868,77,198348
11454,0.000863,172.217.27.0-255,2543,83411,77,198348
11455,0.000866,172.31.40.0-255,66,83477,77,198348
11456,0.000873,172.217.27.0-255,7156,90633,77,198348
11457,0.000875,172.31.40.0-255,66,90699,77,198348
11458,0.000884,172.217.27.0-255,9633,100332,77,198348
11459,0.000886,172.31.40.0-255,66,100398,77,198348
11460,0.001506,172.217.27.0-255,1484,101882,77,198348
11461,0.001515,172.217.27.0-255,2902,104784,77,198348
11462,0.001519,172.31.40.0-255,66,104850,77,198348
11463,0.001526,172.217.27.0-255,4320,109170,77,198348
11464,0.001529,172.31.40.0-255,66,109236,77,198348
11465,0.001536,172.217.27.0-255,7156,116392,77,198348
11466,0.001539,172.31.40.0-255,66,116458,77,198348
11467,0.001566,172.217.27.0-255,1484,117942,77,198348
11468,0.001576,172.217.27.0-255,11410,129352,77,198348
11469,0.001579,172.31.40.0-255,66,129418,77,198348
11470,0.001604,172.217.27.0-255,5020,134438,77,198348
11471,0.001607,172.31.40.0-255,66,134504,77,198348
11472,0.00324,172.217.27.0-255,5738,140242,77,198348
11473,0.003244,172.31.40.0-255,66,140308,77,198348
11474,0.00487,172.217.27.0-255,5738,146046,77,198348
11475,0.004877,172.31.40.0-255,66,146112,77,198348
11476,0.00651,172.217.27.0-255,5738,151850,77,198348
11477,0.006516,172.31.40.0-255,66,151916,77,198348
11478,0.008147,172.217.27.0-255,5738,157654,77,198348
11479,0.008153,172.31.40.0-255,66,157720,77,198348
11480,0.009781,172.217.27.0-255,5738,163458,77,198348
11481,0.009787,172.31.40.0-255,66,163524,77,198348
11482,0.011416,172.217.27.0-255,5738,169262,77,198348
11483,0.011423,172.31.40.0-255,66,169328,77,198348
11484,0.013072,172.217.27.0-255,5738,175066,77,198348
11485,0.013079,172.31.40.0-255,66,175132,77,198348
11486,0.01475,172.217.27.0-255,5738,180870,77,198348
11487,0.014757,172.31.40.0-255,66,180936,77,198348
11488,0.016395,172.217.27.0-255,5738,186674,77,198348
11489,0.016404,172.31.40.0-255,66,186740,77,198348
11490,0.018039,172.217.27.0-255,5738,192478,77,198348
11491,0.018047,172.31.40.0-255,66,192544,77,198348
11492,0.019684,172.217.27.0-255,5738,198282,77,198348
11493,0.01969,172.31.40.0-255,66,198348,77,198348
11494,0.0,74.125.24.0-255,153,153,77,235226
11495,3.5e-05,172.31.40.0-255,66,219,77,235226
11496,6.8e-05,74.125.24.0-255,1484,1703,77,235226
11497,7.3e-05,172.31.40.0-255,66,1769,77,235226
11498,7.8e-05,74.125.24.0-255,2902,4671,77,235226
11499,8.1e-05,172.31.40.0-255,66,4737,77,235226
11500,8.8e-05,74.125.24.0-255,4320,9057,77,235226
11501,9.1e-05,172.31.40.0-255,66,9123,77,235226
11502,0.000122,74.125.24.0-255,1484,10607,77,235226
11503,0.000125,172.31.40.0-255,66,10673,77,235226
11504,0.000131,74.125.24.0-255,3446,14119,77,235226
11505,0.000134,172.31.40.0-255,66,14185,77,235226
11506,0.00026,74.125.24.0-255,1484,15669,77,235226
11507,0.000264,172.31.40.0-255,66,15735,77,235226
11508,0.00027,74.125.24.0-255,2902,18637,77,235226
11509,0.000272,172.31.40.0-255,66,18703,77,235226
11510,0.000275,74.125.24.0-255,1484,20187,77,235226
11511,0.000284,172.31.40.0-255,66,20253,77,235226
11512,0.000315,74.125.24.0-255,4320,24573,77,235226
11513,0.00032,172.31.40.0-255,66,24639,77,235226
11514,0.000325,74.125.24.0-255,4320,28959,77,235226
11515,0.000327,172.31.40.0-255,66,29025,77,235226
11516,0.000369,74.125.24.0-255,9633,38658,77,235226
11517,0.000375,172.31.40.0-255,66,38724,77,235226
11518,0.00038,74.125.24.0-255,4320,43044,77,235226
11519,0.000382,172.31.40.0-255,66,43110,77,235226
11520,0.000408,74.125.24.0-255,5379,48489,77,235226
11521,0.000412,172.31.40.0-255,66,48555,77,235226
11522,0.000444,74.125.24.0-255,5738,54293,77,235226
11523,0.000447,172.31.40.0-255,66,54359,77,235226
11524,0.000478,74.125.24.0-255,4320,58679,77,235226
11525,0.000481,172.31.40.0-255,66,58745,77,235226
11526,0.000489,74.125.24.0-255,6797,65542,77,235226
11527,0.000492,172.31.40.0-255,66,65608,77,235226
11528,0.000495,74.125.24.0-255,403,66011,77,235226
11529,0.000784,74.125.24.0-255,341,66352,77,235226
11530,0.000819,172.31.40.0-255,66,66418,77,235226
11531,0.000892,74.125.24.0-255,1484,67902,77,235226
11532,0.000901,74.125.24.0-255,2902,70804,77,235226
11533,0.000904,172.31.40.0-255,66,70870,77,235226
11534,0.000911,74.125.24.0-255,5738,76608,77,235226
11535,0.000913,172.31.40.0-255,66,76674,77,235226
11536,0.000944,74.125.24.0-255,6797,83471,77,235226
11537,0.000947,172.31.40.0-255,66,83537,77,235226
11538,0.000979,74.125.24.0-255,5738,89275,77,235226
11539,0.000983,172.31.40.0-255,66,89341,77,235226
11540,0.001012,74.125.24.0-255,8574,97915,77,235226
11541,0.001015,172.31.40.0-255,66,97981,77,235226
11542,0.001019,74.125.24.0-255,2543,100524,77,235226
11543,0.001022,172.31.40.0-255,66,100590,77,235226
11544,0.001913,74.125.24.0-255,1484,102074,77,235226
11545,0.001921,74.125.24.0-255,2902,104976,77,235226
11546,0.001925,172.31.40.0-255,66,105042,77,235226
11547,0.001954,74.125.24.0-255,5738,110780,77,235226
11548,0.001957,172.31.40.0-255,66,110846,77,235226
11549,0.001962,74.125.24.0-255,4320,115166,77,235226
11550,0.001964,172.31.40.0-255,66,115232,77,235226
11551,0.001981,74.125.24.0-255,1484,116716,77,235226
11552,0.002015,74.125.24.0-255,9992,126708,77,235226
11553,0.002018,172.31.40.0-255,66,126774,77,235226
11554,0.002053,74.125.24.0-255,4320,131094,77,235226
11555,0.002055,172.31.40.0-255,66,131160,77,235226
11556,0.002079,74.125.24.0-255,3602,134762,77,235226
11557,0.002081,172.31.40.0-255,66,134828,77,235226
11558,0.002278,74.125.24.0-255,1484,136312,77,235226
11559,0.002296,74.125.24.0-255,2902,139214,77,235226
11560,0.002299,172.31.40.0-255,66,139280,77,235226
11561,0.00232,74.125.24.0-255,1484,140764,77,235226
11562,0.002323,74.125.24.0-255,2902,143666,77,235226
11563,0.002325,172.31.40.0-255,66,143732,77,235226
11564,0.002328,74.125.24.0-255,1484,145216,77,235226
11565,0.002349,74.125.24.0-255,4320,149536,77,235226
11566,0.002351,172.31.40.0-255,66,149602,77,235226
11567,0.002354,74.125.24.0-255,1484,151086,77,235226
11568,0.00239,74.125.24.0-255,11410,162496,77,235226
11569,0.002393,172.31.40.0-255,66,162562,77,235226
11570,0.002413,74.125.24.0-255,7156,169718,77,235226
11571,0.002416,172.31.40.0-255,66,169784,77,235226
11572,0.002452,74.125.24.0-255,13528,183312,77,235226
11573,0.002454,172.31.40.0-255,66,183378,77,235226
11574,0.002469,172.31.40.0-255,66,183444,77,235226
11575,0.002472,74.125.24.0-255,2184,185628,77,235226
11576,0.002474,172.31.40.0-255,66,185694,77,235226
11577,0.002511,74.125.24.0-255,2902,188596,77,235226
11578,0.002513,172.31.40.0-255,66,188662,77,235226
11579,0.002519,74.125.24.0-255,4320,192982,77,235226
11580,0.002521,172.31.40.0-255,66,193048,77,235226
11581,0.002544,74.125.24.0-255,1484,194532,77,235226
11582,0.002551,74.125.24.0-255,7156,201688,77,235226
11583,0.002553,172.31.40.0-255,66,201754,77,235226
11584,0.005069,74.125.24.0-255,4320,206074,77,235226
11585,0.005072,172.31.40.0-255,66,206140,77,235226
11586,0.005088,74.125.24.0-255,1484,207624,77,235226
11587,0.007558,74.125.24.0-255,4320,211944,77,235226
11588,0.007566,172.31.40.0-255,66,212010,77,235226
11589,0.010197,74.125.24.0-255,5738,217748,77,235226
11590,0.010273,172.31.40.0-255,66,217814,77,235226
11591,0.012815,74.125.24.0-255,5738,223552,77,235226
11592,0.012825,172.31.40.0-255,66,223618,77,235226
11593,0.015329,74.125.24.0-255,5738,229356,77,235226
11594,0.015338,172.31.40.0-255,66,229422,77,235226
11595,0.017857,74.125.24.0-255,5738,235160,77,235226
11596,0.017867,172.31.40.0-255,66,235226,77,235226
11597,0.0,172.217.194.0-255,153,153,77,268941
11598,1.6e-05,172.31.40.0-255,66,219,77,268941
11599,2.3e-05,172.217.194.0-255,1484,1703,77,268941
11600,2.7e-05,172.31.40.0-255,66,1769,77,268941
11601,3.2e-05,172.217.194.0-255,2902,4671,77,268941
11602,3.5e-05,172.31.40.0-255,66,4737,77,268941
11603,4.6e-05,172.217.194.0-255,4320,9057,77,268941
11604,4.9e-05,172.31.40.0-255,66,9123,77,268941
11605,9e-05,172.217.194.0-255,7156,16279,77,268941
11606,9.2e-05,172.31.40.0-255,66,16345,77,268941
11607,0.000117,172.217.194.0-255,2166,18511,77,268941
11608,0.000119,172.31.40.0-255,66,18577,77,268941
11609,0.000125,172.217.194.0-255,5738,24315,77,268941
11610,0.000127,172.31.40.0-255,66,24381,77,268941
11611,0.000157,172.217.194.0-255,6797,31178,77,268941
11612,0.00016,172.31.40.0-255,66,31244,77,268941
11613,0.000201,172.217.194.0-255,1484,32728,77,268941
11614,0.000203,172.31.40.0-255,66,32794,77,268941
11615,0.000226,172.217.194.0-255,2902,35696,77,268941
11616,0.000228,172.31.40.0-255,66,35762,77,268941
11617,0.000234,172.217.194.0-255,5738,41500,77,268941
11618,0.000236,172.31.40.0-255,66,41566,77,268941
11619,0.00028,172.217.194.0-255,6797,48363,77,268941
11620,0.000282,172.31.40.0-255,66,48429,77,268941
11621,0.000544,172.217.194.0-255,1484,49913,77,268941
11622,0.000549,172.31.40.0-255,66,49979,77,268941
11623,0.000557,172.217.194.0-255,2902,52881,77,268941
11624,0.000559,172.31.40.0-255,66,52947,77,268941
11625,0.000571,172.217.194.0-255,5738,58685,77,268941
11626,0.000574,172.31.40.0-255,66,58751,77,268941
11627,0.00061,172.217.194.0-255,8574,67325,77,268941
11628,0.000614,172.31.40.0-255,66,67391,77,268941
11629,0.000642,172.217.194.0-255,5379,72770,77,268941
11630,0.000645,172.31.40.0-255,66,72836,77,268941
11631,0.000682,172.217.194.0-255,8574,81410,77,268941
11632,0.000685,172.31.40.0-255,66,81476,77,268941
11633,0.00072,172.217.194.0-255,5738,87214,77,268941
11634,0.000724,172.31.40.0-255,66,87280,77,268941
11635,0.000731,172.217.194.0-255,7156,94436,77,268941
11636,0.000733,172.31.40.0-255,66,94502,77,268941
11637,0.000744,172.217.194.0-255,5020,99522,77,268941
11638,0.000746,172.31.40.0-255,66,99588,77,268941
11639,0.00078,172.217.194.0-255,360,99948,77,268941
11640,0.000827,172.217.194.0-255,1484,101432,77,268941
11641,0.000831,172.31.40.0-255,66,101498,77,268941
11642,0.000836,172.217.194.0-255,2902,104400,77,268941
11643,0.000839,172.31.40.0-255,66,104466,77,268941
11644,0.000869,172.217.194.0-255,5738,110204,77,268941
11645,0.000873,172.31.40.0-255,66,110270,77,268941
11646,0.000903,172.217.194.0-255,6416,116686,77,268941
11647,0.000906,172.31.40.0-255,66,116752,77,268941
11648,0.001024,172.217.194.0-255,1484,118236,77,268941
11649,0.00103,172.217.194.0-255,2902,121138,77,268941
11650,0.001033,172.31.40.0-255,66,121204,77,268941
11651,0.00104,172.217.194.0-255,5738,126942,77,268941
11652,0.001042,172.31.40.0-255,66,127008,77,268941
11653,0.001059,172.217.194.0-255,12828,139836,77,268941
11654,0.001061,172.31.40.0-255,66,139902,77,268941
11655,0.001071,172.217.194.0-255,10692,150594,77,268941
11656,0.001075,172.31.40.0-255,66,150660,77,268941
11657,0.001104,172.217.194.0-255,1484,152144,77,268941
11658,0.001148,172.31.40.0-255,66,152210,77,268941
11659,0.001169,172.217.194.0-255,1484,153694,77,268941
11660,0.001198,172.31.40.0-255,66,153760,77,268941
11661,0.001201,172.217.194.0-255,1484,155244,77,268941
11662,0.001303,172.217.194.0-255,1823,157067,77,268941
11663,0.001307,172.31.40.0-255,66,157133,77,268941
11664,0.00131,172.31.40.0-255,66,157199,77,268941
11665,0.001334,172.217.194.0-255,1484,158683,77,268941
11666,0.001355,172.217.194.0-255,2902,161585,77,268941
11667,0.001358,172.31.40.0-255,66,161651,77,268941
11668,0.001365,172.217.194.0-255,5738,167389,77,268941
11669,0.001367,172.31.40.0-255,66,167455,77,268941
11670,0.001429,172.217.194.0-255,12828,180283,77,268941
11671,0.001433,172.31.40.0-255,66,180349,77,268941
11672,0.001443,172.217.194.0-255,10692,191041,77,268941
11673,0.00145,172.31.40.0-255,66,191107,77,268941
11674,0.001567,172.217.194.0-255,1484,192591,77,268941
11675,0.001572,172.217.194.0-255,2902,195493,77,268941
11676,0.001578,172.31.40.0-255,66,195559,77,268941
11677,0.001593,172.217.194.0-255,5738,201297,77,268941
11678,0.001596,172.31.40.0-255,66,201363,77,268941
11679,0.001625,172.217.194.0-255,12828,214191,77,268941
11680,0.001628,172.31.40.0-255,66,214257,77,268941
11681,0.001634,172.217.194.0-255,4320,218577,77,268941
11682,0.001637,172.31.40.0-255,66,218643,77,268941
11683,0.001665,172.217.194.0-255,6438,225081,77,268941
11684,0.001672,172.31.40.0-255,66,225147,77,268941
11685,0.002327,172.217.194.0-255,1484,226631,77,268941
11686,0.002333,172.217.194.0-255,2902,229533,77,268941
11687,0.002337,172.31.40.0-255,66,229599,77,268941
11688,0.003993,172.217.194.0-255,1484,231083,77,268941
11689,0.004639,172.217.194.0-255,4320,235403,77,268941
11690,0.004647,172.31.40.0-255,66,235469,77,268941
11691,0.006938,172.217.194.0-255,4320,239789,77,268941
11692,0.006941,172.31.40.0-255,66,239855,77,268941
11693,0.006964,172.217.194.0-255,1484,241339,77,268941
11694,0.009221,172.217.194.0-255,4320,245659,77,268941
11695,0.009225,172.31.40.0-255,66,245725,77,268941
11696,0.011512,172.217.194.0-255,5738,251463,77,268941
11697,0.01152,172.31.40.0-255,66,251529,77,268941
11698,0.013852,172.217.194.0-255,5738,257267,77,268941
11699,0.01386,172.31.40.0-255,66,257333,77,268941
11700,0.016153,172.217.194.0-255,5738,263071,77,268941
11701,0.01616,172.31.40.0-255,66,263137,77,268941
11702,0.018452,172.217.194.0-255,5738,268875,77,268941
11703,0.01846,172.31.40.0-255,66,268941,77,268941
11704,0.0,172.31.40.0-255,105,105,77,210
11705,0.001794,157.240.7.0-255,105,210,77,210
11706,0.0,172.217.194.0-255,297,297,77,197335
11707,2.4e-05,172.31.40.0-255,66,363,77,197335
11708,3e-05,172.217.194.0-255,1484,1847,77,197335
11709,3.5e-05,172.31.40.0-255,66,1913,77,197335
11710,4.2e-05,172.217.194.0-255,4320,6233,77,197335
11711,5.3e-05,172.31.40.0-255,66,6299,77,197335
11712,0.000154,172.217.194.0-255,5738,12037,77,197335
11713,0.000158,172.31.40.0-255,66,12103,77,197335
11714,0.000177,172.217.194.0-255,1865,13968,77,197335
11715,0.00018,172.31.40.0-255,66,14034,77,197335
11716,0.000364,172.217.194.0-255,4320,18354,77,197335
11717,0.000369,172.31.40.0-255,66,18420,77,197335
11718,0.000495,172.217.194.0-255,5738,24158,77,197335
11719,0.0005,172.31.40.0-255,66,24224,77,197335
11720,0.000666,172.217.194.0-255,7156,31380,77,197335
11721,0.00067,172.31.40.0-255,66,31446,77,197335
11722,0.000695,172.217.194.0-255,5379,36825,77,197335
11723,0.000697,172.31.40.0-255,66,36891,77,197335
11724,0.001013,172.217.194.0-255,5738,42629,77,197335
11725,0.001017,172.31.40.0-255,66,42695,77,197335
11726,0.001054,172.217.194.0-255,5379,48074,77,197335
11727,0.001056,172.31.40.0-255,66,48140,77,197335
11728,0.001337,172.217.194.0-255,9992,58132,77,197335
11729,0.001342,172.31.40.0-255,66,58198,77,197335
11730,0.001613,172.217.194.0-255,10213,68411,77,197335
11731,0.001619,172.31.40.0-255,66,68477,77,197335
11732,0.001937,172.31.40.0-255,66,68543,77,197335
11733,0.001967,172.217.194.0-255,3961,72504,77,197335
11734,0.00197,172.31.40.0-255,66,72570,77,197335
11735,0.002532,172.217.194.0-255,8215,80785,77,197335
11736,0.002539,172.31.40.0-255,66,80851,77,197335
11737,0.002765,172.217.194.0-255,2902,83753,77,197335
11738,0.002768,172.31.40.0-255,66,83819,77,197335
11739,0.002825,172.31.40.0-255,66,83885,77,197335
11740,0.003685,172.217.194.0-255,766,84651,77,197335
11741,0.003718,172.217.194.0-255,2902,87553,77,197335
11742,0.003721,172.31.40.0-255,66,87619,77,197335
11743,0.003751,172.31.40.0-255,66,87685,77,197335
11744,0.003791,172.217.194.0-255,12110,99795,77,197335
11745,0.004667,172.217.194.0-255,5738,105533,77,197335
11746,0.004689,172.217.194.0-255,9992,115525,77,197335
11747,0.004743,172.217.194.0-255,8574,124099,77,197335
11748,0.004759,172.217.194.0-255,5738,129837,77,197335
11749,0.005529,172.217.194.0-255,7156,136993,77,197335
11750,0.005726,172.217.194.0-255,2902,139895,77,197335
11751,0.005784,172.217.194.0-255,12828,152723,77,197335
11752,0.006664,172.31.40.0-255,66,152789,77,197335
11753,0.006744,172.217.194.0-255,7156,159945,77,197335
11754,0.006771,172.31.40.0-255,66,160011,77,197335
11755,0.007311,172.31.40.0-255,101,160112,77,197335
11756,0.00763,172.31.40.0-255,66,160178,77,197335
11757,0.007686,172.31.40.0-255,66,160244,77,197335
11758,0.008563,172.217.194.0-255,8574,168818,77,197335
11759,0.008567,172.31.40.0-255,66,168884,77,197335
11760,0.008615,172.31.40.0-255,66,168950,77,197335
11761,0.00901,172.217.194.0-255,5738,174688,77,197335
11762,0.009014,172.31.40.0-255,66,174754,77,197335
11763,0.009068,172.31.40.0-255,66,174820,77,197335
11764,0.009993,172.217.194.0-255,8574,183394,77,197335
11765,0.010001,172.31.40.0-255,66,183460,77,197335
11766,0.010083,172.31.40.0-255,66,183526,77,197335
11767,0.010956,172.217.194.0-255,4320,187846,77,197335
11768,0.010962,172.31.40.0-255,66,187912,77,197335
11769,0.010978,172.217.194.0-255,1484,189396,77,197335
11770,0.011101,172.217.194.0-255,7636,197032,77,197335
11771,0.011104,172.31.40.0-255,66,197098,77,197335
11772,0.011247,172.217.194.0-255,66,197164,77,197335
11773,0.014124,172.31.40.0-255,105,197269,77,197335
11774,0.016442,172.217.194.0-255,66,197335,77,197335
11775,0.0,74.125.130.0-255,150,150,77,255757
11776,2.2e-05,172.31.40.0-255,66,216,77,255757
11777,2.9e-05,74.125.130.0-255,1484,1700,77,255757
11778,3.3e-05,172.31.40.0-255,66,1766,77,255757
11779,3.6e-05,74.125.130.0-255,1484,3250,77,255757
11780,3.9e-05,172.31.40.0-255,66,3316,77,255757
11781,7e-05,74.125.130.0-255,1484,4800,77,255757
11782,7.3e-05,172.31.40.0-255,66,4866,77,255757
11783,7.9e-05,74.125.130.0-255,5738,10604,77,255757
11784,8.2e-05,172.31.40.0-255,66,10670,77,255757
11785,8.4e-05,74.125.130.0-255,1484,12154,77,255757
11786,9e-05,172.31.40.0-255,66,12220,77,255757
11787,9.4e-05,74.125.130.0-255,2067,14287,77,255757
11788,9.7e-05,172.31.40.0-255,66,14353,77,255757
11789,0.000141,74.125.130.0-255,1484,15837,77,255757
11790,0.000143,172.31.40.0-255,66,15903,77,255757
11791,0.000147,74.125.130.0-255,1484,17387,77,255757
11792,0.000148,172.31.40.0-255,66,17453,77,255757
11793,0.000168,74.125.130.0-255,1484,18937,77,255757
11794,0.00017,172.31.40.0-255,66,19003,77,255757
11795,0.000178,74.125.130.0-255,2902,21905,77,255757
11796,0.00018,172.31.40.0-255,66,21971,77,255757
11797,0.000185,74.125.130.0-255,4320,26291,77,255757
11798,0.000187,172.31.40.0-255,66,26357,77,255757
11799,0.000219,74.125.130.0-255,4320,30677,77,255757
11800,0.000221,172.31.40.0-255,66,30743,77,255757
11801,0.000231,74.125.130.0-255,1125,31868,77,255757
11802,0.000237,172.31.40.0-255,66,31934,77,255757
11803,0.000353,74.125.130.0-255,1484,33418,77,255757
11804,0.000356,172.31.40.0-255,66,33484,77,255757
11805,0.000362,74.125.130.0-255,2902,36386,77,255757
11806,0.000364,172.31.40.0-255,66,36452,77,255757
11807,0.000397,74.125.130.0-255,4320,40772,77,255757
11808,0.000411,74.125.130.0-255,1484,42256,77,255757
11809,0.000431,74.125.130.0-255,8215,50471,77,255757
11810,0.000434,74.125.130.0-255,2902,53373,77,255757
11811,0.00048,74.125.130.0-255,1484,54857,77,255757
11812,0.000505,74.125.130.0-255,11304,66161,77,255757
11813,0.000507,74.125.130.0-255,116,66277,77,255757
11814,0.00057,172.31.40.0-255,66,66343,77,255757
11815,0.000626,74.125.130.0-255,1484,67827,77,255757
11816,0.00063,74.125.130.0-255,1484,69311,77,255757
11817,0.000634,172.31.40.0-255,66,69377,77,255757
11818,0.000641,74.125.130.0-255,1484,70861,77,255757
11819,0.000665,74.125.130.0-255,5738,76599,77,255757
11820,0.000683,74.125.130.0-255,6797,83396,77,255757
11821,0.0007,74.125.130.0-255,4320,87716,77,255757
11822,0.000703,172.31.40.0-255,66,87782,77,255757
11823,0.000713,74.125.130.0-255,2902,90684,77,255757
11824,0.000727,74.125.130.0-255,2902,93586,77,255757
11825,0.00073,172.31.40.0-255,66,93652,77,255757
11826,0.00076,74.125.130.0-255,5738,99390,77,255757
11827,0.000772,74.125.130.0-255,1443,100833,77,255757
11828,0.000778,172.31.40.0-255,66,100899,77,255757
11829,0.001318,74.125.130.0-255,1484,102383,77,255757
11830,0.001325,74.125.130.0-255,2902,105285,77,255757
11831,0.001328,172.31.40.0-255,66,105351,77,255757
11832,0.001332,74.125.130.0-255,1484,106835,77,255757
11833,0.001358,74.125.130.0-255,1484,108319,77,255757
11834,0.001364,74.125.130.0-255,4320,112639,77,255757
11835,0.001375,172.31.40.0-255,66,112705,77,255757
11836,0.001403,74.125.130.0-255,7156,119861,77,255757
11837,0.001411,172.31.40.0-255,66,119927,77,255757
11838,0.001467,74.125.130.0-255,8574,128501,77,255757
11839,0.001473,74.125.130.0-255,2902,131403,77,255757
11840,0.001478,74.125.130.0-255,3602,135005,77,255757
11841,0.001495,172.31.40.0-255,66,135071,77,255757
11842,0.001529,74.125.130.0-255,1484,136555,77,255757
11843,0.001547,74.125.130.0-255,2902,139457,77,255757
11844,0.001571,74.125.130.0-255,5738,145195,77,255757
11845,0.001588,74.125.130.0-255,1484,146679,77,255757
11846,0.00161,74.125.130.0-255,9992,156671,77,255757
11847,0.001624,74.125.130.0-255,1484,158155,77,255757
11848,0.001646,74.125.130.0-255,5738,163893,77,255757
11849,0.001668,74.125.130.0-255,5020,168913,77,255757
11850,0.001744,74.125.130.0-255,1484,170397,77,255757
11851,0.00176,74.125.130.0-255,2902,173299,77,255757
11852,0.001778,74.125.130.0-255,2902,176201,77,255757
11853,0.001796,74.125.130.0-255,2902,179103,77,255757
11854,0.001803,74.125.130.0-255,7156,186259,77,255757
11855,0.001824,74.125.130.0-255,8574,194833,77,255757
11856,0.001879,74.125.130.0-255,5738,200571,77,255757
11857,0.001893,74.125.130.0-255,2184,202755,77,255757
11858,0.002046,74.125.130.0-255,1484,204239,77,255757
11859,0.002065,74.125.130.0-255,2902,207141,77,255757
11860,0.002075,74.125.130.0-255,1484,208625,77,255757
11861,0.002093,74.125.130.0-255,4320,212945,77,255757
11862,0.002097,74.125.130.0-255,2902,215847,77,255757
11863,0.0021,74.125.130.0-255,1484,217331,77,255757
11864,0.002122,74.125.130.0-255,2902,220233,77,255757
11865,0.002129,74.125.130.0-255,5738,225971,77,255757
11866,0.002145,74.125.130.0-255,2902,228873,77,255757
11867,0.002152,74.125.130.0-255,7156,236029,77,255757
11868,0.002178,74.125.130.0-255,766,236795,77,255757
11869,0.002371,74.125.130.0-255,1484,238279,77,255757
11870,0.005702,172.31.40.0-255,66,238345,77,255757
11871,0.00806,74.125.130.0-255,5738,244083,77,255757
11872,0.008067,172.31.40.0-255,66,244149,77,255757
11873,0.010423,74.125.130.0-255,5738,249887,77,255757
11874,0.01043,172.31.40.0-255,66,249953,77,255757
11875,0.012783,74.125.130.0-255,5738,255691,77,255757
11876,0.017791,172.31.40.0-255,66,255757,77,255757
11877,0.0,172.217.194.0-255,146,146,77,195582
11878,2.4e-05,172.31.40.0-255,66,212,77,195582
11879,2.9e-05,172.217.194.0-255,1484,1696,77,195582
11880,3.4e-05,172.31.40.0-255,66,1762,77,195582
11881,5.9e-05,172.217.194.0-255,2902,4664,77,195582
11882,6.2e-05,172.31.40.0-255,66,4730,77,195582
11883,6.7e-05,172.217.194.0-255,4320,9050,77,195582
11884,7e-05,172.31.40.0-255,66,9116,77,195582
11885,9.8e-05,172.217.194.0-255,4320,13436,77,195582
11886,0.000101,172.31.40.0-255,66,13502,77,195582
11887,0.000121,172.217.194.0-255,4837,18339,77,195582
11888,0.000125,172.31.40.0-255,66,18405,77,195582
11889,0.000134,172.217.194.0-255,9992,28397,77,195582
11890,0.000136,172.31.40.0-255,66,28463,77,195582
11891,0.00016,172.217.194.0-255,2543,31006,77,195582
11892,0.000162,172.31.40.0-255,66,31072,77,195582
11893,0.000264,172.217.194.0-255,1484,32556,77,195582
11894,0.000269,172.31.40.0-255,66,32622,77,195582
11895,0.000274,172.217.194.0-255,2902,35524,77,195582
11896,0.000278,172.31.40.0-255,66,35590,77,195582
11897,0.000292,172.217.194.0-255,2902,38492,77,195582
11898,0.000295,172.31.40.0-255,66,38558,77,195582
11899,0.000318,172.217.194.0-255,2902,41460,77,195582
11900,0.000322,172.31.40.0-255,66,41526,77,195582
11901,0.000327,172.217.194.0-255,4320,45846,77,195582
11902,0.000332,172.31.40.0-255,66,45912,77,195582
11903,0.000336,172.217.194.0-255,2902,48814,77,195582
11904,0.000338,172.31.40.0-255,66,48880,77,195582
11905,0.000357,172.217.194.0-255,8574,57454,77,195582
11906,0.000361,172.31.40.0-255,66,57520,77,195582
11907,0.000364,172.217.194.0-255,1484,59004,77,195582
11908,0.000366,172.31.40.0-255,66,59070,77,195582
11909,0.000382,172.217.194.0-255,2902,61972,77,195582
11910,0.000385,172.31.40.0-255,66,62038,77,195582
11911,0.000405,172.217.194.0-255,3602,65640,77,195582
11912,0.00041,172.31.40.0-255,66,65706,77,195582
11913,0.000435,172.217.194.0-255,676,66382,77,195582
11914,0.0005,172.217.194.0-255,1484,67866,77,195582
11915,0.000504,172.31.40.0-255,66,67932,77,195582
11916,0.00051,172.217.194.0-255,2902,70834,77,195582
11917,0.000512,172.31.40.0-255,66,70900,77,195582
11918,0.000517,172.217.194.0-255,4320,75220,77,195582
11919,0.000519,172.31.40.0-255,66,75286,77,195582
11920,0.000552,172.217.194.0-255,1484,76770,77,195582
11921,0.000564,172.217.194.0-255,12828,89598,77,195582
11922,0.000567,172.31.40.0-255,66,89664,77,195582
11923,0.000599,172.217.194.0-255,5738,95402,77,195582
11924,0.000602,172.31.40.0-255,66,95468,77,195582
11925,0.000625,172.217.194.0-255,4472,99940,77,195582
11926,0.000628,172.31.40.0-255,66,100006,77,195582
11927,0.000942,172.217.194.0-255,1484,101490,77,195582
11928,0.000948,172.217.194.0-255,2902,104392,77,195582
11929,0.000952,172.31.40.0-255,66,104458,77,195582
11930,0.000961,172.217.194.0-255,1484,105942,77,195582
11931,0.000975,172.217.194.0-255,2902,108844,77,195582
11932,0.000978,172.31.40.0-255,66,108910,77,195582
11933,0.000984,172.217.194.0-255,5738,114648,77,195582
11934,0.000986,172.31.40.0-255,66,114714,77,195582
11935,0.001005,172.217.194.0-255,5738,120452,77,195582
11936,0.001009,172.31.40.0-255,66,120518,77,195582
11937,0.001026,172.217.194.0-255,5738,126256,77,195582
11938,0.001045,172.31.40.0-255,66,126322,77,195582
11939,0.001053,172.217.194.0-255,7856,134178,77,195582
11940,0.001056,172.31.40.0-255,66,134244,77,195582
11941,0.002029,172.217.194.0-255,1484,135728,77,195582
11942,0.002041,172.217.194.0-255,2902,138630,77,195582
11943,0.002045,172.31.40.0-255,66,138696,77,195582
11944,0.002053,172.217.194.0-255,5738,144434,77,195582
11945,0.002055,172.31.40.0-255,66,144500,77,195582
11946,0.002061,172.217.194.0-255,5738,150238,77,195582
11947,0.002063,172.31.40.0-255,66,150304,77,195582
11948,0.004095,172.217.194.0-255,5738,156042,77,195582
11949,0.004099,172.31.40.0-255,66,156108,77,195582
11950,0.006132,172.217.194.0-255,2902,159010,77,195582
11951,0.006136,172.31.40.0-255,66,159076,77,195582
11952,0.006148,172.217.194.0-255,2902,161978,77,195582
11953,0.00615,172.31.40.0-255,66,162044,77,195582
11954,0.008183,172.217.194.0-255,4320,166364,77,195582
11955,0.008188,172.31.40.0-255,66,166430,77,195582
11956,0.008207,172.217.194.0-255,1484,167914,77,195582
11957,0.010367,172.217.194.0-255,4320,172234,77,195582
11958,0.010428,172.31.40.0-255,66,172300,77,195582
11959,0.01249,172.217.194.0-255,5738,178038,77,195582
11960,0.012497,172.31.40.0-255,66,178104,77,195582
11961,0.014552,172.217.194.0-255,5738,183842,77,195582
11962,0.014567,172.31.40.0-255,66,183908,77,195582
11963,0.016627,172.217.194.0-255,5738,189646,77,195582
11964,0.016638,172.31.40.0-255,66,189712,77,195582
11965,0.01866,172.217.194.0-255,4320,194032,77,195582
11966,0.018668,172.31.40.0-255,66,194098,77,195582
11967,0.018697,172.217.194.0-255,1484,195582,77,195582
11968,0.0,172.31.40.0-255,105,105,77,276
11969,0.001781,157.240.7.0-255,105,210,77,276
11970,0.001792,172.31.40.0-255,66,276,77,276
11971,0.0,74.125.24.0-255,150,150,77,380810
11972,2.2e-05,172.31.40.0-255,66,216,77,380810
11973,2.9e-05,74.125.24.0-255,1484,1700,77,380810
11974,3.3e-05,172.31.40.0-255,66,1766,77,380810
11975,4.9e-05,74.125.24.0-255,2902,4668,77,380810
11976,5.2e-05,172.31.40.0-255,66,4734,77,380810
11977,5.9e-05,74.125.24.0-255,7156,11890,77,380810
11978,6.3e-05,172.31.40.0-255,66,11956,77,380810
11979,6.7e-05,74.125.24.0-255,2126,14082,77,380810
11980,6.9e-05,172.31.40.0-255,66,14148,77,380810
11981,0.000116,74.125.24.0-255,11410,25558,77,380810
11982,0.000119,172.31.40.0-255,66,25624,77,380810
11983,0.000124,74.125.24.0-255,4320,29944,77,380810
11984,0.000127,172.31.40.0-255,66,30010,77,380810
11985,0.000145,74.125.24.0-255,1125,31135,77,380810
11986,0.000147,172.31.40.0-255,66,31201,77,380810
11987,0.000259,74.125.24.0-255,1484,32685,77,380810
11988,0.000263,172.31.40.0-255,66,32751,77,380810
11989,0.000267,74.125.24.0-255,2902,35653,77,380810
11990,0.00027,172.31.40.0-255,66,35719,77,380810
11991,0.0003,74.125.24.0-255,5738,41457,77,380810
11992,0.000303,172.31.40.0-255,66,41523,77,380810
11993,0.000307,74.125.24.0-255,1484,43007,77,380810
11994,0.000309,172.31.40.0-255,66,43073,77,380810
11995,0.000333,74.125.24.0-255,5379,48452,77,380810
11996,0.000336,172.31.40.0-255,66,48518,77,380810
11997,0.000375,172.31.40.0-255,66,48584,77,380810
11998,0.00038,74.125.24.0-255,2543,51127,77,380810
11999,0.000382,172.31.40.0-255,66,51193,77,380810
12000,0.000408,74.125.24.0-255,413,51606,77,380810
12001,0.000411,172.31.40.0-255,66,51672,77,380810
12002,0.000495,74.125.24.0-255,1484,53156,77,380810
12003,0.000501,74.125.24.0-255,2902,56058,77,380810
12004,0.000505,172.31.40.0-255,66,56124,77,380810
12005,0.000511,74.125.24.0-255,5738,61862,77,380810
12006,0.000514,172.31.40.0-255,66,61928,77,380810
12007,0.000532,74.125.24.0-255,1484,63412,77,380810
12008,0.000565,74.125.24.0-255,11410,74822,77,380810
12009,0.000569,172.31.40.0-255,66,74888,77,380810
12010,0.000579,74.125.24.0-255,10376,85264,77,380810
12011,0.000585,172.31.40.0-255,66,85330,77,380810
12012,0.000711,74.125.24.0-255,1484,86814,77,380810
12013,0.000718,74.125.24.0-255,2902,89716,77,380810
12014,0.000721,172.31.40.0-255,66,89782,77,380810
12015,0.000726,74.125.24.0-255,2902,92684,77,380810
12016,0.000729,172.31.40.0-255,66,92750,77,380810
12017,0.00075,74.125.24.0-255,2902,95652,77,380810
12018,0.000753,172.31.40.0-255,66,95718,77,380810
12019,0.000764,74.125.24.0-255,12828,108546,77,380810
12020,0.000772,172.31.40.0-255,66,108612,77,380810
12021,0.000779,74.125.24.0-255,7156,115768,77,380810
12022,0.000782,172.31.40.0-255,66,115834,77,380810
12023,0.000837,74.125.24.0-255,3602,119436,77,380810
12024,0.000841,172.31.40.0-255,66,119502,77,380810
12025,0.000979,74.125.24.0-255,1484,120986,77,380810
12026,0.000986,74.125.24.0-255,2902,123888,77,380810
12027,0.000989,172.31.40.0-255,66,123954,77,380810
12028,0.000993,74.125.24.0-255,1484,125438,77,380810
12029,0.001018,74.125.24.0-255,4320,129758,77,380810
12030,0.001021,172.31.40.0-255,66,129824,77,380810
12031,0.001025,74.125.24.0-255,2902,132726,77,380810
12032,0.001027,172.31.40.0-255,66,132792,77,380810
12033,0.001061,74.125.24.0-255,9992,142784,77,380810
12034,0.001065,172.31.40.0-255,66,142850,77,380810
12035,0.001072,74.125.24.0-255,7156,150006,77,380810
12036,0.001074,172.31.40.0-255,66,150072,77,380810
12037,0.001121,74.125.24.0-255,3602,153674,77,380810
12038,0.001125,172.31.40.0-255,66,153740,77,380810
12039,0.001158,74.125.24.0-255,4320,158060,77,380810
12040,0.001161,172.31.40.0-255,66,158126,77,380810
12041,0.001164,74.125.24.0-255,1484,159610,77,380810
12042,0.001192,74.125.24.0-255,7156,166766,77,380810
12043,0.001196,172.31.40.0-255,66,166832,77,380810
12044,0.001227,74.125.24.0-255,12828,179660,77,380810
12045,0.00123,172.31.40.0-255,66,179726,77,380810
12046,0.001259,74.125.24.0-255,2902,182628,77,380810
12047,0.001262,172.31.40.0-255,66,182694,77,380810
12048,0.001268,74.125.24.0-255,5020,187714,77,380810
12049,0.001271,172.31.40.0-255,66,187780,77,380810
12050,0.001554,74.125.24.0-255,1484,189264,77,380810
12051,0.001561,74.125.24.0-255,2902,192166,77,380810
12052,0.001564,172.31.40.0-255,66,192232,77,380810
12053,0.00157,74.125.24.0-255,4320,196552,77,380810
12054,0.001572,172.31.40.0-255,66,196618,77,380810
12055,0.001591,74.125.24.0-255,1484,198102,77,380810
12056,0.001596,74.125.24.0-255,4320,202422,77,380810
12057,0.001603,172.31.40.0-255,66,202488,77,380810
12058,0.001614,74.125.24.0-255,11410,213898,77,380810
12059,0.001617,172.31.40.0-255,66,213964,77,380810
12060,0.001652,74.125.24.0-255,7856,221820,77,380810
12061,0.001654,172.31.40.0-255,66,221886,77,380810
12062,0.001711,74.125.24.0-255,1484,223370,77,380810
12063,0.001725,74.125.24.0-255,2902,226272,77,380810
12064,0.001728,172.31.40.0-255,66,226338,77,380810
12065,0.00176,74.125.24.0-255,5738,232076,77,380810
12066,0.001763,172.31.40.0-255,66,232142,77,380810
12067,0.001775,74.125.24.0-255,7156,239298,77,380810
12068,0.001782,172.31.40.0-255,66,239364,77,380810
12069,0.001809,74.125.24.0-255,5738,245102,77,380810
12070,0.001812,172.31.40.0-255,66,245168,77,380810
12071,0.001827,74.125.24.0-255,10692,255860,77,380810
12072,0.00183,172.31.40.0-255,66,255926,77,380810
12073,0.001833,74.125.24.0-255,1484,257410,77,380810
12074,0.001859,74.125.24.0-255,2902,260312,77,380810
12075,0.001862,172.31.40.0-255,66,260378,77,380810
12076,0.001868,74.125.24.0-255,5738,266116,77,380810
12077,0.001871,172.31.40.0-255,66,266182,77,380810
12078,0.001886,74.125.24.0-255,11410,277592,77,380810
12079,0.001888,172.31.40.0-255,66,277658,77,380810
12080,0.001893,74.125.24.0-255,4320,281978,77,380810
12081,0.001896,172.31.40.0-255,66,282044,77,380810
12082,0.001902,74.125.24.0-255,5738,287782,77,380810
12083,0.001904,172.31.40.0-255,66,287848,77,380810
12084,0.001932,74.125.24.0-255,2184,290032,77,380810
12085,0.001936,172.31.40.0-255,66,290098,77,380810
12086,0.002046,74.125.24.0-255,1484,291582,77,380810
12087,0.002052,74.125.24.0-255,2902,294484,77,380810
12088,0.002056,172.31.40.0-255,66,294550,77,380810
12089,0.002085,74.125.24.0-255,5738,300288,77,380810
12090,0.002087,172.31.40.0-255,66,300354,77,380810
12091,0.002091,74.125.24.0-255,2902,303256,77,380810
12092,0.002093,172.31.40.0-255,66,303322,77,380810
12093,0.002172,74.125.24.0-255,9992,313314,77,380810
12094,0.002175,172.31.40.0-255,66,313380,77,380810
12095,0.002185,74.125.24.0-255,10692,324072,77,380810
12096,0.002193,172.31.40.0-255,66,324138,77,380810
12097,0.002238,74.125.24.0-255,1484,325622,77,380810
12098,0.002251,74.125.24.0-255,2902,328524,77,380810
12099,0.002254,172.31.40.0-255,66,328590,77,380810
12100,0.002283,74.125.24.0-255,5738,334328,77,380810
12101,0.002287,172.31.40.0-255,66,334394,77,380810
12102,0.002292,74.125.24.0-255,2902,337296,77,380810
12103,0.002294,172.31.40.0-255,66,337362,77,380810
12104,0.002321,74.125.24.0-255,5738,343100,77,380810
12105,0.002324,172.31.40.0-255,66,343166,77,380810
12106,0.002353,74.125.24.0-255,8574,351740,77,380810
12107,0.002357,172.31.40.0-255,66,351806,77,380810
12108,0.002386,74.125.24.0-255,6438,358244,77,380810
12109,0.00239,172.31.40.0-255,66,358310,77,380810
12110,0.002399,74.125.24.0-255,9992,368302,77,380810
12111,0.002405,172.31.40.0-255,66,368368,77,380810
12112,0.002437,74.125.24.0-255,5738,374106,77,380810
12113,0.00244,172.31.40.0-255,66,374172,77,380810
12114,0.002462,172.31.40.0-255,66,374238,77,380810
12115,0.002466,74.125.24.0-255,2184,376422,77,380810
12116,0.002468,172.31.40.0-255,66,376488,77,380810
12117,0.002493,74.125.24.0-255,3914,380402,77,380810
12118,0.002496,172.31.40.0-255,66,380468,77,380810
12119,0.002523,74.125.24.0-255,105,380573,77,380810
12120,0.004919,172.31.40.0-255,66,380639,77,380810
12121,0.01223,172.31.40.0-255,105,380744,77,380810
12122,0.014842,74.125.24.0-255,66,380810,77,380810
12123,0.0,172.217.194.0-255,153,153,77,347582
12124,2.3e-05,172.31.40.0-255,66,219,77,347582
12125,3.1e-05,172.217.194.0-255,1484,1703,77,347582
12126,3.5e-05,172.31.40.0-255,66,1769,77,347582
12127,4.7e-05,172.217.194.0-255,2902,4671,77,347582
12128,5e-05,172.31.40.0-255,66,4737,77,347582
12129,5.8e-05,172.217.194.0-255,7156,11893,77,347582
12130,6.2e-05,172.31.40.0-255,66,11959,77,347582
12131,6.5e-05,172.217.194.0-255,1984,13943,77,347582
12132,6.8e-05,172.31.40.0-255,66,14009,77,347582
12133,0.000563,172.217.194.0-255,1484,15493,77,347582
12134,0.000569,172.31.40.0-255,66,15559,77,347582
12135,0.000578,172.217.194.0-255,2902,18461,77,347582
12136,0.000581,172.31.40.0-255,66,18527,77,347582
12137,0.000593,172.217.194.0-255,5738,24265,77,347582
12138,0.000595,172.31.40.0-255,66,24331,77,347582
12139,0.000627,172.217.194.0-255,6797,31128,77,347582
12140,0.00063,172.31.40.0-255,66,31194,77,347582
12141,0.000661,172.217.194.0-255,7156,38350,77,347582
12142,0.000664,172.31.40.0-255,66,38416,77,347582
12143,0.000704,172.31.40.0-255,66,38482,77,347582
12144,0.000752,172.217.194.0-255,10692,49174,77,347582
12145,0.000755,172.31.40.0-255,66,49240,77,347582
12146,0.000758,172.217.194.0-255,677,49917,77,347582
12147,0.00076,172.31.40.0-255,66,49983,77,347582
12148,0.000825,172.217.194.0-255,1484,51467,77,347582
12149,0.000828,172.31.40.0-255,66,51533,77,347582
12150,0.000833,172.217.194.0-255,2902,54435,77,347582
12151,0.000836,172.31.40.0-255,66,54501,77,347582
12152,0.000867,172.217.194.0-255,5738,60239,77,347582
12153,0.00087,172.31.40.0-255,66,60305,77,347582
12154,0.000903,172.217.194.0-255,7156,67461,77,347582
12155,0.000906,172.31.40.0-255,66,67527,77,347582
12156,0.000915,172.217.194.0-255,8574,76101,77,347582
12157,0.000917,172.31.40.0-255,66,76167,77,347582
12158,0.000946,172.217.194.0-255,5738,81905,77,347582
12159,0.00095,172.31.40.0-255,66,81971,77,347582
12160,0.000954,172.217.194.0-255,2184,84155,77,347582
12161,0.000956,172.31.40.0-255,66,84221,77,347582
12162,0.000996,172.217.194.0-255,1484,85705,77,347582
12163,0.001002,172.217.194.0-255,2902,88607,77,347582
12164,0.001005,172.31.40.0-255,66,88673,77,347582
12165,0.001012,172.217.194.0-255,5738,94411,77,347582
12166,0.001014,172.31.40.0-255,66,94477,77,347582
12167,0.001028,172.217.194.0-255,4320,98797,77,347582
12168,0.00103,172.31.40.0-255,66,98863,77,347582
12169,0.001058,172.217.194.0-255,2902,101765,77,347582
12170,0.001062,172.31.40.0-255,66,101831,77,347582
12171,0.001077,172.31.40.0-255,66,101897,77,347582
12172,0.001081,172.217.194.0-255,2184,104081,77,347582
12173,0.001083,172.31.40.0-255,66,104147,77,347582
12174,0.001119,172.217.194.0-255,1484,105631,77,347582
12175,0.001139,172.217.194.0-255,2902,108533,77,347582
12176,0.001143,172.31.40.0-255,66,108599,77,347582
12177,0.001149,172.217.194.0-255,5738,114337,77,347582
12178,0.001152,172.31.40.0-255,66,114403,77,347582
12179,0.00117,172.217.194.0-255,1484,115887,77,347582
12180,0.001202,172.217.194.0-255,11410,127297,77,347582
12181,0.001207,172.31.40.0-255,66,127363,77,347582
12182,0.001235,172.217.194.0-255,7156,134519,77,347582
12183,0.001238,172.31.40.0-255,66,134585,77,347582
12184,0.001251,172.217.194.0-255,3602,138187,77,347582
12185,0.001259,172.31.40.0-255,66,138253,77,347582
12186,0.001432,172.217.194.0-255,1484,139737,77,347582
12187,0.00144,172.217.194.0-255,2902,142639,77,347582
12188,0.001444,172.31.40.0-255,66,142705,77,347582
12189,0.001451,172.217.194.0-255,5738,148443,77,347582
12190,0.001453,172.31.40.0-255,66,148509,77,347582
12191,0.00149,172.217.194.0-255,12828,161337,77,347582
12192,0.001493,172.31.40.0-255,66,161403,77,347582
12193,0.001498,172.217.194.0-255,4320,165723,77,347582
12194,0.0015,172.31.40.0-255,66,165789,77,347582
12195,0.001526,172.217.194.0-255,6438,172227,77,347582
12196,0.001529,172.31.40.0-255,66,172293,77,347582
12197,0.001607,172.217.194.0-255,1484,173777,77,347582
12198,0.001613,172.217.194.0-255,2902,176679,77,347582
12199,0.001616,172.31.40.0-255,66,176745,77,347582
12200,0.001623,172.217.194.0-255,5738,182483,77,347582
12201,0.001626,172.31.40.0-255,66,182549,77,347582
12202,0.001671,172.217.194.0-255,12828,195377,77,347582
12203,0.001674,172.31.40.0-255,66,195443,77,347582
12204,0.001678,172.217.194.0-255,2902,198345,77,347582
12205,0.00168,172.31.40.0-255,66,198411,77,347582
12206,0.001728,172.217.194.0-255,1484,199895,77,347582
12207,0.001754,172.217.194.0-255,6438,206333,77,347582
12208,0.001758,172.31.40.0-255,66,206399,77,347582
12209,0.001762,172.217.194.0-255,2902,209301,77,347582
12210,0.001764,172.31.40.0-255,66,209367,77,347582
12211,0.001808,172.217.194.0-255,2902,212269,77,347582
12212,0.001811,172.31.40.0-255,66,212335,77,347582
12213,0.001841,172.217.194.0-255,1484,213819,77,347582
12214,0.00185,172.217.194.0-255,8574,222393,77,347582
12215,0.001853,172.31.40.0-255,66,222459,77,347582
12216,0.001867,172.217.194.0-255,8574,231033,77,347582
12217,0.00187,172.31.40.0-255,66,231099,77,347582
12218,0.00188,172.217.194.0-255,9274,240373,77,347582
12219,0.001885,172.31.40.0-255,66,240439,77,347582
12220,0.001944,172.217.194.0-255,1484,241923,77,347582
12221,0.001949,172.217.194.0-255,2902,244825,77,347582
12222,0.001952,172.31.40.0-255,66,244891,77,347582
12223,0.001981,172.217.194.0-255,5738,250629,77,347582
12224,0.001984,172.31.40.0-255,66,250695,77,347582
12225,0.001993,172.217.194.0-255,9992,260687,77,347582
12226,0.001995,172.31.40.0-255,66,260753,77,347582
12227,0.002015,172.217.194.0-255,2902,263655,77,347582
12228,0.002017,172.31.40.0-255,66,263721,77,347582
12229,0.002031,172.217.194.0-255,10692,274413,77,347582
12230,0.002058,172.217.194.0-255,1484,275897,77,347582
12231,0.002081,172.217.194.0-255,2902,278799,77,347582
12232,0.002088,172.217.194.0-255,5738,284537,77,347582
12233,0.002114,172.217.194.0-255,8574,293111,77,347582
12234,0.002128,172.217.194.0-255,4320,297431,77,347582
12235,0.00213,172.217.194.0-255,1484,298915,77,347582
12236,0.002159,172.217.194.0-255,4320,303235,77,347582
12237,0.00218,172.217.194.0-255,6438,309673,77,347582
12238,0.002191,172.217.194.0-255,11410,321083,77,347582
12239,0.002214,172.217.194.0-255,5738,326821,77,347582
12240,0.002253,172.217.194.0-255,1484,328305,77,347582
12241,0.002317,172.217.194.0-255,12110,340415,77,347582
12242,0.002323,172.217.194.0-255,6759,347174,77,347582
12243,0.005068,172.31.40.0-255,66,347240,77,347582
12244,0.007368,172.217.194.0-255,105,347345,77,347582
12245,0.008134,172.31.40.0-255,66,347411,77,347582
12246,0.00817,172.31.40.0-255,105,347516,77,347582
12247,0.010469,172.217.194.0-255,66,347582,77,347582
12248,0.0,172.217.194.0-255,153,153,77,329533
12249,2.3e-05,172.31.40.0-255,66,219,77,329533
12250,3e-05,172.217.194.0-255,1484,1703,77,329533
12251,3.4e-05,172.31.40.0-255,66,1769,77,329533
12252,4e-05,172.217.194.0-255,2902,4671,77,329533
12253,4.3e-05,172.31.40.0-255,66,4737,77,329533
12254,6.4e-05,172.217.194.0-255,2902,7639,77,329533
12255,6.7e-05,172.31.40.0-255,66,7705,77,329533
12256,7.2e-05,172.217.194.0-255,4320,12025,77,329533
12257,7.6e-05,172.31.40.0-255,66,12091,77,329533
12258,0.00011,172.217.194.0-255,2002,14093,77,329533
12259,0.000113,172.31.40.0-255,66,14159,77,329533
12260,0.000117,172.217.194.0-255,2902,17061,77,329533
12261,0.000119,172.31.40.0-255,66,17127,77,329533
12262,0.000123,172.217.194.0-255,1484,18611,77,329533
12263,0.000125,172.31.40.0-255,66,18677,77,329533
12264,0.000152,172.217.194.0-255,5738,24415,77,329533
12265,0.000154,172.31.40.0-255,66,24481,77,329533
12266,0.000186,172.217.194.0-255,5738,30219,77,329533
12267,0.000189,172.31.40.0-255,66,30285,77,329533
12268,0.000203,172.217.194.0-255,1125,31410,77,329533
12269,0.000205,172.31.40.0-255,66,31476,77,329533
12270,0.000241,172.217.194.0-255,1484,32960,77,329533
12271,0.000243,172.31.40.0-255,66,33026,77,329533
12272,0.000247,172.217.194.0-255,2902,35928,77,329533
12273,0.00025,172.31.40.0-255,66,35994,77,329533
12274,0.000271,172.217.194.0-255,5738,41732,77,329533
12275,0.000273,172.31.40.0-255,66,41798,77,329533
12276,0.000297,172.217.194.0-255,8574,50372,77,329533
12277,0.0003,172.31.40.0-255,66,50438,77,329533
12278,0.000332,172.217.194.0-255,5379,55817,77,329533
12279,0.000335,172.31.40.0-255,66,55883,77,329533
12280,0.000345,172.217.194.0-255,9633,65516,77,329533
12281,0.000348,172.31.40.0-255,66,65582,77,329533
12282,0.000391,172.217.194.0-255,647,66229,77,329533
12283,0.000462,172.217.194.0-255,1484,67713,77,329533
12284,0.000466,172.31.40.0-255,66,67779,77,329533
12285,0.000471,172.217.194.0-255,2902,70681,77,329533
12286,0.000474,172.31.40.0-255,66,70747,77,329533
12287,0.000479,172.217.194.0-255,4320,75067,77,329533
12288,0.000482,172.31.40.0-255,66,75133,77,329533
12289,0.000505,172.217.194.0-255,1484,76617,77,329533
12290,0.000515,172.217.194.0-255,8574,85191,77,329533
12291,0.000518,172.31.40.0-255,66,85257,77,329533
12292,0.000542,172.217.194.0-255,5379,90636,77,329533
12293,0.000544,172.31.40.0-255,66,90702,77,329533
12294,0.000554,172.217.194.0-255,9633,100335,77,329533
12295,0.000556,172.31.40.0-255,66,100401,77,329533
12296,0.000766,172.217.194.0-255,1484,101885,77,329533
12297,0.000771,172.217.194.0-255,2902,104787,77,329533
12298,0.000777,172.31.40.0-255,66,104853,77,329533
12299,0.000797,172.217.194.0-255,5738,110591,77,329533
12300,0.0008,172.31.40.0-255,66,110657,77,329533
12301,0.00081,172.217.194.0-255,9992,120649,77,329533
12302,0.000812,172.31.40.0-255,66,120715,77,329533
12303,0.000834,172.217.194.0-255,2902,123617,77,329533
12304,0.000837,172.31.40.0-255,66,123683,77,329533
12305,0.000845,172.217.194.0-255,8574,132257,77,329533
12306,0.000848,172.31.40.0-255,66,132323,77,329533
12307,0.000863,172.217.194.0-255,3602,135925,77,329533
12308,0.000867,172.31.40.0-255,66,135991,77,329533
12309,0.000872,172.217.194.0-255,2902,138893,77,329533
12310,0.000874,172.31.40.0-255,66,138959,77,329533
12311,0.000891,172.217.194.0-255,1484,140443,77,329533
12312,0.000901,172.217.194.0-255,8574,149017,77,329533
12313,0.000903,172.31.40.0-255,66,149083,77,329533
12314,0.000916,172.217.194.0-255,1484,150567,77,329533
12315,0.000935,172.217.194.0-255,9992,160559,77,329533
12316,0.000937,172.31.40.0-255,66,160625,77,329533
12317,0.000966,172.217.194.0-255,7856,168481,77,329533
12318,0.000969,172.31.40.0-255,66,168547,77,329533
12319,0.000988,172.31.40.0-255,66,168613,77,329533
12320,0.000997,172.217.194.0-255,9992,178605,77,329533
12321,0.001,172.31.40.0-255,66,178671,77,329533
12322,0.00102,172.217.194.0-255,5020,183691,77,329533
12323,0.001022,172.31.40.0-255,66,183757,77,329533
12324,0.001026,172.217.194.0-255,1484,185241,77,329533
12325,0.001031,172.217.194.0-255,2902,188143,77,329533
12326,0.001033,172.31.40.0-255,66,188209,77,329533
12327,0.001036,172.217.194.0-255,1484,189693,77,329533
12328,0.001059,172.217.194.0-255,4320,194013,77,329533
12329,0.001062,172.31.40.0-255,66,194079,77,329533
12330,0.001068,172.217.194.0-255,5738,199817,77,329533
12331,0.00107,172.31.40.0-255,66,199883,77,329533
12332,0.001091,172.217.194.0-255,7156,207039,77,329533
12333,0.001093,172.31.40.0-255,66,207105,77,329533
12334,0.001104,172.217.194.0-255,10692,217797,77,329533
12335,0.001106,172.31.40.0-255,66,217863,77,329533
12336,0.001131,172.217.194.0-255,1484,219347,77,329533
12337,0.001172,172.31.40.0-255,66,219413,77,329533
12338,0.00119,172.217.194.0-255,2902,222315,77,329533
12339,0.001192,172.31.40.0-255,66,222381,77,329533
12340,0.001201,172.217.194.0-255,7856,230237,77,329533
12341,0.001205,172.31.40.0-255,66,230303,77,329533
12342,0.001323,172.217.194.0-255,1484,231787,77,329533
12343,0.001353,172.217.194.0-255,1484,233271,77,329533
12344,0.001356,172.217.194.0-255,1484,234755,77,329533
12345,0.001365,172.31.40.0-255,66,234821,77,329533
12346,0.001373,172.217.194.0-255,1484,236305,77,329533
12347,0.001378,172.217.194.0-255,2902,239207,77,329533
12348,0.001387,172.217.194.0-255,1484,240691,77,329533
12349,0.001394,172.217.194.0-255,5738,246429,77,329533
12350,0.001431,172.31.40.0-255,66,246495,77,329533
12351,0.001456,172.217.194.0-255,11410,257905,77,329533
12352,0.001463,172.217.194.0-255,6438,264343,77,329533
12353,0.001488,172.31.40.0-255,66,264409,77,329533
12354,0.001508,172.217.194.0-255,1484,265893,77,329533
12355,0.001528,172.217.194.0-255,2902,268795,77,329533
12356,0.001531,172.31.40.0-255,66,268861,77,329533
12357,0.001537,172.217.194.0-255,5738,274599,77,329533
12358,0.001551,172.217.194.0-255,4320,278919,77,329533
12359,0.001566,172.217.194.0-255,8574,287493,77,329533
12360,0.001574,172.31.40.0-255,66,287559,77,329533
12361,0.001599,172.217.194.0-255,7156,294715,77,329533
12362,0.001621,172.217.194.0-255,12110,306825,77,329533
12363,0.001644,172.217.194.0-255,4320,311145,77,329533
12364,0.001654,172.31.40.0-255,66,311211,77,329533
12365,0.001668,172.217.194.0-255,7856,319067,77,329533
12366,0.001673,172.31.40.0-255,66,319133,77,329533
12367,0.00171,172.217.194.0-255,9992,329125,77,329533
12368,0.001724,172.31.40.0-255,66,329191,77,329533
12369,0.00176,172.217.194.0-255,105,329296,77,329533
12370,0.001778,172.31.40.0-255,66,329362,77,329533
12371,0.004484,172.31.40.0-255,105,329467,77,329533
12372,0.006758,172.217.194.0-255,66,329533,77,329533
12373,0.0,172.217.194.0-255,146,146,77,250383
12374,2.4e-05,172.31.40.0-255,66,212,77,250383
12375,3.1e-05,172.217.194.0-255,1484,1696,77,250383
12376,3.5e-05,172.31.40.0-255,66,1762,77,250383
12377,4.1e-05,172.217.194.0-255,2902,4664,77,250383
12378,4.5e-05,172.31.40.0-255,66,4730,77,250383
12379,6e-05,172.217.194.0-255,7156,11886,77,250383
12380,6.4e-05,172.31.40.0-255,66,11952,77,250383
12381,0.000133,172.217.194.0-255,2902,14854,77,250383
12382,0.000136,172.31.40.0-255,66,14920,77,250383
12383,0.000149,172.217.194.0-255,2147,17067,77,250383
12384,0.000159,172.31.40.0-255,66,17133,77,250383
12385,0.000202,172.217.194.0-255,8574,25707,77,250383
12386,0.000205,172.31.40.0-255,66,25773,77,250383
12387,0.00023,172.217.194.0-255,5379,31152,77,250383
12388,0.000234,172.31.40.0-255,66,31218,77,250383
12389,0.000376,172.217.194.0-255,5738,36956,77,250383
12390,0.00038,172.31.40.0-255,66,37022,77,250383
12391,0.000422,172.217.194.0-255,11051,48073,77,250383
12392,0.000426,172.31.40.0-255,66,48139,77,250383
12393,0.000588,172.217.194.0-255,2902,51041,77,250383
12394,0.000592,172.31.40.0-255,66,51107,77,250383
12395,0.000639,172.31.40.0-255,66,51173,77,250383
12396,0.000788,172.217.194.0-255,382,51555,77,250383
12397,0.000793,172.31.40.0-255,66,51621,77,250383
12398,0.001278,172.217.194.0-255,1484,53105,77,250383
12399,0.001282,172.31.40.0-255,66,53171,77,250383
12400,0.001288,172.217.194.0-255,2902,56073,77,250383
12401,0.001291,172.31.40.0-255,66,56139,77,250383
12402,0.001322,172.217.194.0-255,5738,61877,77,250383
12403,0.001325,172.31.40.0-255,66,61943,77,250383
12404,0.001385,172.217.194.0-255,2902,64845,77,250383
12405,0.001401,172.217.194.0-255,3961,68806,77,250383
12406,0.001469,172.217.194.0-255,1484,70290,77,250383
12407,0.001495,172.217.194.0-255,5738,76028,77,250383
12408,0.001561,172.217.194.0-255,5738,81766,77,250383
12409,0.001588,172.217.194.0-255,9992,91758,77,250383
12410,0.001756,172.217.194.0-255,2902,94660,77,250383
12411,0.001772,172.217.194.0-255,5738,100398,77,250383
12412,0.001793,172.217.194.0-255,2184,102582,77,250383
12413,0.001923,172.217.194.0-255,4320,106902,77,250383
12414,0.001948,172.217.194.0-255,12469,119371,77,250383
12415,0.002103,172.217.194.0-255,4320,123691,77,250383
12416,0.002158,172.217.194.0-255,2902,126593,77,250383
12417,0.002181,172.217.194.0-255,9992,136585,77,250383
12418,0.002475,172.31.40.0-255,66,136651,77,250383
12419,0.002527,172.217.194.0-255,2902,139553,77,250383
12420,0.002559,172.217.194.0-255,5738,145291,77,250383
12421,0.002577,172.217.194.0-255,1484,146775,77,250383
12422,0.002623,172.217.194.0-255,4320,151095,77,250383
12423,0.00267,172.217.194.0-255,5020,156115,77,250383
12424,0.002767,172.31.40.0-255,66,156181,77,250383
12425,0.003047,172.217.194.0-255,1484,157665,77,250383
12426,0.003054,172.217.194.0-255,2902,160567,77,250383
12427,0.003068,172.31.40.0-255,66,160633,77,250383
12428,0.003072,172.217.194.0-255,1484,162117,77,250383
12429,0.003099,172.217.194.0-255,4320,166437,77,250383
12430,0.00311,172.31.40.0-255,66,166503,77,250383
12431,0.003142,172.217.194.0-255,9992,176495,77,250383
12432,0.003157,172.217.194.0-255,2902,179397,77,250383
12433,0.003173,172.31.40.0-255,66,179463,77,250383
12434,0.00326,172.217.194.0-255,8574,188037,77,250383
12435,0.003274,172.217.194.0-255,2184,190221,77,250383
12436,0.003287,172.31.40.0-255,66,190287,77,250383
12437,0.003356,172.217.194.0-255,1484,191771,77,250383
12438,0.003376,172.217.194.0-255,2902,194673,77,250383
12439,0.003386,172.31.40.0-255,66,194739,77,250383
12440,0.003419,172.217.194.0-255,1484,196223,77,250383
12441,0.003428,172.217.194.0-255,8574,204797,77,250383
12442,0.003446,172.31.40.0-255,66,204863,77,250383
12443,0.003507,172.217.194.0-255,5738,210601,77,250383
12444,0.003513,172.31.40.0-255,66,210667,77,250383
12445,0.003554,172.217.194.0-255,12828,223495,77,250383
12446,0.003573,172.31.40.0-255,66,223561,77,250383
12447,0.003685,172.217.194.0-255,766,224327,77,250383
12448,0.003702,172.217.194.0-255,2902,227229,77,250383
12449,0.003708,172.31.40.0-255,66,227295,77,250383
12450,0.003812,172.31.40.0-255,66,227361,77,250383
12451,0.004052,172.217.194.0-255,5738,233099,77,250383
12452,0.004057,172.31.40.0-255,66,233165,77,250383
12453,0.004136,172.217.194.0-255,9274,242439,77,250383
12454,0.00415,172.31.40.0-255,66,242505,77,250383
12455,0.004615,172.217.194.0-255,5738,248243,77,250383
12456,0.004619,172.31.40.0-255,66,248309,77,250383
12457,0.004691,172.31.40.0-255,66,248375,77,250383
12458,0.004709,172.217.194.0-255,1771,250146,77,250383
12459,0.004721,172.31.40.0-255,66,250212,77,250383
12460,0.011105,172.31.40.0-255,105,250317,77,250383
12461,0.013106,172.217.194.0-255,66,250383,77,250383
12462,0.0,74.125.24.0-255,148,148,77,202026
12463,2.3e-05,172.31.40.0-255,66,214,77,202026
12464,2.9e-05,74.125.24.0-255,1484,1698,77,202026
12465,3.4e-05,172.31.40.0-255,66,1764,77,202026
12466,4e-05,74.125.24.0-255,2902,4666,77,202026
12467,4.4e-05,172.31.40.0-255,66,4732,77,202026
12468,5.1e-05,74.125.24.0-255,5738,10470,77,202026
12469,5.4e-05,172.31.40.0-255,66,10536,77,202026
12470,7.6e-05,74.125.24.0-255,1484,12020,77,202026
12471,7.9e-05,172.31.40.0-255,66,12086,77,202026
12472,0.000147,74.125.24.0-255,2073,14159,77,202026
12473,0.00015,172.31.40.0-255,66,14225,77,202026
12474,0.000175,74.125.24.0-255,1484,15709,77,202026
12475,0.000178,172.31.40.0-255,66,15775,77,202026
12476,0.000191,74.125.24.0-255,1484,17259,77,202026
12477,0.000193,172.31.40.0-255,66,17325,77,202026
12478,0.000197,74.125.24.0-255,1484,18809,77,202026
12479,0.000199,172.31.40.0-255,66,18875,77,202026
12480,0.000227,74.125.24.0-255,5738,24613,77,202026
12481,0.00023,172.31.40.0-255,66,24679,77,202026
12482,0.000294,74.125.24.0-255,2902,27581,77,202026
12483,0.000297,172.31.40.0-255,66,27647,77,202026
12484,0.000314,74.125.24.0-255,1484,29131,77,202026
12485,0.000317,172.31.40.0-255,66,29197,77,202026
12486,0.000352,74.125.24.0-255,2543,31740,77,202026
12487,0.000355,172.31.40.0-255,66,31806,77,202026
12488,0.000386,74.125.24.0-255,2902,34708,77,202026
12489,0.000389,172.31.40.0-255,66,34774,77,202026
12490,0.000428,74.125.24.0-255,4320,39094,77,202026
12491,0.000432,172.31.40.0-255,66,39160,77,202026
12492,0.000447,74.125.24.0-255,2902,42062,77,202026
12493,0.000449,172.31.40.0-255,66,42128,77,202026
12494,0.000529,74.125.24.0-255,6797,48925,77,202026
12495,0.000552,172.31.40.0-255,66,48991,77,202026
12496,0.000607,74.125.24.0-255,4320,53311,77,202026
12497,0.000613,172.31.40.0-255,66,53377,77,202026
12498,0.00063,74.125.24.0-255,11410,64787,77,202026
12499,0.000644,74.125.24.0-255,1125,65912,77,202026
12500,0.000657,172.31.40.0-255,66,65978,77,202026
12501,0.000812,74.125.24.0-255,646,66624,77,202026
12502,0.000949,74.125.24.0-255,1484,68108,77,202026
12503,0.000958,172.31.40.0-255,66,68174,77,202026
12504,0.000967,74.125.24.0-255,2902,71076,77,202026
12505,0.000972,172.31.40.0-255,66,71142,77,202026
12506,0.000991,74.125.24.0-255,2902,74044,77,202026
12507,0.001006,74.125.24.0-255,2902,76946,77,202026
12508,0.001014,172.31.40.0-255,66,77012,77,202026
12509,0.001067,74.125.24.0-255,5738,82750,77,202026
12510,0.001081,74.125.24.0-255,1484,84234,77,202026
12511,0.001086,172.31.40.0-255,66,84300,77,202026
12512,0.00115,74.125.24.0-255,7156,91456,77,202026
12513,0.001154,172.31.40.0-255,66,91522,77,202026
12514,0.001174,74.125.24.0-255,2902,94424,77,202026
12515,0.001179,172.31.40.0-255,66,94490,77,202026
12516,0.001275,74.125.24.0-255,6438,100928,77,202026
12517,0.001294,172.31.40.0-255,66,100994,77,202026
12518,0.001445,74.125.24.0-255,1484,102478,77,202026
12519,0.00146,74.125.24.0-255,2902,105380,77,202026
12520,0.001463,172.31.40.0-255,66,105446,77,202026
12521,0.001487,74.125.24.0-255,5738,111184,77,202026
12522,0.001496,172.31.40.0-255,66,111250,77,202026
12523,0.001557,74.125.24.0-255,4320,115570,77,202026
12524,0.001564,172.31.40.0-255,66,115636,77,202026
12525,0.001571,74.125.24.0-255,1484,117120,77,202026
12526,0.001629,74.125.24.0-255,4320,121440,77,202026
12527,0.001633,172.31.40.0-255,66,121506,77,202026
12528,0.001658,74.125.24.0-255,8574,130080,77,202026
12529,0.001663,172.31.40.0-255,66,130146,77,202026
12530,0.001818,74.125.24.0-255,4320,134466,77,202026
12531,0.001822,172.31.40.0-255,66,134532,77,202026
12532,0.001842,74.125.24.0-255,766,135298,77,202026
12533,0.001866,74.125.24.0-255,2902,138200,77,202026
12534,0.001871,172.31.40.0-255,66,138266,77,202026
12535,0.001912,172.31.40.0-255,66,138332,77,202026
12536,0.002141,74.125.24.0-255,2902,141234,77,202026
12537,0.002146,172.31.40.0-255,66,141300,77,202026
12538,0.00218,74.125.24.0-255,9274,150574,77,202026
12539,0.002197,172.31.40.0-255,66,150640,77,202026
12540,0.002306,74.125.24.0-255,5738,156378,77,202026
12541,0.00231,172.31.40.0-255,66,156444,77,202026
12542,0.002339,74.125.24.0-255,7156,163600,77,202026
12543,0.00235,172.31.40.0-255,66,163666,77,202026
12544,0.002475,74.125.24.0-255,8574,172240,77,202026
12545,0.002479,172.31.40.0-255,66,172306,77,202026
12546,0.002518,172.31.40.0-255,66,172372,77,202026
12547,0.002825,74.125.24.0-255,12828,185200,77,202026
12548,0.00283,172.31.40.0-255,66,185266,77,202026
12549,0.003289,74.125.24.0-255,5020,190286,77,202026
12550,0.011188,172.31.40.0-255,66,190352,77,202026
12551,0.011928,74.125.24.0-255,1484,191836,77,202026
12552,0.013495,74.125.24.0-255,4320,196156,77,202026
12553,0.013508,172.31.40.0-255,66,196222,77,202026
12554,0.015883,74.125.24.0-255,5738,201960,77,202026
12555,0.019115,172.31.40.0-255,66,202026,77,202026
12556,0.0,74.125.24.0-255,153,153,77,329883
12557,2.2e-05,172.31.40.0-255,66,219,77,329883
12558,2.9e-05,74.125.24.0-255,1484,1703,77,329883
12559,3.4e-05,172.31.40.0-255,66,1769,77,329883
12560,4e-05,74.125.24.0-255,2902,4671,77,329883
12561,4.3e-05,172.31.40.0-255,66,4737,77,329883
12562,5.1e-05,74.125.24.0-255,7156,11893,77,329883
12563,5.4e-05,172.31.40.0-255,66,11959,77,329883
12564,5.8e-05,74.125.24.0-255,1484,13443,77,329883
12565,6.1e-05,172.31.40.0-255,66,13509,77,329883
12566,8.2e-05,74.125.24.0-255,2029,15538,77,329883
12567,8.5e-05,172.31.40.0-255,66,15604,77,329883
12568,9.1e-05,74.125.24.0-255,4320,19924,77,329883
12569,9.4e-05,172.31.40.0-255,66,19990,77,329883
12570,0.000118,74.125.24.0-255,5738,25728,77,329883
12571,0.000121,172.31.40.0-255,66,25794,77,329883
12572,0.000147,74.125.24.0-255,4320,30114,77,329883
12573,0.00015,172.31.40.0-255,66,30180,77,329883
12574,0.000162,74.125.24.0-255,1484,31664,77,329883
12575,0.000164,172.31.40.0-255,66,31730,77,329883
12576,0.00019,74.125.24.0-255,9992,41722,77,329883
12577,0.000193,172.31.40.0-255,66,41788,77,329883
12578,0.0002,74.125.24.0-255,6438,48226,77,329883
12579,0.000202,172.31.40.0-255,66,48292,77,329883
12580,0.000774,74.125.24.0-255,1484,49776,77,329883
12581,0.000781,172.31.40.0-255,66,49842,77,329883
12582,0.000788,74.125.24.0-255,2902,52744,77,329883
12583,0.00079,172.31.40.0-255,66,52810,77,329883
12584,0.000806,74.125.24.0-255,2902,55712,77,329883
12585,0.000808,172.31.40.0-255,66,55778,77,329883
12586,0.000829,74.125.24.0-255,2902,58680,77,329883
12587,0.000831,172.31.40.0-255,66,58746,77,329883
12588,0.000873,74.125.24.0-255,1484,60230,77,329883
12589,0.000899,74.125.24.0-255,5734,65964,77,329883
12590,0.000902,172.31.40.0-255,66,66030,77,329883
12591,0.001453,74.125.24.0-255,1484,67514,77,329883
12592,0.001461,74.125.24.0-255,2902,70416,77,329883
12593,0.001466,172.31.40.0-255,66,70482,77,329883
12594,0.001471,74.125.24.0-255,1484,71966,77,329883
12595,0.00149,74.125.24.0-255,4320,76286,77,329883
12596,0.001493,172.31.40.0-255,66,76352,77,329883
12597,0.001513,74.125.24.0-255,8574,84926,77,329883
12598,0.001515,172.31.40.0-255,66,84992,77,329883
12599,0.001534,74.125.24.0-255,4320,89312,77,329883
12600,0.001537,172.31.40.0-255,66,89378,77,329883
12601,0.001547,74.125.24.0-255,10692,100070,77,329883
12602,0.001549,172.31.40.0-255,66,100136,77,329883
12603,0.002245,74.125.24.0-255,1484,101620,77,329883
12604,0.002254,74.125.24.0-255,2902,104522,77,329883
12605,0.002258,172.31.40.0-255,66,104588,77,329883
12606,0.002287,74.125.24.0-255,5738,110326,77,329883
12607,0.002289,172.31.40.0-255,66,110392,77,329883
12608,0.002296,74.125.24.0-255,5738,116130,77,329883
12609,0.002298,172.31.40.0-255,66,116196,77,329883
12610,0.002316,74.125.24.0-255,7156,123352,77,329883
12611,0.002319,172.31.40.0-255,66,123418,77,329883
12612,0.002327,74.125.24.0-255,7156,130574,77,329883
12613,0.002329,172.31.40.0-255,66,130640,77,329883
12614,0.002349,74.125.24.0-255,3602,134242,77,329883
12615,0.002352,172.31.40.0-255,66,134308,77,329883
12616,0.002417,172.31.40.0-255,66,134374,77,329883
12617,0.002427,74.125.24.0-255,10692,145066,77,329883
12618,0.00243,172.31.40.0-255,66,145132,77,329883
12619,0.003011,74.125.24.0-255,1484,146616,77,329883
12620,0.003025,74.125.24.0-255,2902,149518,77,329883
12621,0.003027,172.31.40.0-255,66,149584,77,329883
12622,0.003043,74.125.24.0-255,2902,152486,77,329883
12623,0.003046,172.31.40.0-255,66,152552,77,329883
12624,0.003058,74.125.24.0-255,2902,155454,77,329883
12625,0.003062,172.31.40.0-255,66,155520,77,329883
12626,0.003067,74.125.24.0-255,4320,159840,77,329883
12627,0.003069,172.31.40.0-255,66,159906,77,329883
12628,0.003093,74.125.24.0-255,8574,168480,77,329883
12629,0.003096,172.31.40.0-255,66,168546,77,329883
12630,0.003119,74.125.24.0-255,2902,171448,77,329883
12631,0.003121,172.31.40.0-255,66,171514,77,329883
12632,0.003135,74.125.24.0-255,5738,177252,77,329883
12633,0.003138,172.31.40.0-255,66,177318,77,329883
12634,0.003152,74.125.24.0-255,2184,179502,77,329883
12635,0.003154,172.31.40.0-255,66,179568,77,329883
12636,0.003782,74.125.24.0-255,1484,181052,77,329883
12637,0.003799,74.125.24.0-255,2902,183954,77,329883
12638,0.003803,172.31.40.0-255,66,184020,77,329883
12639,0.003807,74.125.24.0-255,2902,186922,77,329883
12640,0.00381,172.31.40.0-255,66,186988,77,329883
12641,0.003825,74.125.24.0-255,2902,189890,77,329883
12642,0.003828,172.31.40.0-255,66,189956,77,329883
12643,0.003832,74.125.24.0-255,2902,192858,77,329883
12644,0.003835,172.31.40.0-255,66,192924,77,329883
12645,0.003861,74.125.24.0-255,7156,200080,77,329883
12646,0.003864,172.31.40.0-255,66,200146,77,329883
12647,0.0039,74.125.24.0-255,5738,205884,77,329883
12648,0.003902,172.31.40.0-255,66,205950,77,329883
12649,0.003929,74.125.24.0-255,12110,218060,77,329883
12650,0.003932,172.31.40.0-255,66,218126,77,329883
12651,0.003941,74.125.24.0-255,9992,228118,77,329883
12652,0.003943,172.31.40.0-255,66,228184,77,329883
12653,0.003993,74.125.24.0-255,8574,236758,77,329883
12654,0.003996,172.31.40.0-255,66,236824,77,329883
12655,0.004007,74.125.24.0-255,10692,247516,77,329883
12656,0.004009,172.31.40.0-255,66,247582,77,329883
12657,0.004065,74.125.24.0-255,1484,249066,77,329883
12658,0.004082,74.125.24.0-255,2902,251968,77,329883
12659,0.004085,172.31.40.0-255,66,252034,77,329883
12660,0.004123,74.125.24.0-255,4320,256354,77,329883
12661,0.004126,172.31.40.0-255,66,256420,77,329883
12662,0.004129,74.125.24.0-255,1484,257904,77,329883
12663,0.004133,74.125.24.0-255,1484,259388,77,329883
12664,0.004135,172.31.40.0-255,66,259454,77,329883
12665,0.004141,74.125.24.0-255,4320,263774,77,329883
12666,0.004144,172.31.40.0-255,66,263840,77,329883
12667,0.004152,74.125.24.0-255,7156,270996,77,329883
12668,0.004154,172.31.40.0-255,66,271062,77,329883
12669,0.004157,74.125.24.0-255,1484,272546,77,329883
12670,0.004182,74.125.24.0-255,5738,278284,77,329883
12671,0.004185,172.31.40.0-255,66,278350,77,329883
12672,0.004207,74.125.24.0-255,3602,281952,77,329883
12673,0.00421,172.31.40.0-255,66,282018,77,329883
12674,0.004251,74.125.24.0-255,2902,284920,77,329883
12675,0.004254,172.31.40.0-255,66,284986,77,329883
12676,0.00426,74.125.24.0-255,4320,289306,77,329883
12677,0.004262,172.31.40.0-255,66,289372,77,329883
12678,0.004276,74.125.24.0-255,2902,292274,77,329883
12679,0.004279,172.31.40.0-255,66,292340,77,329883
12680,0.0043,74.125.24.0-255,5738,298078,77,329883
12681,0.004303,172.31.40.0-255,66,298144,77,329883
12682,0.004348,74.125.24.0-255,7156,305300,77,329883
12683,0.00435,172.31.40.0-255,66,305366,77,329883
12684,0.004369,74.125.24.0-255,2902,308268,77,329883
12685,0.004371,172.31.40.0-255,66,308334,77,329883
12686,0.004386,172.31.40.0-255,66,308400,77,329883
12687,0.004408,74.125.24.0-255,3602,312002,77,329883
12688,0.00441,172.31.40.0-255,66,312068,77,329883
12689,0.004427,172.31.40.0-255,66,312134,77,329883
12690,0.004456,74.125.24.0-255,2902,315036,77,329883
12691,0.00446,172.31.40.0-255,66,315102,77,329883
12692,0.004466,74.125.24.0-255,5020,320122,77,329883
12693,0.004468,172.31.40.0-255,66,320188,77,329883
12694,0.004482,172.31.40.0-255,66,320254,77,329883
12695,0.004514,74.125.24.0-255,1484,321738,77,329883
12696,0.004531,172.31.40.0-255,66,321804,77,329883
12697,0.004535,74.125.24.0-255,2184,323988,77,329883
12698,0.004537,172.31.40.0-255,66,324054,77,329883
12699,0.004578,74.125.24.0-255,5421,329475,77,329883
12700,0.004582,172.31.40.0-255,66,329541,77,329883
12701,0.004611,74.125.24.0-255,105,329646,77,329883
12702,0.007427,172.31.40.0-255,66,329712,77,329883
12703,0.007465,172.31.40.0-255,105,329817,77,329883
12704,0.010012,74.125.24.0-255,66,329883,77,329883
12705,0.0,172.217.194.0-255,153,153,77,342935
12706,3.1e-05,172.31.40.0-255,66,219,77,342935
12707,3.7e-05,172.217.194.0-255,1484,1703,77,342935
12708,4.1e-05,172.31.40.0-255,66,1769,77,342935
12709,4.6e-05,172.217.194.0-255,2902,4671,77,342935
12710,4.9e-05,172.31.40.0-255,66,4737,77,342935
12711,6.4e-05,172.217.194.0-255,7156,11893,77,342935
12712,6.6e-05,172.31.40.0-255,66,11959,77,342935
12713,7e-05,172.217.194.0-255,1983,13942,77,342935
12714,7.3e-05,172.31.40.0-255,66,14008,77,342935
12715,7.8e-05,172.217.194.0-255,2902,16910,77,342935
12716,8e-05,172.31.40.0-255,66,16976,77,342935
12717,0.000117,172.217.194.0-255,8574,25550,77,342935
12718,0.00012,172.31.40.0-255,66,25616,77,342935
12719,0.000126,172.217.194.0-255,5379,30995,77,342935
12720,0.000128,172.31.40.0-255,66,31061,77,342935
12721,0.000234,172.217.194.0-255,1484,32545,77,342935
12722,0.000238,172.31.40.0-255,66,32611,77,342935
12723,0.000243,172.217.194.0-255,1484,34095,77,342935
12724,0.000246,172.31.40.0-255,66,34161,77,342935
12725,0.000291,172.217.194.0-255,1484,35645,77,342935
12726,0.000295,172.31.40.0-255,66,35711,77,342935
12727,0.000305,172.217.194.0-255,4320,40031,77,342935
12728,0.000308,172.31.40.0-255,66,40097,77,342935
12729,0.000313,172.217.194.0-255,5738,45835,77,342935
12730,0.000316,172.31.40.0-255,66,45901,77,342935
12731,0.000325,172.217.194.0-255,11410,57311,77,342935
12732,0.000327,172.31.40.0-255,66,57377,77,342935
12733,0.000334,172.217.194.0-255,7856,65233,77,342935
12734,0.000338,172.31.40.0-255,66,65299,77,342935
12735,0.00034,172.217.194.0-255,676,65975,77,342935
12736,0.000343,172.31.40.0-255,66,66041,77,342935
12737,0.000429,172.217.194.0-255,1484,67525,77,342935
12738,0.000436,172.217.194.0-255,2902,70427,77,342935
12739,0.000439,172.31.40.0-255,66,70493,77,342935
12740,0.000446,172.217.194.0-255,5738,76231,77,342935
12741,0.000451,172.31.40.0-255,66,76297,77,342935
12742,0.000483,172.217.194.0-255,5738,82035,77,342935
12743,0.000487,172.31.40.0-255,66,82101,77,342935
12744,0.000497,172.217.194.0-255,12828,94929,77,342935
12745,0.0005,172.31.40.0-255,66,94995,77,342935
12746,0.000524,172.217.194.0-255,5020,100015,77,342935
12747,0.000527,172.31.40.0-255,66,100081,77,342935
12748,0.000651,172.217.194.0-255,1484,101565,77,342935
12749,0.000677,172.217.194.0-255,1484,103049,77,342935
12750,0.00068,172.31.40.0-255,66,103115,77,342935
12751,0.000707,172.217.194.0-255,1484,104599,77,342935
12752,0.000713,172.217.194.0-255,5738,110337,77,342935
12753,0.000715,172.31.40.0-255,66,110403,77,342935
12754,0.000725,172.217.194.0-255,12828,123231,77,342935
12755,0.000727,172.31.40.0-255,66,123297,77,342935
12756,0.000734,172.217.194.0-255,7156,130453,77,342935
12757,0.000741,172.31.40.0-255,66,130519,77,342935
12758,0.000768,172.217.194.0-255,3602,134121,77,342935
12759,0.00077,172.31.40.0-255,66,134187,77,342935
12760,0.000932,172.217.194.0-255,1484,135671,77,342935
12761,0.000937,172.217.194.0-255,2902,138573,77,342935
12762,0.000939,172.31.40.0-255,66,138639,77,342935
12763,0.000969,172.217.194.0-255,5738,144377,77,342935
12764,0.000972,172.31.40.0-255,66,144443,77,342935
12765,0.000979,172.217.194.0-255,8574,153017,77,342935
12766,0.000981,172.31.40.0-255,66,153083,77,342935
12767,0.001029,172.217.194.0-255,12828,165911,77,342935
12768,0.001033,172.31.40.0-255,66,165977,77,342935
12769,0.001067,172.217.194.0-255,3602,169579,77,342935
12770,0.00107,172.31.40.0-255,66,169645,77,342935
12771,0.001076,172.217.194.0-255,8574,178219,77,342935
12772,0.001078,172.31.40.0-255,66,178285,77,342935
12773,0.001103,172.217.194.0-255,1484,179769,77,342935
12774,0.001126,172.217.194.0-255,11410,191179,77,342935
12775,0.001129,172.31.40.0-255,66,191245,77,342935
12776,0.001158,172.217.194.0-255,10692,201937,77,342935
12777,0.001161,172.31.40.0-255,66,202003,77,342935
12778,0.001379,172.217.194.0-255,1484,203487,77,342935
12779,0.001382,172.217.194.0-255,1484,204971,77,342935
12780,0.001385,172.31.40.0-255,66,205037,77,342935
12781,0.001399,172.217.194.0-255,1484,206521,77,342935
12782,0.001409,172.217.194.0-255,5738,212259,77,342935
12783,0.001411,172.31.40.0-255,66,212325,77,342935
12784,0.001441,172.217.194.0-255,7156,219481,77,342935
12785,0.001445,172.31.40.0-255,66,219547,77,342935
12786,0.001474,172.217.194.0-255,5738,225285,77,342935
12787,0.001478,172.217.194.0-255,5738,231023,77,342935
12788,0.001478,172.31.40.0-255,66,231089,77,342935
12789,0.001482,172.31.40.0-255,66,231155,77,342935
12790,0.001491,172.217.194.0-255,5020,236175,77,342935
12791,0.001493,172.31.40.0-255,66,236241,77,342935
12792,0.001534,172.217.194.0-255,2902,239143,77,342935
12793,0.001537,172.31.40.0-255,66,239209,77,342935
12794,0.001561,172.217.194.0-255,2902,242111,77,342935
12795,0.001563,172.31.40.0-255,66,242177,77,342935
12796,0.001566,172.217.194.0-255,1484,243661,77,342935
12797,0.001572,172.217.194.0-255,8574,252235,77,342935
12798,0.001574,172.31.40.0-255,66,252301,77,342935
12799,0.001623,172.31.40.0-255,66,252367,77,342935
12800,0.001635,172.31.40.0-255,66,252433,77,342935
12801,0.001713,172.31.40.0-255,66,252499,77,342935
12802,0.00172,172.217.194.0-255,5738,258237,77,342935
12803,0.001724,172.31.40.0-255,66,258303,77,342935
12804,0.00176,172.217.194.0-255,12828,271131,77,342935
12805,0.001764,172.31.40.0-255,66,271197,77,342935
12806,0.001768,172.217.194.0-255,2902,274099,77,342935
12807,0.00177,172.31.40.0-255,66,274165,77,342935
12808,0.001804,172.217.194.0-255,12110,286275,77,342935
12809,0.001807,172.31.40.0-255,66,286341,77,342935
12810,0.002395,172.217.194.0-255,1484,287825,77,342935
12811,0.002418,172.217.194.0-255,2902,290727,77,342935
12812,0.002423,172.31.40.0-255,66,290793,77,342935
12813,0.002427,172.217.194.0-255,2902,293695,77,342935
12814,0.002429,172.31.40.0-255,66,293761,77,342935
12815,0.002435,172.217.194.0-255,4320,298081,77,342935
12816,0.002437,172.31.40.0-255,66,298147,77,342935
12817,0.002477,172.217.194.0-255,8574,306721,77,342935
12818,0.00248,172.31.40.0-255,66,306787,77,342935
12819,0.002491,172.217.194.0-255,13528,320315,77,342935
12820,0.002495,172.31.40.0-255,66,320381,77,342935
12821,0.002514,172.217.194.0-255,7156,327537,77,342935
12822,0.002518,172.31.40.0-255,66,327603,77,342935
12823,0.002563,172.217.194.0-255,7156,334759,77,342935
12824,0.002566,172.31.40.0-255,66,334825,77,342935
12825,0.002582,172.31.40.0-255,66,334891,77,342935
12826,0.002589,172.217.194.0-255,7156,342047,77,342935
12827,0.002595,172.31.40.0-255,66,342113,77,342935
12828,0.002617,172.217.194.0-255,414,342527,77,342935
12829,0.003323,172.31.40.0-255,66,342593,77,342935
12830,0.005101,172.217.194.0-255,105,342698,77,342935
12831,0.008393,172.31.40.0-255,66,342764,77,342935
12832,0.008427,172.31.40.0-255,105,342869,77,342935
12833,0.010918,172.217.194.0-255,66,342935,77,342935
12834,0.0,172.217.194.0-255,152,152,77,208087
12835,2.3e-05,172.31.40.0-255,66,218,77,208087
12836,3.1e-05,172.217.194.0-255,1484,1702,77,208087
12837,3.4e-05,172.31.40.0-255,66,1768,77,208087
12838,4e-05,172.217.194.0-255,2902,4670,77,208087
12839,5.1e-05,172.31.40.0-255,66,4736,77,208087
12840,5.9e-05,172.217.194.0-255,7156,11892,77,208087
12841,6.2e-05,172.31.40.0-255,66,11958,77,208087
12842,6.6e-05,172.217.194.0-255,2136,14094,77,208087
12843,6.9e-05,172.31.40.0-255,66,14160,77,208087
12844,0.000235,172.217.194.0-255,1484,15644,77,208087
12845,0.00024,172.31.40.0-255,66,15710,77,208087
12846,0.000247,172.217.194.0-255,2902,18612,77,208087
12847,0.00025,172.31.40.0-255,66,18678,77,208087
12848,0.000284,172.217.194.0-255,5738,24416,77,208087
12849,0.000287,172.31.40.0-255,66,24482,77,208087
12850,0.000318,172.217.194.0-255,6797,31279,77,208087
12851,0.000321,172.31.40.0-255,66,31345,77,208087
12852,0.000392,172.217.194.0-255,4320,35665,77,208087
12853,0.000396,172.31.40.0-255,66,35731,77,208087
12854,0.000427,172.217.194.0-255,5738,41469,77,208087
12855,0.000431,172.31.40.0-255,66,41535,77,208087
12856,0.000454,172.217.194.0-255,9633,51168,77,208087
12857,0.000456,172.31.40.0-255,66,51234,77,208087
12858,0.000489,172.217.194.0-255,9992,61226,77,208087
12859,0.000492,172.31.40.0-255,66,61292,77,208087
12860,0.000498,172.217.194.0-255,3961,65253,77,208087
12861,0.0005,172.31.40.0-255,66,65319,77,208087
12862,0.000515,172.217.194.0-255,360,65679,77,208087
12863,0.000518,172.31.40.0-255,66,65745,77,208087
12864,0.000631,172.217.194.0-255,383,66128,77,208087
12865,0.000636,172.31.40.0-255,66,66194,77,208087
12866,0.000946,172.217.194.0-255,1484,67678,77,208087
12867,0.000951,172.217.194.0-255,1484,69162,77,208087
12868,0.000955,172.31.40.0-255,66,69228,77,208087
12869,0.000987,172.217.194.0-255,1484,70712,77,208087
12870,0.000994,172.217.194.0-255,5738,76450,77,208087
12871,0.000997,172.31.40.0-255,66,76516,77,208087
12872,0.001008,172.217.194.0-255,12828,89344,77,208087
12873,0.00101,172.31.40.0-255,66,89410,77,208087
12874,0.001024,172.217.194.0-255,8574,97984,77,208087
12875,0.001027,172.31.40.0-255,66,98050,77,208087
12876,0.001069,172.217.194.0-255,2184,100234,77,208087
12877,0.001071,172.31.40.0-255,66,100300,77,208087
12878,0.001184,172.31.40.0-255,101,100401,77,208087
12879,0.00162,172.217.194.0-255,1484,101885,77,208087
12880,0.001634,172.217.194.0-255,2902,104787,77,208087
12881,0.001638,172.31.40.0-255,66,104853,77,208087
12882,0.001645,172.217.194.0-255,4320,109173,77,208087
12883,0.001647,172.31.40.0-255,66,109239,77,208087
12884,0.001677,172.217.194.0-255,8574,117813,77,208087
12885,0.00168,172.31.40.0-255,66,117879,77,208087
12886,0.001714,172.217.194.0-255,5738,123617,77,208087
12887,0.001717,172.31.40.0-255,66,123683,77,208087
12888,0.001748,172.217.194.0-255,8574,132257,77,208087
12889,0.00175,172.31.40.0-255,66,132323,77,208087
12890,0.001755,172.217.194.0-255,2184,134507,77,208087
12891,0.001757,172.31.40.0-255,66,134573,77,208087
12892,0.002325,172.217.194.0-255,1484,136057,77,208087
12893,0.002336,172.217.194.0-255,2902,138959,77,208087
12894,0.002341,172.31.40.0-255,66,139025,77,208087
12895,0.002347,172.217.194.0-255,2902,141927,77,208087
12896,0.002349,172.31.40.0-255,66,141993,77,208087
12897,0.002381,172.217.194.0-255,2902,144895,77,208087
12898,0.002384,172.31.40.0-255,66,144961,77,208087
12899,0.002397,172.217.194.0-255,12828,157789,77,208087
12900,0.002399,172.31.40.0-255,66,157855,77,208087
12901,0.002423,172.217.194.0-255,1484,159339,77,208087
12902,0.002454,172.217.194.0-255,9274,168613,77,208087
12903,0.002457,172.31.40.0-255,66,168679,77,208087
12904,0.002609,172.217.194.0-255,1484,170163,77,208087
12905,0.002617,172.217.194.0-255,2902,173065,77,208087
12906,0.00262,172.31.40.0-255,66,173131,77,208087
12907,0.00374,172.217.194.0-255,66,173197,77,208087
12908,0.005036,172.217.194.0-255,1484,174681,77,208087
12909,0.005205,172.217.194.0-255,4320,179001,77,208087
12910,0.005208,172.31.40.0-255,66,179067,77,208087
12911,0.007793,172.217.194.0-255,5738,184805,77,208087
12912,0.0078,172.31.40.0-255,66,184871,77,208087
12913,0.01045,172.217.194.0-255,5738,190609,77,208087
12914,0.010458,172.31.40.0-255,66,190675,77,208087
12915,0.013045,172.217.194.0-255,5738,196413,77,208087
12916,0.013053,172.31.40.0-255,66,196479,77,208087
12917,0.015662,172.217.194.0-255,5738,202217,77,208087
12918,0.015671,172.31.40.0-255,66,202283,77,208087
12919,0.018285,172.217.194.0-255,5738,208021,77,208087
12920,0.018299,172.31.40.0-255,66,208087,77,208087
12921,0.0,172.217.194.0-255,153,153,77,347186
12922,2.9e-05,172.31.40.0-255,66,219,77,347186
12923,3.8e-05,172.217.194.0-255,1484,1703,77,347186
12924,4.2e-05,172.31.40.0-255,66,1769,77,347186
12925,4.7e-05,172.217.194.0-255,2902,4671,77,347186
12926,5.1e-05,172.31.40.0-255,66,4737,77,347186
12927,5.6e-05,172.217.194.0-255,2902,7639,77,347186
12928,5.9e-05,172.31.40.0-255,66,7705,77,347186
12929,8.1e-05,172.217.194.0-255,2902,10607,77,347186
12930,8.4e-05,172.31.40.0-255,66,10673,77,347186
12931,9.9e-05,172.217.194.0-255,4320,14993,77,347186
12932,0.000101,172.31.40.0-255,66,15059,77,347186
12933,0.000119,172.217.194.0-255,683,15742,77,347186
12934,0.000121,172.31.40.0-255,66,15808,77,347186
12935,0.000128,172.217.194.0-255,5738,21546,77,347186
12936,0.00013,172.31.40.0-255,66,21612,77,347186
12937,0.00014,172.217.194.0-255,9633,31245,77,347186
12938,0.000142,172.31.40.0-255,66,31311,77,347186
12939,0.000187,172.217.194.0-255,1484,32795,77,347186
12940,0.00019,172.31.40.0-255,66,32861,77,347186
12941,0.000194,172.217.194.0-255,2902,35763,77,347186
12942,0.000197,172.31.40.0-255,66,35829,77,347186
12943,0.000204,172.217.194.0-255,5738,41567,77,347186
12944,0.000207,172.31.40.0-255,66,41633,77,347186
12945,0.000256,172.217.194.0-255,13887,55520,77,347186
12946,0.000259,172.31.40.0-255,66,55586,77,347186
12947,0.000262,172.217.194.0-255,1484,57070,77,347186
12948,0.000264,172.31.40.0-255,66,57136,77,347186
12949,0.000287,172.217.194.0-255,2902,60038,77,347186
12950,0.00029,172.31.40.0-255,66,60104,77,347186
12951,0.000311,172.217.194.0-255,5692,65796,77,347186
12952,0.000314,172.31.40.0-255,66,65862,77,347186
12953,0.000317,172.217.194.0-255,364,66226,77,347186
12954,0.00067,172.217.194.0-255,1484,67710,77,347186
12955,0.000675,172.31.40.0-255,66,67776,77,347186
12956,0.000681,172.217.194.0-255,2902,70678,77,347186
12957,0.000684,172.31.40.0-255,66,70744,77,347186
12958,0.00069,172.217.194.0-255,5738,76482,77,347186
12959,0.000693,172.31.40.0-255,66,76548,77,347186
12960,0.00073,172.217.194.0-255,12828,89376,77,347186
12961,0.000734,172.31.40.0-255,66,89442,77,347186
12962,0.000738,172.217.194.0-255,2902,92344,77,347186
12963,0.00074,172.31.40.0-255,66,92410,77,347186
12964,0.000763,172.217.194.0-255,7856,100266,77,347186
12965,0.000766,172.31.40.0-255,66,100332,77,347186
12966,0.000891,172.217.194.0-255,1484,101816,77,347186
12967,0.000897,172.217.194.0-255,2902,104718,77,347186
12968,0.000901,172.31.40.0-255,66,104784,77,347186
12969,0.000908,172.217.194.0-255,5738,110522,77,347186
12970,0.000911,172.31.40.0-255,66,110588,77,347186
12971,0.00095,172.217.194.0-255,12828,123416,77,347186
12972,0.000953,172.31.40.0-255,66,123482,77,347186
12973,0.000964,172.217.194.0-255,10692,134174,77,347186
12974,0.000966,172.31.40.0-255,66,134240,77,347186
12975,0.001324,172.217.194.0-255,1484,135724,77,347186
12976,0.001331,172.217.194.0-255,2902,138626,77,347186
12977,0.001336,172.31.40.0-255,66,138692,77,347186
12978,0.001355,172.217.194.0-255,4320,143012,77,347186
12979,0.001358,172.31.40.0-255,66,143078,77,347186
12980,0.001381,172.217.194.0-255,1484,144562,77,347186
12981,0.001402,172.217.194.0-255,5738,150300,77,347186
12982,0.001405,172.31.40.0-255,66,150366,77,347186
12983,0.001422,172.217.194.0-255,2902,153268,77,347186
12984,0.001424,172.31.40.0-255,66,153334,77,347186
12985,0.00145,172.217.194.0-255,4320,157654,77,347186
12986,0.001452,172.31.40.0-255,66,157720,77,347186
12987,0.001475,172.217.194.0-255,1484,159204,77,347186
12988,0.001482,172.217.194.0-255,7156,166360,77,347186
12989,0.001485,172.31.40.0-255,66,166426,77,347186
12990,0.001489,172.217.194.0-255,2184,168610,77,347186
12991,0.001491,172.31.40.0-255,66,168676,77,347186
12992,0.001548,172.217.194.0-255,1484,170160,77,347186
12993,0.001552,172.217.194.0-255,1484,171644,77,347186
12994,0.001554,172.31.40.0-255,66,171710,77,347186
12995,0.001572,172.217.194.0-255,1484,173194,77,347186
12996,0.001593,172.217.194.0-255,5738,178932,77,347186
12997,0.001596,172.31.40.0-255,66,178998,77,347186
12998,0.001603,172.217.194.0-255,5738,184736,77,347186
12999,0.001605,172.31.40.0-255,66,184802,77,347186
13000,0.001609,172.217.194.0-255,2902,187704,77,347186
13001,0.001612,172.31.40.0-255,66,187770,77,347186
13002,0.001627,172.217.194.0-255,4320,192090,77,347186
13003,0.00163,172.31.40.0-255,66,192156,77,347186
13004,0.001662,172.217.194.0-255,10692,202848,77,347186
13005,0.001666,172.31.40.0-255,66,202914,77,347186
13006,0.002167,172.217.194.0-255,1484,204398,77,347186
13007,0.002176,172.217.194.0-255,2902,207300,77,347186
13008,0.002181,172.31.40.0-255,66,207366,77,347186
13009,0.00219,172.217.194.0-255,5738,213104,77,347186
13010,0.002193,172.31.40.0-255,66,213170,77,347186
13011,0.002196,172.217.194.0-255,1484,214654,77,347186
13012,0.002219,172.217.194.0-255,11410,226064,77,347186
13013,0.002222,172.31.40.0-255,66,226130,77,347186
13014,0.002228,172.217.194.0-255,5738,231868,77,347186
13015,0.002271,172.217.194.0-255,5020,236888,77,347186
13016,0.002295,172.217.194.0-255,4320,241208,77,347186
13017,0.002308,172.217.194.0-255,1484,242692,77,347186
13018,0.002314,172.217.194.0-255,4320,247012,77,347186
13019,0.002332,172.217.194.0-255,2902,249914,77,347186
13020,0.002375,172.217.194.0-255,5738,255652,77,347186
13021,0.002395,172.217.194.0-255,6438,262090,77,347186
13022,0.002406,172.217.194.0-255,12828,274918,77,347186
13023,0.002482,172.217.194.0-255,5738,280656,77,347186
13024,0.002501,172.217.194.0-255,7856,288512,77,347186
13025,0.002534,172.217.194.0-255,2902,291414,77,347186
13026,0.002553,172.217.194.0-255,3602,295016,77,347186
13027,0.002598,172.217.194.0-255,1484,296500,77,347186
13028,0.002611,172.217.194.0-255,2902,299402,77,347186
13029,0.002622,172.217.194.0-255,2902,302304,77,347186
13030,0.002625,172.217.194.0-255,1484,303788,77,347186
13031,0.002636,172.217.194.0-255,2902,306690,77,347186
13032,0.002688,172.217.194.0-255,5738,312428,77,347186
13033,0.002708,172.217.194.0-255,2902,315330,77,347186
13034,0.002716,172.217.194.0-255,8574,323904,77,347186
13035,0.006646,172.31.40.0-255,66,323970,77,347186
13036,0.009348,172.217.194.0-255,5738,329708,77,347186
13037,0.009357,172.31.40.0-255,66,329774,77,347186
13038,0.012062,172.217.194.0-255,5738,335512,77,347186
13039,0.012073,172.31.40.0-255,66,335578,77,347186
13040,0.014731,172.217.194.0-255,5738,341316,77,347186
13041,0.014741,172.31.40.0-255,66,341382,77,347186
13042,0.017386,172.217.194.0-255,5738,347120,77,347186
13043,0.017395,172.31.40.0-255,66,347186,77,347186
13044,0.0,172.217.194.0-255,153,153,77,227106
13045,2.1e-05,172.31.40.0-255,66,219,77,227106
13046,2.8e-05,172.217.194.0-255,1484,1703,77,227106
13047,3.1e-05,172.31.40.0-255,66,1769,77,227106
13048,3.7e-05,172.217.194.0-255,2902,4671,77,227106
13049,4.8e-05,172.31.40.0-255,66,4737,77,227106
13050,5.5e-05,172.217.194.0-255,7156,11893,77,227106
13051,5.8e-05,172.31.40.0-255,66,11959,77,227106
13052,8.5e-05,172.217.194.0-255,12828,24787,77,227106
13053,9.2e-05,172.31.40.0-255,66,24853,77,227106
13054,0.000116,172.217.194.0-255,565,25418,77,227106
13055,0.000118,172.31.40.0-255,66,25484,77,227106
13056,0.000124,172.217.194.0-255,5379,30863,77,227106
13057,0.000126,172.31.40.0-255,66,30929,77,227106
13058,0.000447,172.217.194.0-255,1484,32413,77,227106
13059,0.000452,172.31.40.0-255,66,32479,77,227106
13060,0.000458,172.217.194.0-255,2902,35381,77,227106
13061,0.00046,172.31.40.0-255,66,35447,77,227106
13062,0.000464,172.217.194.0-255,1484,36931,77,227106
13063,0.000465,172.31.40.0-255,66,36997,77,227106
13064,0.000493,172.217.194.0-255,4320,41317,77,227106
13065,0.000497,172.31.40.0-255,66,41383,77,227106
13066,0.000503,172.217.194.0-255,5738,47121,77,227106
13067,0.000505,172.31.40.0-255,66,47187,77,227106
13068,0.000534,172.217.194.0-255,8215,55402,77,227106
13069,0.000537,172.31.40.0-255,66,55468,77,227106
13070,0.000548,172.217.194.0-255,8574,64042,77,227106
13071,0.00055,172.31.40.0-255,66,64108,77,227106
13072,0.00058,172.217.194.0-255,1416,65524,77,227106
13073,0.000582,172.31.40.0-255,66,65590,77,227106
13074,0.000585,172.217.194.0-255,363,65953,77,227106
13075,0.000587,172.31.40.0-255,66,66019,77,227106
13076,0.001675,172.217.194.0-255,1484,67503,77,227106
13077,0.001686,172.217.194.0-255,2902,70405,77,227106
13078,0.001692,172.31.40.0-255,66,70471,77,227106
13079,0.0017,172.217.194.0-255,5738,76209,77,227106
13080,0.001702,172.31.40.0-255,66,76275,77,227106
13081,0.001714,172.217.194.0-255,5738,82013,77,227106
13082,0.001716,172.31.40.0-255,66,82079,77,227106
13083,0.001756,172.217.194.0-255,12828,94907,77,227106
13084,0.001759,172.31.40.0-255,66,94973,77,227106
13085,0.001785,172.217.194.0-255,1125,96098,77,227106
13086,0.001797,172.217.194.0-255,12828,108926,77,227106
13087,0.0018,172.31.40.0-255,66,108992,77,227106
13088,0.001848,172.217.194.0-255,2902,111894,77,227106
13089,0.001851,172.31.40.0-255,66,111960,77,227106
13090,0.001881,172.217.194.0-255,5020,116980,77,227106
13091,0.001883,172.31.40.0-255,66,117046,77,227106
13092,0.002085,172.217.194.0-255,1484,118530,77,227106
13093,0.0021,172.217.194.0-255,2902,121432,77,227106
13094,0.002103,172.31.40.0-255,66,121498,77,227106
13095,0.002131,172.217.194.0-255,5738,127236,77,227106
13096,0.002133,172.31.40.0-255,66,127302,77,227106
13097,0.002136,172.217.194.0-255,1484,128786,77,227106
13098,0.002146,172.217.194.0-255,9992,138778,77,227106
13099,0.002153,172.31.40.0-255,66,138844,77,227106
13100,0.002178,172.217.194.0-255,2902,141746,77,227106
13101,0.00218,172.31.40.0-255,66,141812,77,227106
13102,0.002187,172.217.194.0-255,5738,147550,77,227106
13103,0.002189,172.31.40.0-255,66,147616,77,227106
13104,0.002226,172.217.194.0-255,7856,155472,77,227106
13105,0.002229,172.31.40.0-255,66,155538,77,227106
13106,0.002249,172.31.40.0-255,66,155604,77,227106
13107,0.002266,172.31.40.0-255,66,155670,77,227106
13108,0.002341,172.217.194.0-255,11410,167080,77,227106
13109,0.002367,172.217.194.0-255,2902,169982,77,227106
13110,0.002372,172.217.194.0-255,2902,172884,77,227106
13111,0.002385,172.217.194.0-255,4320,177204,77,227106
13112,0.002439,172.217.194.0-255,4320,181524,77,227106
13113,0.002475,172.217.194.0-255,10692,192216,77,227106
13114,0.004584,172.31.40.0-255,66,192282,77,227106
13115,0.006937,172.217.194.0-255,5738,198020,77,227106
13116,0.006943,172.31.40.0-255,66,198086,77,227106
13117,0.009347,172.217.194.0-255,5738,203824,77,227106
13118,0.009354,172.31.40.0-255,66,203890,77,227106
13119,0.011717,172.217.194.0-255,5738,209628,77,227106
13120,0.011727,172.31.40.0-255,66,209694,77,227106
13121,0.014093,172.217.194.0-255,5738,215432,77,227106
13122,0.014102,172.31.40.0-255,66,215498,77,227106
13123,0.016458,172.217.194.0-255,5738,221236,77,227106
13124,0.016469,172.31.40.0-255,66,221302,77,227106
13125,0.018845,172.217.194.0-255,5738,227040,77,227106
13126,0.018852,172.31.40.0-255,66,227106,77,227106
13127,0.0,74.125.68.0-255,296,296,77,198471
13128,2.4e-05,172.31.40.0-255,66,362,77,198471
13129,3.1e-05,74.125.68.0-255,1484,1846,77,198471
13130,3.6e-05,172.31.40.0-255,66,1912,77,198471
13131,4.2e-05,74.125.68.0-255,2902,4814,77,198471
13132,4.5e-05,172.31.40.0-255,66,4880,77,198471
13133,7e-05,74.125.68.0-255,5738,10618,77,198471
13134,7.4e-05,172.31.40.0-255,66,10684,77,198471
13135,7.9e-05,74.125.68.0-255,3359,14043,77,198471
13136,8.1e-05,172.31.40.0-255,66,14109,77,198471
13137,0.000155,74.125.68.0-255,1484,15593,77,198471
13138,0.000159,172.31.40.0-255,66,15659,77,198471
13139,0.000164,74.125.68.0-255,2902,18561,77,198471
13140,0.000166,172.31.40.0-255,66,18627,77,198471
13141,0.000188,74.125.68.0-255,2902,21529,77,198471
13142,0.00019,172.31.40.0-255,66,21595,77,198471
13143,0.000205,74.125.68.0-255,2902,24497,77,198471
13144,0.000207,172.31.40.0-255,66,24563,77,198471
13145,0.000215,74.125.68.0-255,6797,31360,77,198471
13146,0.000218,172.31.40.0-255,66,31426,77,198471
13147,0.000244,74.125.68.0-255,1484,32910,77,198471
13148,0.000246,172.31.40.0-255,66,32976,77,198471
13149,0.000265,74.125.68.0-255,2902,35878,77,198471
13150,0.000268,172.31.40.0-255,66,35944,77,198471
13151,0.000272,74.125.68.0-255,2902,38846,77,198471
13152,0.000274,172.31.40.0-255,66,38912,77,198471
13153,0.000293,74.125.68.0-255,2902,41814,77,198471
13154,0.000296,172.31.40.0-255,66,41880,77,198471
13155,0.0003,74.125.68.0-255,2902,44782,77,198471
13156,0.000302,172.31.40.0-255,66,44848,77,198471
13157,0.000347,74.125.68.0-255,3961,48809,77,198471
13158,0.00035,172.31.40.0-255,66,48875,77,198471
13159,0.000477,74.125.68.0-255,1484,50359,77,198471
13160,0.000482,74.125.68.0-255,1484,51843,77,198471
13161,0.000497,74.125.68.0-255,2902,54745,77,198471
13162,0.000526,74.125.68.0-255,5738,60483,77,198471
13163,0.000534,172.31.40.0-255,66,60549,77,198471
13164,0.000546,74.125.68.0-255,5722,66271,77,198471
13165,0.000555,172.31.40.0-255,66,66337,77,198471
13166,0.000739,74.125.68.0-255,334,66671,77,198471
13167,0.000922,74.125.68.0-255,1484,68155,77,198471
13168,0.000927,74.125.68.0-255,1484,69639,77,198471
13169,0.000942,172.31.40.0-255,66,69705,77,198471
13170,0.000946,74.125.68.0-255,1484,71189,77,198471
13171,0.000952,74.125.68.0-255,5738,76927,77,198471
13172,0.000957,172.31.40.0-255,66,76993,77,198471
13173,0.000979,74.125.68.0-255,2902,79895,77,198471
13174,0.000984,74.125.68.0-255,3961,83856,77,198471
13175,0.000991,172.31.40.0-255,66,83922,77,198471
13176,0.001027,74.125.68.0-255,1484,85406,77,198471
13177,0.001032,74.125.68.0-255,2902,88308,77,198471
13178,0.001036,172.31.40.0-255,66,88374,77,198471
13179,0.001057,74.125.68.0-255,4320,92694,77,198471
13180,0.001061,172.31.40.0-255,66,92760,77,198471
13181,0.00107,74.125.68.0-255,1484,94244,77,198471
13182,0.001075,74.125.68.0-255,2902,97146,77,198471
13183,0.001081,74.125.68.0-255,3961,101107,77,198471
13184,0.0011,172.31.40.0-255,66,101173,77,198471
13185,0.001587,74.125.68.0-255,1484,102657,77,198471
13186,0.001594,74.125.68.0-255,1484,104141,77,198471
13187,0.001598,172.31.40.0-255,66,104207,77,198471
13188,0.001617,74.125.68.0-255,1484,105691,77,198471
13189,0.001621,74.125.68.0-255,1484,107175,77,198471
13190,0.001626,74.125.68.0-255,2902,110077,77,198471
13191,0.001658,74.125.68.0-255,1484,111561,77,198471
13192,0.001671,74.125.68.0-255,2902,114463,77,198471
13193,0.001688,74.125.68.0-255,5738,120201,77,198471
13194,0.001713,74.125.68.0-255,2902,123103,77,198471
13195,0.00173,74.125.68.0-255,2902,126005,77,198471
13196,0.001732,74.125.68.0-255,1484,127489,77,198471
13197,0.001752,74.125.68.0-255,5738,133227,77,198471
13198,0.001781,74.125.68.0-255,2184,135411,77,198471
13199,0.00187,74.125.68.0-255,1484,136895,77,198471
13200,0.001891,74.125.68.0-255,2902,139797,77,198471
13201,0.001917,74.125.68.0-255,4320,144117,77,198471
13202,0.001932,74.125.68.0-255,1484,145601,77,198471
13203,0.001982,74.125.68.0-255,4320,149921,77,198471
13204,0.001995,74.125.68.0-255,2902,152823,77,198471
13205,0.001998,74.125.68.0-255,2902,155725,77,198471
13206,0.002025,74.125.68.0-255,5738,161463,77,198471
13207,0.00204,74.125.68.0-255,4320,165783,77,198471
13208,0.002071,74.125.68.0-255,3602,169385,77,198471
13209,0.007038,172.31.40.0-255,66,169451,77,198471
13210,0.009115,74.125.68.0-255,5738,175189,77,198471
13211,0.009123,172.31.40.0-255,66,175255,77,198471
13212,0.011193,74.125.68.0-255,5738,180993,77,198471
13213,0.0112,172.31.40.0-255,66,181059,77,198471
13214,0.013281,74.125.68.0-255,5738,186797,77,198471
13215,0.014289,172.31.40.0-255,66,186863,77,198471
13216,0.016374,74.125.68.0-255,5738,192601,77,198471
13217,0.016382,172.31.40.0-255,66,192667,77,198471
13218,0.018457,74.125.68.0-255,5738,198405,77,198471
13219,0.018468,172.31.40.0-255,66,198471,77,198471
13220,0.0,74.125.130.0-255,153,153,77,333386
13221,2.8e-05,172.31.40.0-255,66,219,77,333386
13222,3.5e-05,74.125.130.0-255,1484,1703,77,333386
13223,4.1e-05,172.31.40.0-255,66,1769,77,333386
13224,4.7e-05,74.125.130.0-255,2902,4671,77,333386
13225,5.9e-05,172.31.40.0-255,66,4737,77,333386
13226,6.7e-05,74.125.130.0-255,7156,11893,77,333386
13227,7e-05,172.31.40.0-255,66,11959,77,333386
13228,7.4e-05,74.125.130.0-255,2027,13986,77,333386
13229,7.7e-05,172.31.40.0-255,66,14052,77,333386
13230,0.000159,74.125.130.0-255,1484,15536,77,333386
13231,0.000162,172.31.40.0-255,66,15602,77,333386
13232,0.000181,74.125.130.0-255,2902,18504,77,333386
13233,0.000189,172.31.40.0-255,66,18570,77,333386
13234,0.000196,74.125.130.0-255,5738,24308,77,333386
13235,0.000198,172.31.40.0-255,66,24374,77,333386
13236,0.000205,74.125.130.0-255,6797,31171,77,333386
13237,0.000207,172.31.40.0-255,66,31237,77,333386
13238,0.000315,74.125.130.0-255,1484,32721,77,333386
13239,0.000319,172.31.40.0-255,66,32787,77,333386
13240,0.000324,74.125.130.0-255,2902,35689,77,333386
13241,0.000326,172.31.40.0-255,66,35755,77,333386
13242,0.000331,74.125.130.0-255,2902,38657,77,333386
13243,0.000334,172.31.40.0-255,66,38723,77,333386
13244,0.000359,74.125.130.0-255,2902,41625,77,333386
13245,0.000362,172.31.40.0-255,66,41691,77,333386
13246,0.000369,74.125.130.0-255,6797,48488,77,333386
13247,0.000371,172.31.40.0-255,66,48554,77,333386
13248,0.000377,74.125.130.0-255,5738,54292,77,333386
13249,0.00038,172.31.40.0-255,66,54358,77,333386
13250,0.000408,74.125.130.0-255,1484,55842,77,333386
13251,0.00041,172.31.40.0-255,66,55908,77,333386
13252,0.000429,74.125.130.0-255,8574,64482,77,333386
13253,0.000436,172.31.40.0-255,66,64548,77,333386
13254,0.000453,74.125.130.0-255,1125,65673,77,333386
13255,0.000457,74.125.130.0-255,677,66350,77,333386
13256,0.000459,172.31.40.0-255,66,66416,77,333386
13257,0.000663,74.125.130.0-255,1484,67900,77,333386
13258,0.00067,74.125.130.0-255,2902,70802,77,333386
13259,0.000674,172.31.40.0-255,66,70868,77,333386
13260,0.000678,74.125.130.0-255,1484,72352,77,333386
13261,0.000704,74.125.130.0-255,4320,76672,77,333386
13262,0.000706,172.31.40.0-255,66,76738,77,333386
13263,0.000711,74.125.130.0-255,2902,79640,77,333386
13264,0.000713,172.31.40.0-255,66,79706,77,333386
13265,0.000747,74.125.130.0-255,9992,89698,77,333386
13266,0.000756,74.125.130.0-255,8574,98272,77,333386
13267,0.00076,74.125.130.0-255,2184,100456,77,333386
13268,0.000778,172.31.40.0-255,66,100522,77,333386
13269,0.001019,74.125.130.0-255,1484,102006,77,333386
13270,0.001041,74.125.130.0-255,2902,104908,77,333386
13271,0.001045,172.31.40.0-255,66,104974,77,333386
13272,0.00105,74.125.130.0-255,4320,109294,77,333386
13273,0.001068,172.31.40.0-255,66,109360,77,333386
13274,0.001072,74.125.130.0-255,1484,110844,77,333386
13275,0.001075,74.125.130.0-255,1484,112328,77,333386
13276,0.00108,172.31.40.0-255,66,112394,77,333386
13277,0.001114,74.125.130.0-255,9992,122386,77,333386
13278,0.001126,74.125.130.0-255,12110,134496,77,333386
13279,0.001151,172.31.40.0-255,66,134562,77,333386
13280,0.001217,74.125.130.0-255,1484,136046,77,333386
13281,0.001231,74.125.130.0-255,2902,138948,77,333386
13282,0.001244,172.31.40.0-255,66,139014,77,333386
13283,0.001256,74.125.130.0-255,5738,144752,77,333386
13284,0.001277,74.125.130.0-255,5738,150490,77,333386
13285,0.001292,74.125.130.0-255,4320,154810,77,333386
13286,0.001299,74.125.130.0-255,7156,161966,77,333386
13287,0.001308,172.31.40.0-255,66,162032,77,333386
13288,0.001319,74.125.130.0-255,4320,166352,77,333386
13289,0.001328,74.125.130.0-255,2184,168536,77,333386
13290,0.001333,172.31.40.0-255,66,168602,77,333386
13291,0.002048,74.125.130.0-255,1484,170086,77,333386
13292,0.002055,74.125.130.0-255,2902,172988,77,333386
13293,0.002058,172.31.40.0-255,66,173054,77,333386
13294,0.002066,74.125.130.0-255,5738,178792,77,333386
13295,0.002067,172.31.40.0-255,66,178858,77,333386
13296,0.002089,74.125.130.0-255,5738,184596,77,333386
13297,0.002091,172.31.40.0-255,66,184662,77,333386
13298,0.002099,74.125.130.0-255,7156,191818,77,333386
13299,0.002104,172.31.40.0-255,66,191884,77,333386
13300,0.002168,74.125.130.0-255,7156,199040,77,333386
13301,0.002172,172.31.40.0-255,66,199106,77,333386
13302,0.002197,74.125.130.0-255,3602,202708,77,333386
13303,0.002204,172.31.40.0-255,66,202774,77,333386
13304,0.002214,74.125.130.0-255,11410,214184,77,333386
13305,0.002216,172.31.40.0-255,66,214250,77,333386
13306,0.002226,74.125.130.0-255,9992,224242,77,333386
13307,0.002232,172.31.40.0-255,66,224308,77,333386
13308,0.002251,74.125.130.0-255,7156,231464,77,333386
13309,0.002257,172.31.40.0-255,66,231530,77,333386
13310,0.002283,74.125.130.0-255,5020,236550,77,333386
13311,0.002295,172.31.40.0-255,66,236616,77,333386
13312,0.002342,74.125.130.0-255,1484,238100,77,333386
13313,0.002366,74.125.130.0-255,2902,241002,77,333386
13314,0.002373,74.125.130.0-255,5738,246740,77,333386
13315,0.002385,172.31.40.0-255,66,246806,77,333386
13316,0.002399,74.125.130.0-255,5738,252544,77,333386
13317,0.002429,74.125.130.0-255,5738,258282,77,333386
13318,0.002441,74.125.130.0-255,12110,270392,77,333386
13319,0.002525,74.125.130.0-255,1484,271876,77,333386
13320,0.002539,74.125.130.0-255,2902,274778,77,333386
13321,0.002542,74.125.130.0-255,1484,276262,77,333386
13322,0.002563,74.125.130.0-255,2902,279164,77,333386
13323,0.002569,74.125.130.0-255,4320,283484,77,333386
13324,0.002588,74.125.130.0-255,4320,287804,77,333386
13325,0.002602,74.125.130.0-255,4320,292124,77,333386
13326,0.002624,74.125.130.0-255,9992,302116,77,333386
13327,0.002637,74.125.130.0-255,2184,304300,77,333386
13328,0.006467,172.31.40.0-255,66,304366,77,333386
13329,0.009055,74.125.130.0-255,5738,310104,77,333386
13330,0.009063,172.31.40.0-255,66,310170,77,333386
13331,0.011643,74.125.130.0-255,5738,315908,77,333386
13332,0.011652,172.31.40.0-255,66,315974,77,333386
13333,0.014224,74.125.130.0-255,5738,321712,77,333386
13334,0.014233,172.31.40.0-255,66,321778,77,333386
13335,0.016818,74.125.130.0-255,5738,327516,77,333386
13336,0.01683,172.31.40.0-255,66,327582,77,333386
13337,0.019407,74.125.130.0-255,5738,333320,77,333386
13338,0.019416,172.31.40.0-255,66,333386,77,333386
13339,0.0,74.125.24.0-255,153,153,77,398219
13340,2.6e-05,172.31.40.0-255,66,219,77,398219
13341,3.4e-05,74.125.24.0-255,1484,1703,77,398219
13342,3.9e-05,172.31.40.0-255,66,1769,77,398219
13343,4.5e-05,74.125.24.0-255,2902,4671,77,398219
13344,4.9e-05,172.31.40.0-255,66,4737,77,398219
13345,5.4e-05,74.125.24.0-255,2902,7639,77,398219
13346,5.7e-05,172.31.40.0-255,66,7705,77,398219
13347,8.4e-05,74.125.24.0-255,6194,13899,77,398219
13348,8.7e-05,172.31.40.0-255,66,13965,77,398219
13349,0.000463,74.125.24.0-255,1484,15449,77,398219
13350,0.000469,172.31.40.0-255,66,15515,77,398219
13351,0.000476,74.125.24.0-255,2902,18417,77,398219
13352,0.000479,172.31.40.0-255,66,18483,77,398219
13353,0.000485,74.125.24.0-255,5738,24221,77,398219
13354,0.000488,172.31.40.0-255,66,24287,77,398219
13355,0.000491,74.125.24.0-255,1484,25771,77,398219
13356,0.000493,172.31.40.0-255,66,25837,77,398219
13357,0.000509,74.125.24.0-255,2902,28739,77,398219
13358,0.000512,172.31.40.0-255,66,28805,77,398219
13359,0.000534,74.125.24.0-255,2543,31348,77,398219
13360,0.000536,172.31.40.0-255,66,31414,77,398219
13361,0.000646,74.125.24.0-255,1484,32898,77,398219
13362,0.000651,172.31.40.0-255,66,32964,77,398219
13363,0.000657,74.125.24.0-255,2902,35866,77,398219
13364,0.000659,172.31.40.0-255,66,35932,77,398219
13365,0.000687,74.125.24.0-255,5738,41670,77,398219
13366,0.00069,172.31.40.0-255,66,41736,77,398219
13367,0.000698,74.125.24.0-255,7156,48892,77,398219
13368,0.000701,172.31.40.0-255,66,48958,77,398219
13369,0.000724,74.125.24.0-255,6797,55755,77,398219
13370,0.000727,172.31.40.0-255,66,55821,77,398219
13371,0.000729,74.125.24.0-255,1484,57305,77,398219
13372,0.000748,74.125.24.0-255,5738,63043,77,398219
13373,0.000762,172.31.40.0-255,66,63109,77,398219
13374,0.000773,74.125.24.0-255,2814,65923,77,398219
13375,0.000775,74.125.24.0-255,415,66338,77,398219
13376,0.000781,172.31.40.0-255,66,66404,77,398219
13377,0.001128,172.31.40.0-255,66,66470,77,398219
13378,0.001184,74.125.24.0-255,1484,67954,77,398219
13379,0.00119,74.125.24.0-255,2902,70856,77,398219
13380,0.001241,74.125.24.0-255,5738,76594,77,398219
13381,0.001253,74.125.24.0-255,12828,89422,77,398219
13382,0.001257,74.125.24.0-255,2902,92324,77,398219
13383,0.001272,74.125.24.0-255,4320,96644,77,398219
13384,0.001283,172.31.40.0-255,66,96710,77,398219
13385,0.001301,74.125.24.0-255,1484,98194,77,398219
13386,0.001319,74.125.24.0-255,2184,100378,77,398219
13387,0.001327,172.31.40.0-255,66,100444,77,398219
13388,0.001361,74.125.24.0-255,1484,101928,77,398219
13389,0.001377,74.125.24.0-255,1484,103412,77,398219
13390,0.00139,74.125.24.0-255,1484,104896,77,398219
13391,0.001396,74.125.24.0-255,5738,110634,77,398219
13392,0.001398,74.125.24.0-255,1484,112118,77,398219
13393,0.001401,172.31.40.0-255,66,112184,77,398219
13394,0.001414,74.125.24.0-255,4320,116504,77,398219
13395,0.001418,172.31.40.0-255,66,116570,77,398219
13396,0.001435,74.125.24.0-255,7156,123726,77,398219
13397,0.001454,172.31.40.0-255,66,123792,77,398219
13398,0.001476,74.125.24.0-255,2902,126694,77,398219
13399,0.001485,172.31.40.0-255,66,126760,77,398219
13400,0.001502,74.125.24.0-255,7856,134616,77,398219
13401,0.00152,172.31.40.0-255,66,134682,77,398219
13402,0.002153,74.125.24.0-255,1484,136166,77,398219
13403,0.002163,74.125.24.0-255,2902,139068,77,398219
13404,0.002167,172.31.40.0-255,66,139134,77,398219
13405,0.002175,74.125.24.0-255,4320,143454,77,398219
13406,0.002189,74.125.24.0-255,1484,144938,77,398219
13407,0.002194,74.125.24.0-255,2902,147840,77,398219
13408,0.002223,74.125.24.0-255,9992,157832,77,398219
13409,0.00224,74.125.24.0-255,4320,162152,77,398219
13410,0.002255,74.125.24.0-255,6438,168590,77,398219
13411,0.004084,74.125.24.0-255,1484,170074,77,398219
13412,0.004104,74.125.24.0-255,2902,172976,77,398219
13413,0.00411,74.125.24.0-255,4320,177296,77,398219
13414,0.004128,74.125.24.0-255,1484,178780,77,398219
13415,0.004134,74.125.24.0-255,4320,183100,77,398219
13416,0.004147,74.125.24.0-255,1484,184584,77,398219
13417,0.004152,74.125.24.0-255,2902,187486,77,398219
13418,0.004189,74.125.24.0-255,766,188252,77,398219
13419,0.004617,74.125.24.0-255,1484,189736,77,398219
13420,0.004638,74.125.24.0-255,2902,192638,77,398219
13421,0.004642,74.125.24.0-255,1484,194122,77,398219
13422,0.004661,74.125.24.0-255,4320,198442,77,398219
13423,0.004678,74.125.24.0-255,2902,201344,77,398219
13424,0.00469,74.125.24.0-255,1484,202828,77,398219
13425,0.004709,74.125.24.0-255,4320,207148,77,398219
13426,0.004727,74.125.24.0-255,4320,211468,77,398219
13427,0.004739,74.125.24.0-255,2902,214370,77,398219
13428,0.004761,74.125.24.0-255,5738,220108,77,398219
13429,0.004776,74.125.24.0-255,1484,221592,77,398219
13430,0.004778,74.125.24.0-255,766,222358,77,398219
13431,0.005037,74.125.24.0-255,1484,223842,77,398219
13432,0.005042,74.125.24.0-255,2902,226744,77,398219
13433,0.005064,74.125.24.0-255,2902,229646,77,398219
13434,0.005077,74.125.24.0-255,2902,232548,77,398219
13435,0.00509,74.125.24.0-255,1484,234032,77,398219
13436,0.005112,74.125.24.0-255,7156,241188,77,398219
13437,0.005151,74.125.24.0-255,1484,242672,77,398219
13438,0.005169,74.125.24.0-255,8574,251246,77,398219
13439,0.005174,74.125.24.0-255,4320,255566,77,398219
13440,0.005192,74.125.24.0-255,7156,262722,77,398219
13441,0.005208,74.125.24.0-255,7156,269878,77,398219
13442,0.005219,74.125.24.0-255,2184,272062,77,398219
13443,0.005235,74.125.24.0-255,4320,276382,77,398219
13444,0.005269,74.125.24.0-255,13528,289910,77,398219
13445,0.005298,74.125.24.0-255,1484,291394,77,398219
13446,0.005314,74.125.24.0-255,2902,294296,77,398219
13447,0.00532,74.125.24.0-255,4320,298616,77,398219
13448,0.005336,74.125.24.0-255,1484,300100,77,398219
13449,0.00534,74.125.24.0-255,2902,303002,77,398219
13450,0.005355,74.125.24.0-255,7156,310158,77,398219
13451,0.005375,74.125.24.0-255,7156,317314,77,398219
13452,0.005399,74.125.24.0-255,6438,323752,77,398219
13453,0.005664,74.125.24.0-255,1484,325236,77,398219
13454,0.005685,74.125.24.0-255,2902,328138,77,398219
13455,0.005711,74.125.24.0-255,5738,333876,77,398219
13456,0.005718,74.125.24.0-255,5738,339614,77,398219
13457,0.005731,74.125.24.0-255,2902,342516,77,398219
13458,0.00576,74.125.24.0-255,7156,349672,77,398219
13459,0.005779,74.125.24.0-255,2902,352574,77,398219
13460,0.005785,74.125.24.0-255,2902,355476,77,398219
13461,0.00581,74.125.24.0-255,9274,364750,77,398219
13462,0.005817,74.125.24.0-255,4320,369070,77,398219
13463,0.005839,74.125.24.0-255,8574,377644,77,398219
13464,0.005861,74.125.24.0-255,5738,383382,77,398219
13465,0.005883,74.125.24.0-255,7856,391238,77,398219
13466,0.005895,74.125.24.0-255,1484,392722,77,398219
13467,0.0059,74.125.24.0-255,2902,395624,77,398219
13468,0.005916,74.125.24.0-255,2253,397877,77,398219
13469,0.00592,74.125.24.0-255,105,397982,77,398219
13470,0.006844,172.31.40.0-255,66,398048,77,398219
13471,0.010916,172.31.40.0-255,105,398153,77,398219
13472,0.012917,74.125.24.0-255,66,398219,77,398219
13473,0.0,172.217.194.0-255,153,153,77,323341
13474,2.4e-05,172.31.40.0-255,66,219,77,323341
13475,3e-05,172.217.194.0-255,1484,1703,77,323341
13476,3.5e-05,172.31.40.0-255,66,1769,77,323341
13477,4e-05,172.217.194.0-255,2902,4671,77,323341
13478,4.3e-05,172.31.40.0-255,66,4737,77,323341
13479,5.2e-05,172.217.194.0-255,7156,11893,77,323341
13480,5.4e-05,172.31.40.0-255,66,11959,77,323341
13481,5.8e-05,172.217.194.0-255,1940,13899,77,323341
13482,6.2e-05,172.31.40.0-255,66,13965,77,323341
13483,8.7e-05,172.217.194.0-255,2902,16867,77,323341
13484,9.1e-05,172.31.40.0-255,66,16933,77,323341
13485,0.000116,172.217.194.0-255,8574,25507,77,323341
13486,0.000119,172.31.40.0-255,66,25573,77,323341
13487,0.000125,172.217.194.0-255,5379,30952,77,323341
13488,0.000128,172.31.40.0-255,66,31018,77,323341
13489,0.000438,172.217.194.0-255,1484,32502,77,323341
13490,0.000444,172.31.40.0-255,66,32568,77,323341
13491,0.00045,172.217.194.0-255,2902,35470,77,323341
13492,0.000452,172.31.40.0-255,66,35536,77,323341
13493,0.000459,172.217.194.0-255,5738,41274,77,323341
13494,0.000462,172.31.40.0-255,66,41340,77,323341
13495,0.000487,172.217.194.0-255,4320,45660,77,323341
13496,0.000491,172.31.40.0-255,66,45726,77,323341
13497,0.000517,172.217.194.0-255,8574,54300,77,323341
13498,0.00052,172.31.40.0-255,66,54366,77,323341
13499,0.000528,172.217.194.0-255,8574,62940,77,323341
13500,0.00053,172.31.40.0-255,66,63006,77,323341
13501,0.000546,172.217.194.0-255,1484,64490,77,323341
13502,0.000548,172.31.40.0-255,66,64556,77,323341
13503,0.000568,172.217.194.0-255,1109,65665,77,323341
13504,0.000571,172.31.40.0-255,66,65731,77,323341
13505,0.000809,172.217.194.0-255,1484,67215,77,323341
13506,0.000836,172.217.194.0-255,2902,70117,77,323341
13507,0.000839,172.31.40.0-255,66,70183,77,323341
13508,0.000855,172.217.194.0-255,1484,71667,77,323341
13509,0.000877,172.217.194.0-255,2902,74569,77,323341
13510,0.00088,172.217.194.0-255,1484,76053,77,323341
13511,0.000884,172.31.40.0-255,66,76119,77,323341
13512,0.000911,172.217.194.0-255,4320,80439,77,323341
13513,0.000914,172.31.40.0-255,66,80505,77,323341
13514,0.000922,172.217.194.0-255,8574,89079,77,323341
13515,0.000924,172.31.40.0-255,66,89145,77,323341
13516,0.000939,172.217.194.0-255,1484,90629,77,323341
13517,0.000958,172.217.194.0-255,4320,94949,77,323341
13518,0.000962,172.31.40.0-255,66,95015,77,323341
13519,0.000977,172.217.194.0-255,5020,100035,77,323341
13520,0.000979,172.31.40.0-255,66,100101,77,323341
13521,0.000988,172.217.194.0-255,8574,108675,77,323341
13522,0.000991,172.31.40.0-255,66,108741,77,323341
13523,0.001013,172.217.194.0-255,1484,110225,77,323341
13524,0.001021,172.217.194.0-255,6516,116741,77,323341
13525,0.001024,172.31.40.0-255,66,116807,77,323341
13526,0.001167,172.217.194.0-255,1484,118291,77,323341
13527,0.001171,172.217.194.0-255,1484,119775,77,323341
13528,0.001175,172.31.40.0-255,66,119841,77,323341
13529,0.001198,172.217.194.0-255,1484,121325,77,323341
13530,0.001205,172.217.194.0-255,5738,127063,77,323341
13531,0.001207,172.31.40.0-255,66,127129,77,323341
13532,0.00124,172.217.194.0-255,7156,134285,77,323341
13533,0.001242,172.31.40.0-255,66,134351,77,323341
13534,0.001266,172.217.194.0-255,5738,140089,77,323341
13535,0.001269,172.31.40.0-255,66,140155,77,323341
13536,0.001277,172.217.194.0-255,8574,148729,77,323341
13537,0.00128,172.31.40.0-255,66,148795,77,323341
13538,0.001284,172.217.194.0-255,2184,150979,77,323341
13539,0.001286,172.31.40.0-255,66,151045,77,323341
13540,0.001632,172.217.194.0-255,1484,152529,77,323341
13541,0.001649,172.217.194.0-255,1484,154013,77,323341
13542,0.001654,172.31.40.0-255,66,154079,77,323341
13543,0.001666,172.217.194.0-255,1484,155563,77,323341
13544,0.001672,172.217.194.0-255,5738,161301,77,323341
13545,0.001674,172.31.40.0-255,66,161367,77,323341
13546,0.001681,172.217.194.0-255,5738,167105,77,323341
13547,0.001683,172.31.40.0-255,66,167171,77,323341
13548,0.001708,172.217.194.0-255,2902,170073,77,323341
13549,0.001711,172.31.40.0-255,66,170139,77,323341
13550,0.00174,172.217.194.0-255,9992,180131,77,323341
13551,0.001742,172.31.40.0-255,66,180197,77,323341
13552,0.001748,172.217.194.0-255,5020,185217,77,323341
13553,0.00175,172.31.40.0-255,66,185283,77,323341
13554,0.002061,172.217.194.0-255,1484,186767,77,323341
13555,0.002074,172.217.194.0-255,2902,189669,77,323341
13556,0.002077,172.31.40.0-255,66,189735,77,323341
13557,0.002083,172.217.194.0-255,2902,192637,77,323341
13558,0.002085,172.31.40.0-255,66,192703,77,323341
13559,0.0021,172.217.194.0-255,2902,195605,77,323341
13560,0.002118,172.31.40.0-255,66,195671,77,323341
13561,0.00213,172.217.194.0-255,12828,208499,77,323341
13562,0.002132,172.31.40.0-255,66,208565,77,323341
13563,0.002136,172.217.194.0-255,2902,211467,77,323341
13564,0.002138,172.31.40.0-255,66,211533,77,323341
13565,0.00217,172.217.194.0-255,1484,213017,77,323341
13566,0.002197,172.217.194.0-255,6438,219455,77,323341
13567,0.0022,172.31.40.0-255,66,219521,77,323341
13568,0.002221,172.217.194.0-255,2902,222423,77,323341
13569,0.002223,172.31.40.0-255,66,222489,77,323341
13570,0.002245,172.217.194.0-255,5738,228227,77,323341
13571,0.002248,172.31.40.0-255,66,228293,77,323341
13572,0.002254,172.217.194.0-255,5738,234031,77,323341
13573,0.002256,172.31.40.0-255,66,234097,77,323341
13574,0.002275,172.217.194.0-255,4320,238417,77,323341
13575,0.002278,172.31.40.0-255,66,238483,77,323341
13576,0.002281,172.217.194.0-255,1484,239967,77,323341
13577,0.0023,172.217.194.0-255,5738,245705,77,323341
13578,0.002302,172.31.40.0-255,66,245771,77,323341
13579,0.002332,172.217.194.0-255,7856,253627,77,323341
13580,0.002336,172.31.40.0-255,66,253693,77,323341
13581,0.002339,172.217.194.0-255,1484,255177,77,323341
13582,0.002343,172.217.194.0-255,2902,258079,77,323341
13583,0.002345,172.31.40.0-255,66,258145,77,323341
13584,0.002352,172.217.194.0-255,5738,263883,77,323341
13585,0.002354,172.31.40.0-255,66,263949,77,323341
13586,0.002382,172.217.194.0-255,11410,275359,77,323341
13587,0.002385,172.31.40.0-255,66,275425,77,323341
13588,0.002403,172.217.194.0-255,1484,276909,77,323341
13589,0.002409,172.217.194.0-255,5738,282647,77,323341
13590,0.002412,172.31.40.0-255,66,282713,77,323341
13591,0.004801,172.217.194.0-255,5738,288451,77,323341
13592,0.00481,172.31.40.0-255,66,288517,77,323341
13593,0.007178,172.217.194.0-255,5738,294255,77,323341
13594,0.007187,172.31.40.0-255,66,294321,77,323341
13595,0.00955,172.217.194.0-255,5738,300059,77,323341
13596,0.009566,172.31.40.0-255,66,300125,77,323341
13597,0.011936,172.217.194.0-255,5738,305863,77,323341
13598,0.011954,172.31.40.0-255,66,305929,77,323341
13599,0.014295,172.217.194.0-255,5738,311667,77,323341
13600,0.014305,172.31.40.0-255,66,311733,77,323341
13601,0.01668,172.217.194.0-255,5738,317471,77,323341
13602,0.016695,172.31.40.0-255,66,317537,77,323341
13603,0.019099,172.217.194.0-255,5738,323275,77,323341
13604,0.019115,172.31.40.0-255,66,323341,77,323341
13605,0.0,74.125.24.0-255,153,153,77,368006
13606,1.8e-05,172.31.40.0-255,66,219,77,368006
13607,2.6e-05,74.125.24.0-255,1484,1703,77,368006
13608,3e-05,172.31.40.0-255,66,1769,77,368006
13609,3.6e-05,74.125.24.0-255,2902,4671,77,368006
13610,4.7e-05,172.31.40.0-255,66,4737,77,368006
13611,5.5e-05,74.125.24.0-255,7156,11893,77,368006
13612,5.8e-05,172.31.40.0-255,66,11959,77,368006
13613,6.2e-05,74.125.24.0-255,1981,13940,77,368006
13614,6.5e-05,172.31.40.0-255,66,14006,77,368006
13615,0.000105,74.125.24.0-255,11410,25416,77,368006
13616,0.000108,172.31.40.0-255,66,25482,77,368006
13617,0.000111,74.125.24.0-255,1484,26966,77,368006
13618,0.000113,172.31.40.0-255,66,27032,77,368006
13619,0.000134,74.125.24.0-255,1484,28516,77,368006
13620,0.000137,172.31.40.0-255,66,28582,77,368006
13621,0.00016,74.125.24.0-255,2543,31125,77,368006
13622,0.000167,172.31.40.0-255,66,31191,77,368006
13623,0.000173,74.125.24.0-255,4320,35511,77,368006
13624,0.000176,172.31.40.0-255,66,35577,77,368006
13625,0.000216,74.125.24.0-255,8574,44151,77,368006
13626,0.000219,172.31.40.0-255,66,44217,77,368006
13627,0.00023,74.125.24.0-255,9992,54209,77,368006
13628,0.000232,172.31.40.0-255,66,54275,77,368006
13629,0.000264,74.125.24.0-255,5379,59654,77,368006
13630,0.000267,172.31.40.0-255,66,59720,77,368006
13631,0.000273,74.125.24.0-255,5671,65391,77,368006
13632,0.000275,172.31.40.0-255,66,65457,77,368006
13633,0.000283,74.125.24.0-255,128,65585,77,368006
13634,0.000285,172.31.40.0-255,66,65651,77,368006
13635,0.000343,74.125.24.0-255,1484,67135,77,368006
13636,0.000346,172.31.40.0-255,66,67201,77,368006
13637,0.000351,74.125.24.0-255,2902,70103,77,368006
13638,0.000354,172.31.40.0-255,66,70169,77,368006
13639,0.000366,74.125.24.0-255,7156,77325,77,368006
13640,0.000369,172.31.40.0-255,66,77391,77,368006
13641,0.000375,74.125.24.0-255,5379,82770,77,368006
13642,0.000378,172.31.40.0-255,66,82836,77,368006
13643,0.000384,74.125.24.0-255,5738,88574,77,368006
13644,0.000386,172.31.40.0-255,66,88640,77,368006
13645,0.000417,74.125.24.0-255,9992,98632,77,368006
13646,0.00042,172.31.40.0-255,66,98698,77,368006
13647,0.000449,74.125.24.0-255,833,99531,77,368006
13648,0.000506,74.125.24.0-255,1484,101015,77,368006
13649,0.00051,172.31.40.0-255,66,101081,77,368006
13650,0.000538,74.125.24.0-255,2902,103983,77,368006
13651,0.00054,172.31.40.0-255,66,104049,77,368006
13652,0.000546,74.125.24.0-255,5738,109787,77,368006
13653,0.000549,172.31.40.0-255,66,109853,77,368006
13654,0.000562,74.125.24.0-255,8574,118427,77,368006
13655,0.000564,172.31.40.0-255,66,118493,77,368006
13656,0.000617,172.31.40.0-255,66,118559,77,368006
13657,0.000653,172.31.40.0-255,66,118625,77,368006
13658,0.000661,74.125.24.0-255,8574,127199,77,368006
13659,0.000664,172.31.40.0-255,66,127265,77,368006
13660,0.000702,74.125.24.0-255,12828,140093,77,368006
13661,0.000704,172.31.40.0-255,66,140159,77,368006
13662,0.000744,74.125.24.0-255,13528,153687,77,368006
13663,0.000746,172.31.40.0-255,66,153753,77,368006
13664,0.00075,74.125.24.0-255,2902,156655,77,368006
13665,0.000752,172.31.40.0-255,66,156721,77,368006
13666,0.000758,74.125.24.0-255,4320,161041,77,368006
13667,0.00076,172.31.40.0-255,66,161107,77,368006
13668,0.000798,74.125.24.0-255,9274,170381,77,368006
13669,0.000801,172.31.40.0-255,66,170447,77,368006
13670,0.000824,74.125.24.0-255,1484,171931,77,368006
13671,0.000829,74.125.24.0-255,2902,174833,77,368006
13672,0.000831,172.31.40.0-255,66,174899,77,368006
13673,0.000854,74.125.24.0-255,5738,180637,77,368006
13674,0.000857,172.31.40.0-255,66,180703,77,368006
13675,0.000862,74.125.24.0-255,4320,185023,77,368006
13676,0.000864,172.31.40.0-255,66,185089,77,368006
13677,0.000871,74.125.24.0-255,7156,192245,77,368006
13678,0.000874,172.31.40.0-255,66,192311,77,368006
13679,0.0009,74.125.24.0-255,4320,196631,77,368006
13680,0.000907,172.31.40.0-255,66,196697,77,368006
13681,0.000913,74.125.24.0-255,5738,202435,77,368006
13682,0.000915,172.31.40.0-255,66,202501,77,368006
13683,0.000946,74.125.24.0-255,2184,204685,77,368006
13684,0.000948,172.31.40.0-255,66,204751,77,368006
13685,0.000951,74.125.24.0-255,1484,206235,77,368006
13686,0.000975,74.125.24.0-255,2902,209137,77,368006
13687,0.000977,172.31.40.0-255,66,209203,77,368006
13688,0.000982,74.125.24.0-255,2902,212105,77,368006
13689,0.000984,172.31.40.0-255,66,212171,77,368006
13690,0.001003,74.125.24.0-255,2902,215073,77,368006
13691,0.001005,172.31.40.0-255,66,215139,77,368006
13692,0.001013,74.125.24.0-255,1484,216623,77,368006
13693,0.001048,74.125.24.0-255,11410,228033,77,368006
13694,0.001051,172.31.40.0-255,66,228099,77,368006
13695,0.001058,74.125.24.0-255,7156,235255,77,368006
13696,0.001061,172.31.40.0-255,66,235321,77,368006
13697,0.001073,74.125.24.0-255,7856,243177,77,368006
13698,0.001075,172.31.40.0-255,66,243243,77,368006
13699,0.001083,74.125.24.0-255,8574,251817,77,368006
13700,0.001086,172.31.40.0-255,66,251883,77,368006
13701,0.001134,74.125.24.0-255,7156,259039,77,368006
13702,0.001137,172.31.40.0-255,66,259105,77,368006
13703,0.001174,74.125.24.0-255,11410,270515,77,368006
13704,0.001177,172.31.40.0-255,66,270581,77,368006
13705,0.001181,74.125.24.0-255,2184,272765,77,368006
13706,0.001183,172.31.40.0-255,66,272831,77,368006
13707,0.001186,74.125.24.0-255,1484,274315,77,368006
13708,0.00119,74.125.24.0-255,2902,277217,77,368006
13709,0.001192,172.31.40.0-255,66,277283,77,368006
13710,0.001195,74.125.24.0-255,1484,278767,77,368006
13711,0.001229,74.125.24.0-255,4320,283087,77,368006
13712,0.001232,172.31.40.0-255,66,283153,77,368006
13713,0.001249,74.125.24.0-255,12828,295981,77,368006
13714,0.001252,172.31.40.0-255,66,296047,77,368006
13715,0.001258,74.125.24.0-255,7156,303203,77,368006
13716,0.001261,172.31.40.0-255,66,303269,77,368006
13717,0.001291,74.125.24.0-255,3602,306871,77,368006
13718,0.001294,172.31.40.0-255,66,306937,77,368006
13719,0.001297,74.125.24.0-255,1484,308421,77,368006
13720,0.001299,74.125.24.0-255,1484,309905,77,368006
13721,0.001302,172.31.40.0-255,66,309971,77,368006
13722,0.001322,74.125.24.0-255,1484,311455,77,368006
13723,0.001328,74.125.24.0-255,5738,317193,77,368006
13724,0.001335,172.31.40.0-255,66,317259,77,368006
13725,0.001342,74.125.24.0-255,7156,324415,77,368006
13726,0.001345,172.31.40.0-255,66,324481,77,368006
13727,0.001377,74.125.24.0-255,5738,330219,77,368006
13728,0.00138,172.31.40.0-255,66,330285,77,368006
13729,0.001395,74.125.24.0-255,10692,340977,77,368006
13730,0.001398,172.31.40.0-255,66,341043,77,368006
13731,0.001429,74.125.24.0-255,8574,349617,77,368006
13732,0.001432,172.31.40.0-255,66,349683,77,368006
13733,0.00147,172.31.40.0-255,66,349749,77,368006
13734,0.001516,74.125.24.0-255,12828,362577,77,368006
13735,0.001519,172.31.40.0-255,66,362643,77,368006
13736,0.001545,74.125.24.0-255,4955,367598,77,368006
13737,0.001547,172.31.40.0-255,66,367664,77,368006
13738,0.001551,74.125.24.0-255,105,367769,77,368006
13739,0.013115,172.31.40.0-255,66,367835,77,368006
13740,0.013166,172.31.40.0-255,105,367940,77,368006
13741,0.015436,74.125.24.0-255,66,368006,77,368006
13742,0.0,74.125.68.0-255,146,146,77,346559
13743,1.4e-05,172.31.40.0-255,66,212,77,346559
13744,2.2e-05,74.125.68.0-255,1484,1696,77,346559
13745,2.7e-05,172.31.40.0-255,66,1762,77,346559
13746,3e-05,74.125.68.0-255,1484,3246,77,346559
13747,3.3e-05,172.31.40.0-255,66,3312,77,346559
13748,6.1e-05,74.125.68.0-255,1484,4796,77,346559
13749,6.5e-05,172.31.40.0-255,66,4862,77,346559
13750,7.3e-05,74.125.68.0-255,7156,12018,77,346559
13751,7.6e-05,172.31.40.0-255,66,12084,77,346559
13752,0.000112,74.125.68.0-255,1986,14070,77,346559
13753,0.000115,172.31.40.0-255,66,14136,77,346559
13754,0.000234,74.125.68.0-255,1484,15620,77,346559
13755,0.000238,172.31.40.0-255,66,15686,77,346559
13756,0.000243,74.125.68.0-255,2902,18588,77,346559
13757,0.000245,172.31.40.0-255,66,18654,77,346559
13758,0.000257,74.125.68.0-255,1484,20138,77,346559
13759,0.000259,172.31.40.0-255,66,20204,77,346559
13760,0.000278,74.125.68.0-255,2902,23106,77,346559
13761,0.00028,172.31.40.0-255,66,23172,77,346559
13762,0.000286,74.125.68.0-255,5738,28910,77,346559
13763,0.000288,172.31.40.0-255,66,28976,77,346559
13764,0.000311,74.125.68.0-255,3961,32937,77,346559
13765,0.000313,172.31.40.0-255,66,33003,77,346559
13766,0.000338,74.125.68.0-255,4320,37323,77,346559
13767,0.00034,172.31.40.0-255,66,37389,77,346559
13768,0.000358,74.125.68.0-255,4320,41709,77,346559
13769,0.00036,172.31.40.0-255,66,41775,77,346559
13770,0.000381,74.125.68.0-255,5738,47513,77,346559
13771,0.000384,172.31.40.0-255,66,47579,77,346559
13772,0.000387,74.125.68.0-255,1125,48704,77,346559
13773,0.000389,172.31.40.0-255,66,48770,77,346559
13774,0.000487,74.125.68.0-255,1484,50254,77,346559
13775,0.000512,74.125.68.0-255,2902,53156,77,346559
13776,0.000516,172.31.40.0-255,66,53222,77,346559
13777,0.000539,74.125.68.0-255,2902,56124,77,346559
13778,0.000541,172.31.40.0-255,66,56190,77,346559
13779,0.000547,74.125.68.0-255,4320,60510,77,346559
13780,0.000554,172.31.40.0-255,66,60576,77,346559
13781,0.000579,74.125.68.0-255,5710,66286,77,346559
13782,0.000582,172.31.40.0-255,66,66352,77,346559
13783,0.000585,74.125.68.0-255,111,66463,77,346559
13784,0.000684,74.125.68.0-255,1484,67947,77,346559
13785,0.000688,172.31.40.0-255,66,68013,77,346559
13786,0.000693,74.125.68.0-255,2902,70915,77,346559
13787,0.000696,172.31.40.0-255,66,70981,77,346559
13788,0.000699,74.125.68.0-255,1484,72465,77,346559
13789,0.000725,74.125.68.0-255,4320,76785,77,346559
13790,0.000728,172.31.40.0-255,66,76851,77,346559
13791,0.000734,74.125.68.0-255,4320,81171,77,346559
13792,0.000736,172.31.40.0-255,66,81237,77,346559
13793,0.000738,74.125.68.0-255,1484,82721,77,346559
13794,0.000759,74.125.68.0-255,3961,86682,77,346559
13795,0.000762,172.31.40.0-255,66,86748,77,346559
13796,0.000779,74.125.68.0-255,4320,91068,77,346559
13797,0.000782,172.31.40.0-255,66,91134,77,346559
13798,0.000806,74.125.68.0-255,5738,96872,77,346559
13799,0.000809,172.31.40.0-255,66,96938,77,346559
13800,0.000827,74.125.68.0-255,3961,100899,77,346559
13801,0.00083,172.31.40.0-255,66,100965,77,346559
13802,0.001211,74.125.68.0-255,1484,102449,77,346559
13803,0.001218,74.125.68.0-255,2902,105351,77,346559
13804,0.001222,172.31.40.0-255,66,105417,77,346559
13805,0.001245,74.125.68.0-255,4320,109737,77,346559
13806,0.001247,172.31.40.0-255,66,109803,77,346559
13807,0.00127,74.125.68.0-255,2902,112705,77,346559
13808,0.001272,172.31.40.0-255,66,112771,77,346559
13809,0.001288,74.125.68.0-255,5738,118509,77,346559
13810,0.00129,172.31.40.0-255,66,118575,77,346559
13811,0.001317,74.125.68.0-255,9992,128567,77,346559
13812,0.00132,172.31.40.0-255,66,128633,77,346559
13813,0.001324,74.125.68.0-255,1484,130117,77,346559
13814,0.001349,74.125.68.0-255,5020,135137,77,346559
13815,0.001352,172.31.40.0-255,66,135203,77,346559
13816,0.001665,74.125.68.0-255,1484,136687,77,346559
13817,0.001672,74.125.68.0-255,2902,139589,77,346559
13818,0.001675,172.31.40.0-255,66,139655,77,346559
13819,0.001689,74.125.68.0-255,4320,143975,77,346559
13820,0.001692,172.31.40.0-255,66,144041,77,346559
13821,0.001714,74.125.68.0-255,5738,149779,77,346559
13822,0.001716,172.31.40.0-255,66,149845,77,346559
13823,0.001737,74.125.68.0-255,2902,152747,77,346559
13824,0.00174,172.31.40.0-255,66,152813,77,346559
13825,0.001746,74.125.68.0-255,5738,158551,77,346559
13826,0.001748,172.31.40.0-255,66,158617,77,346559
13827,0.001783,74.125.68.0-255,7156,165773,77,346559
13828,0.001786,172.31.40.0-255,66,165839,77,346559
13829,0.001789,74.125.68.0-255,1484,167323,77,346559
13830,0.001838,74.125.68.0-255,10692,178015,77,346559
13831,0.001841,172.31.40.0-255,66,178081,77,346559
13832,0.001846,74.125.68.0-255,4320,182401,77,346559
13833,0.001848,172.31.40.0-255,66,182467,77,346559
13834,0.001883,74.125.68.0-255,4320,186787,77,346559
13835,0.001887,172.31.40.0-255,66,186853,77,346559
13836,0.001924,74.125.68.0-255,12828,199681,77,346559
13837,0.001926,172.31.40.0-255,66,199747,77,346559
13838,0.001931,74.125.68.0-255,3602,203349,77,346559
13839,0.001933,172.31.40.0-255,66,203415,77,346559
13840,0.001952,74.125.68.0-255,1484,204899,77,346559
13841,0.00198,74.125.68.0-255,2902,207801,77,346559
13842,0.001983,172.31.40.0-255,66,207867,77,346559
13843,0.00199,74.125.68.0-255,5738,213605,77,346559
13844,0.001993,172.31.40.0-255,66,213671,77,346559
13845,0.001995,74.125.68.0-255,1484,215155,77,346559
13846,0.001999,74.125.68.0-255,2902,218057,77,346559
13847,0.002002,172.31.40.0-255,66,218123,77,346559
13848,0.00203,74.125.68.0-255,5738,223861,77,346559
13849,0.002033,172.31.40.0-255,66,223927,77,346559
13850,0.00205,74.125.68.0-255,2902,226829,77,346559
13851,0.002052,172.31.40.0-255,66,226895,77,346559
13852,0.002078,74.125.68.0-255,5738,232633,77,346559
13853,0.002081,172.31.40.0-255,66,232699,77,346559
13854,0.002135,74.125.68.0-255,9274,241973,77,346559
13855,0.002138,172.31.40.0-255,66,242039,77,346559
13856,0.002152,74.125.68.0-255,9992,252031,77,346559
13857,0.002155,172.31.40.0-255,66,252097,77,346559
13858,0.002162,74.125.68.0-255,7156,259253,77,346559
13859,0.002166,172.31.40.0-255,66,259319,77,346559
13860,0.002187,74.125.68.0-255,2902,262221,77,346559
13861,0.00219,172.31.40.0-255,66,262287,77,346559
13862,0.002205,74.125.68.0-255,4320,266607,77,346559
13863,0.002208,172.31.40.0-255,66,266673,77,346559
13864,0.002236,74.125.68.0-255,6438,273111,77,346559
13865,0.002239,172.31.40.0-255,66,273177,77,346559
13866,0.002247,74.125.68.0-255,8574,281751,77,346559
13867,0.002249,172.31.40.0-255,66,281817,77,346559
13868,0.002276,74.125.68.0-255,2902,284719,77,346559
13869,0.002278,172.31.40.0-255,66,284785,77,346559
13870,0.002284,74.125.68.0-255,4320,289105,77,346559
13871,0.002286,172.31.40.0-255,66,289171,77,346559
13872,0.002292,74.125.68.0-255,5738,294909,77,346559
13873,0.002295,172.31.40.0-255,66,294975,77,346559
13874,0.002302,74.125.68.0-255,7156,302131,77,346559
13875,0.002304,172.31.40.0-255,66,302197,77,346559
13876,0.002321,74.125.68.0-255,3602,305799,77,346559
13877,0.002323,172.31.40.0-255,66,305865,77,346559
13878,0.004602,74.125.68.0-255,1484,307349,77,346559
13879,0.004622,74.125.68.0-255,4320,311669,77,346559
13880,0.004626,172.31.40.0-255,66,311735,77,346559
13881,0.006935,74.125.68.0-255,5738,317473,77,346559
13882,0.006939,172.31.40.0-255,66,317539,77,346559
13883,0.009249,74.125.68.0-255,5738,323277,77,346559
13884,0.009256,172.31.40.0-255,66,323343,77,346559
13885,0.011568,74.125.68.0-255,5738,329081,77,346559
13886,0.011574,172.31.40.0-255,66,329147,77,346559
13887,0.013888,74.125.68.0-255,5738,334885,77,346559
13888,0.013896,172.31.40.0-255,66,334951,77,346559
13889,0.01621,74.125.68.0-255,5738,340689,77,346559
13890,0.016216,172.31.40.0-255,66,340755,77,346559
13891,0.018531,74.125.68.0-255,5738,346493,77,346559
13892,0.018539,172.31.40.0-255,66,346559,77,346559
13893,0.0,172.31.40.0-255,105,105,77,210
13894,0.00176,157.240.25.0-255,105,210,77,210
13895,0.0,74.125.200.0-255,153,153,77,273391
13896,2.2e-05,172.31.40.0-255,66,219,77,273391
13897,2.9e-05,74.125.200.0-255,1484,1703,77,273391
13898,3.4e-05,172.31.40.0-255,66,1769,77,273391
13899,4e-05,74.125.200.0-255,2902,4671,77,273391
13900,4.4e-05,172.31.40.0-255,66,4737,77,273391
13901,4.8e-05,74.125.200.0-255,2902,7639,77,273391
13902,5e-05,172.31.40.0-255,66,7705,77,273391
13903,6.7e-05,74.125.200.0-255,2902,10607,77,273391
13904,7e-05,172.31.40.0-255,66,10673,77,273391
13905,7.3e-05,74.125.200.0-255,1484,12157,77,273391
13906,7.5e-05,172.31.40.0-255,66,12223,77,273391
13907,9.1e-05,74.125.200.0-255,2030,14253,77,273391
13908,9.4e-05,172.31.40.0-255,66,14319,77,273391
13909,0.0002,74.125.200.0-255,1484,15803,77,273391
13910,0.000204,172.31.40.0-255,66,15869,77,273391
13911,0.000209,74.125.200.0-255,2902,18771,77,273391
13912,0.000212,172.31.40.0-255,66,18837,77,273391
13913,0.000222,74.125.200.0-255,1484,20321,77,273391
13914,0.000224,172.31.40.0-255,66,20387,77,273391
13915,0.000251,74.125.200.0-255,4320,24707,77,273391
13916,0.000253,172.31.40.0-255,66,24773,77,273391
13917,0.00026,74.125.200.0-255,6797,31570,77,273391
13918,0.000263,172.31.40.0-255,66,31636,77,273391
13919,0.000537,74.125.200.0-255,1484,33120,77,273391
13920,0.000548,172.31.40.0-255,66,33186,77,273391
13921,0.000554,74.125.200.0-255,2902,36088,77,273391
13922,0.000558,172.31.40.0-255,66,36154,77,273391
13923,0.000563,74.125.200.0-255,4320,40474,77,273391
13924,0.000565,172.31.40.0-255,66,40540,77,273391
13925,0.000585,74.125.200.0-255,1484,42024,77,273391
13926,0.000588,172.31.40.0-255,66,42090,77,273391
13927,0.000595,74.125.200.0-255,6797,48887,77,273391
13928,0.000597,172.31.40.0-255,66,48953,77,273391
13929,0.000627,74.125.200.0-255,7156,56109,77,273391
13930,0.00063,172.31.40.0-255,66,56175,77,273391
13931,0.00065,74.125.200.0-255,4320,60495,77,273391
13932,0.000653,172.31.40.0-255,66,60561,77,273391
13933,0.000666,74.125.200.0-255,1484,62045,77,273391
13934,0.000685,74.125.200.0-255,3961,66006,77,273391
13935,0.000688,172.31.40.0-255,66,66072,77,273391
13936,0.001011,74.125.200.0-255,645,66717,77,273391
13937,0.001108,172.31.40.0-255,66,66783,77,273391
13938,0.00116,74.125.200.0-255,1484,68267,77,273391
13939,0.001173,74.125.200.0-255,2902,71169,77,273391
13940,0.001176,172.31.40.0-255,66,71235,77,273391
13941,0.001196,74.125.200.0-255,5738,76973,77,273391
13942,0.001198,172.31.40.0-255,66,77039,77,273391
13943,0.001224,74.125.200.0-255,4320,81359,77,273391
13944,0.001226,172.31.40.0-255,66,81425,77,273391
13945,0.001249,74.125.200.0-255,8574,89999,77,273391
13946,0.001252,172.31.40.0-255,66,90065,77,273391
13947,0.001272,74.125.200.0-255,1484,91549,77,273391
13948,0.001285,74.125.200.0-255,4320,95869,77,273391
13949,0.001287,172.31.40.0-255,66,95935,77,273391
13950,0.001307,74.125.200.0-255,5020,100955,77,273391
13951,0.001309,172.31.40.0-255,66,101021,77,273391
13952,0.001351,74.125.200.0-255,1484,102505,77,273391
13953,0.001366,74.125.200.0-255,2902,105407,77,273391
13954,0.001368,172.31.40.0-255,66,105473,77,273391
13955,0.001371,74.125.200.0-255,1484,106957,77,273391
13956,0.001373,74.125.200.0-255,1484,108441,77,273391
13957,0.001375,172.31.40.0-255,66,108507,77,273391
13958,0.001387,74.125.200.0-255,1484,109991,77,273391
13959,0.001391,74.125.200.0-255,2902,112893,77,273391
13960,0.001393,172.31.40.0-255,66,112959,77,273391
13961,0.001404,74.125.200.0-255,2902,115861,77,273391
13962,0.001406,172.31.40.0-255,66,115927,77,273391
13963,0.001428,74.125.200.0-255,4320,120247,77,273391
13964,0.001431,172.31.40.0-255,66,120313,77,273391
13965,0.001445,74.125.200.0-255,7156,127469,77,273391
13966,0.001447,172.31.40.0-255,66,127535,77,273391
13967,0.001482,74.125.200.0-255,5738,133273,77,273391
13968,0.001484,172.31.40.0-255,66,133339,77,273391
13969,0.001504,74.125.200.0-255,2184,135523,77,273391
13970,0.001507,172.31.40.0-255,66,135589,77,273391
13971,0.001735,74.125.200.0-255,1484,137073,77,273391
13972,0.001748,74.125.200.0-255,2902,139975,77,273391
13973,0.001751,172.31.40.0-255,66,140041,77,273391
13974,0.001754,74.125.200.0-255,1484,141525,77,273391
13975,0.001774,74.125.200.0-255,4320,145845,77,273391
13976,0.001777,172.31.40.0-255,66,145911,77,273391
13977,0.001781,74.125.200.0-255,4320,150231,77,273391
13978,0.001783,172.31.40.0-255,66,150297,77,273391
13979,0.001787,74.125.200.0-255,2902,153199,77,273391
13980,0.001788,172.31.40.0-255,66,153265,77,273391
13981,0.001803,74.125.200.0-255,2902,156167,77,273391
13982,0.001805,172.31.40.0-255,66,156233,77,273391
13983,0.00182,74.125.200.0-255,4320,160553,77,273391
13984,0.001823,172.31.40.0-255,66,160619,77,273391
13985,0.001834,74.125.200.0-255,7156,167775,77,273391
13986,0.001836,172.31.40.0-255,66,167841,77,273391
13987,0.00184,74.125.200.0-255,2184,170025,77,273391
13988,0.001841,172.31.40.0-255,66,170091,77,273391
13989,0.002257,74.125.200.0-255,1484,171575,77,273391
13990,0.002266,74.125.200.0-255,2902,174477,77,273391
13991,0.002269,172.31.40.0-255,66,174543,77,273391
13992,0.00229,74.125.200.0-255,2902,177445,77,273391
13993,0.002292,172.31.40.0-255,66,177511,77,273391
13994,0.002298,74.125.200.0-255,4320,181831,77,273391
13995,0.0023,172.31.40.0-255,66,181897,77,273391
13996,0.002337,74.125.200.0-255,8574,190471,77,273391
13997,0.002339,172.31.40.0-255,66,190537,77,273391
13998,0.002347,74.125.200.0-255,7156,197693,77,273391
13999,0.002349,172.31.40.0-255,66,197759,77,273391
14000,0.002386,74.125.200.0-255,4320,202079,77,273391
14001,0.002388,172.31.40.0-255,66,202145,77,273391
14002,0.0024,74.125.200.0-255,2184,204329,77,273391
14003,0.002402,172.31.40.0-255,66,204395,77,273391
14004,0.002487,74.125.200.0-255,1484,205879,77,273391
14005,0.002491,74.125.200.0-255,1484,207363,77,273391
14006,0.002494,172.31.40.0-255,66,207429,77,273391
14007,0.002514,74.125.200.0-255,1484,208913,77,273391
14008,0.002521,74.125.200.0-255,5738,214651,77,273391
14009,0.002523,172.31.40.0-255,66,214717,77,273391
14010,0.002526,74.125.200.0-255,1484,216201,77,273391
14011,0.002546,74.125.200.0-255,5738,221939,77,273391
14012,0.002548,172.31.40.0-255,66,222005,77,273391
14013,0.002572,74.125.200.0-255,8574,230579,77,273391
14014,0.002575,172.31.40.0-255,66,230645,77,273391
14015,0.002599,74.125.200.0-255,7856,238501,77,273391
14016,0.002602,172.31.40.0-255,66,238567,77,273391
14017,0.005158,74.125.200.0-255,5738,244305,77,273391
14018,0.005167,172.31.40.0-255,66,244371,77,273391
14019,0.007732,74.125.200.0-255,5738,250109,77,273391
14020,0.007739,172.31.40.0-255,66,250175,77,273391
14021,0.010308,74.125.200.0-255,5738,255913,77,273391
14022,0.010317,172.31.40.0-255,66,255979,77,273391
14023,0.012906,74.125.200.0-255,5738,261717,77,273391
14024,0.012927,172.31.40.0-255,66,261783,77,273391
14025,0.015514,74.125.200.0-255,5738,267521,77,273391
14026,0.015531,172.31.40.0-255,66,267587,77,273391
14027,0.018101,74.125.200.0-255,5738,273325,77,273391
14028,0.01811,172.31.40.0-255,66,273391,77,273391
14029,0.0,74.125.24.0-255,153,153,77,146574
14030,2.3e-05,172.31.40.0-255,66,219,77,146574
14031,3e-05,74.125.24.0-255,1484,1703,77,146574
14032,3.4e-05,172.31.40.0-255,66,1769,77,146574
14033,4e-05,74.125.24.0-255,2902,4671,77,146574
14034,4.3e-05,172.31.40.0-255,66,4737,77,146574
14035,5e-05,74.125.24.0-255,7156,11893,77,146574
14036,5.2e-05,172.31.40.0-255,66,11959,77,146574
14037,8.4e-05,74.125.24.0-255,9122,21081,77,146574
14038,8.8e-05,172.31.40.0-255,66,21147,77,146574
14039,9.6e-05,74.125.24.0-255,9633,30780,77,146574
14040,9.8e-05,172.31.40.0-255,66,30846,77,146574
14041,0.000203,74.125.24.0-255,1484,32330,77,146574
14042,0.000207,172.31.40.0-255,66,32396,77,146574
14043,0.000213,74.125.24.0-255,2902,35298,77,146574
14044,0.000214,172.31.40.0-255,66,35364,77,146574
14045,0.00022,74.125.24.0-255,5738,41102,77,146574
14046,0.000222,172.31.40.0-255,66,41168,77,146574
14047,0.000245,74.125.24.0-255,1484,42652,77,146574
14048,0.000248,172.31.40.0-255,66,42718,77,146574
14049,0.000278,74.125.24.0-255,12469,55187,77,146574
14050,0.000281,172.31.40.0-255,66,55253,77,146574
14051,0.000289,74.125.24.0-255,8574,63827,77,146574
14052,0.000291,172.31.40.0-255,66,63893,77,146574
14053,0.000328,74.125.24.0-255,1438,65331,77,146574
14054,0.000331,172.31.40.0-255,66,65397,77,146574
14055,0.000409,74.125.24.0-255,109,65506,77,146574
14056,0.000414,172.31.40.0-255,66,65572,77,146574
14057,0.000798,74.125.24.0-255,332,65904,77,146574
14058,0.000803,172.31.40.0-255,66,65970,77,146574
14059,0.001259,74.125.24.0-255,1484,67454,77,146574
14060,0.001265,172.31.40.0-255,66,67520,77,146574
14061,0.001273,74.125.24.0-255,2902,70422,77,146574
14062,0.001275,172.31.40.0-255,66,70488,77,146574
14063,0.001281,74.125.24.0-255,5738,76226,77,146574
14064,0.001283,172.31.40.0-255,66,76292,77,146574
14065,0.001325,74.125.24.0-255,12828,89120,77,146574
14066,0.001329,172.31.40.0-255,66,89186,77,146574
14067,0.001336,74.125.24.0-255,7156,96342,77,146574
14068,0.001338,172.31.40.0-255,66,96408,77,146574
14069,0.001363,74.125.24.0-255,3602,100010,77,146574
14070,0.001366,172.31.40.0-255,66,100076,77,146574
14071,0.003369,74.125.24.0-255,1484,101560,77,146574
14072,0.003469,74.125.24.0-255,4320,105880,77,146574
14073,0.003474,172.31.40.0-255,66,105946,77,146574
14074,0.005577,74.125.24.0-255,5738,111684,77,146574
14075,0.005584,172.31.40.0-255,66,111750,77,146574
14076,0.007848,74.125.24.0-255,5738,117488,77,146574
14077,0.007909,172.31.40.0-255,66,117554,77,146574
14078,0.009992,74.125.24.0-255,5738,123292,77,146574
14079,0.009999,172.31.40.0-255,66,123358,77,146574
14080,0.012067,74.125.24.0-255,5738,129096,77,146574
14081,0.012075,172.31.40.0-255,66,129162,77,146574
14082,0.014168,74.125.24.0-255,5738,134900,77,146574
14083,0.01418,172.31.40.0-255,66,134966,77,146574
14084,0.016258,74.125.24.0-255,5738,140704,77,146574
14085,0.016264,172.31.40.0-255,66,140770,77,146574
14086,0.018344,74.125.24.0-255,5738,146508,77,146574
14087,0.018352,172.31.40.0-255,66,146574,77,146574
14088,0.0,74.125.200.0-255,153,153,77,141820
14089,3.2e-05,172.31.40.0-255,66,219,77,141820
14090,3.9e-05,74.125.200.0-255,1484,1703,77,141820
14091,4.3e-05,172.31.40.0-255,66,1769,77,141820
14092,5.5e-05,74.125.200.0-255,2902,4671,77,141820
14093,5.8e-05,172.31.40.0-255,66,4737,77,141820
14094,6.2e-05,74.125.200.0-255,1484,6221,77,141820
14095,6.5e-05,172.31.40.0-255,66,6287,77,141820
14096,9.1e-05,74.125.200.0-255,2902,9189,77,141820
14097,9.4e-05,172.31.40.0-255,66,9255,77,141820
14098,0.000103,74.125.200.0-255,6291,15546,77,141820
14099,0.000105,172.31.40.0-255,66,15612,77,141820
14100,0.000135,74.125.200.0-255,7156,22768,77,141820
14101,0.000139,172.31.40.0-255,66,22834,77,141820
14102,0.000144,74.125.200.0-255,4320,27154,77,141820
14103,0.000146,172.31.40.0-255,66,27220,77,141820
14104,0.000171,74.125.200.0-255,1484,28704,77,141820
14105,0.000176,172.31.40.0-255,66,28770,77,141820
14106,0.000202,74.125.200.0-255,2543,31313,77,141820
14107,0.000205,172.31.40.0-255,66,31379,77,141820
14108,0.000274,74.125.200.0-255,1484,32863,77,141820
14109,0.000278,172.31.40.0-255,66,32929,77,141820
14110,0.000281,74.125.200.0-255,1484,34413,77,141820
14111,0.000286,172.31.40.0-255,66,34479,77,141820
14112,0.000305,74.125.200.0-255,1484,35963,77,141820
14113,0.000308,172.31.40.0-255,66,36029,77,141820
14114,0.000313,74.125.200.0-255,4320,40349,77,141820
14115,0.000316,172.31.40.0-255,66,40415,77,141820
14116,0.000342,74.125.200.0-255,2902,43317,77,141820
14117,0.000346,172.31.40.0-255,66,43383,77,141820
14118,0.000379,74.125.200.0-255,5738,49121,77,141820
14119,0.000383,172.31.40.0-255,66,49187,77,141820
14120,0.000386,74.125.200.0-255,1484,50671,77,141820
14121,0.000391,74.125.200.0-255,4320,54991,77,141820
14122,0.000405,172.31.40.0-255,66,55057,77,141820
14123,0.000426,74.125.200.0-255,7156,62213,77,141820
14124,0.000431,74.125.200.0-255,2902,65115,77,141820
14125,0.000436,172.31.40.0-255,66,65181,77,141820
14126,0.000458,74.125.200.0-255,1100,66281,77,141820
14127,0.000706,74.125.200.0-255,110,66391,77,141820
14128,0.000816,172.31.40.0-255,66,66457,77,141820
14129,0.000846,74.125.200.0-255,1484,67941,77,141820
14130,0.000853,74.125.200.0-255,2902,70843,77,141820
14131,0.000856,74.125.200.0-255,1484,72327,77,141820
14132,0.000859,74.125.200.0-255,1484,73811,77,141820
14133,0.00087,74.125.200.0-255,1484,75295,77,141820
14134,0.000873,74.125.200.0-255,1484,76779,77,141820
14135,0.000875,172.31.40.0-255,66,76845,77,141820
14136,0.000905,74.125.200.0-255,4320,81165,77,141820
14137,0.000909,74.125.200.0-255,2902,84067,77,141820
14138,0.000909,172.31.40.0-255,66,84133,77,141820
14139,0.000934,74.125.200.0-255,8574,92707,77,141820
14140,0.000933,172.31.40.0-255,66,92773,77,141820
14141,0.000937,172.31.40.0-255,66,92839,77,141820
14142,0.000987,74.125.200.0-255,2902,95741,77,141820
14143,0.001001,172.31.40.0-255,66,95807,77,141820
14144,0.001003,74.125.200.0-255,5020,100827,77,141820
14145,0.001017,172.31.40.0-255,66,100893,77,141820
14146,0.003096,74.125.200.0-255,5738,106631,77,141820
14147,0.003102,172.31.40.0-255,66,106697,77,141820
14148,0.00517,74.125.200.0-255,4320,111017,77,141820
14149,0.005189,74.125.200.0-255,1484,112501,77,141820
14150,0.005342,172.31.40.0-255,66,112567,77,141820
14151,0.007395,74.125.200.0-255,5738,118305,77,141820
14152,0.0074,172.31.40.0-255,66,118371,77,141820
14153,0.007507,172.31.40.0-255,101,118472,77,141820
14154,0.009459,74.125.200.0-255,4320,122792,77,141820
14155,0.009481,74.125.200.0-255,1484,124276,77,141820
14156,0.009532,74.125.200.0-255,66,124342,77,141820
14157,0.011785,172.31.40.0-255,66,124408,77,141820
14158,0.01385,74.125.200.0-255,5738,130146,77,141820
14159,0.013916,172.31.40.0-255,66,130212,77,141820
14160,0.015995,74.125.200.0-255,5738,135950,77,141820
14161,0.016008,172.31.40.0-255,66,136016,77,141820
14162,0.018076,74.125.200.0-255,5738,141754,77,141820
14163,0.018473,172.31.40.0-255,66,141820,77,141820
14164,0.0,172.217.194.0-255,153,153,77,305455
14165,2.5e-05,172.31.40.0-255,66,219,77,305455
14166,3.2e-05,172.217.194.0-255,1484,1703,77,305455
14167,3.7e-05,172.31.40.0-255,66,1769,77,305455
14168,4.2e-05,172.217.194.0-255,2902,4671,77,305455
14169,4.6e-05,172.31.40.0-255,66,4737,77,305455
14170,8e-05,172.217.194.0-255,4320,9057,77,305455
14171,8.3e-05,172.31.40.0-255,66,9123,77,305455
14172,0.000103,172.217.194.0-255,2902,12025,77,305455
14173,0.000105,172.31.40.0-255,66,12091,77,305455
14174,0.000109,172.217.194.0-255,2028,14119,77,305455
14175,0.000112,172.31.40.0-255,66,14185,77,305455
14176,0.000123,172.217.194.0-255,11410,25595,77,305455
14177,0.000126,172.31.40.0-255,66,25661,77,305455
14178,0.000132,172.217.194.0-255,5379,31040,77,305455
14179,0.000134,172.31.40.0-255,66,31106,77,305455
14180,0.00018,172.217.194.0-255,1484,32590,77,305455
14181,0.000183,172.31.40.0-255,66,32656,77,305455
14182,0.000188,172.217.194.0-255,2902,35558,77,305455
14183,0.00019,172.31.40.0-255,66,35624,77,305455
14184,0.000196,172.217.194.0-255,4320,39944,77,305455
14185,0.000198,172.31.40.0-255,66,40010,77,305455
14186,0.000221,172.217.194.0-255,1484,41494,77,305455
14187,0.000223,172.31.40.0-255,66,41560,77,305455
14188,0.000229,172.217.194.0-255,4320,45880,77,305455
14189,0.000231,172.31.40.0-255,66,45946,77,305455
14190,0.000249,172.217.194.0-255,2543,48489,77,305455
14191,0.000251,172.31.40.0-255,66,48555,77,305455
14192,0.000454,172.217.194.0-255,1484,50039,77,305455
14193,0.000461,172.31.40.0-255,66,50105,77,305455
14194,0.000467,172.217.194.0-255,2902,53007,77,305455
14195,0.00047,172.31.40.0-255,66,53073,77,305455
14196,0.000476,172.217.194.0-255,5738,58811,77,305455
14197,0.000479,172.31.40.0-255,66,58877,77,305455
14198,0.000483,172.217.194.0-255,2902,61779,77,305455
14199,0.000485,172.31.40.0-255,66,61845,77,305455
14200,0.000507,172.217.194.0-255,2902,64747,77,305455
14201,0.00051,172.31.40.0-255,66,64813,77,305455
14202,0.000532,172.217.194.0-255,1706,66519,77,305455
14203,0.000535,172.31.40.0-255,66,66585,77,305455
14204,0.000686,172.217.194.0-255,1484,68069,77,305455
14205,0.000693,172.217.194.0-255,2902,70971,77,305455
14206,0.000697,172.31.40.0-255,66,71037,77,305455
14207,0.000703,172.217.194.0-255,4320,75357,77,305455
14208,0.000705,172.31.40.0-255,66,75423,77,305455
14209,0.000717,172.217.194.0-255,1484,76907,77,305455
14210,0.000722,172.217.194.0-255,2902,79809,77,305455
14211,0.000724,172.31.40.0-255,66,79875,77,305455
14212,0.000753,172.217.194.0-255,9992,89867,77,305455
14213,0.000755,172.31.40.0-255,66,89933,77,305455
14214,0.000764,172.217.194.0-255,9992,99925,77,305455
14215,0.000767,172.31.40.0-255,66,99991,77,305455
14216,0.00077,172.217.194.0-255,766,100757,77,305455
14217,0.001163,172.217.194.0-255,1484,102241,77,305455
14218,0.001169,172.31.40.0-255,66,102307,77,305455
14219,0.001174,172.217.194.0-255,2902,105209,77,305455
14220,0.001176,172.31.40.0-255,66,105275,77,305455
14221,0.001183,172.217.194.0-255,5738,111013,77,305455
14222,0.001186,172.31.40.0-255,66,111079,77,305455
14223,0.001198,172.217.194.0-255,12828,123907,77,305455
14224,0.001201,172.31.40.0-255,66,123973,77,305455
14225,0.001205,172.217.194.0-255,2902,126875,77,305455
14226,0.001208,172.31.40.0-255,66,126941,77,305455
14227,0.001236,172.217.194.0-255,7856,134797,77,305455
14228,0.001239,172.31.40.0-255,66,134863,77,305455
14229,0.001273,172.217.194.0-255,8574,143437,77,305455
14230,0.001279,172.217.194.0-255,7156,150593,77,305455
14231,0.001284,172.31.40.0-255,66,150659,77,305455
14232,0.001291,172.31.40.0-255,66,150725,77,305455
14233,0.001295,172.217.194.0-255,2902,153627,77,305455
14234,0.001298,172.31.40.0-255,66,153693,77,305455
14235,0.001311,172.217.194.0-255,12828,166521,77,305455
14236,0.001314,172.31.40.0-255,66,166587,77,305455
14237,0.001331,172.217.194.0-255,2184,168771,77,305455
14238,0.001333,172.31.40.0-255,66,168837,77,305455
14239,0.001405,172.217.194.0-255,1484,170321,77,305455
14240,0.001412,172.217.194.0-255,2902,173223,77,305455
14241,0.001431,172.217.194.0-255,5738,178961,77,305455
14242,0.001437,172.31.40.0-255,66,179027,77,305455
14243,0.001447,172.217.194.0-255,5738,184765,77,305455
14244,0.001452,172.31.40.0-255,66,184831,77,305455
14245,0.00147,172.217.194.0-255,7156,191987,77,305455
14246,0.001473,172.217.194.0-255,1484,193471,77,305455
14247,0.001527,172.217.194.0-255,9274,202745,77,305455
14248,0.001533,172.31.40.0-255,66,202811,77,305455
14249,0.001587,172.217.194.0-255,1484,204295,77,305455
14250,0.001593,172.217.194.0-255,2902,207197,77,305455
14251,0.001599,172.217.194.0-255,5738,212935,77,305455
14252,0.001614,172.31.40.0-255,66,213001,77,305455
14253,0.001637,172.217.194.0-255,12828,225829,77,305455
14254,0.001641,172.217.194.0-255,1484,227313,77,305455
14255,0.001662,172.31.40.0-255,66,227379,77,305455
14256,0.001673,172.217.194.0-255,9274,236653,77,305455
14257,0.001678,172.31.40.0-255,66,236719,77,305455
14258,0.00169,172.217.194.0-255,1484,238203,77,305455
14259,0.001714,172.217.194.0-255,9992,248195,77,305455
14260,0.001726,172.217.194.0-255,8574,256769,77,305455
14261,0.001745,172.217.194.0-255,2902,259671,77,305455
14262,0.001755,172.31.40.0-255,66,259737,77,305455
14263,0.001792,172.31.40.0-255,66,259803,77,305455
14264,0.001815,172.217.194.0-255,766,260569,77,305455
14265,0.001826,172.217.194.0-255,9992,270561,77,305455
14266,0.001836,172.217.194.0-255,11410,281971,77,305455
14267,0.00185,172.31.40.0-255,66,282037,77,305455
14268,0.001927,172.31.40.0-255,66,282103,77,305455
14269,0.001937,172.217.194.0-255,3602,285705,77,305455
14270,0.001994,172.31.40.0-255,66,285771,77,305455
14271,0.002012,172.217.194.0-255,10692,296463,77,305455
14272,0.002037,172.217.194.0-255,8650,305113,77,305455
14273,0.002039,172.217.194.0-255,105,305218,77,305455
14274,0.002063,172.31.40.0-255,66,305284,77,305455
14275,0.004693,172.31.40.0-255,105,305389,77,305455
14276,0.006944,172.217.194.0-255,66,305455,77,305455
14277,0.0,172.217.194.0-255,298,298,77,347584
14278,1.6e-05,172.31.40.0-255,66,364,77,347584
14279,3e-05,172.217.194.0-255,1484,1848,77,347584
14280,3.5e-05,172.31.40.0-255,66,1914,77,347584
14281,4.2e-05,172.217.194.0-255,4320,6234,77,347584
14282,4.6e-05,172.31.40.0-255,66,6300,77,347584
14283,5.5e-05,172.217.194.0-255,8968,15268,77,347584
14284,5.8e-05,172.31.40.0-255,66,15334,77,347584
14285,6.2e-05,172.217.194.0-255,1484,16818,77,347584
14286,6.4e-05,172.31.40.0-255,66,16884,77,347584
14287,0.000106,172.217.194.0-255,13887,30771,77,347584
14288,0.00011,172.31.40.0-255,66,30837,77,347584
14289,0.000123,172.217.194.0-255,1484,32321,77,347584
14290,0.000126,172.31.40.0-255,66,32387,77,347584
14291,0.000131,172.217.194.0-255,2902,35289,77,347584
14292,0.000133,172.31.40.0-255,66,35355,77,347584
14293,0.000138,172.217.194.0-255,4320,39675,77,347584
14294,0.000141,172.31.40.0-255,66,39741,77,347584
14295,0.000155,172.217.194.0-255,1484,41225,77,347584
14296,0.000157,172.31.40.0-255,66,41291,77,347584
14297,0.000165,172.217.194.0-255,6797,48088,77,347584
14298,0.000167,172.31.40.0-255,66,48154,77,347584
14299,0.000208,172.31.40.0-255,66,48220,77,347584
14300,0.000213,172.217.194.0-255,2794,51014,77,347584
14301,0.000214,172.31.40.0-255,66,51080,77,347584
14302,0.000235,172.217.194.0-255,435,51515,77,347584
14303,0.000237,172.31.40.0-255,66,51581,77,347584
14304,0.000396,172.217.194.0-255,1484,53065,77,347584
14305,0.000401,172.31.40.0-255,66,53131,77,347584
14306,0.000408,172.217.194.0-255,2902,56033,77,347584
14307,0.00041,172.31.40.0-255,66,56099,77,347584
14308,0.000413,172.217.194.0-255,1484,57583,77,347584
14309,0.000431,172.217.194.0-255,4320,61903,77,347584
14310,0.000434,172.31.40.0-255,66,61969,77,347584
14311,0.000445,172.217.194.0-255,11410,73379,77,347584
14312,0.000447,172.31.40.0-255,66,73445,77,347584
14313,0.000465,172.217.194.0-255,1484,74929,77,347584
14314,0.000476,172.217.194.0-255,10692,85621,77,347584
14315,0.000478,172.31.40.0-255,66,85687,77,347584
14316,0.000686,172.217.194.0-255,1484,87171,77,347584
14317,0.000693,172.217.194.0-255,2902,90073,77,347584
14318,0.000696,172.31.40.0-255,66,90139,77,347584
14319,0.000749,172.217.194.0-255,5738,95877,77,347584
14320,0.000752,172.31.40.0-255,66,95943,77,347584
14321,0.000763,172.217.194.0-255,12828,108771,77,347584
14322,0.000766,172.31.40.0-255,66,108837,77,347584
14323,0.00077,172.217.194.0-255,2902,111739,77,347584
14324,0.000773,172.31.40.0-255,66,111805,77,347584
14325,0.00081,172.217.194.0-255,7856,119661,77,347584
14326,0.000813,172.31.40.0-255,66,119727,77,347584
14327,0.000922,172.217.194.0-255,2902,122629,77,347584
14328,0.000926,172.31.40.0-255,66,122695,77,347584
14329,0.000931,172.217.194.0-255,4320,127015,77,347584
14330,0.000935,172.31.40.0-255,66,127081,77,347584
14331,0.000942,172.217.194.0-255,8574,135655,77,347584
14332,0.000945,172.31.40.0-255,66,135721,77,347584
14333,0.000955,172.217.194.0-255,11410,147131,77,347584
14334,0.000958,172.31.40.0-255,66,147197,77,347584
14335,0.000965,172.217.194.0-255,6438,153635,77,347584
14336,0.000968,172.31.40.0-255,66,153701,77,347584
14337,0.000975,172.217.194.0-255,7156,160857,77,347584
14338,0.000978,172.31.40.0-255,66,160923,77,347584
14339,0.000986,172.217.194.0-255,8574,169497,77,347584
14340,0.000989,172.31.40.0-255,66,169563,77,347584
14341,0.001011,172.217.194.0-255,7156,176719,77,347584
14342,0.001014,172.217.194.0-255,1484,178203,77,347584
14343,0.001031,172.217.194.0-255,9274,187477,77,347584
14344,0.001052,172.217.194.0-255,4320,191797,77,347584
14345,0.001058,172.31.40.0-255,66,191863,77,347584
14346,0.001075,172.217.194.0-255,7156,199019,77,347584
14347,0.001085,172.217.194.0-255,11410,210429,77,347584
14348,0.001104,172.217.194.0-255,4320,214749,77,347584
14349,0.001108,172.31.40.0-255,66,214815,77,347584
14350,0.001113,172.31.40.0-255,66,214881,77,347584
14351,0.001148,172.217.194.0-255,12828,227709,77,347584
14352,0.001167,172.31.40.0-255,66,227775,77,347584
14353,0.0012,172.217.194.0-255,10692,238467,77,347584
14354,0.001227,172.217.194.0-255,11410,249877,77,347584
14355,0.001231,172.217.194.0-255,4320,254197,77,347584
14356,0.001235,172.31.40.0-255,66,254263,77,347584
14357,0.001245,172.217.194.0-255,1484,255747,77,347584
14358,0.001303,172.31.40.0-255,66,255813,77,347584
14359,0.001336,172.217.194.0-255,4320,260133,77,347584
14360,0.001356,172.217.194.0-255,12110,272243,77,347584
14361,0.001359,172.31.40.0-255,66,272309,77,347584
14362,0.001386,172.217.194.0-255,4320,276629,77,347584
14363,0.001394,172.31.40.0-255,66,276695,77,347584
14364,0.001418,172.217.194.0-255,8574,285269,77,347584
14365,0.001423,172.217.194.0-255,2902,288171,77,347584
14366,0.001433,172.31.40.0-255,66,288237,77,347584
14367,0.00145,172.217.194.0-255,11410,299647,77,347584
14368,0.001456,172.217.194.0-255,4320,303967,77,347584
14369,0.001466,172.31.40.0-255,66,304033,77,347584
14370,0.001476,172.217.194.0-255,2184,306217,77,347584
14371,0.001481,172.217.194.0-255,2902,309119,77,347584
14372,0.001484,172.217.194.0-255,2902,312021,77,347584
14373,0.001488,172.31.40.0-255,66,312087,77,347584
14374,0.001494,172.217.194.0-255,1484,313571,77,347584
14375,0.001498,172.217.194.0-255,2902,316473,77,347584
14376,0.001509,172.217.194.0-255,2902,319375,77,347584
14377,0.001523,172.217.194.0-255,2902,322277,77,347584
14378,0.001528,172.31.40.0-255,66,322343,77,347584
14379,0.001542,172.217.194.0-255,5738,328081,77,347584
14380,0.001565,172.217.194.0-255,12110,340191,77,347584
14381,0.00157,172.31.40.0-255,66,340257,77,347584
14382,0.001578,172.217.194.0-255,1484,341741,77,347584
14383,0.001597,172.217.194.0-255,5435,347176,77,347584
14384,0.001604,172.31.40.0-255,66,347242,77,347584
14385,0.001621,172.217.194.0-255,105,347347,77,347584
14386,0.004093,172.31.40.0-255,66,347413,77,347584
14387,0.004125,172.31.40.0-255,105,347518,77,347584
14388,0.006357,172.217.194.0-255,66,347584,77,347584
14389,0.0,74.125.68.0-255,295,295,77,251014
14390,2.1e-05,172.31.40.0-255,66,361,77,251014
14391,2.7e-05,74.125.68.0-255,1484,1845,77,251014
14392,3.2e-05,172.31.40.0-255,66,1911,77,251014
14393,3.9e-05,74.125.68.0-255,4320,6231,77,251014
14394,4.3e-05,172.31.40.0-255,66,6297,77,251014
14395,4.8e-05,74.125.68.0-255,2902,9199,77,251014
14396,5e-05,172.31.40.0-255,66,9265,77,251014
14397,8e-05,74.125.68.0-255,4320,13585,77,251014
14398,8.3e-05,172.31.40.0-255,66,13651,77,251014
14399,0.000101,74.125.68.0-255,458,14109,77,251014
14400,0.000103,172.31.40.0-255,66,14175,77,251014
14401,0.000318,74.125.68.0-255,1484,15659,77,251014
14402,0.000324,172.31.40.0-255,66,15725,77,251014
14403,0.00033,74.125.68.0-255,2902,18627,77,251014
14404,0.000332,172.31.40.0-255,66,18693,77,251014
14405,0.000335,74.125.68.0-255,1484,20177,77,251014
14406,0.000337,172.31.40.0-255,66,20243,77,251014
14407,0.000358,74.125.68.0-255,2902,23145,77,251014
14408,0.000361,172.31.40.0-255,66,23211,77,251014
14409,0.000375,74.125.68.0-255,5738,28949,77,251014
14410,0.000378,172.31.40.0-255,66,29015,77,251014
14411,0.000382,74.125.68.0-255,2543,31558,77,251014
14412,0.000385,172.31.40.0-255,66,31624,77,251014
14413,0.000403,74.125.68.0-255,2902,34526,77,251014
14414,0.000406,172.31.40.0-255,66,34592,77,251014
14415,0.000442,74.125.68.0-255,7156,41748,77,251014
14416,0.000445,172.31.40.0-255,66,41814,77,251014
14417,0.000449,74.125.68.0-255,2902,44716,77,251014
14418,0.000451,172.31.40.0-255,66,44782,77,251014
14419,0.000501,74.125.68.0-255,1484,46266,77,251014
14420,0.000504,172.31.40.0-255,66,46332,77,251014
14421,0.000517,74.125.68.0-255,2543,48875,77,251014
14422,0.00052,172.31.40.0-255,66,48941,77,251014
14423,0.000862,74.125.68.0-255,1484,50425,77,251014
14424,0.000882,74.125.68.0-255,2902,53327,77,251014
14425,0.000885,172.31.40.0-255,66,53393,77,251014
14426,0.000889,74.125.68.0-255,1484,54877,77,251014
14427,0.000903,74.125.68.0-255,1484,56361,77,251014
14428,0.000906,172.31.40.0-255,66,56427,77,251014
14429,0.000923,74.125.68.0-255,1484,57911,77,251014
14430,0.000929,74.125.68.0-255,5738,63649,77,251014
14431,0.000931,172.31.40.0-255,66,63715,77,251014
14432,0.000955,74.125.68.0-255,2543,66258,77,251014
14433,0.000957,172.31.40.0-255,66,66324,77,251014
14434,0.001054,74.125.68.0-255,1484,67808,77,251014
14435,0.001066,74.125.68.0-255,2902,70710,77,251014
14436,0.001069,172.31.40.0-255,66,70776,77,251014
14437,0.001085,74.125.68.0-255,2902,73678,77,251014
14438,0.001087,172.31.40.0-255,66,73744,77,251014
14439,0.001114,74.125.68.0-255,2902,76646,77,251014
14440,0.001119,74.125.68.0-255,2902,79548,77,251014
14441,0.001149,74.125.68.0-255,4320,83868,77,251014
14442,0.001153,172.31.40.0-255,66,83934,77,251014
14443,0.00116,172.31.40.0-255,66,84000,77,251014
14444,0.001163,172.31.40.0-255,66,84066,77,251014
14445,0.00117,74.125.68.0-255,5738,89804,77,251014
14446,0.001172,172.31.40.0-255,66,89870,77,251014
14447,0.001183,74.125.68.0-255,10692,100562,77,251014
14448,0.001186,172.31.40.0-255,66,100628,77,251014
14449,0.001219,74.125.68.0-255,1484,102112,77,251014
14450,0.001224,74.125.68.0-255,1484,103596,77,251014
14451,0.001227,172.31.40.0-255,66,103662,77,251014
14452,0.001238,74.125.68.0-255,1484,105146,77,251014
14453,0.001254,74.125.68.0-255,4320,109466,77,251014
14454,0.001256,172.31.40.0-255,66,109532,77,251014
14455,0.001286,74.125.68.0-255,5738,115270,77,251014
14456,0.001289,172.31.40.0-255,66,115336,77,251014
14457,0.001293,74.125.68.0-255,2425,117761,77,251014
14458,0.001296,172.31.40.0-255,66,117827,77,251014
14459,0.001373,74.125.68.0-255,1484,119311,77,251014
14460,0.001378,74.125.68.0-255,1484,120795,77,251014
14461,0.001381,172.31.40.0-255,66,120861,77,251014
14462,0.001394,74.125.68.0-255,1484,122345,77,251014
14463,0.001409,74.125.68.0-255,2902,125247,77,251014
14464,0.001412,172.31.40.0-255,66,125313,77,251014
14465,0.001425,74.125.68.0-255,1484,126797,77,251014
14466,0.001431,74.125.68.0-255,4320,131117,77,251014
14467,0.001433,172.31.40.0-255,66,131183,77,251014
14468,0.001455,74.125.68.0-255,1484,132667,77,251014
14469,0.001462,74.125.68.0-255,4659,137326,77,251014
14470,0.001465,172.31.40.0-255,66,137392,77,251014
14471,0.001468,74.125.68.0-255,1484,138876,77,251014
14472,0.001484,74.125.68.0-255,4320,143196,77,251014
14473,0.001487,172.31.40.0-255,66,143262,77,251014
14474,0.001513,74.125.68.0-255,4320,147582,77,251014
14475,0.001517,172.31.40.0-255,66,147648,77,251014
14476,0.001543,74.125.68.0-255,2902,150550,77,251014
14477,0.001546,172.31.40.0-255,66,150616,77,251014
14478,0.001558,74.125.68.0-255,1484,152100,77,251014
14479,0.001575,74.125.68.0-255,7156,159256,77,251014
14480,0.001578,172.31.40.0-255,66,159322,77,251014
14481,0.001613,74.125.68.0-255,9992,169314,77,251014
14482,0.001617,172.31.40.0-255,66,169380,77,251014
14483,0.00162,74.125.68.0-255,766,170146,77,251014
14484,0.001879,74.125.68.0-255,1484,171630,77,251014
14485,0.001883,172.31.40.0-255,66,171696,77,251014
14486,0.001889,74.125.68.0-255,2902,174598,77,251014
14487,0.001892,172.31.40.0-255,66,174664,77,251014
14488,0.001895,74.125.68.0-255,1484,176148,77,251014
14489,0.001923,74.125.68.0-255,4320,180468,77,251014
14490,0.001926,172.31.40.0-255,66,180534,77,251014
14491,0.00193,74.125.68.0-255,2902,183436,77,251014
14492,0.001933,172.31.40.0-255,66,183502,77,251014
14493,0.001938,74.125.68.0-255,4320,187822,77,251014
14494,0.00194,172.31.40.0-255,66,187888,77,251014
14495,0.001947,74.125.68.0-255,5738,193626,77,251014
14496,0.001949,172.31.40.0-255,66,193692,77,251014
14497,0.00198,74.125.68.0-255,2902,196594,77,251014
14498,0.001983,172.31.40.0-255,66,196660,77,251014
14499,0.001991,74.125.68.0-255,7856,204516,77,251014
14500,0.001993,172.31.40.0-255,66,204582,77,251014
14501,0.004058,74.125.68.0-255,5738,210320,77,251014
14502,0.004066,172.31.40.0-255,66,210386,77,251014
14503,0.006137,74.125.68.0-255,5738,216124,77,251014
14504,0.006143,172.31.40.0-255,66,216190,77,251014
14505,0.008218,74.125.68.0-255,5738,221928,77,251014
14506,0.008225,172.31.40.0-255,66,221994,77,251014
14507,0.01029,74.125.68.0-255,5738,227732,77,251014
14508,0.010297,172.31.40.0-255,66,227798,77,251014
14509,0.01238,74.125.68.0-255,5738,233536,77,251014
14510,0.012388,172.31.40.0-255,66,233602,77,251014
14511,0.014462,74.125.68.0-255,5738,239340,77,251014
14512,0.01447,172.31.40.0-255,66,239406,77,251014
14513,0.016547,74.125.68.0-255,5738,245144,77,251014
14514,0.016555,172.31.40.0-255,66,245210,77,251014
14515,0.018642,74.125.68.0-255,5738,250948,77,251014
14516,0.018651,172.31.40.0-255,66,251014,77,251014
14517,0.0,74.125.68.0-255,153,153,77,221512
14518,2.3e-05,172.31.40.0-255,66,219,77,221512
14519,3e-05,74.125.68.0-255,1484,1703,77,221512
14520,3.4e-05,172.31.40.0-255,66,1769,77,221512
14521,4.8e-05,74.125.68.0-255,2902,4671,77,221512
14522,5.1e-05,172.31.40.0-255,66,4737,77,221512
14523,5.9e-05,74.125.68.0-255,7156,11893,77,221512
14524,6.2e-05,172.31.40.0-255,66,11959,77,221512
14525,7.6e-05,74.125.68.0-255,2102,14061,77,221512
14526,7.8e-05,172.31.40.0-255,66,14127,77,221512
14527,0.000117,74.125.68.0-255,2902,17029,77,221512
14528,0.00012,172.31.40.0-255,66,17095,77,221512
14529,0.000123,74.125.68.0-255,1484,18579,77,221512
14530,0.000125,172.31.40.0-255,66,18645,77,221512
14531,0.000132,74.125.68.0-255,5738,24383,77,221512
14532,0.000139,172.31.40.0-255,66,24449,77,221512
14533,0.000159,74.125.68.0-255,1484,25933,77,221512
14534,0.000161,172.31.40.0-255,66,25999,77,221512
14535,0.0002,74.125.68.0-255,11410,37409,77,221512
14536,0.000203,172.31.40.0-255,66,37475,77,221512
14537,0.000208,74.125.68.0-255,5738,43213,77,221512
14538,0.00021,172.31.40.0-255,66,43279,77,221512
14539,0.000245,74.125.68.0-255,5020,48299,77,221512
14540,0.000247,172.31.40.0-255,66,48365,77,221512
14541,0.000313,74.125.68.0-255,1484,49849,77,221512
14542,0.000316,172.31.40.0-255,66,49915,77,221512
14543,0.000329,74.125.68.0-255,2902,52817,77,221512
14544,0.000335,172.31.40.0-255,66,52883,77,221512
14545,0.000341,74.125.68.0-255,4320,57203,77,221512
14546,0.000343,172.31.40.0-255,66,57269,77,221512
14547,0.000401,74.125.68.0-255,8215,65484,77,221512
14548,0.000404,172.31.40.0-255,66,65550,77,221512
14549,0.000895,74.125.68.0-255,1484,67034,77,221512
14550,0.000912,74.125.68.0-255,2902,69936,77,221512
14551,0.000916,172.31.40.0-255,66,70002,77,221512
14552,0.000928,74.125.68.0-255,2902,72904,77,221512
14553,0.000939,172.31.40.0-255,66,72970,77,221512
14554,0.000965,74.125.68.0-255,4320,77290,77,221512
14555,0.000968,172.31.40.0-255,66,77356,77,221512
14556,0.000994,74.125.68.0-255,5379,82735,77,221512
14557,0.000996,172.31.40.0-255,66,82801,77,221512
14558,0.001003,74.125.68.0-255,5738,88539,77,221512
14559,0.001005,172.31.40.0-255,66,88605,77,221512
14560,0.001031,74.125.68.0-255,1484,90089,77,221512
14561,0.001051,74.125.68.0-255,8574,98663,77,221512
14562,0.001054,172.31.40.0-255,66,98729,77,221512
14563,0.00108,74.125.68.0-255,1706,100435,77,221512
14564,0.001082,172.31.40.0-255,66,100501,77,221512
14565,0.001156,74.125.68.0-255,1484,101985,77,221512
14566,0.001159,74.125.68.0-255,1484,103469,77,221512
14567,0.001164,172.31.40.0-255,66,103535,77,221512
14568,0.001188,74.125.68.0-255,1484,105019,77,221512
14569,0.00119,74.125.68.0-255,1484,106503,77,221512
14570,0.001193,172.31.40.0-255,66,106569,77,221512
14571,0.001196,74.125.68.0-255,1484,108053,77,221512
14572,0.001217,74.125.68.0-255,1484,109537,77,221512
14573,0.00122,172.31.40.0-255,66,109603,77,221512
14574,0.001226,74.125.68.0-255,5738,115341,77,221512
14575,0.001228,172.31.40.0-255,66,115407,77,221512
14576,0.001238,74.125.68.0-255,4320,119727,77,221512
14577,0.00124,172.31.40.0-255,66,119793,77,221512
14578,0.001251,74.125.68.0-255,2902,122695,77,221512
14579,0.001254,172.31.40.0-255,66,122761,77,221512
14580,0.001262,74.125.68.0-255,8574,131335,77,221512
14581,0.001283,74.125.68.0-255,3602,134937,77,221512
14582,0.001304,172.31.40.0-255,66,135003,77,221512
14583,0.001365,172.31.40.0-255,101,135104,77,221512
14584,0.001529,74.125.68.0-255,1484,136588,77,221512
14585,0.001547,74.125.68.0-255,2902,139490,77,221512
14586,0.00155,172.31.40.0-255,66,139556,77,221512
14587,0.001582,74.125.68.0-255,5738,145294,77,221512
14588,0.001585,172.31.40.0-255,66,145360,77,221512
14589,0.001588,74.125.68.0-255,1484,146844,77,221512
14590,0.001619,74.125.68.0-255,9992,156836,77,221512
14591,0.001622,172.31.40.0-255,66,156902,77,221512
14592,0.001629,74.125.68.0-255,7156,164058,77,221512
14593,0.001631,172.31.40.0-255,66,164124,77,221512
14594,0.001659,74.125.68.0-255,5020,169144,77,221512
14595,0.001661,172.31.40.0-255,66,169210,77,221512
14596,0.003264,74.125.68.0-255,66,169276,77,221512
14597,0.003618,74.125.68.0-255,5738,175014,77,221512
14598,0.003623,172.31.40.0-255,66,175080,77,221512
14599,0.005586,74.125.68.0-255,5738,180818,77,221512
14600,0.005589,172.31.40.0-255,66,180884,77,221512
14601,0.007523,74.125.68.0-255,5738,186622,77,221512
14602,0.007527,172.31.40.0-255,66,186688,77,221512
14603,0.009469,74.125.68.0-255,5738,192426,77,221512
14604,0.009477,172.31.40.0-255,66,192492,77,221512
14605,0.011416,74.125.68.0-255,5738,198230,77,221512
14606,0.011424,172.31.40.0-255,66,198296,77,221512
14607,0.013367,74.125.68.0-255,5738,204034,77,221512
14608,0.013373,172.31.40.0-255,66,204100,77,221512
14609,0.015313,74.125.68.0-255,5738,209838,77,221512
14610,0.015319,172.31.40.0-255,66,209904,77,221512
14611,0.01726,74.125.68.0-255,5738,215642,77,221512
14612,0.017267,172.31.40.0-255,66,215708,77,221512
14613,0.019216,74.125.68.0-255,5738,221446,77,221512
14614,0.019224,172.31.40.0-255,66,221512,77,221512
14615,0.0,74.125.68.0-255,150,150,77,284964
14616,2.5e-05,172.31.40.0-255,66,216,77,284964
14617,3.3e-05,74.125.68.0-255,1484,1700,77,284964
14618,3.8e-05,172.31.40.0-255,66,1766,77,284964
14619,4.4e-05,74.125.68.0-255,2902,4668,77,284964
14620,4.8e-05,172.31.40.0-255,66,4734,77,284964
14621,5.3e-05,74.125.68.0-255,2902,7636,77,284964
14622,5.6e-05,172.31.40.0-255,66,7702,77,284964
14623,6.2e-05,74.125.68.0-255,4320,12022,77,284964
14624,6.4e-05,172.31.40.0-255,66,12088,77,284964
14625,9.4e-05,74.125.68.0-255,9245,21333,77,284964
14626,9.7e-05,172.31.40.0-255,66,21399,77,284964
14627,0.000134,74.125.68.0-255,9633,31032,77,284964
14628,0.000137,172.31.40.0-255,66,31098,77,284964
14629,0.000259,74.125.68.0-255,1484,32582,77,284964
14630,0.000263,172.31.40.0-255,66,32648,77,284964
14631,0.000268,74.125.68.0-255,2902,35550,77,284964
14632,0.00027,172.31.40.0-255,66,35616,77,284964
14633,0.000295,74.125.68.0-255,5738,41354,77,284964
14634,0.000297,172.31.40.0-255,66,41420,77,284964
14635,0.000305,74.125.68.0-255,6797,48217,77,284964
14636,0.000307,172.31.40.0-255,66,48283,77,284964
14637,0.000336,74.125.68.0-255,4320,52603,77,284964
14638,0.000339,172.31.40.0-255,66,52669,77,284964
14639,0.00036,74.125.68.0-255,2902,55571,77,284964
14640,0.000362,172.31.40.0-255,66,55637,77,284964
14641,0.000371,74.125.68.0-255,8574,64211,77,284964
14642,0.000373,172.31.40.0-255,66,64277,77,284964
14643,0.000388,74.125.68.0-255,1398,65675,77,284964
14644,0.000391,172.31.40.0-255,66,65741,77,284964
14645,0.000405,74.125.68.0-255,133,65874,77,284964
14646,0.000407,172.31.40.0-255,66,65940,77,284964
14647,0.000418,74.125.68.0-255,346,66286,77,284964
14648,0.000675,74.125.68.0-255,1484,67770,77,284964
14649,0.00068,172.31.40.0-255,66,67836,77,284964
14650,0.000686,74.125.68.0-255,2902,70738,77,284964
14651,0.000689,172.31.40.0-255,66,70804,77,284964
14652,0.000691,74.125.68.0-255,1484,72288,77,284964
14653,0.000709,74.125.68.0-255,2902,75190,77,284964
14654,0.000711,172.31.40.0-255,66,75256,77,284964
14655,0.000717,74.125.68.0-255,4320,79576,77,284964
14656,0.000719,172.31.40.0-255,66,79642,77,284964
14657,0.000734,74.125.68.0-255,1484,81126,77,284964
14658,0.000763,74.125.68.0-255,7156,88282,77,284964
14659,0.000766,172.31.40.0-255,66,88348,77,284964
14660,0.000786,74.125.68.0-255,5738,94086,77,284964
14661,0.00079,172.31.40.0-255,66,94152,77,284964
14662,0.000794,74.125.68.0-255,2902,97054,77,284964
14663,0.000796,172.31.40.0-255,66,97120,77,284964
14664,0.000817,74.125.68.0-255,3602,100722,77,284964
14665,0.000823,172.31.40.0-255,66,100788,77,284964
14666,0.001005,74.125.68.0-255,1484,102272,77,284964
14667,0.00101,74.125.68.0-255,1484,103756,77,284964
14668,0.001013,172.31.40.0-255,66,103822,77,284964
14669,0.001032,74.125.68.0-255,1484,105306,77,284964
14670,0.001038,74.125.68.0-255,5738,111044,77,284964
14671,0.001041,172.31.40.0-255,66,111110,77,284964
14672,0.001064,74.125.68.0-255,7156,118266,77,284964
14673,0.001068,74.125.68.0-255,2902,121168,77,284964
14674,0.001071,172.31.40.0-255,66,121234,77,284964
14675,0.001074,172.31.40.0-255,66,121300,77,284964
14676,0.001085,74.125.68.0-255,2902,124202,77,284964
14677,0.001087,172.31.40.0-255,66,124268,77,284964
14678,0.001105,74.125.68.0-255,2902,127170,77,284964
14679,0.001107,172.31.40.0-255,66,127236,77,284964
14680,0.001116,74.125.68.0-255,7856,135092,77,284964
14681,0.001118,172.31.40.0-255,66,135158,77,284964
14682,0.0015,74.125.68.0-255,1484,136642,77,284964
14683,0.001515,74.125.68.0-255,2902,139544,77,284964
14684,0.001524,172.31.40.0-255,66,139610,77,284964
14685,0.001546,74.125.68.0-255,5738,145348,77,284964
14686,0.001548,172.31.40.0-255,66,145414,77,284964
14687,0.001569,74.125.68.0-255,5738,151152,77,284964
14688,0.001572,172.31.40.0-255,66,151218,77,284964
14689,0.001597,74.125.68.0-255,7156,158374,77,284964
14690,0.001599,172.31.40.0-255,66,158440,77,284964
14691,0.001618,74.125.68.0-255,4320,162760,77,284964
14692,0.00162,172.31.40.0-255,66,162826,77,284964
14693,0.001647,74.125.68.0-255,5738,168564,77,284964
14694,0.00165,172.31.40.0-255,66,168630,77,284964
14695,0.001653,74.125.68.0-255,766,169396,77,284964
14696,0.001742,74.125.68.0-255,1484,170880,77,284964
14697,0.001745,172.31.40.0-255,66,170946,77,284964
14698,0.001749,74.125.68.0-255,1484,172430,77,284964
14699,0.001764,74.125.68.0-255,1484,173914,77,284964
14700,0.001766,172.31.40.0-255,66,173980,77,284964
14701,0.001771,74.125.68.0-255,2902,176882,77,284964
14702,0.001773,172.31.40.0-255,66,176948,77,284964
14703,0.001778,74.125.68.0-255,4320,181268,77,284964
14704,0.00178,172.31.40.0-255,66,181334,77,284964
14705,0.001807,74.125.68.0-255,8574,189908,77,284964
14706,0.00181,172.31.40.0-255,66,189974,77,284964
14707,0.001813,74.125.68.0-255,1484,191458,77,284964
14708,0.001832,74.125.68.0-255,4320,195778,77,284964
14709,0.001835,172.31.40.0-255,66,195844,77,284964
14710,0.00184,74.125.68.0-255,4320,200164,77,284964
14711,0.001842,172.31.40.0-255,66,200230,77,284964
14712,0.001855,74.125.68.0-255,2902,203132,77,284964
14713,0.001857,172.31.40.0-255,66,203198,77,284964
14714,0.001859,74.125.68.0-255,766,203964,77,284964
14715,0.002005,74.125.68.0-255,1484,205448,77,284964
14716,0.002009,172.31.40.0-255,66,205514,77,284964
14717,0.002014,74.125.68.0-255,2902,208416,77,284964
14718,0.002016,172.31.40.0-255,66,208482,77,284964
14719,0.002022,74.125.68.0-255,5738,214220,77,284964
14720,0.002025,172.31.40.0-255,66,214286,77,284964
14721,0.002028,74.125.68.0-255,1484,215770,77,284964
14722,0.00206,74.125.68.0-255,5738,221508,77,284964
14723,0.002063,172.31.40.0-255,66,221574,77,284964
14724,0.002069,74.125.68.0-255,4320,225894,77,284964
14725,0.002071,172.31.40.0-255,66,225960,77,284964
14726,0.002083,74.125.68.0-255,1484,227444,77,284964
14727,0.002086,74.125.68.0-255,1484,228928,77,284964
14728,0.002088,172.31.40.0-255,66,228994,77,284964
14729,0.002109,74.125.68.0-255,5738,234732,77,284964
14730,0.002112,172.31.40.0-255,66,234798,77,284964
14731,0.002117,74.125.68.0-255,3602,238400,77,284964
14732,0.002119,172.31.40.0-255,66,238466,77,284964
14733,0.002224,74.125.68.0-255,1484,239950,77,284964
14734,0.004332,74.125.68.0-255,4320,244270,77,284964
14735,0.00434,172.31.40.0-255,66,244336,77,284964
14736,0.006547,74.125.68.0-255,5738,250074,77,284964
14737,0.006554,172.31.40.0-255,66,250140,77,284964
14738,0.008773,74.125.68.0-255,5738,255878,77,284964
14739,0.00878,172.31.40.0-255,66,255944,77,284964
14740,0.011007,74.125.68.0-255,5738,261682,77,284964
14741,0.011026,172.31.40.0-255,66,261748,77,284964
14742,0.013246,74.125.68.0-255,5738,267486,77,284964
14743,0.01326,172.31.40.0-255,66,267552,77,284964
14744,0.015467,74.125.68.0-255,5738,273290,77,284964
14745,0.015475,172.31.40.0-255,66,273356,77,284964
14746,0.0177,74.125.68.0-255,5738,279094,77,284964
14747,0.017715,172.31.40.0-255,66,279160,77,284964
14748,0.019919,74.125.68.0-255,5738,284898,77,284964
14749,0.019929,172.31.40.0-255,66,284964,77,284964
14750,0.0,172.217.160.0-255,153,153,77,288769
14751,1.5e-05,172.31.40.0-255,66,219,77,288769
14752,2.1e-05,172.217.160.0-255,1484,1703,77,288769
14753,2.5e-05,172.31.40.0-255,66,1769,77,288769
14754,3.1e-05,172.217.160.0-255,2902,4671,77,288769
14755,4.6e-05,172.31.40.0-255,66,4737,77,288769
14756,5e-05,172.217.160.0-255,1484,6221,77,288769
14757,5.2e-05,172.31.40.0-255,66,6287,77,288769
14758,6e-05,172.217.160.0-255,5738,12025,77,288769
14759,6.2e-05,172.31.40.0-255,66,12091,77,288769
14760,6.6e-05,172.217.160.0-255,1979,14070,77,288769
14761,6.8e-05,172.31.40.0-255,66,14136,77,288769
14762,0.000136,172.217.160.0-255,2902,17038,77,288769
14763,0.000139,172.31.40.0-255,66,17104,77,288769
14764,0.000167,172.217.160.0-255,7156,24260,77,288769
14765,0.00017,172.31.40.0-255,66,24326,77,288769
14766,0.000178,172.217.160.0-255,6797,31123,77,288769
14767,0.00018,172.31.40.0-255,66,31189,77,288769
14768,0.00033,172.217.160.0-255,1484,32673,77,288769
14769,0.000335,172.31.40.0-255,66,32739,77,288769
14770,0.000339,172.217.160.0-255,1484,34223,77,288769
14771,0.000341,172.31.40.0-255,66,34289,77,288769
14772,0.000361,172.217.160.0-255,1484,35773,77,288769
14773,0.000367,172.31.40.0-255,66,35839,77,288769
14774,0.000375,172.217.160.0-255,5738,41577,77,288769
14775,0.000377,172.31.40.0-255,66,41643,77,288769
14776,0.000424,172.217.160.0-255,13887,55530,77,288769
14777,0.000427,172.31.40.0-255,66,55596,77,288769
14778,0.000437,172.217.160.0-255,8574,64170,77,288769
14779,0.000444,172.31.40.0-255,66,64236,77,288769
14780,0.000447,172.217.160.0-255,1393,65629,77,288769
14781,0.000449,172.31.40.0-255,66,65695,77,288769
14782,0.000877,172.217.160.0-255,123,65818,77,288769
14783,0.001028,172.217.160.0-255,1484,67302,77,288769
14784,0.001034,172.31.40.0-255,66,67368,77,288769
14785,0.001039,172.217.160.0-255,2902,70270,77,288769
14786,0.001041,172.31.40.0-255,66,70336,77,288769
14787,0.001047,172.217.160.0-255,4320,74656,77,288769
14788,0.001054,172.31.40.0-255,66,74722,77,288769
14789,0.00109,172.217.160.0-255,1484,76206,77,288769
14790,0.001104,172.217.160.0-255,13887,90093,77,288769
14791,0.001107,172.31.40.0-255,66,90159,77,288769
14792,0.001121,172.217.160.0-255,2902,93061,77,288769
14793,0.001128,172.31.40.0-255,66,93127,77,288769
14794,0.001161,172.217.160.0-255,6797,99924,77,288769
14795,0.001163,172.31.40.0-255,66,99990,77,288769
14796,0.001398,172.217.160.0-255,383,100373,77,288769
14797,0.001438,172.217.160.0-255,1484,101857,77,288769
14798,0.001442,172.31.40.0-255,66,101923,77,288769
14799,0.001448,172.217.160.0-255,4320,106243,77,288769
14800,0.00145,172.31.40.0-255,66,106309,77,288769
14801,0.001464,172.217.160.0-255,9992,116301,77,288769
14802,0.001466,172.31.40.0-255,66,116367,77,288769
14803,0.001499,172.217.160.0-255,12828,129195,77,288769
14804,0.001502,172.31.40.0-255,66,129261,77,288769
14805,0.001548,172.217.160.0-255,5020,134281,77,288769
14806,0.001551,172.31.40.0-255,66,134347,77,288769
14807,0.001597,172.217.160.0-255,1484,135831,77,288769
14808,0.001611,172.217.160.0-255,2902,138733,77,288769
14809,0.001615,172.31.40.0-255,66,138799,77,288769
14810,0.001622,172.217.160.0-255,5738,144537,77,288769
14811,0.001623,172.31.40.0-255,66,144603,77,288769
14812,0.001634,172.217.160.0-255,5738,150341,77,288769
14813,0.001636,172.31.40.0-255,66,150407,77,288769
14814,0.001644,172.217.160.0-255,7156,157563,77,288769
14815,0.001646,172.31.40.0-255,66,157629,77,288769
14816,0.001691,172.217.160.0-255,5738,163367,77,288769
14817,0.001695,172.31.40.0-255,66,163433,77,288769
14818,0.001726,172.217.160.0-255,5020,168453,77,288769
14819,0.001729,172.31.40.0-255,66,168519,77,288769
14820,0.001784,172.217.160.0-255,1484,170003,77,288769
14821,0.001789,172.217.160.0-255,2902,172905,77,288769
14822,0.001792,172.31.40.0-255,66,172971,77,288769
14823,0.001813,172.217.160.0-255,5738,178709,77,288769
14824,0.001815,172.31.40.0-255,66,178775,77,288769
14825,0.001849,172.217.160.0-255,12828,191603,77,288769
14826,0.001853,172.31.40.0-255,66,191669,77,288769
14827,0.001856,172.217.160.0-255,1484,193153,77,288769
14828,0.001903,172.217.160.0-255,8574,201727,77,288769
14829,0.001906,172.31.40.0-255,66,201793,77,288769
14830,0.001918,172.217.160.0-255,766,202559,77,288769
14831,0.001925,172.217.160.0-255,1484,204043,77,288769
14832,0.001927,172.31.40.0-255,66,204109,77,288769
14833,0.001932,172.217.160.0-255,2902,207011,77,288769
14834,0.001934,172.31.40.0-255,66,207077,77,288769
14835,0.00194,172.217.160.0-255,5738,212815,77,288769
14836,0.001942,172.31.40.0-255,66,212881,77,288769
14837,0.001953,172.217.160.0-255,12828,225709,77,288769
14838,0.001956,172.31.40.0-255,66,225775,77,288769
14839,0.001966,172.217.160.0-255,10692,236467,77,288769
14840,0.001969,172.31.40.0-255,66,236533,77,288769
14841,0.003937,172.217.160.0-255,5738,242271,77,288769
14842,0.003944,172.31.40.0-255,66,242337,77,288769
14843,0.00593,172.217.160.0-255,5738,248075,77,288769
14844,0.005934,172.31.40.0-255,66,248141,77,288769
14845,0.007928,172.217.160.0-255,5738,253879,77,288769
14846,0.007934,172.31.40.0-255,66,253945,77,288769
14847,0.009924,172.217.160.0-255,5738,259683,77,288769
14848,0.009939,172.31.40.0-255,66,259749,77,288769
14849,0.011921,172.217.160.0-255,5738,265487,77,288769
14850,0.011934,172.31.40.0-255,66,265553,77,288769
14851,0.013927,172.217.160.0-255,5738,271291,77,288769
14852,0.013939,172.31.40.0-255,66,271357,77,288769
14853,0.015932,172.217.160.0-255,5738,277095,77,288769
14854,0.015942,172.31.40.0-255,66,277161,77,288769
14855,0.017925,172.217.160.0-255,5738,282899,77,288769
14856,0.017932,172.31.40.0-255,66,282965,77,288769
14857,0.019915,172.217.160.0-255,5738,288703,77,288769
14858,0.019923,172.31.40.0-255,66,288769,77,288769
14859,0.0,74.125.24.0-255,153,153,77,192770
14860,2.2e-05,172.31.40.0-255,66,219,77,192770
14861,3e-05,74.125.24.0-255,1484,1703,77,192770
14862,3.4e-05,172.31.40.0-255,66,1769,77,192770
14863,4.1e-05,74.125.24.0-255,2902,4671,77,192770
14864,4.3e-05,172.31.40.0-255,66,4737,77,192770
14865,6e-05,74.125.24.0-255,7156,11893,77,192770
14866,6.4e-05,172.31.40.0-255,66,11959,77,192770
14867,7e-05,74.125.24.0-255,3555,15514,77,192770
14868,7.2e-05,172.31.40.0-255,66,15580,77,192770
14869,8.4e-05,74.125.24.0-255,12828,28408,77,192770
14870,8.7e-05,172.31.40.0-255,66,28474,77,192770
14871,9.2e-05,74.125.24.0-255,2543,31017,77,192770
14872,9.5e-05,172.31.40.0-255,66,31083,77,192770
14873,0.001224,74.125.24.0-255,1484,32567,77,192770
14874,0.001229,172.31.40.0-255,66,32633,77,192770
14875,0.001239,74.125.24.0-255,2902,35535,77,192770
14876,0.001241,172.31.40.0-255,66,35601,77,192770
14877,0.001252,74.125.24.0-255,2902,38503,77,192770
14878,0.001254,172.31.40.0-255,66,38569,77,192770
14879,0.001285,74.125.24.0-255,2902,41471,77,192770
14880,0.001287,172.31.40.0-255,66,41537,77,192770
14881,0.001299,74.125.24.0-255,6797,48334,77,192770
14882,0.001301,172.31.40.0-255,66,48400,77,192770
14883,0.001309,74.125.24.0-255,7156,55556,77,192770
14884,0.001311,172.31.40.0-255,66,55622,77,192770
14885,0.001346,74.125.24.0-255,4320,59942,77,192770
14886,0.001348,172.31.40.0-255,66,60008,77,192770
14887,0.001378,74.125.24.0-255,5652,65660,77,192770
14888,0.001381,172.31.40.0-255,66,65726,77,192770
14889,0.001564,172.31.40.0-255,101,65827,77,192770
14890,0.001872,74.125.24.0-255,1484,67311,77,192770
14891,0.001882,74.125.24.0-255,2902,70213,77,192770
14892,0.001886,172.31.40.0-255,66,70279,77,192770
14893,0.001918,74.125.24.0-255,5738,76017,77,192770
14894,0.001921,172.31.40.0-255,66,76083,77,192770
14895,0.001927,74.125.24.0-255,5738,81821,77,192770
14896,0.00193,172.31.40.0-255,66,81887,77,192770
14897,0.001956,74.125.24.0-255,5738,87625,77,192770
14898,0.001959,172.31.40.0-255,66,87691,77,192770
14899,0.002005,74.125.24.0-255,8215,95906,77,192770
14900,0.002009,172.31.40.0-255,66,95972,77,192770
14901,0.002014,74.125.24.0-255,4254,100226,77,192770
14902,0.002017,172.31.40.0-255,66,100292,77,192770
14903,0.002024,74.125.24.0-255,5738,106030,77,192770
14904,0.002029,172.31.40.0-255,66,106096,77,192770
14905,0.00206,74.125.24.0-255,5738,111834,77,192770
14906,0.002063,172.31.40.0-255,66,111900,77,192770
14907,0.002069,74.125.24.0-255,4713,116613,77,192770
14908,0.002072,172.31.40.0-255,66,116679,77,192770
14909,0.002107,74.125.24.0-255,763,117442,77,192770
14910,0.002221,74.125.24.0-255,1484,118926,77,192770
14911,0.002225,172.31.40.0-255,66,118992,77,192770
14912,0.002232,74.125.24.0-255,2902,121894,77,192770
14913,0.002236,172.31.40.0-255,66,121960,77,192770
14914,0.002246,74.125.24.0-255,5738,127698,77,192770
14915,0.002249,172.31.40.0-255,66,127764,77,192770
14916,0.002294,74.125.24.0-255,12828,140592,77,192770
14917,0.002298,172.31.40.0-255,66,140658,77,192770
14918,0.002329,74.125.24.0-255,7156,147814,77,192770
14919,0.002333,172.31.40.0-255,66,147880,77,192770
14920,0.002361,74.125.24.0-255,3602,151482,77,192770
14921,0.002363,172.31.40.0-255,66,151548,77,192770
14922,0.003802,74.125.24.0-255,66,151614,77,192770
14923,0.004616,74.125.24.0-255,2902,154516,77,192770
14924,0.004621,172.31.40.0-255,66,154582,77,192770
14925,0.004644,74.125.24.0-255,2902,157484,77,192770
14926,0.004648,172.31.40.0-255,66,157550,77,192770
14927,0.006896,74.125.24.0-255,2902,160452,77,192770
14928,0.006903,172.31.40.0-255,66,160518,77,192770
14929,0.006946,74.125.24.0-255,2902,163420,77,192770
14930,0.006949,172.31.40.0-255,66,163486,77,192770
14931,0.009185,74.125.24.0-255,2902,166388,77,192770
14932,0.009202,172.31.40.0-255,66,166454,77,192770
14933,0.009234,74.125.24.0-255,2902,169356,77,192770
14934,0.009237,172.31.40.0-255,66,169422,77,192770
14935,0.011502,74.125.24.0-255,2902,172324,77,192770
14936,0.011517,172.31.40.0-255,66,172390,77,192770
14937,0.011548,74.125.24.0-255,2902,175292,77,192770
14938,0.011552,172.31.40.0-255,66,175358,77,192770
14939,0.01388,74.125.24.0-255,5738,181096,77,192770
14940,0.013893,172.31.40.0-255,66,181162,77,192770
14941,0.016199,74.125.24.0-255,5738,186900,77,192770
14942,0.016208,172.31.40.0-255,66,186966,77,192770
14943,0.01856,74.125.24.0-255,5738,192704,77,192770
14944,0.018569,172.31.40.0-255,66,192770,77,192770
14945,0.0,74.125.24.0-255,153,153,77,279867
14946,3e-05,172.31.40.0-255,66,219,77,279867
14947,3.8e-05,74.125.24.0-255,1484,1703,77,279867
14948,4.2e-05,172.31.40.0-255,66,1769,77,279867
14949,4.8e-05,74.125.24.0-255,2902,4671,77,279867
14950,5.2e-05,172.31.40.0-255,66,4737,77,279867
14951,6e-05,74.125.24.0-255,7156,11893,77,279867
14952,6.4e-05,172.31.40.0-255,66,11959,77,279867
14953,6.7e-05,74.125.24.0-255,1902,13861,77,279867
14954,7e-05,172.31.40.0-255,66,13927,77,279867
14955,0.000102,74.125.24.0-255,2902,16829,77,279867
14956,0.000105,172.31.40.0-255,66,16895,77,279867
14957,0.000113,74.125.24.0-255,7156,24051,77,279867
14958,0.000116,172.31.40.0-255,66,24117,77,279867
14959,0.000162,74.125.24.0-255,6797,30914,77,279867
14960,0.000166,172.31.40.0-255,66,30980,77,279867
14961,0.000186,74.125.24.0-255,4320,35300,77,279867
14962,0.000188,172.31.40.0-255,66,35366,77,279867
14963,0.000201,74.125.24.0-255,2902,38268,77,279867
14964,0.000204,172.31.40.0-255,66,38334,77,279867
14965,0.000213,74.125.24.0-255,9633,47967,77,279867
14966,0.000215,172.31.40.0-255,66,48033,77,279867
14967,0.00103,74.125.24.0-255,1484,49517,77,279867
14968,0.001036,172.31.40.0-255,66,49583,77,279867
14969,0.001046,74.125.24.0-255,2902,52485,77,279867
14970,0.001049,172.31.40.0-255,66,52551,77,279867
14971,0.001055,74.125.24.0-255,5738,58289,77,279867
14972,0.001057,172.31.40.0-255,66,58355,77,279867
14973,0.001062,74.125.24.0-255,2902,61257,77,279867
14974,0.001064,172.31.40.0-255,66,61323,77,279867
14975,0.001093,74.125.24.0-255,5379,66702,77,279867
14976,0.001097,172.31.40.0-255,66,66768,77,279867
14977,0.001105,74.125.24.0-255,8574,75342,77,279867
14978,0.001141,74.125.24.0-255,2902,78244,77,279867
14979,0.001165,74.125.24.0-255,3961,82205,77,279867
14980,0.001398,74.125.24.0-255,1484,83689,77,279867
14981,0.001406,74.125.24.0-255,2902,86591,77,279867
14982,0.001429,74.125.24.0-255,5738,92329,77,279867
14983,0.001457,74.125.24.0-255,2902,95231,77,279867
14984,0.001483,74.125.24.0-255,9992,105223,77,279867
14985,0.001494,74.125.24.0-255,10692,115915,77,279867
14986,0.001753,74.125.24.0-255,1484,117399,77,279867
14987,0.001775,74.125.24.0-255,2902,120301,77,279867
14988,0.001779,74.125.24.0-255,2902,123203,77,279867
14989,0.001791,74.125.24.0-255,2902,126105,77,279867
14990,0.001821,74.125.24.0-255,5738,131843,77,279867
14991,0.001836,74.125.24.0-255,2902,134745,77,279867
14992,0.001854,74.125.24.0-255,2902,137647,77,279867
14993,0.001875,74.125.24.0-255,7156,144803,77,279867
14994,0.001878,74.125.24.0-255,1484,146287,77,279867
14995,0.001895,74.125.24.0-255,3602,149889,77,279867
14996,0.001925,74.125.24.0-255,5738,155627,77,279867
14997,0.001939,74.125.24.0-255,5738,161365,77,279867
14998,0.001952,74.125.24.0-255,2902,164267,77,279867
14999,0.001976,74.125.24.0-255,9992,174259,77,279867
15000,0.001981,74.125.24.0-255,4320,178579,77,279867
15001,0.001994,74.125.24.0-255,2902,181481,77,279867
15002,0.002015,74.125.24.0-255,2184,183665,77,279867
15003,0.002074,74.125.24.0-255,1484,185149,77,279867
15004,0.002077,74.125.24.0-255,1484,186633,77,279867
15005,0.002088,74.125.24.0-255,1484,188117,77,279867
15006,0.002094,74.125.24.0-255,5738,193855,77,279867
15007,0.002117,74.125.24.0-255,4320,198175,77,279867
15008,0.002127,74.125.24.0-255,1484,199659,77,279867
15009,0.00213,74.125.24.0-255,1484,201143,77,279867
15010,0.002161,74.125.24.0-255,11410,212553,77,279867
15011,0.002213,74.125.24.0-255,5020,217573,77,279867
15012,0.002271,74.125.24.0-255,1484,219057,77,279867
15013,0.002287,74.125.24.0-255,2902,221959,77,279867
15014,0.002293,74.125.24.0-255,4320,226279,77,279867
15015,0.002307,74.125.24.0-255,1484,227763,77,279867
15016,0.002311,74.125.24.0-255,2902,230665,77,279867
15017,0.002336,74.125.24.0-255,9992,240657,77,279867
15018,0.002339,74.125.24.0-255,1484,242141,77,279867
15019,0.00236,74.125.24.0-255,7156,249297,77,279867
15020,0.002363,74.125.24.0-255,1484,250781,77,279867
15021,0.00572,172.31.40.0-255,66,250847,77,279867
15022,0.008096,74.125.24.0-255,5738,256585,77,279867
15023,0.008106,172.31.40.0-255,66,256651,77,279867
15024,0.010464,74.125.24.0-255,5738,262389,77,279867
15025,0.010479,172.31.40.0-255,66,262455,77,279867
15026,0.012831,74.125.24.0-255,5738,268193,77,279867
15027,0.01284,172.31.40.0-255,66,268259,77,279867
15028,0.015189,74.125.24.0-255,5738,273997,77,279867
15029,0.015893,172.31.40.0-255,66,274063,77,279867
15030,0.018215,74.125.24.0-255,5738,279801,77,279867
15031,0.018228,172.31.40.0-255,66,279867,77,279867
15032,0.0,172.217.194.0-255,150,150,77,146750
15033,1.5e-05,172.31.40.0-255,66,216,77,146750
15034,2.1e-05,172.217.194.0-255,1484,1700,77,146750
15035,2.5e-05,172.31.40.0-255,66,1766,77,146750
15036,3.2e-05,172.217.194.0-255,2902,4668,77,146750
15037,4.2e-05,172.31.40.0-255,66,4734,77,146750
15038,5.1e-05,172.217.194.0-255,7156,11890,77,146750
15039,5.4e-05,172.31.40.0-255,66,11956,77,146750
15040,8.2e-05,172.217.194.0-255,2024,13980,77,146750
15041,8.5e-05,172.31.40.0-255,66,14046,77,146750
15042,0.000161,172.217.194.0-255,1484,15530,77,146750
15043,0.000165,172.31.40.0-255,66,15596,77,146750
15044,0.00017,172.217.194.0-255,2902,18498,77,146750
15045,0.000173,172.31.40.0-255,66,18564,77,146750
15046,0.0002,172.217.194.0-255,1484,20048,77,146750
15047,0.000202,172.31.40.0-255,66,20114,77,146750
15048,0.000229,172.217.194.0-255,4320,24434,77,146750
15049,0.000232,172.31.40.0-255,66,24500,77,146750
15050,0.00024,172.217.194.0-255,6797,31297,77,146750
15051,0.000242,172.31.40.0-255,66,31363,77,146750
15052,0.000705,172.217.194.0-255,1484,32847,77,146750
15053,0.00071,172.31.40.0-255,66,32913,77,146750
15054,0.000716,172.217.194.0-255,2902,35815,77,146750
15055,0.000717,172.31.40.0-255,66,35881,77,146750
15056,0.000727,172.217.194.0-255,5738,41619,77,146750
15057,0.000729,172.31.40.0-255,66,41685,77,146750
15058,0.000759,172.217.194.0-255,13887,55572,77,146750
15059,0.000762,172.31.40.0-255,66,55638,77,146750
15060,0.000785,172.217.194.0-255,4320,59958,77,146750
15061,0.000789,172.31.40.0-255,66,60024,77,146750
15062,0.000813,172.217.194.0-255,5673,65697,77,146750
15063,0.000816,172.31.40.0-255,66,65763,77,146750
15064,0.000819,172.217.194.0-255,383,66146,77,146750
15065,0.00107,172.31.40.0-255,66,66212,77,146750
15066,0.001469,172.217.194.0-255,1484,67696,77,146750
15067,0.001478,172.217.194.0-255,2902,70598,77,146750
15068,0.001482,172.31.40.0-255,66,70664,77,146750
15069,0.001489,172.217.194.0-255,5738,76402,77,146750
15070,0.001491,172.31.40.0-255,66,76468,77,146750
15071,0.001526,172.217.194.0-255,12828,89296,77,146750
15072,0.001529,172.31.40.0-255,66,89362,77,146750
15073,0.001564,172.217.194.0-255,7156,96518,77,146750
15074,0.001566,172.31.40.0-255,66,96584,77,146750
15075,0.001584,172.217.194.0-255,3602,100186,77,146750
15076,0.001587,172.31.40.0-255,66,100252,77,146750
15077,0.003597,172.217.194.0-255,1484,101736,77,146750
15078,0.003641,172.217.194.0-255,4320,106056,77,146750
15079,0.003645,172.31.40.0-255,66,106122,77,146750
15080,0.005662,172.217.194.0-255,5738,111860,77,146750
15081,0.005668,172.31.40.0-255,66,111926,77,146750
15082,0.007707,172.217.194.0-255,5738,117664,77,146750
15083,0.007712,172.31.40.0-255,66,117730,77,146750
15084,0.00975,172.217.194.0-255,5738,123468,77,146750
15085,0.00976,172.31.40.0-255,66,123534,77,146750
15086,0.011798,172.217.194.0-255,5738,129272,77,146750
15087,0.011804,172.31.40.0-255,66,129338,77,146750
15088,0.013832,172.217.194.0-255,5738,135076,77,146750
15089,0.013842,172.31.40.0-255,66,135142,77,146750
15090,0.015889,172.217.194.0-255,5738,140880,77,146750
15091,0.015898,172.31.40.0-255,66,140946,77,146750
15092,0.017965,172.217.194.0-255,5738,146684,77,146750
15093,0.017972,172.31.40.0-255,66,146750,77,146750
15094,0.0,74.125.200.0-255,153,153,77,177483
15095,2.3e-05,172.31.40.0-255,66,219,77,177483
15096,3.1e-05,74.125.200.0-255,1484,1703,77,177483
15097,3.5e-05,172.31.40.0-255,66,1769,77,177483
15098,3.8e-05,74.125.200.0-255,1484,3253,77,177483
15099,4.1e-05,172.31.40.0-255,66,3319,77,177483
15100,8.2e-05,74.125.200.0-255,1484,4803,77,177483
15101,8.5e-05,172.31.40.0-255,66,4869,77,177483
15102,9.3e-05,74.125.200.0-255,5738,10607,77,177483
15103,9.5e-05,172.31.40.0-255,66,10673,77,177483
15104,0.000104,74.125.200.0-255,1484,12157,77,177483
15105,0.000106,172.31.40.0-255,66,12223,77,177483
15106,0.000131,74.125.200.0-255,2077,14300,77,177483
15107,0.000134,172.31.40.0-255,66,14366,77,177483
15108,0.000278,74.125.200.0-255,1484,15850,77,177483
15109,0.000283,172.31.40.0-255,66,15916,77,177483
15110,0.000314,74.125.200.0-255,2902,18818,77,177483
15111,0.000317,172.31.40.0-255,66,18884,77,177483
15112,0.00032,74.125.200.0-255,1484,20368,77,177483
15113,0.000322,172.31.40.0-255,66,20434,77,177483
15114,0.000348,74.125.200.0-255,4320,24754,77,177483
15115,0.00035,172.31.40.0-255,66,24820,77,177483
15116,0.000366,74.125.200.0-255,1484,26304,77,177483
15117,0.000372,172.31.40.0-255,66,26370,77,177483
15118,0.000377,74.125.200.0-255,2902,29272,77,177483
15119,0.000379,172.31.40.0-255,66,29338,77,177483
15120,0.0004,74.125.200.0-255,2543,31881,77,177483
15121,0.000407,172.31.40.0-255,66,31947,77,177483
15122,0.000411,74.125.200.0-255,2902,34849,77,177483
15123,0.000413,172.31.40.0-255,66,34915,77,177483
15124,0.000437,74.125.200.0-255,2902,37817,77,177483
15125,0.000443,172.31.40.0-255,66,37883,77,177483
15126,0.000446,74.125.200.0-255,1484,39367,77,177483
15127,0.000473,74.125.200.0-255,2902,42269,77,177483
15128,0.000475,172.31.40.0-255,66,42335,77,177483
15129,0.000496,74.125.200.0-255,5738,48073,77,177483
15130,0.000498,172.31.40.0-255,66,48139,77,177483
15131,0.000503,74.125.200.0-255,2902,51041,77,177483
15132,0.000505,172.31.40.0-255,66,51107,77,177483
15133,0.000529,74.125.200.0-255,2902,54009,77,177483
15134,0.000532,172.31.40.0-255,66,54075,77,177483
15135,0.000566,74.125.200.0-255,5738,59813,77,177483
15136,0.000569,172.31.40.0-255,66,59879,77,177483
15137,0.000598,74.125.200.0-255,6438,66317,77,177483
15138,0.000601,172.31.40.0-255,66,66383,77,177483
15139,0.000603,74.125.200.0-255,359,66742,77,177483
15140,0.000744,74.125.200.0-255,383,67125,77,177483
15141,0.000787,74.125.200.0-255,1484,68609,77,177483
15142,0.000791,172.31.40.0-255,66,68675,77,177483
15143,0.000838,74.125.200.0-255,2902,71577,77,177483
15144,0.000841,172.31.40.0-255,66,71643,77,177483
15145,0.000848,74.125.200.0-255,5738,77381,77,177483
15146,0.00085,172.31.40.0-255,66,77447,77,177483
15147,0.000861,74.125.200.0-255,7156,84603,77,177483
15148,0.000863,172.31.40.0-255,66,84669,77,177483
15149,0.000903,74.125.200.0-255,8574,93243,77,177483
15150,0.000906,172.31.40.0-255,66,93309,77,177483
15151,0.000956,74.125.200.0-255,7856,101165,77,177483
15152,0.00096,172.31.40.0-255,66,101231,77,177483
15153,0.002016,74.125.200.0-255,1484,102715,77,177483
15154,0.002027,74.125.200.0-255,2902,105617,77,177483
15155,0.002032,172.31.40.0-255,66,105683,77,177483
15156,0.00204,74.125.200.0-255,5738,111421,77,177483
15157,0.002042,172.31.40.0-255,66,111487,77,177483
15158,0.002051,74.125.200.0-255,2902,114389,77,177483
15159,0.002053,172.31.40.0-255,66,114455,77,177483
15160,0.002085,74.125.200.0-255,7156,121611,77,177483
15161,0.002088,172.31.40.0-255,66,121677,77,177483
15162,0.002112,74.125.200.0-255,2902,124579,77,177483
15163,0.002115,172.31.40.0-255,66,124645,77,177483
15164,0.002119,74.125.200.0-255,1484,126129,77,177483
15165,0.002129,74.125.200.0-255,2902,129031,77,177483
15166,0.002131,172.31.40.0-255,66,129097,77,177483
15167,0.002138,74.125.200.0-255,4320,133417,77,177483
15168,0.00214,172.31.40.0-255,66,133483,77,177483
15169,0.002169,74.125.200.0-255,1484,134967,77,177483
15170,0.002173,74.125.200.0-255,766,135733,77,177483
15171,0.002179,172.31.40.0-255,66,135799,77,177483
15172,0.004476,74.125.200.0-255,2902,138701,77,177483
15173,0.004486,172.31.40.0-255,66,138767,77,177483
15174,0.004503,74.125.200.0-255,1484,140251,77,177483
15175,0.004518,74.125.200.0-255,1484,141735,77,177483
15176,0.00452,172.31.40.0-255,66,141801,77,177483
15177,0.006822,74.125.200.0-255,2902,144703,77,177483
15178,0.00683,172.31.40.0-255,66,144769,77,177483
15179,0.006864,74.125.200.0-255,2902,147671,77,177483
15180,0.006866,172.31.40.0-255,66,147737,77,177483
15181,0.009154,74.125.200.0-255,1484,149221,77,177483
15182,0.009171,74.125.200.0-255,1484,150705,77,177483
15183,0.009176,172.31.40.0-255,66,150771,77,177483
15184,0.009211,74.125.200.0-255,2902,153673,77,177483
15185,0.009213,172.31.40.0-255,66,153739,77,177483
15186,0.011509,74.125.200.0-255,2902,156641,77,177483
15187,0.011522,172.31.40.0-255,66,156707,77,177483
15188,0.011555,74.125.200.0-255,2902,159609,77,177483
15189,0.011558,172.31.40.0-255,66,159675,77,177483
15190,0.01385,74.125.200.0-255,2902,162577,77,177483
15191,0.013861,172.31.40.0-255,66,162643,77,177483
15192,0.013895,74.125.200.0-255,2902,165545,77,177483
15193,0.013898,172.31.40.0-255,66,165611,77,177483
15194,0.0162,74.125.200.0-255,2902,168513,77,177483
15195,0.016215,172.31.40.0-255,66,168579,77,177483
15196,0.01625,74.125.200.0-255,2902,171481,77,177483
15197,0.016253,172.31.40.0-255,66,171547,77,177483
15198,0.018543,74.125.200.0-255,2902,174449,77,177483
15199,0.018556,172.31.40.0-255,66,174515,77,177483
15200,0.018589,74.125.200.0-255,2902,177417,77,177483
15201,0.018592,172.31.40.0-255,66,177483,77,177483
15202,0.0,172.31.40.0-255,105,105,77,459
15203,0.000264,172.31.40.0-255,90,195,77,459
15204,0.000275,172.31.40.0-255,66,261,77,459
15205,0.002284,172.217.194.0-255,66,327,77,459
15206,0.002312,172.217.194.0-255,66,393,77,459
15207,0.002333,172.31.40.0-255,66,459,77,459
15208,0.0,172.217.194.0-255,153,153,77,316134
15209,1.3e-05,172.31.40.0-255,66,219,77,316134
15210,2e-05,172.217.194.0-255,1484,1703,77,316134
15211,2.4e-05,172.31.40.0-255,66,1769,77,316134
15212,2.9e-05,172.217.194.0-255,2902,4671,77,316134
15213,3.9e-05,172.31.40.0-255,66,4737,77,316134
15214,4.7e-05,172.217.194.0-255,7156,11893,77,316134
15215,5e-05,172.31.40.0-255,66,11959,77,316134
15216,5.4e-05,172.217.194.0-255,2023,13982,77,316134
15217,5.6e-05,172.31.40.0-255,66,14048,77,316134
15218,9.4e-05,172.217.194.0-255,11410,25458,77,316134
15219,9.7e-05,172.31.40.0-255,66,25524,77,316134
15220,0.000103,172.217.194.0-255,5379,30903,77,316134
15221,0.000105,172.31.40.0-255,66,30969,77,316134
15222,0.000171,172.217.194.0-255,1484,32453,77,316134
15223,0.000174,172.31.40.0-255,66,32519,77,316134
15224,0.000178,172.217.194.0-255,2902,35421,77,316134
15225,0.00018,172.31.40.0-255,66,35487,77,316134
15226,0.000216,172.217.194.0-255,5738,41225,77,316134
15227,0.000219,172.31.40.0-255,66,41291,77,316134
15228,0.000223,172.217.194.0-255,4320,45611,77,316134
15229,0.000226,172.31.40.0-255,66,45677,77,316134
15230,0.000253,172.217.194.0-255,2902,48579,77,316134
15231,0.000255,172.31.40.0-255,66,48645,77,316134
15232,0.000286,172.217.194.0-255,9633,58278,77,316134
15233,0.000289,172.31.40.0-255,66,58344,77,316134
15234,0.000314,172.217.194.0-255,7049,65393,77,316134
15235,0.000316,172.31.40.0-255,66,65459,77,316134
15236,0.000338,172.217.194.0-255,119,65578,77,316134
15237,0.00034,172.31.40.0-255,66,65644,77,316134
15238,0.00042,172.217.194.0-255,1484,67128,77,316134
15239,0.000423,172.31.40.0-255,66,67194,77,316134
15240,0.000443,172.217.194.0-255,2902,70096,77,316134
15241,0.000445,172.31.40.0-255,66,70162,77,316134
15242,0.000451,172.217.194.0-255,5738,75900,77,316134
15243,0.000453,172.31.40.0-255,66,75966,77,316134
15244,0.000476,172.217.194.0-255,4320,80286,77,316134
15245,0.000479,172.31.40.0-255,66,80352,77,316134
15246,0.0005,172.217.194.0-255,2902,83254,77,316134
15247,0.000502,172.31.40.0-255,66,83320,77,316134
15248,0.000537,172.217.194.0-255,8574,91894,77,316134
15249,0.000539,172.31.40.0-255,66,91960,77,316134
15250,0.000546,172.217.194.0-255,7156,99116,77,316134
15251,0.000548,172.31.40.0-255,66,99182,77,316134
15252,0.00055,172.217.194.0-255,766,99948,77,316134
15253,0.000636,172.217.194.0-255,1484,101432,77,316134
15254,0.000639,172.31.40.0-255,66,101498,77,316134
15255,0.000644,172.217.194.0-255,2902,104400,77,316134
15256,0.000646,172.31.40.0-255,66,104466,77,316134
15257,0.00065,172.217.194.0-255,2902,107368,77,316134
15258,0.000651,172.31.40.0-255,66,107434,77,316134
15259,0.000676,172.217.194.0-255,2902,110336,77,316134
15260,0.000678,172.31.40.0-255,66,110402,77,316134
15261,0.000683,172.217.194.0-255,4320,114722,77,316134
15262,0.000713,172.31.40.0-255,66,114788,77,316134
15263,0.000736,172.217.194.0-255,5100,119888,77,316134
15264,0.000739,172.31.40.0-255,66,119954,77,316134
15265,0.000745,172.217.194.0-255,5738,125692,77,316134
15266,0.000747,172.31.40.0-255,66,125758,77,316134
15267,0.000804,172.217.194.0-255,11410,137168,77,316134
15268,0.000808,172.31.40.0-255,66,137234,77,316134
15269,0.000841,172.217.194.0-255,12828,150062,77,316134
15270,0.000845,172.31.40.0-255,66,150128,77,316134
15271,0.000867,172.217.194.0-255,766,150894,77,316134
15272,0.00097,172.217.194.0-255,1484,152378,77,316134
15273,0.000973,172.31.40.0-255,66,152444,77,316134
15274,0.000978,172.217.194.0-255,2902,155346,77,316134
15275,0.00098,172.31.40.0-255,66,155412,77,316134
15276,0.001018,172.217.194.0-255,5738,161150,77,316134
15277,0.00102,172.31.40.0-255,66,161216,77,316134
15278,0.001026,172.217.194.0-255,4320,165536,77,316134
15279,0.001027,172.31.40.0-255,66,165602,77,316134
15280,0.001062,172.217.194.0-255,11410,177012,77,316134
15281,0.001065,172.31.40.0-255,66,177078,77,316134
15282,0.001094,172.217.194.0-255,7856,184934,77,316134
15283,0.001099,172.31.40.0-255,66,185000,77,316134
15284,0.001271,172.217.194.0-255,1484,186484,77,316134
15285,0.001291,172.217.194.0-255,2902,189386,77,316134
15286,0.001295,172.31.40.0-255,66,189452,77,316134
15287,0.001302,172.217.194.0-255,4320,193772,77,316134
15288,0.001303,172.31.40.0-255,66,193838,77,316134
15289,0.001323,172.217.194.0-255,1484,195322,77,316134
15290,0.001327,172.217.194.0-255,1484,196806,77,316134
15291,0.001333,172.31.40.0-255,66,196872,77,316134
15292,0.001371,172.217.194.0-255,11410,208282,77,316134
15293,0.001374,172.31.40.0-255,66,208348,77,316134
15294,0.001387,172.217.194.0-255,13528,221876,77,316134
15295,0.00139,172.31.40.0-255,66,221942,77,316134
15296,0.001401,172.217.194.0-255,12828,234770,77,316134
15297,0.001403,172.31.40.0-255,66,234836,77,316134
15298,0.001456,172.31.40.0-255,66,234902,77,316134
15299,0.001471,172.217.194.0-255,3602,238504,77,316134
15300,0.001474,172.31.40.0-255,66,238570,77,316134
15301,0.001487,172.217.194.0-255,8574,247144,77,316134
15302,0.001489,172.31.40.0-255,66,247210,77,316134
15303,0.001534,172.217.194.0-255,9992,257202,77,316134
15304,0.001538,172.31.40.0-255,66,257268,77,316134
15305,0.001548,172.217.194.0-255,12828,270096,77,316134
15306,0.001551,172.31.40.0-255,66,270162,77,316134
15307,0.001563,172.217.194.0-255,7856,278018,77,316134
15308,0.001567,172.31.40.0-255,66,278084,77,316134
15309,0.001576,172.217.194.0-255,8574,286658,77,316134
15310,0.001578,172.31.40.0-255,66,286724,77,316134
15311,0.001621,172.217.194.0-255,11410,298134,77,316134
15312,0.001624,172.31.40.0-255,66,298200,77,316134
15313,0.001656,172.217.194.0-255,7156,305356,77,316134
15314,0.001659,172.31.40.0-255,66,305422,77,316134
15315,0.001668,172.217.194.0-255,3602,309024,77,316134
15316,0.001671,172.31.40.0-255,66,309090,77,316134
15317,0.001692,172.31.40.0-255,66,309156,77,316134
15318,0.001698,172.217.194.0-255,6438,315594,77,316134
15319,0.001701,172.31.40.0-255,66,315660,77,316134
15320,0.00178,172.31.40.0-255,66,315726,77,316134
15321,0.001805,172.31.40.0-255,66,315792,77,316134
15322,0.001808,172.217.194.0-255,105,315897,77,316134
15323,0.011812,172.31.40.0-255,66,315963,77,316134
15324,0.011851,172.31.40.0-255,105,316068,77,316134
15325,0.014391,172.217.194.0-255,66,316134,77,316134
15326,0.0,74.125.200.0-255,153,153,77,346058
15327,2.5e-05,172.31.40.0-255,66,219,77,346058
15328,3.2e-05,74.125.200.0-255,1484,1703,77,346058
15329,3.7e-05,172.31.40.0-255,66,1769,77,346058
15330,4.3e-05,74.125.200.0-255,2902,4671,77,346058
15331,5.3e-05,172.31.40.0-255,66,4737,77,346058
15332,5.6e-05,74.125.200.0-255,1484,6221,77,346058
15333,5.9e-05,172.31.40.0-255,66,6287,77,346058
15334,6.4e-05,74.125.200.0-255,2902,9189,77,346058
15335,6.7e-05,172.31.40.0-255,66,9255,77,346058
15336,0.000104,74.125.200.0-255,4840,14095,77,346058
15337,0.000108,172.31.40.0-255,66,14161,77,346058
15338,0.000205,74.125.200.0-255,1484,15645,77,346058
15339,0.000209,172.31.40.0-255,66,15711,77,346058
15340,0.000228,74.125.200.0-255,2902,18613,77,346058
15341,0.00023,172.31.40.0-255,66,18679,77,346058
15342,0.000233,74.125.200.0-255,1484,20163,77,346058
15343,0.000236,172.31.40.0-255,66,20229,77,346058
15344,0.00027,74.125.200.0-255,2902,23131,77,346058
15345,0.000273,172.31.40.0-255,66,23197,77,346058
15346,0.000279,74.125.200.0-255,5738,28935,77,346058
15347,0.000281,172.31.40.0-255,66,29001,77,346058
15348,0.000301,74.125.200.0-255,7156,36157,77,346058
15349,0.000304,172.31.40.0-255,66,36223,77,346058
15350,0.000329,74.125.200.0-255,2543,38766,77,346058
15351,0.000331,172.31.40.0-255,66,38832,77,346058
15352,0.00034,74.125.200.0-255,9992,48824,77,346058
15353,0.000343,172.31.40.0-255,66,48890,77,346058
15354,0.000352,74.125.200.0-255,8574,57464,77,346058
15355,0.000357,172.31.40.0-255,66,57530,77,346058
15356,0.000379,74.125.200.0-255,2902,60432,77,346058
15357,0.000382,172.31.40.0-255,66,60498,77,346058
15358,0.000393,74.125.200.0-255,5396,65894,77,346058
15359,0.000395,172.31.40.0-255,66,65960,77,346058
15360,0.000578,74.125.200.0-255,332,66292,77,346058
15361,0.000911,74.125.200.0-255,1484,67776,77,346058
15362,0.000917,172.31.40.0-255,66,67842,77,346058
15363,0.000923,74.125.200.0-255,2902,70744,77,346058
15364,0.000925,172.31.40.0-255,66,70810,77,346058
15365,0.000952,74.125.200.0-255,5738,76548,77,346058
15366,0.000955,172.31.40.0-255,66,76614,77,346058
15367,0.000959,74.125.200.0-255,2902,79516,77,346058
15368,0.000961,172.31.40.0-255,66,79582,77,346058
15369,0.000995,74.125.200.0-255,9992,89574,77,346058
15370,0.001002,74.125.200.0-255,7156,96730,77,346058
15371,0.001006,172.31.40.0-255,66,96796,77,346058
15372,0.001009,172.31.40.0-255,66,96862,77,346058
15373,0.001033,74.125.200.0-255,3602,100464,77,346058
15374,0.001036,172.31.40.0-255,66,100530,77,346058
15375,0.001236,74.125.200.0-255,1484,102014,77,346058
15376,0.001253,74.125.200.0-255,1484,103498,77,346058
15377,0.001257,172.31.40.0-255,66,103564,77,346058
15378,0.001289,74.125.200.0-255,1484,105048,77,346058
15379,0.001294,74.125.200.0-255,4320,109368,77,346058
15380,0.001297,172.31.40.0-255,66,109434,77,346058
15381,0.001305,74.125.200.0-255,8574,118008,77,346058
15382,0.001307,172.31.40.0-255,66,118074,77,346058
15383,0.001321,74.125.200.0-255,8574,126648,77,346058
15384,0.001323,172.31.40.0-255,66,126714,77,346058
15385,0.001358,74.125.200.0-255,1484,128198,77,346058
15386,0.001383,74.125.200.0-255,6438,134636,77,346058
15387,0.001387,172.31.40.0-255,66,134702,77,346058
15388,0.001392,74.125.200.0-255,4320,139022,77,346058
15389,0.001395,172.31.40.0-255,66,139088,77,346058
15390,0.001416,74.125.200.0-255,4320,143408,77,346058
15391,0.001423,172.31.40.0-255,66,143474,77,346058
15392,0.001428,74.125.200.0-255,4320,147794,77,346058
15393,0.001431,172.31.40.0-255,66,147860,77,346058
15394,0.001466,74.125.200.0-255,5738,153598,77,346058
15395,0.001469,172.31.40.0-255,66,153664,77,346058
15396,0.001479,74.125.200.0-255,9992,163656,77,346058
15397,0.001481,172.31.40.0-255,66,163722,77,346058
15398,0.001501,74.125.200.0-255,4320,168042,77,346058
15399,0.001504,172.31.40.0-255,66,168108,77,346058
15400,0.001506,74.125.200.0-255,766,168874,77,346058
15401,0.001527,74.125.200.0-255,1484,170358,77,346058
15402,0.00153,172.31.40.0-255,66,170424,77,346058
15403,0.001535,74.125.200.0-255,4320,174744,77,346058
15404,0.001538,172.31.40.0-255,66,174810,77,346058
15405,0.001565,74.125.200.0-255,4320,179130,77,346058
15406,0.001568,172.31.40.0-255,66,179196,77,346058
15407,0.001603,74.125.200.0-255,4320,183516,77,346058
15408,0.001613,74.125.200.0-255,9992,193508,77,346058
15409,0.001618,74.125.200.0-255,5738,199246,77,346058
15410,0.001622,172.31.40.0-255,66,199312,77,346058
15411,0.001626,172.31.40.0-255,66,199378,77,346058
15412,0.001633,172.31.40.0-255,66,199444,77,346058
15413,0.001642,74.125.200.0-255,3602,203046,77,346058
15414,0.001645,172.31.40.0-255,66,203112,77,346058
15415,0.001704,74.125.200.0-255,1484,204596,77,346058
15416,0.001716,74.125.200.0-255,1484,206080,77,346058
15417,0.001719,172.31.40.0-255,66,206146,77,346058
15418,0.001724,74.125.200.0-255,2902,209048,77,346058
15419,0.001727,172.31.40.0-255,66,209114,77,346058
15420,0.001751,74.125.200.0-255,2902,212016,77,346058
15421,0.001753,172.31.40.0-255,66,212082,77,346058
15422,0.001783,74.125.200.0-255,2902,214984,77,346058
15423,0.001786,172.31.40.0-255,66,215050,77,346058
15424,0.001794,74.125.200.0-255,8574,223624,77,346058
15425,0.001796,172.31.40.0-255,66,223690,77,346058
15426,0.00181,74.125.200.0-255,9992,233682,77,346058
15427,0.001812,172.31.40.0-255,66,233748,77,346058
15428,0.001817,74.125.200.0-255,3602,237350,77,346058
15429,0.00182,172.31.40.0-255,66,237416,77,346058
15430,0.001858,74.125.200.0-255,4320,241736,77,346058
15431,0.001861,172.31.40.0-255,66,241802,77,346058
15432,0.00188,74.125.200.0-255,4320,246122,77,346058
15433,0.001883,172.31.40.0-255,66,246188,77,346058
15434,0.001909,74.125.200.0-255,1484,247672,77,346058
15435,0.001925,74.125.200.0-255,11410,259082,77,346058
15436,0.001931,74.125.200.0-255,4320,263402,77,346058
15437,0.001984,74.125.200.0-255,7856,271258,77,346058
15438,0.001988,172.31.40.0-255,66,271324,77,346058
15439,0.002,172.31.40.0-255,66,271390,77,346058
15440,0.002092,74.125.200.0-255,1484,272874,77,346058
15441,0.002109,74.125.200.0-255,2902,275776,77,346058
15442,0.002118,172.31.40.0-255,66,275842,77,346058
15443,0.002132,74.125.200.0-255,4320,280162,77,346058
15444,0.002142,74.125.200.0-255,5738,285900,77,346058
15445,0.002167,74.125.200.0-255,11410,297310,77,346058
15446,0.002172,74.125.200.0-255,2902,300212,77,346058
15447,0.002184,74.125.200.0-255,1484,301696,77,346058
15448,0.002188,172.31.40.0-255,66,301762,77,346058
15449,0.00222,74.125.200.0-255,3602,305364,77,346058
15450,0.002237,172.31.40.0-255,66,305430,77,346058
15451,0.004531,74.125.200.0-255,5738,311168,77,346058
15452,0.004537,172.31.40.0-255,66,311234,77,346058
15453,0.006856,74.125.200.0-255,5738,316972,77,346058
15454,0.006862,172.31.40.0-255,66,317038,77,346058
15455,0.009192,74.125.200.0-255,5738,322776,77,346058
15456,0.009212,172.31.40.0-255,66,322842,77,346058
15457,0.01153,74.125.200.0-255,5738,328580,77,346058
15458,0.011543,172.31.40.0-255,66,328646,77,346058
15459,0.01387,74.125.200.0-255,5738,334384,77,346058
15460,0.013883,172.31.40.0-255,66,334450,77,346058
15461,0.016215,74.125.200.0-255,5738,340188,77,346058
15462,0.016221,172.31.40.0-255,66,340254,77,346058
15463,0.01854,74.125.200.0-255,5738,345992,77,346058
15464,0.018548,172.31.40.0-255,66,346058,77,346058
15465,0.0,172.31.40.0-255,105,105,77,459
15466,0.000361,172.31.40.0-255,90,195,77,459
15467,0.000372,172.31.40.0-255,66,261,77,459
15468,0.002598,74.125.24.0-255,66,327,77,459
15469,0.002641,74.125.24.0-255,66,393,77,459
15470,0.002662,172.31.40.0-255,66,459,77,459
15471,0.0,74.125.68.0-255,153,153,77,284247
15472,2.3e-05,172.31.40.0-255,66,219,77,284247
15473,3e-05,74.125.68.0-255,1484,1703,77,284247
15474,3.4e-05,172.31.40.0-255,66,1769,77,284247
15475,4e-05,74.125.68.0-255,2902,4671,77,284247
15476,5.1e-05,172.31.40.0-255,66,4737,77,284247
15477,5.8e-05,74.125.68.0-255,5738,10475,77,284247
15478,6.1e-05,172.31.40.0-255,66,10541,77,284247
15479,6.7e-05,74.125.68.0-255,3421,13962,77,284247
15480,6.9e-05,172.31.40.0-255,66,14028,77,284247
15481,0.000213,74.125.68.0-255,1484,15512,77,284247
15482,0.000218,172.31.40.0-255,66,15578,77,284247
15483,0.000224,74.125.68.0-255,2902,18480,77,284247
15484,0.000226,172.31.40.0-255,66,18546,77,284247
15485,0.000263,74.125.68.0-255,5738,24284,77,284247
15486,0.000266,172.31.40.0-255,66,24350,77,284247
15487,0.00027,74.125.68.0-255,2902,27252,77,284247
15488,0.000272,172.31.40.0-255,66,27318,77,284247
15489,0.000277,74.125.68.0-255,3961,31279,77,284247
15490,0.000279,172.31.40.0-255,66,31345,77,284247
15491,0.000322,74.125.68.0-255,4320,35665,77,284247
15492,0.000325,172.31.40.0-255,66,35731,77,284247
15493,0.000329,74.125.68.0-255,2902,38633,77,284247
15494,0.000331,172.31.40.0-255,66,38699,77,284247
15495,0.00035,74.125.68.0-255,2902,41601,77,284247
15496,0.000353,172.31.40.0-255,66,41667,77,284247
15497,0.000391,74.125.68.0-255,11410,53077,77,284247
15498,0.000394,172.31.40.0-255,66,53143,77,284247
15499,0.0004,74.125.68.0-255,5738,58881,77,284247
15500,0.000402,172.31.40.0-255,66,58947,77,284247
15501,0.000444,74.125.68.0-255,6438,65385,77,284247
15502,0.000448,172.31.40.0-255,66,65451,77,284247
15503,0.000469,74.125.68.0-255,646,66097,77,284247
15504,0.000645,74.125.68.0-255,1484,67581,77,284247
15505,0.000649,172.31.40.0-255,66,67647,77,284247
15506,0.000668,74.125.68.0-255,2902,70549,77,284247
15507,0.000671,172.31.40.0-255,66,70615,77,284247
15508,0.000697,74.125.68.0-255,2902,73517,77,284247
15509,0.0007,172.31.40.0-255,66,73583,77,284247
15510,0.000729,74.125.68.0-255,4320,77903,77,284247
15511,0.000732,172.31.40.0-255,66,77969,77,284247
15512,0.000739,74.125.68.0-255,5738,83707,77,284247
15513,0.000741,172.31.40.0-255,66,83773,77,284247
15514,0.000768,74.125.68.0-255,2902,86675,77,284247
15515,0.00077,172.31.40.0-255,66,86741,77,284247
15516,0.000776,74.125.68.0-255,4320,91061,77,284247
15517,0.000778,172.31.40.0-255,66,91127,77,284247
15518,0.000812,74.125.68.0-255,5738,96865,77,284247
15519,0.000816,172.31.40.0-255,66,96931,77,284247
15520,0.000821,74.125.68.0-255,3602,100533,77,284247
15521,0.000823,172.31.40.0-255,66,100599,77,284247
15522,0.001098,74.125.68.0-255,1484,102083,77,284247
15523,0.001104,74.125.68.0-255,1484,103567,77,284247
15524,0.001107,172.31.40.0-255,66,103633,77,284247
15525,0.001129,74.125.68.0-255,1484,105117,77,284247
15526,0.001136,74.125.68.0-255,5738,110855,77,284247
15527,0.001138,172.31.40.0-255,66,110921,77,284247
15528,0.001161,74.125.68.0-255,1484,112405,77,284247
15529,0.001173,74.125.68.0-255,1484,113889,77,284247
15530,0.001176,172.31.40.0-255,66,113955,77,284247
15531,0.001181,74.125.68.0-255,2902,116857,77,284247
15532,0.001183,172.31.40.0-255,66,116923,77,284247
15533,0.001198,74.125.68.0-255,1484,118407,77,284247
15534,0.001229,74.125.68.0-255,8574,126981,77,284247
15535,0.001234,74.125.68.0-255,4320,131301,77,284247
15536,0.001263,172.31.40.0-255,66,131367,77,284247
15537,0.001266,172.31.40.0-255,66,131433,77,284247
15538,0.001282,74.125.68.0-255,3602,135035,77,284247
15539,0.001285,172.31.40.0-255,66,135101,77,284247
15540,0.001307,74.125.68.0-255,2902,138003,77,284247
15541,0.001309,172.31.40.0-255,66,138069,77,284247
15542,0.001314,74.125.68.0-255,2902,140971,77,284247
15543,0.001315,172.31.40.0-255,66,141037,77,284247
15544,0.001344,74.125.68.0-255,1484,142521,77,284247
15545,0.001352,74.125.68.0-255,7156,149677,77,284247
15546,0.001356,172.31.40.0-255,66,149743,77,284247
15547,0.001367,74.125.68.0-255,1484,151227,77,284247
15548,0.001391,74.125.68.0-255,4320,155547,77,284247
15549,0.001396,172.31.40.0-255,66,155613,77,284247
15550,0.001424,74.125.68.0-255,5738,161351,77,284247
15551,0.001427,172.31.40.0-255,66,161417,77,284247
15552,0.001459,74.125.68.0-255,7856,169273,77,284247
15553,0.001462,172.31.40.0-255,66,169339,77,284247
15554,0.001594,74.125.68.0-255,1484,170823,77,284247
15555,0.001611,74.125.68.0-255,2902,173725,77,284247
15556,0.001614,172.31.40.0-255,66,173791,77,284247
15557,0.00165,74.125.68.0-255,5738,179529,77,284247
15558,0.001653,172.31.40.0-255,66,179595,77,284247
15559,0.001658,74.125.68.0-255,4320,183915,77,284247
15560,0.00166,172.31.40.0-255,66,183981,77,284247
15561,0.001682,74.125.68.0-255,4320,188301,77,284247
15562,0.001688,172.31.40.0-255,66,188367,77,284247
15563,0.001702,74.125.68.0-255,1484,189851,77,284247
15564,0.001716,74.125.68.0-255,11410,201261,77,284247
15565,0.001719,172.31.40.0-255,66,201327,77,284247
15566,0.001758,74.125.68.0-255,2184,203511,77,284247
15567,0.001761,172.31.40.0-255,66,203577,77,284247
15568,0.001787,74.125.68.0-255,2902,206479,77,284247
15569,0.001789,172.31.40.0-255,66,206545,77,284247
15570,0.001792,74.125.68.0-255,1484,208029,77,284247
15571,0.001819,74.125.68.0-255,2902,210931,77,284247
15572,0.001821,172.31.40.0-255,66,210997,77,284247
15573,0.001828,74.125.68.0-255,5738,216735,77,284247
15574,0.001831,172.31.40.0-255,66,216801,77,284247
15575,0.001851,74.125.68.0-255,1484,218285,77,284247
15576,0.001877,74.125.68.0-255,9992,228277,77,284247
15577,0.001881,172.31.40.0-255,66,228343,77,284247
15578,0.00192,74.125.68.0-255,2902,231245,77,284247
15579,0.001924,172.31.40.0-255,66,231311,77,284247
15580,0.001956,74.125.68.0-255,6438,237749,77,284247
15581,0.00196,172.31.40.0-255,66,237815,77,284247
15582,0.004023,74.125.68.0-255,5738,243553,77,284247
15583,0.00403,172.31.40.0-255,66,243619,77,284247
15584,0.006096,74.125.68.0-255,5738,249357,77,284247
15585,0.0061,172.31.40.0-255,66,249423,77,284247
15586,0.008153,74.125.68.0-255,5738,255161,77,284247
15587,0.00816,172.31.40.0-255,66,255227,77,284247
15588,0.010229,74.125.68.0-255,5738,260965,77,284247
15589,0.010245,172.31.40.0-255,66,261031,77,284247
15590,0.012319,74.125.68.0-255,5738,266769,77,284247
15591,0.012333,172.31.40.0-255,66,266835,77,284247
15592,0.014414,74.125.68.0-255,5738,272573,77,284247
15593,0.014427,172.31.40.0-255,66,272639,77,284247
15594,0.016498,74.125.68.0-255,5738,278377,77,284247
15595,0.016505,172.31.40.0-255,66,278443,77,284247
15596,0.018566,74.125.68.0-255,5738,284181,77,284247
15597,0.018574,172.31.40.0-255,66,284247,77,284247
15598,0.0,172.31.40.0-255,105,105,77,459
15599,0.000247,172.31.40.0-255,90,195,77,459
15600,0.000267,172.31.40.0-255,66,261,77,459
15601,0.00256,172.217.194.0-255,66,327,77,459
15602,0.002591,172.217.194.0-255,66,393,77,459
15603,0.002614,172.31.40.0-255,66,459,77,459
15604,0.0,172.31.40.0-255,66,66,77,66
15605,0.0,172.31.40.0-255,105,105,77,210
15606,0.001502,157.240.13.0-255,105,210,77,210
15607,0.0,74.125.24.0-255,152,152,77,179806
15608,2.2e-05,172.31.40.0-255,66,218,77,179806
15609,2.9e-05,74.125.24.0-255,1484,1702,77,179806
15610,3.3e-05,172.31.40.0-255,66,1768,77,179806
15611,3.9e-05,74.125.24.0-255,2902,4670,77,179806
15612,5.3e-05,172.31.40.0-255,66,4736,77,179806
15613,6.1e-05,74.125.24.0-255,7156,11892,77,179806
15614,6.3e-05,172.31.40.0-255,66,11958,77,179806
15615,6.7e-05,74.125.24.0-255,2039,13997,77,179806
15616,6.9e-05,172.31.40.0-255,66,14063,77,179806
15617,0.000107,74.125.24.0-255,8574,22637,77,179806
15618,0.00011,172.31.40.0-255,66,22703,77,179806
15619,0.000127,74.125.24.0-255,2902,25605,77,179806
15620,0.000129,172.31.40.0-255,66,25671,77,179806
15621,0.000136,74.125.24.0-255,5379,31050,77,179806
15622,0.000139,172.31.40.0-255,66,31116,77,179806
15623,0.000193,74.125.24.0-255,1484,32600,77,179806
15624,0.000195,172.31.40.0-255,66,32666,77,179806
15625,0.0002,74.125.24.0-255,2902,35568,77,179806
15626,0.000202,172.31.40.0-255,66,35634,77,179806
15627,0.000205,74.125.24.0-255,1484,37118,77,179806
15628,0.000207,172.31.40.0-255,66,37184,77,179806
15629,0.000235,74.125.24.0-255,4320,41504,77,179806
15630,0.000242,172.31.40.0-255,66,41570,77,179806
15631,0.000247,74.125.24.0-255,4320,45890,77,179806
15632,0.00025,172.31.40.0-255,66,45956,77,179806
15633,0.000275,74.125.24.0-255,2543,48499,77,179806
15634,0.000278,172.31.40.0-255,66,48565,77,179806
15635,0.000466,74.125.24.0-255,1484,50049,77,179806
15636,0.000471,172.31.40.0-255,66,50115,77,179806
15637,0.000477,74.125.24.0-255,2902,53017,77,179806
15638,0.000479,172.31.40.0-255,66,53083,77,179806
15639,0.000518,74.125.24.0-255,5738,58821,77,179806
15640,0.000528,74.125.24.0-255,6797,65618,77,179806
15641,0.000582,74.125.24.0-255,1484,67102,77,179806
15642,0.000589,74.125.24.0-255,2902,70004,77,179806
15643,0.000604,74.125.24.0-255,2902,72906,77,179806
15644,0.000615,74.125.24.0-255,2902,75808,77,179806
15645,0.00063,74.125.24.0-255,6797,82605,77,179806
15646,0.000772,172.31.40.0-255,66,82671,77,179806
15647,0.001219,74.125.24.0-255,1484,84155,77,179806
15648,0.001225,74.125.24.0-255,1484,85639,77,179806
15649,0.001229,172.31.40.0-255,66,85705,77,179806
15650,0.00126,74.125.24.0-255,1484,87189,77,179806
15651,0.001267,74.125.24.0-255,5738,92927,77,179806
15652,0.001276,74.125.24.0-255,9992,102919,77,179806
15653,0.001293,172.31.40.0-255,66,102985,77,179806
15654,0.001303,74.125.24.0-255,2902,105887,77,179806
15655,0.001311,74.125.24.0-255,9992,115879,77,179806
15656,0.001317,74.125.24.0-255,766,116645,77,179806
15657,0.001324,172.31.40.0-255,66,116711,77,179806
15658,0.002072,74.125.24.0-255,1484,118195,77,179806
15659,0.002083,74.125.24.0-255,2902,121097,77,179806
15660,0.002087,172.31.40.0-255,66,121163,77,179806
15661,0.002095,74.125.24.0-255,5738,126901,77,179806
15662,0.002122,74.125.24.0-255,7156,134057,77,179806
15663,0.002142,74.125.24.0-255,5738,139795,77,179806
15664,0.002148,74.125.24.0-255,4320,144115,77,179806
15665,0.002172,74.125.24.0-255,6438,150553,77,179806
15666,0.004674,172.31.40.0-255,66,150619,77,179806
15667,0.004844,172.31.40.0-255,101,150720,77,179806
15668,0.007235,74.125.24.0-255,5738,156458,77,179806
15669,0.007241,172.31.40.0-255,66,156524,77,179806
15670,0.007386,74.125.24.0-255,66,156590,77,179806
15671,0.009819,74.125.24.0-255,5738,162328,77,179806
15672,0.009828,172.31.40.0-255,66,162394,77,179806
15673,0.012404,74.125.24.0-255,5738,168132,77,179806
15674,0.012414,172.31.40.0-255,66,168198,77,179806
15675,0.015008,74.125.24.0-255,5738,173936,77,179806
15676,0.015172,172.31.40.0-255,66,174002,77,179806
15677,0.017738,74.125.24.0-255,5738,179740,77,179806
15678,0.017752,172.31.40.0-255,66,179806,77,179806
15679,0.0,74.125.24.0-255,153,153,77,242683
15680,2.9e-05,172.31.40.0-255,66,219,77,242683
15681,3.6e-05,74.125.24.0-255,1484,1703,77,242683
15682,4e-05,172.31.40.0-255,66,1769,77,242683
15683,5.2e-05,74.125.24.0-255,2902,4671,77,242683
15684,5.5e-05,172.31.40.0-255,66,4737,77,242683
15685,6.2e-05,74.125.24.0-255,7156,11893,77,242683
15686,6.5e-05,172.31.40.0-255,66,11959,77,242683
15687,9.9e-05,74.125.24.0-255,2066,14025,77,242683
15688,0.000102,172.31.40.0-255,66,14091,77,242683
15689,0.000178,74.125.24.0-255,1484,15575,77,242683
15690,0.000181,172.31.40.0-255,66,15641,77,242683
15691,0.000207,74.125.24.0-255,2902,18543,77,242683
15692,0.00021,172.31.40.0-255,66,18609,77,242683
15693,0.000215,74.125.24.0-255,4320,22929,77,242683
15694,0.000217,172.31.40.0-255,66,22995,77,242683
15695,0.000234,74.125.24.0-255,1484,24479,77,242683
15696,0.000236,172.31.40.0-255,66,24545,77,242683
15697,0.000265,74.125.24.0-255,6797,31342,77,242683
15698,0.000268,172.31.40.0-255,66,31408,77,242683
15699,0.000445,74.125.24.0-255,1484,32892,77,242683
15700,0.000449,172.31.40.0-255,66,32958,77,242683
15701,0.000469,74.125.24.0-255,2902,35860,77,242683
15702,0.000472,172.31.40.0-255,66,35926,77,242683
15703,0.000476,74.125.24.0-255,4320,40246,77,242683
15704,0.000478,172.31.40.0-255,66,40312,77,242683
15705,0.000518,74.125.24.0-255,9633,49945,77,242683
15706,0.000521,172.31.40.0-255,66,50011,77,242683
15707,0.000524,74.125.24.0-255,1484,51495,77,242683
15708,0.000525,172.31.40.0-255,66,51561,77,242683
15709,0.000559,74.125.24.0-255,13887,65448,77,242683
15710,0.000562,172.31.40.0-255,66,65514,77,242683
15711,0.000827,74.125.24.0-255,645,66159,77,242683
15712,0.000952,74.125.24.0-255,1484,67643,77,242683
15713,0.000956,172.31.40.0-255,66,67709,77,242683
15714,0.00096,74.125.24.0-255,1484,69193,77,242683
15715,0.00099,74.125.24.0-255,1484,70677,77,242683
15716,0.000993,172.31.40.0-255,66,70743,77,242683
15717,0.000999,74.125.24.0-255,5738,76481,77,242683
15718,0.001001,172.31.40.0-255,66,76547,77,242683
15719,0.001009,74.125.24.0-255,9992,86539,77,242683
15720,0.001015,172.31.40.0-255,66,86605,77,242683
15721,0.001054,74.125.24.0-255,13528,100133,77,242683
15722,0.001056,172.31.40.0-255,66,100199,77,242683
15723,0.001399,74.125.24.0-255,1484,101683,77,242683
15724,0.001406,74.125.24.0-255,2902,104585,77,242683
15725,0.00141,172.31.40.0-255,66,104651,77,242683
15726,0.001443,74.125.24.0-255,5738,110389,77,242683
15727,0.001446,172.31.40.0-255,66,110455,77,242683
15728,0.001455,74.125.24.0-255,8574,119029,77,242683
15729,0.001457,172.31.40.0-255,66,119095,77,242683
15730,0.001479,74.125.24.0-255,4320,123415,77,242683
15731,0.001481,172.31.40.0-255,66,123481,77,242683
15732,0.001491,74.125.24.0-255,10692,134173,77,242683
15733,0.001493,172.31.40.0-255,66,134239,77,242683
15734,0.001498,74.125.24.0-255,2902,137141,77,242683
15735,0.0015,172.31.40.0-255,66,137207,77,242683
15736,0.001517,74.125.24.0-255,8574,145781,77,242683
15737,0.001519,172.31.40.0-255,66,145847,77,242683
15738,0.001552,74.125.24.0-255,11410,157257,77,242683
15739,0.001554,172.31.40.0-255,66,157323,77,242683
15740,0.001615,74.125.24.0-255,10692,168015,77,242683
15741,0.001617,172.31.40.0-255,66,168081,77,242683
15742,0.001646,74.125.24.0-255,1484,169565,77,242683
15743,0.001651,74.125.24.0-255,2902,172467,77,242683
15744,0.001654,172.31.40.0-255,66,172533,77,242683
15745,0.001659,74.125.24.0-255,5738,178271,77,242683
15746,0.001662,172.31.40.0-255,66,178337,77,242683
15747,0.001665,74.125.24.0-255,1484,179821,77,242683
15748,0.001707,74.125.24.0-255,11410,191231,77,242683
15749,0.00171,172.31.40.0-255,66,191297,77,242683
15750,0.00172,74.125.24.0-255,10692,201989,77,242683
15751,0.001723,172.31.40.0-255,66,202055,77,242683
15752,0.004055,74.125.24.0-255,5738,207793,77,242683
15753,0.004063,172.31.40.0-255,66,207859,77,242683
15754,0.006363,74.125.24.0-255,5738,213597,77,242683
15755,0.00637,172.31.40.0-255,66,213663,77,242683
15756,0.008719,74.125.24.0-255,5738,219401,77,242683
15757,0.008726,172.31.40.0-255,66,219467,77,242683
15758,0.011054,74.125.24.0-255,5738,225205,77,242683
15759,0.011061,172.31.40.0-255,66,225271,77,242683
15760,0.013398,74.125.24.0-255,5738,231009,77,242683
15761,0.013405,172.31.40.0-255,66,231075,77,242683
15762,0.015745,74.125.24.0-255,5738,236813,77,242683
15763,0.015752,172.31.40.0-255,66,236879,77,242683
15764,0.018061,74.125.24.0-255,5738,242617,77,242683
15765,0.01807,172.31.40.0-255,66,242683,77,242683
15766,0.0,74.125.24.0-255,153,153,77,275883
15767,2.3e-05,172.31.40.0-255,66,219,77,275883
15768,2.9e-05,74.125.24.0-255,1484,1703,77,275883
15769,3.3e-05,172.31.40.0-255,66,1769,77,275883
15770,3.9e-05,74.125.24.0-255,2902,4671,77,275883
15771,5e-05,172.31.40.0-255,66,4737,77,275883
15772,5.6e-05,74.125.24.0-255,7156,11893,77,275883
15773,5.9e-05,172.31.40.0-255,66,11959,77,275883
15774,9.6e-05,74.125.24.0-255,2065,14024,77,275883
15775,9.8e-05,172.31.40.0-255,66,14090,77,275883
15776,0.000103,74.125.24.0-255,2902,16992,77,275883
15777,0.000106,172.31.40.0-255,66,17058,77,275883
15778,0.000143,74.125.24.0-255,7156,24214,77,275883
15779,0.000146,172.31.40.0-255,66,24280,77,275883
15780,0.000177,74.125.24.0-255,6797,31077,77,275883
15781,0.00018,172.31.40.0-255,66,31143,77,275883
15782,0.0003,74.125.24.0-255,1484,32627,77,275883
15783,0.000304,172.31.40.0-255,66,32693,77,275883
15784,0.00031,74.125.24.0-255,2902,35595,77,275883
15785,0.000312,172.31.40.0-255,66,35661,77,275883
15786,0.000333,74.125.24.0-255,1484,37145,77,275883
15787,0.000339,172.31.40.0-255,66,37211,77,275883
15788,0.000344,74.125.24.0-255,2902,40113,77,275883
15789,0.000347,172.31.40.0-255,66,40179,77,275883
15790,0.000352,74.125.24.0-255,4320,44499,77,275883
15791,0.000355,172.31.40.0-255,66,44565,77,275883
15792,0.000376,74.125.24.0-255,1484,46049,77,275883
15793,0.000382,172.31.40.0-255,66,46115,77,275883
15794,0.000417,74.125.24.0-255,9992,56107,77,275883
15795,0.000419,172.31.40.0-255,66,56173,77,275883
15796,0.000456,74.125.24.0-255,1125,57298,77,275883
15797,0.000458,172.31.40.0-255,66,57364,77,275883
15798,0.000467,74.125.24.0-255,8486,65850,77,275883
15799,0.000469,172.31.40.0-255,66,65916,77,275883
15800,0.000522,74.125.24.0-255,135,66051,77,275883
15801,0.000636,74.125.24.0-255,1484,67535,77,275883
15802,0.00064,172.31.40.0-255,66,67601,77,275883
15803,0.000645,74.125.24.0-255,1484,69085,77,275883
15804,0.000667,74.125.24.0-255,1484,70569,77,275883
15805,0.00067,172.31.40.0-255,66,70635,77,275883
15806,0.000676,74.125.24.0-255,4320,74955,77,275883
15807,0.000678,172.31.40.0-255,66,75021,77,275883
15808,0.000719,74.125.24.0-255,1484,76505,77,275883
15809,0.000725,74.125.24.0-255,4320,80825,77,275883
15810,0.000728,172.31.40.0-255,66,80891,77,275883
15811,0.000739,74.125.24.0-255,11410,92301,77,275883
15812,0.000742,172.31.40.0-255,66,92367,77,275883
15813,0.000757,74.125.24.0-255,10692,103059,77,275883
15814,0.000759,172.31.40.0-255,66,103125,77,275883
15815,0.000762,74.125.24.0-255,1484,104609,77,275883
15816,0.000805,74.125.24.0-255,9992,114601,77,275883
15817,0.000808,172.31.40.0-255,66,114667,77,275883
15818,0.000831,172.31.40.0-255,66,114733,77,275883
15819,0.001563,74.125.24.0-255,1484,116217,77,275883
15820,0.00157,74.125.24.0-255,2902,119119,77,275883
15821,0.001573,172.31.40.0-255,66,119185,77,275883
15822,0.00158,74.125.24.0-255,5738,124923,77,275883
15823,0.001582,172.31.40.0-255,66,124989,77,275883
15824,0.001587,74.125.24.0-255,4320,129309,77,275883
15825,0.001594,172.31.40.0-255,66,129375,77,275883
15826,0.001629,74.125.24.0-255,8574,137949,77,275883
15827,0.001632,172.31.40.0-255,66,138015,77,275883
15828,0.001646,74.125.24.0-255,4320,142335,77,275883
15829,0.001652,172.31.40.0-255,66,142401,77,275883
15830,0.001681,74.125.24.0-255,6438,148839,77,275883
15831,0.001683,172.31.40.0-255,66,148905,77,275883
15832,0.001831,74.125.24.0-255,1484,150389,77,275883
15833,0.001837,74.125.24.0-255,2902,153291,77,275883
15834,0.00184,172.31.40.0-255,66,153357,77,275883
15835,0.001846,74.125.24.0-255,4320,157677,77,275883
15836,0.001848,172.31.40.0-255,66,157743,77,275883
15837,0.001857,74.125.24.0-255,2902,160645,77,275883
15838,0.001859,172.31.40.0-255,66,160711,77,275883
15839,0.001912,74.125.24.0-255,5738,166449,77,275883
15840,0.001915,172.31.40.0-255,66,166515,77,275883
15841,0.001937,172.31.40.0-255,66,166581,77,275883
15842,0.002015,74.125.24.0-255,1484,168065,77,275883
15843,0.002038,74.125.24.0-255,2902,170967,77,275883
15844,0.002041,172.31.40.0-255,66,171033,77,275883
15845,0.002048,74.125.24.0-255,5738,176771,77,275883
15846,0.00205,172.31.40.0-255,66,176837,77,275883
15847,0.002053,74.125.24.0-255,1484,178321,77,275883
15848,0.002062,74.125.24.0-255,4320,182641,77,275883
15849,0.002064,172.31.40.0-255,66,182707,77,275883
15850,0.002077,74.125.24.0-255,4320,187027,77,275883
15851,0.002081,172.31.40.0-255,66,187093,77,275883
15852,0.002106,74.125.24.0-255,7156,194249,77,275883
15853,0.002109,172.31.40.0-255,66,194315,77,275883
15854,0.002137,74.125.24.0-255,4320,198635,77,275883
15855,0.00214,172.31.40.0-255,66,198701,77,275883
15856,0.002144,74.125.24.0-255,2184,200885,77,275883
15857,0.002146,172.31.40.0-255,66,200951,77,275883
15858,0.00218,74.125.24.0-255,2902,203853,77,275883
15859,0.002184,172.31.40.0-255,66,203919,77,275883
15860,0.002252,74.125.24.0-255,7156,211075,77,275883
15861,0.002255,172.31.40.0-255,66,211141,77,275883
15862,0.002279,74.125.24.0-255,11410,222551,77,275883
15863,0.002282,172.31.40.0-255,66,222617,77,275883
15864,0.002285,74.125.24.0-255,1484,224101,77,275883
15865,0.002289,74.125.24.0-255,2902,227003,77,275883
15866,0.002291,172.31.40.0-255,66,227069,77,275883
15867,0.002322,74.125.24.0-255,1484,228553,77,275883
15868,0.002326,74.125.24.0-255,2902,231455,77,275883
15869,0.002329,172.31.40.0-255,66,231521,77,275883
15870,0.002355,74.125.24.0-255,3602,235123,77,275883
15871,0.002358,172.31.40.0-255,66,235189,77,275883
15872,0.004653,74.125.24.0-255,1484,236673,77,275883
15873,0.004675,74.125.24.0-255,4320,240993,77,275883
15874,0.004683,172.31.40.0-255,66,241059,77,275883
15875,0.006975,74.125.24.0-255,5738,246797,77,275883
15876,0.00698,172.31.40.0-255,66,246863,77,275883
15877,0.00928,74.125.24.0-255,5738,252601,77,275883
15878,0.00929,172.31.40.0-255,66,252667,77,275883
15879,0.011625,74.125.24.0-255,5738,258405,77,275883
15880,0.011643,172.31.40.0-255,66,258471,77,275883
15881,0.013964,74.125.24.0-255,5738,264209,77,275883
15882,0.013975,172.31.40.0-255,66,264275,77,275883
15883,0.016282,74.125.24.0-255,5738,270013,77,275883
15884,0.016295,172.31.40.0-255,66,270079,77,275883
15885,0.018603,74.125.24.0-255,5738,275817,77,275883
15886,0.018612,172.31.40.0-255,66,275883,77,275883
15887,0.0,172.217.194.0-255,152,152,77,215045
15888,2.3e-05,172.31.40.0-255,66,218,77,215045
15889,3e-05,172.217.194.0-255,1484,1702,77,215045
15890,3.5e-05,172.31.40.0-255,66,1768,77,215045
15891,4.1e-05,172.217.194.0-255,2902,4670,77,215045
15892,4.3e-05,172.31.40.0-255,66,4736,77,215045
15893,4.9e-05,172.217.194.0-255,4320,9056,77,215045
15894,5.2e-05,172.31.40.0-255,66,9122,77,215045
15895,5.9e-05,172.217.194.0-255,4774,13896,77,215045
15896,6.3e-05,172.31.40.0-255,66,13962,77,215045
15897,7.4e-05,172.217.194.0-255,11410,25372,77,215045
15898,7.7e-05,172.31.40.0-255,66,25438,77,215045
15899,8.3e-05,172.217.194.0-255,5379,30817,77,215045
15900,8.7e-05,172.31.40.0-255,66,30883,77,215045
15901,0.00014,172.217.194.0-255,1484,32367,77,215045
15902,0.000143,172.31.40.0-255,66,32433,77,215045
15903,0.000148,172.217.194.0-255,2902,35335,77,215045
15904,0.000151,172.31.40.0-255,66,35401,77,215045
15905,0.000174,172.217.194.0-255,5738,41139,77,215045
15906,0.000177,172.31.40.0-255,66,41205,77,215045
15907,0.000179,172.217.194.0-255,1484,42689,77,215045
15908,0.000181,172.31.40.0-255,66,42755,77,215045
15909,0.000215,172.217.194.0-255,13887,56642,77,215045
15910,0.000219,172.31.40.0-255,66,56708,77,215045
15911,0.000227,172.217.194.0-255,8215,64923,77,215045
15912,0.000229,172.31.40.0-255,66,64989,77,215045
15913,0.000248,172.217.194.0-255,379,65368,77,215045
15914,0.00025,172.31.40.0-255,66,65434,77,215045
15915,0.000308,172.217.194.0-255,364,65798,77,215045
15916,0.000312,172.31.40.0-255,66,65864,77,215045
15917,0.000644,172.217.194.0-255,1484,67348,77,215045
15918,0.000649,172.31.40.0-255,66,67414,77,215045
15919,0.000655,172.217.194.0-255,2902,70316,77,215045
15920,0.000657,172.31.40.0-255,66,70382,77,215045
15921,0.000664,172.217.194.0-255,5738,76120,77,215045
15922,0.000666,172.31.40.0-255,66,76186,77,215045
15923,0.000695,172.217.194.0-255,12828,89014,77,215045
15924,0.000698,172.31.40.0-255,66,89080,77,215045
15925,0.000724,172.217.194.0-255,1484,90564,77,215045
15926,0.000754,172.217.194.0-255,9274,99838,77,215045
15927,0.000762,172.31.40.0-255,66,99904,77,215045
15928,0.001662,172.217.194.0-255,1484,101388,77,215045
15929,0.001673,172.217.194.0-255,2902,104290,77,215045
15930,0.001678,172.31.40.0-255,66,104356,77,215045
15931,0.001687,172.217.194.0-255,5738,110094,77,215045
15932,0.001689,172.31.40.0-255,66,110160,77,215045
15933,0.001694,172.217.194.0-255,2902,113062,77,215045
15934,0.001695,172.31.40.0-255,66,113128,77,215045
15935,0.001725,172.217.194.0-255,9992,123120,77,215045
15936,0.001728,172.31.40.0-255,66,123186,77,215045
15937,0.001759,172.217.194.0-255,10692,133878,77,215045
15938,0.001761,172.31.40.0-255,66,133944,77,215045
15939,0.002066,172.217.194.0-255,1484,135428,77,215045
15940,0.002073,172.217.194.0-255,2902,138330,77,215045
15941,0.002078,172.31.40.0-255,66,138396,77,215045
15942,0.002084,172.217.194.0-255,2902,141298,77,215045
15943,0.002086,172.31.40.0-255,66,141364,77,215045
15944,0.002103,172.217.194.0-255,2902,144266,77,215045
15945,0.002106,172.31.40.0-255,66,144332,77,215045
15946,0.002113,172.217.194.0-255,7156,151488,77,215045
15947,0.002115,172.31.40.0-255,66,151554,77,215045
15948,0.002148,172.217.194.0-255,8574,160128,77,215045
15949,0.00215,172.31.40.0-255,66,160194,77,215045
15950,0.00216,172.217.194.0-255,1484,161678,77,215045
15951,0.002182,172.217.194.0-255,6438,168116,77,215045
15952,0.002184,172.31.40.0-255,66,168182,77,215045
15953,0.004335,172.217.194.0-255,5738,173920,77,215045
15954,0.004339,172.31.40.0-255,66,173986,77,215045
15955,0.005662,172.31.40.0-255,101,174087,77,215045
15956,0.006468,172.217.194.0-255,5738,179825,77,215045
15957,0.006474,172.31.40.0-255,66,179891,77,215045
15958,0.007745,172.217.194.0-255,66,179957,77,215045
15959,0.008624,172.217.194.0-255,5738,185695,77,215045
15960,0.008631,172.31.40.0-255,66,185761,77,215045
15961,0.010811,172.217.194.0-255,5738,191499,77,215045
15962,0.010825,172.31.40.0-255,66,191565,77,215045
15963,0.012919,172.217.194.0-255,2902,194467,77,215045
15964,0.012926,172.31.40.0-255,66,194533,77,215045
15965,0.012953,172.217.194.0-255,2902,197435,77,215045
15966,0.012956,172.31.40.0-255,66,197501,77,215045
15967,0.015028,172.217.194.0-255,2902,200403,77,215045
15968,0.015041,172.31.40.0-255,66,200469,77,215045
15969,0.015081,172.217.194.0-255,2902,203371,77,215045
15970,0.015084,172.31.40.0-255,66,203437,77,215045
15971,0.017188,172.217.194.0-255,5738,209175,77,215045
15972,0.0172,172.31.40.0-255,66,209241,77,215045
15973,0.019313,172.217.194.0-255,5738,214979,77,215045
15974,0.019322,172.31.40.0-255,66,215045,77,215045
15975,0.0,74.125.24.0-255,152,152,77,268306
15976,2.3e-05,172.31.40.0-255,66,218,77,268306
15977,3.1e-05,74.125.24.0-255,1484,1702,77,268306
15978,3.7e-05,172.31.40.0-255,66,1768,77,268306
15979,4.2e-05,74.125.24.0-255,2902,4670,77,268306
15980,4.5e-05,172.31.40.0-255,66,4736,77,268306
15981,5.2e-05,74.125.24.0-255,5738,10474,77,268306
15982,5.4e-05,172.31.40.0-255,66,10540,77,268306
15983,8.3e-05,74.125.24.0-255,3545,14085,77,268306
15984,8.6e-05,172.31.40.0-255,66,14151,77,268306
15985,0.000149,74.125.24.0-255,1484,15635,77,268306
15986,0.000152,172.31.40.0-255,66,15701,77,268306
15987,0.000157,74.125.24.0-255,2902,18603,77,268306
15988,0.000159,172.31.40.0-255,66,18669,77,268306
15989,0.000164,74.125.24.0-255,2902,21571,77,268306
15990,0.000166,172.31.40.0-255,66,21637,77,268306
15991,0.000192,74.125.24.0-255,2902,24539,77,268306
15992,0.000195,172.31.40.0-255,66,24605,77,268306
15993,0.000201,74.125.24.0-255,5738,30343,77,268306
15994,0.000204,172.31.40.0-255,66,30409,77,268306
15995,0.000229,74.125.24.0-255,13887,44296,77,268306
15996,0.000232,172.31.40.0-255,66,44362,77,268306
15997,0.000238,74.125.24.0-255,5738,50100,77,268306
15998,0.00024,172.31.40.0-255,66,50166,77,268306
15999,0.000264,74.125.24.0-255,7156,57322,77,268306
16000,0.000267,172.31.40.0-255,66,57388,77,268306
16001,0.000282,74.125.24.0-255,5738,63126,77,268306
16002,0.000285,172.31.40.0-255,66,63192,77,268306
16003,0.000305,74.125.24.0-255,2517,65709,77,268306
16004,0.000309,172.31.40.0-255,66,65775,77,268306
16005,0.000312,74.125.24.0-255,112,65887,77,268306
16006,0.000314,172.31.40.0-255,66,65953,77,268306
16007,0.000327,74.125.24.0-255,329,66282,77,268306
16008,0.00053,74.125.24.0-255,1484,67766,77,268306
16009,0.000536,172.31.40.0-255,66,67832,77,268306
16010,0.000541,74.125.24.0-255,2902,70734,77,268306
16011,0.000544,172.31.40.0-255,66,70800,77,268306
16012,0.00055,74.125.24.0-255,5738,76538,77,268306
16013,0.000553,172.31.40.0-255,66,76604,77,268306
16014,0.000574,74.125.24.0-255,5738,82342,77,268306
16015,0.000576,172.31.40.0-255,66,82408,77,268306
16016,0.000592,74.125.24.0-255,7156,89564,77,268306
16017,0.000594,172.31.40.0-255,66,89630,77,268306
16018,0.000602,74.125.24.0-255,7156,96786,77,268306
16019,0.000604,172.31.40.0-255,66,96852,77,268306
16020,0.000628,74.125.24.0-255,2902,99754,77,268306
16021,0.00063,172.31.40.0-255,66,99820,77,268306
16022,0.000633,74.125.24.0-255,766,100586,77,268306
16023,0.001235,74.125.24.0-255,1484,102070,77,268306
16024,0.00124,172.31.40.0-255,66,102136,77,268306
16025,0.001246,74.125.24.0-255,2902,105038,77,268306
16026,0.001248,172.31.40.0-255,66,105104,77,268306
16027,0.001251,74.125.24.0-255,1484,106588,77,268306
16028,0.001267,74.125.24.0-255,4320,110908,77,268306
16029,0.001269,172.31.40.0-255,66,110974,77,268306
16030,0.001278,74.125.24.0-255,8574,119548,77,268306
16031,0.00128,172.31.40.0-255,66,119614,77,268306
16032,0.001311,74.125.24.0-255,4320,123934,77,268306
16033,0.001314,172.31.40.0-255,66,124000,77,268306
16034,0.001324,74.125.24.0-255,9992,133992,77,268306
16035,0.001326,172.31.40.0-255,66,134058,77,268306
16036,0.001329,74.125.24.0-255,766,134824,77,268306
16037,0.001411,74.125.24.0-255,1484,136308,77,268306
16038,0.001428,172.31.40.0-255,66,136374,77,268306
16039,0.001434,74.125.24.0-255,2902,139276,77,268306
16040,0.001437,172.31.40.0-255,66,139342,77,268306
16041,0.001458,74.125.24.0-255,5738,145080,77,268306
16042,0.001461,172.31.40.0-255,66,145146,77,268306
16043,0.001468,74.125.24.0-255,7156,152302,77,268306
16044,0.00147,172.31.40.0-255,66,152368,77,268306
16045,0.001531,172.31.40.0-255,66,152434,77,268306
16046,0.001535,74.125.24.0-255,2184,154618,77,268306
16047,0.001537,172.31.40.0-255,66,154684,77,268306
16048,0.001658,74.125.24.0-255,1484,156168,77,268306
16049,0.001664,74.125.24.0-255,2902,159070,77,268306
16050,0.001667,172.31.40.0-255,66,159136,77,268306
16051,0.001674,74.125.24.0-255,5738,164874,77,268306
16052,0.001677,172.31.40.0-255,66,164940,77,268306
16053,0.001698,74.125.24.0-255,5738,170678,77,268306
16054,0.001701,172.31.40.0-255,66,170744,77,268306
16055,0.001731,74.125.24.0-255,7156,177900,77,268306
16056,0.001735,172.31.40.0-255,66,177966,77,268306
16057,0.001741,74.125.24.0-255,5738,183704,77,268306
16058,0.001743,172.31.40.0-255,66,183770,77,268306
16059,0.001747,74.125.24.0-255,1484,185254,77,268306
16060,0.001764,74.125.24.0-255,3602,188856,77,268306
16061,0.001766,172.31.40.0-255,66,188922,77,268306
16062,0.002294,74.125.24.0-255,1484,190406,77,268306
16063,0.002302,74.125.24.0-255,2902,193308,77,268306
16064,0.002308,172.31.40.0-255,66,193374,77,268306
16065,0.002313,74.125.24.0-255,2902,196276,77,268306
16066,0.002316,172.31.40.0-255,66,196342,77,268306
16067,0.002321,74.125.24.0-255,4320,200662,77,268306
16068,0.002323,172.31.40.0-255,66,200728,77,268306
16069,0.002341,74.125.24.0-255,2902,203630,77,268306
16070,0.002344,172.31.40.0-255,66,203696,77,268306
16071,0.002351,74.125.24.0-255,5738,209434,77,268306
16072,0.002353,172.31.40.0-255,66,209500,77,268306
16073,0.002381,74.125.24.0-255,9992,219492,77,268306
16074,0.002384,172.31.40.0-255,66,219558,77,268306
16075,0.002389,74.125.24.0-255,3602,223160,77,268306
16076,0.002392,172.31.40.0-255,66,223226,77,268306
16077,0.002635,74.125.24.0-255,1484,224710,77,268306
16078,0.002643,74.125.24.0-255,2902,227612,77,268306
16079,0.002647,172.31.40.0-255,66,227678,77,268306
16080,0.002655,74.125.24.0-255,5738,233416,77,268306
16081,0.002657,172.31.40.0-255,66,233482,77,268306
16082,0.005268,74.125.24.0-255,5738,239220,77,268306
16083,0.005272,172.31.40.0-255,66,239286,77,268306
16084,0.007885,74.125.24.0-255,5738,245024,77,268306
16085,0.007897,172.31.40.0-255,66,245090,77,268306
16086,0.010515,74.125.24.0-255,5738,250828,77,268306
16087,0.010521,172.31.40.0-255,66,250894,77,268306
16088,0.013157,74.125.24.0-255,5738,256632,77,268306
16089,0.013165,172.31.40.0-255,66,256698,77,268306
16090,0.015765,74.125.24.0-255,5738,262436,77,268306
16091,0.015772,172.31.40.0-255,66,262502,77,268306
16092,0.018388,74.125.24.0-255,5738,268240,77,268306
16093,0.018396,172.31.40.0-255,66,268306,77,268306
16094,0.0,172.31.40.0-255,105,105,77,105
16095,0.0,172.31.40.0-255,105,105,77,459
16096,0.000253,172.31.40.0-255,90,195,77,459
16097,0.000261,172.31.40.0-255,66,261,77,459
16098,0.002496,74.125.68.0-255,66,327,77,459
16099,0.00252,74.125.68.0-255,66,393,77,459
16100,0.00254,172.31.40.0-255,66,459,77,459
16101,0.0,172.217.194.0-255,152,152,77,413353
16102,2e-05,172.31.40.0-255,66,218,77,413353
16103,2.7e-05,172.217.194.0-255,1484,1702,77,413353
16104,3.1e-05,172.31.40.0-255,66,1768,77,413353
16105,3.8e-05,172.217.194.0-255,2902,4670,77,413353
16106,4.1e-05,172.31.40.0-255,66,4736,77,413353
16107,5e-05,172.217.194.0-255,7156,11892,77,413353
16108,5.2e-05,172.31.40.0-255,66,11958,77,413353
16109,5.6e-05,172.217.194.0-255,2041,13999,77,413353
16110,5.9e-05,172.31.40.0-255,66,14065,77,413353
16111,6.4e-05,172.217.194.0-255,2902,16967,77,413353
16112,6.6e-05,172.31.40.0-255,66,17033,77,413353
16113,7.3e-05,172.217.194.0-255,7156,24189,77,413353
16114,7.6e-05,172.31.40.0-255,66,24255,77,413353
16115,8.3e-05,172.217.194.0-255,6797,31052,77,413353
16116,8.6e-05,172.31.40.0-255,66,31118,77,413353
16117,0.00011,172.217.194.0-255,5738,36856,77,413353
16118,0.000113,172.31.40.0-255,66,36922,77,413353
16119,0.000144,172.217.194.0-255,9992,46914,77,413353
16120,0.000147,172.31.40.0-255,66,46980,77,413353
16121,0.00015,172.217.194.0-255,1125,48105,77,413353
16122,0.000152,172.31.40.0-255,66,48171,77,413353
16123,0.000302,172.217.194.0-255,1484,49655,77,413353
16124,0.000307,172.31.40.0-255,66,49721,77,413353
16125,0.000313,172.217.194.0-255,2902,52623,77,413353
16126,0.000316,172.31.40.0-255,66,52689,77,413353
16127,0.000319,172.217.194.0-255,1484,54173,77,413353
16128,0.00032,172.31.40.0-255,66,54239,77,413353
16129,0.00034,172.217.194.0-255,4320,58559,77,413353
16130,0.000343,172.31.40.0-255,66,58625,77,413353
16131,0.000368,172.217.194.0-255,5738,64363,77,413353
16132,0.000371,172.31.40.0-255,66,64429,77,413353
16133,0.000389,172.217.194.0-255,1419,65848,77,413353
16134,0.000655,172.217.194.0-255,385,66233,77,413353
16135,0.00066,172.31.40.0-255,66,66299,77,413353
16136,0.000905,172.217.194.0-255,1484,67783,77,413353
16137,0.000912,172.217.194.0-255,2902,70685,77,413353
16138,0.000915,172.31.40.0-255,66,70751,77,413353
16139,0.000918,172.217.194.0-255,1484,72235,77,413353
16140,0.00094,172.217.194.0-255,4320,76555,77,413353
16141,0.000942,172.31.40.0-255,66,76621,77,413353
16142,0.000949,172.217.194.0-255,7156,83777,77,413353
16143,0.000951,172.31.40.0-255,66,83843,77,413353
16144,0.000961,172.217.194.0-255,9992,93835,77,413353
16145,0.000963,172.31.40.0-255,66,93901,77,413353
16146,0.000984,172.217.194.0-255,4320,98221,77,413353
16147,0.000986,172.31.40.0-255,66,98287,77,413353
16148,0.00099,172.217.194.0-255,2184,100471,77,413353
16149,0.000992,172.31.40.0-255,66,100537,77,413353
16150,0.001448,172.217.194.0-255,1484,102021,77,413353
16151,0.001456,172.217.194.0-255,2902,104923,77,413353
16152,0.00146,172.31.40.0-255,66,104989,77,413353
16153,0.00148,172.217.194.0-255,5738,110727,77,413353
16154,0.001482,172.31.40.0-255,66,110793,77,413353
16155,0.001507,172.217.194.0-255,4320,115113,77,413353
16156,0.00151,172.31.40.0-255,66,115179,77,413353
16157,0.001535,172.217.194.0-255,8574,123753,77,413353
16158,0.001538,172.31.40.0-255,66,123819,77,413353
16159,0.001545,172.217.194.0-255,7156,130975,77,413353
16160,0.001547,172.31.40.0-255,66,131041,77,413353
16161,0.001571,172.217.194.0-255,3602,134643,77,413353
16162,0.001573,172.31.40.0-255,66,134709,77,413353
16163,0.001695,172.217.194.0-255,1484,136193,77,413353
16164,0.001702,172.217.194.0-255,2902,139095,77,413353
16165,0.001705,172.31.40.0-255,66,139161,77,413353
16166,0.001729,172.217.194.0-255,5738,144899,77,413353
16167,0.001731,172.31.40.0-255,66,144965,77,413353
16168,0.001736,172.217.194.0-255,2902,147867,77,413353
16169,0.001738,172.31.40.0-255,66,147933,77,413353
16170,0.001757,172.217.194.0-255,8574,156507,77,413353
16171,0.001759,172.31.40.0-255,66,156573,77,413353
16172,0.001786,172.217.194.0-255,1484,158057,77,413353
16173,0.001797,172.217.194.0-255,10692,168749,77,413353
16174,0.001799,172.31.40.0-255,66,168815,77,413353
16175,0.001828,172.217.194.0-255,11410,180225,77,413353
16176,0.001831,172.31.40.0-255,66,180291,77,413353
16177,0.00184,172.217.194.0-255,9992,190283,77,413353
16178,0.001843,172.31.40.0-255,66,190349,77,413353
16179,0.001886,172.217.194.0-255,4320,194669,77,413353
16180,0.001889,172.31.40.0-255,66,194735,77,413353
16181,0.001914,172.217.194.0-255,7856,202591,77,413353
16182,0.001917,172.31.40.0-255,66,202657,77,413353
16183,0.001973,172.217.194.0-255,1484,204141,77,413353
16184,0.001979,172.217.194.0-255,2902,207043,77,413353
16185,0.001982,172.31.40.0-255,66,207109,77,413353
16186,0.001985,172.217.194.0-255,1484,208593,77,413353
16187,0.002004,172.217.194.0-255,4320,212913,77,413353
16188,0.002007,172.31.40.0-255,66,212979,77,413353
16189,0.00201,172.217.194.0-255,1484,214463,77,413353
16190,0.002044,172.217.194.0-255,11410,225873,77,413353
16191,0.002047,172.31.40.0-255,66,225939,77,413353
16192,0.002057,172.217.194.0-255,10692,236631,77,413353
16193,0.002059,172.31.40.0-255,66,236697,77,413353
16194,0.002086,172.217.194.0-255,4320,241017,77,413353
16195,0.002089,172.31.40.0-255,66,241083,77,413353
16196,0.002096,172.217.194.0-255,5738,246821,77,413353
16197,0.002098,172.31.40.0-255,66,246887,77,413353
16198,0.002141,172.217.194.0-255,11410,258297,77,413353
16199,0.002146,172.31.40.0-255,66,258363,77,413353
16200,0.002157,172.217.194.0-255,12110,270473,77,413353
16201,0.002159,172.31.40.0-255,66,270539,77,413353
16202,0.002223,172.217.194.0-255,1484,272023,77,413353
16203,0.002228,172.217.194.0-255,1484,273507,77,413353
16204,0.002231,172.31.40.0-255,66,273573,77,413353
16205,0.00225,172.217.194.0-255,1484,275057,77,413353
16206,0.002257,172.217.194.0-255,5738,280795,77,413353
16207,0.002259,172.31.40.0-255,66,280861,77,413353
16208,0.002295,172.217.194.0-255,5738,286599,77,413353
16209,0.002297,172.31.40.0-255,66,286665,77,413353
16210,0.002315,172.217.194.0-255,7156,293821,77,413353
16211,0.002318,172.31.40.0-255,66,293887,77,413353
16212,0.002328,172.217.194.0-255,10692,304579,77,413353
16213,0.002331,172.31.40.0-255,66,304645,77,413353
16214,0.002336,172.217.194.0-255,4320,308965,77,413353
16215,0.002338,172.31.40.0-255,66,309031,77,413353
16216,0.002341,172.217.194.0-255,1484,310515,77,413353
16217,0.002363,172.217.194.0-255,4320,314835,77,413353
16218,0.002366,172.31.40.0-255,66,314901,77,413353
16219,0.002373,172.217.194.0-255,7156,322057,77,413353
16220,0.002375,172.31.40.0-255,66,322123,77,413353
16221,0.002407,172.217.194.0-255,4320,326443,77,413353
16222,0.002409,172.31.40.0-255,66,326509,77,413353
16223,0.002421,172.217.194.0-255,12110,338619,77,413353
16224,0.002423,172.31.40.0-255,66,338685,77,413353
16225,0.002471,172.217.194.0-255,1484,340169,77,413353
16226,0.002486,172.217.194.0-255,2902,343071,77,413353
16227,0.002489,172.31.40.0-255,66,343137,77,413353
16228,0.002495,172.217.194.0-255,5738,348875,77,413353
16229,0.002497,172.31.40.0-255,66,348941,77,413353
16230,0.00251,172.217.194.0-255,2902,351843,77,413353
16231,0.002512,172.31.40.0-255,66,351909,77,413353
16232,0.002545,172.217.194.0-255,9992,361901,77,413353
16233,0.002548,172.31.40.0-255,66,361967,77,413353
16234,0.002557,172.217.194.0-255,10692,372659,77,413353
16235,0.00256,172.31.40.0-255,66,372725,77,413353
16236,0.005024,172.217.194.0-255,5738,378463,77,413353
16237,0.005032,172.31.40.0-255,66,378529,77,413353
16238,0.00748,172.217.194.0-255,5738,384267,77,413353
16239,0.007486,172.31.40.0-255,66,384333,77,413353
16240,0.009951,172.217.194.0-255,5738,390071,77,413353
16241,0.009956,172.31.40.0-255,66,390137,77,413353
16242,0.012438,172.217.194.0-255,5738,395875,77,413353
16243,0.012449,172.31.40.0-255,66,395941,77,413353
16244,0.014928,172.217.194.0-255,5738,401679,77,413353
16245,0.014936,172.31.40.0-255,66,401745,77,413353
16246,0.017413,172.217.194.0-255,5738,407483,77,413353
16247,0.017421,172.31.40.0-255,66,407549,77,413353
16248,0.01991,172.217.194.0-255,5738,413287,77,413353
16249,0.019917,172.31.40.0-255,66,413353,77,413353
16250,0.0,172.31.40.0-255,105,105,77,459
16251,0.000241,172.31.40.0-255,90,195,77,459
16252,0.000252,172.31.40.0-255,66,261,77,459
16253,0.002621,74.125.24.0-255,66,327,77,459
16254,0.002652,74.125.24.0-255,66,393,77,459
16255,0.002676,172.31.40.0-255,66,459,77,459
16256,0.0,74.125.130.0-255,153,153,77,295284
16257,2.5e-05,172.31.40.0-255,66,219,77,295284
16258,3.3e-05,74.125.130.0-255,1484,1703,77,295284
16259,3.7e-05,172.31.40.0-255,66,1769,77,295284
16260,4.4e-05,74.125.130.0-255,2902,4671,77,295284
16261,4.8e-05,172.31.40.0-255,66,4737,77,295284
16262,8.4e-05,74.125.130.0-255,7156,11893,77,295284
16263,8.7e-05,172.31.40.0-255,66,11959,77,295284
16264,9.2e-05,74.125.130.0-255,1910,13869,77,295284
16265,9.4e-05,172.31.40.0-255,66,13935,77,295284
16266,0.000119,74.125.130.0-255,1484,15419,77,295284
16267,0.000122,172.31.40.0-255,66,15485,77,295284
16268,0.00015,74.125.130.0-255,2902,18387,77,295284
16269,0.000153,172.31.40.0-255,66,18453,77,295284
16270,0.000157,74.125.130.0-255,1484,19937,77,295284
16271,0.000159,172.31.40.0-255,66,20003,77,295284
16272,0.000184,74.125.130.0-255,2902,22905,77,295284
16273,0.000187,172.31.40.0-255,66,22971,77,295284
16274,0.000204,74.125.130.0-255,2902,25873,77,295284
16275,0.000206,172.31.40.0-255,66,25939,77,295284
16276,0.000227,74.125.130.0-255,2902,28841,77,295284
16277,0.00023,172.31.40.0-255,66,28907,77,295284
16278,0.000258,74.125.130.0-255,2543,31450,77,295284
16279,0.000261,172.31.40.0-255,66,31516,77,295284
16280,0.000391,74.125.130.0-255,1484,33000,77,295284
16281,0.000395,172.31.40.0-255,66,33066,77,295284
16282,0.000415,74.125.130.0-255,1484,34550,77,295284
16283,0.000417,172.31.40.0-255,66,34616,77,295284
16284,0.000422,74.125.130.0-255,2902,37518,77,295284
16285,0.000425,172.31.40.0-255,66,37584,77,295284
16286,0.000449,74.125.130.0-255,5738,43322,77,295284
16287,0.000452,172.31.40.0-255,66,43388,77,295284
16288,0.000456,74.125.130.0-255,2902,46290,77,295284
16289,0.000494,74.125.130.0-255,3961,50251,77,295284
16290,0.000517,74.125.130.0-255,4320,54571,77,295284
16291,0.00053,74.125.130.0-255,2902,57473,77,295284
16292,0.000548,74.125.130.0-255,2902,60375,77,295284
16293,0.000564,74.125.130.0-255,5670,66045,77,295284
16294,0.000596,74.125.130.0-255,100,66145,77,295284
16295,0.00063,172.31.40.0-255,66,66211,77,295284
16296,0.000665,74.125.130.0-255,363,66574,77,295284
16297,0.000817,74.125.130.0-255,1484,68058,77,295284
16298,0.000822,74.125.130.0-255,1484,69542,77,295284
16299,0.00083,172.31.40.0-255,66,69608,77,295284
16300,0.000839,74.125.130.0-255,1484,71092,77,295284
16301,0.000847,74.125.130.0-255,5738,76830,77,295284
16302,0.000867,74.125.130.0-255,5738,82568,77,295284
16303,0.000883,172.31.40.0-255,66,82634,77,295284
16304,0.00089,74.125.130.0-255,7156,89790,77,295284
16305,0.0009,172.31.40.0-255,66,89856,77,295284
16306,0.000951,74.125.130.0-255,8574,98430,77,295284
16307,0.000968,74.125.130.0-255,2184,100614,77,295284
16308,0.000972,172.31.40.0-255,66,100680,77,295284
16309,0.00113,74.125.130.0-255,1484,102164,77,295284
16310,0.00115,74.125.130.0-255,2902,105066,77,295284
16311,0.001165,172.31.40.0-255,66,105132,77,295284
16312,0.001172,74.125.130.0-255,5738,110870,77,295284
16313,0.001181,172.31.40.0-255,66,110936,77,295284
16314,0.001192,74.125.130.0-255,7156,118092,77,295284
16315,0.001217,74.125.130.0-255,2902,120994,77,295284
16316,0.001219,172.31.40.0-255,66,121060,77,295284
16317,0.001226,172.31.40.0-255,66,121126,77,295284
16318,0.001242,74.125.130.0-255,8574,129700,77,295284
16319,0.001255,172.31.40.0-255,66,129766,77,295284
16320,0.001271,74.125.130.0-255,4320,134086,77,295284
16321,0.001278,172.31.40.0-255,66,134152,77,295284
16322,0.001291,74.125.130.0-255,766,134918,77,295284
16323,0.001668,74.125.130.0-255,1484,136402,77,295284
16324,0.001673,172.31.40.0-255,66,136468,77,295284
16325,0.001693,74.125.130.0-255,2902,139370,77,295284
16326,0.001698,172.31.40.0-255,66,139436,77,295284
16327,0.001716,74.125.130.0-255,5738,145174,77,295284
16328,0.001731,172.31.40.0-255,66,145240,77,295284
16329,0.001737,74.125.130.0-255,4320,149560,77,295284
16330,0.001741,172.31.40.0-255,66,149626,77,295284
16331,0.001761,74.125.130.0-255,5738,155364,77,295284
16332,0.001778,172.31.40.0-255,66,155430,77,295284
16333,0.001787,74.125.130.0-255,2902,158332,77,295284
16334,0.001792,74.125.130.0-255,4320,162652,77,295284
16335,0.001816,172.31.40.0-255,66,162718,77,295284
16336,0.001832,74.125.130.0-255,6438,169156,77,295284
16337,0.001848,172.31.40.0-255,66,169222,77,295284
16338,0.001926,74.125.130.0-255,1484,170706,77,295284
16339,0.00193,74.125.130.0-255,1484,172190,77,295284
16340,0.001933,172.31.40.0-255,66,172256,77,295284
16341,0.001952,74.125.130.0-255,1484,173740,77,295284
16342,0.001959,74.125.130.0-255,5738,179478,77,295284
16343,0.001971,172.31.40.0-255,66,179544,77,295284
16344,0.001985,74.125.130.0-255,2902,182446,77,295284
16345,0.00199,172.31.40.0-255,66,182512,77,295284
16346,0.002002,74.125.130.0-255,4320,186832,77,295284
16347,0.002024,172.31.40.0-255,66,186898,77,295284
16348,0.002032,74.125.130.0-255,7156,194054,77,295284
16349,0.002042,172.31.40.0-255,66,194120,77,295284
16350,0.002045,74.125.130.0-255,1484,195604,77,295284
16351,0.002083,74.125.130.0-255,4320,199924,77,295284
16352,0.002098,74.125.130.0-255,3602,203526,77,295284
16353,0.002106,172.31.40.0-255,66,203592,77,295284
16354,0.002227,74.125.130.0-255,1484,205076,77,295284
16355,0.00224,74.125.130.0-255,2902,207978,77,295284
16356,0.002243,172.31.40.0-255,66,208044,77,295284
16357,0.002263,74.125.130.0-255,2902,210946,77,295284
16358,0.002268,172.31.40.0-255,66,211012,77,295284
16359,0.002277,74.125.130.0-255,2902,213914,77,295284
16360,0.002282,74.125.130.0-255,4320,218234,77,295284
16361,0.002287,172.31.40.0-255,66,218300,77,295284
16362,0.002309,74.125.130.0-255,5738,224038,77,295284
16363,0.002322,172.31.40.0-255,66,224104,77,295284
16364,0.002333,74.125.130.0-255,2902,227006,77,295284
16365,0.002358,74.125.130.0-255,8574,235580,77,295284
16366,0.002362,74.125.130.0-255,2184,237764,77,295284
16367,0.002364,172.31.40.0-255,66,237830,77,295284
16368,0.002369,172.31.40.0-255,66,237896,77,295284
16369,0.002456,74.125.130.0-255,1484,239380,77,295284
16370,0.00247,74.125.130.0-255,2902,242282,77,295284
16371,0.002487,74.125.130.0-255,1484,243766,77,295284
16372,0.002496,172.31.40.0-255,66,243832,77,295284
16373,0.002501,74.125.130.0-255,2902,246734,77,295284
16374,0.002504,74.125.130.0-255,1484,248218,77,295284
16375,0.002515,172.31.40.0-255,66,248284,77,295284
16376,0.002528,74.125.130.0-255,4320,252604,77,295284
16377,0.002549,74.125.130.0-255,7156,259760,77,295284
16378,0.002576,74.125.130.0-255,4320,264080,77,295284
16379,0.002597,74.125.130.0-255,4320,268400,77,295284
16380,0.002601,74.125.130.0-255,3602,272002,77,295284
16381,0.007834,172.31.40.0-255,66,272068,77,295284
16382,0.010421,74.125.130.0-255,5738,277806,77,295284
16383,0.010438,172.31.40.0-255,66,277872,77,295284
16384,0.01308,74.125.130.0-255,5738,283610,77,295284
16385,0.013101,172.31.40.0-255,66,283676,77,295284
16386,0.015716,74.125.130.0-255,5738,289414,77,295284
16387,0.015734,172.31.40.0-255,66,289480,77,295284
16388,0.018325,74.125.130.0-255,5738,295218,77,295284
16389,0.019996,172.31.40.0-255,66,295284,77,295284
16390,0.0,172.217.194.0-255,153,153,77,289204
16391,1.7e-05,172.31.40.0-255,66,219,77,289204
16392,2.4e-05,172.217.194.0-255,1484,1703,77,289204
16393,2.8e-05,172.31.40.0-255,66,1769,77,289204
16394,3.4e-05,172.217.194.0-255,2902,4671,77,289204
16395,4.4e-05,172.31.40.0-255,66,4737,77,289204
16396,5.2e-05,172.217.194.0-255,7156,11893,77,289204
16397,5.7e-05,172.31.40.0-255,66,11959,77,289204
16398,0.0001,172.217.194.0-255,10537,22496,77,289204
16399,0.000103,172.31.40.0-255,66,22562,77,289204
16400,0.000117,172.217.194.0-255,5738,28300,77,289204
16401,0.000124,172.31.40.0-255,66,28366,77,289204
16402,0.00015,172.217.194.0-255,2543,30909,77,289204
16403,0.000153,172.31.40.0-255,66,30975,77,289204
16404,0.000181,172.217.194.0-255,8574,39549,77,289204
16405,0.000184,172.31.40.0-255,66,39615,77,289204
16406,0.000189,172.217.194.0-255,4320,43935,77,289204
16407,0.000191,172.31.40.0-255,66,44001,77,289204
16408,0.00022,172.217.194.0-255,5379,49380,77,289204
16409,0.000223,172.31.40.0-255,66,49446,77,289204
16410,0.00023,172.217.194.0-255,7156,56602,77,289204
16411,0.000233,172.31.40.0-255,66,56668,77,289204
16412,0.000265,172.217.194.0-255,8503,65171,77,289204
16413,0.000268,172.31.40.0-255,66,65237,77,289204
16414,0.000391,172.217.194.0-255,99,65336,77,289204
16415,0.000395,172.31.40.0-255,66,65402,77,289204
16416,0.000469,172.217.194.0-255,1484,66886,77,289204
16417,0.000472,172.31.40.0-255,66,66952,77,289204
16418,0.000478,172.217.194.0-255,2902,69854,77,289204
16419,0.00048,172.31.40.0-255,66,69920,77,289204
16420,0.000485,172.217.194.0-255,2902,72822,77,289204
16421,0.000491,172.31.40.0-255,66,72888,77,289204
16422,0.000503,172.217.194.0-255,2902,75790,77,289204
16423,0.000506,172.31.40.0-255,66,75856,77,289204
16424,0.000526,172.217.194.0-255,6797,82653,77,289204
16425,0.000529,172.31.40.0-255,66,82719,77,289204
16426,0.000533,172.217.194.0-255,2902,85621,77,289204
16427,0.000535,172.31.40.0-255,66,85687,77,289204
16428,0.000561,172.217.194.0-255,4320,90007,77,289204
16429,0.000567,172.31.40.0-255,66,90073,77,289204
16430,0.000591,172.217.194.0-255,9633,99706,77,289204
16431,0.000593,172.31.40.0-255,66,99772,77,289204
16432,0.000676,172.217.194.0-255,365,100137,77,289204
16433,0.000785,172.217.194.0-255,1484,101621,77,289204
16434,0.000789,172.31.40.0-255,66,101687,77,289204
16435,0.000794,172.217.194.0-255,2902,104589,77,289204
16436,0.000797,172.31.40.0-255,66,104655,77,289204
16437,0.000831,172.217.194.0-255,5738,110393,77,289204
16438,0.000834,172.31.40.0-255,66,110459,77,289204
16439,0.000841,172.217.194.0-255,7156,117615,77,289204
16440,0.000844,172.31.40.0-255,66,117681,77,289204
16441,0.000858,172.217.194.0-255,9992,127673,77,289204
16442,0.000861,172.31.40.0-255,66,127739,77,289204
16443,0.00089,172.217.194.0-255,4320,132059,77,289204
16444,0.000898,172.31.40.0-255,66,132125,77,289204
16445,0.000902,172.217.194.0-255,2184,134309,77,289204
16446,0.000905,172.31.40.0-255,66,134375,77,289204
16447,0.000909,172.217.194.0-255,2902,137277,77,289204
16448,0.000912,172.31.40.0-255,66,137343,77,289204
16449,0.00092,172.217.194.0-255,7156,144499,77,289204
16450,0.000922,172.31.40.0-255,66,144565,77,289204
16451,0.000967,172.217.194.0-255,8574,153139,77,289204
16452,0.00097,172.31.40.0-255,66,153205,77,289204
16453,0.001007,172.217.194.0-255,1484,154689,77,289204
16454,0.001019,172.217.194.0-255,13528,168217,77,289204
16455,0.001025,172.31.40.0-255,66,168283,77,289204
16456,0.001067,172.31.40.0-255,101,168384,77,289204
16457,0.001117,172.217.194.0-255,1484,169868,77,289204
16458,0.001123,172.217.194.0-255,2902,172770,77,289204
16459,0.001127,172.31.40.0-255,66,172836,77,289204
16460,0.001139,172.217.194.0-255,1484,174320,77,289204
16461,0.001157,172.217.194.0-255,4320,178640,77,289204
16462,0.00116,172.31.40.0-255,66,178706,77,289204
16463,0.001167,172.217.194.0-255,5738,184444,77,289204
16464,0.001169,172.31.40.0-255,66,184510,77,289204
16465,0.001206,172.217.194.0-255,7156,191666,77,289204
16466,0.001215,172.217.194.0-255,9992,201658,77,289204
16467,0.001218,172.217.194.0-255,766,202424,77,289204
16468,0.001242,172.31.40.0-255,66,202490,77,289204
16469,0.001505,172.217.194.0-255,1484,203974,77,289204
16470,0.001511,172.217.194.0-255,2902,206876,77,289204
16471,0.001514,172.31.40.0-255,66,206942,77,289204
16472,0.001518,172.217.194.0-255,1484,208426,77,289204
16473,0.001542,172.217.194.0-255,2902,211328,77,289204
16474,0.001544,172.31.40.0-255,66,211394,77,289204
16475,0.00155,172.217.194.0-255,5738,217132,77,289204
16476,0.001552,172.31.40.0-255,66,217198,77,289204
16477,0.00158,172.217.194.0-255,7156,224354,77,289204
16478,0.001582,172.31.40.0-255,66,224420,77,289204
16479,0.001611,172.217.194.0-255,5738,230158,77,289204
16480,0.001614,172.31.40.0-255,66,230224,77,289204
16481,0.001622,172.217.194.0-255,6438,236662,77,289204
16482,0.001631,172.31.40.0-255,66,236728,77,289204
16483,0.001766,172.217.194.0-255,1484,238212,77,289204
16484,0.001772,172.217.194.0-255,2902,241114,77,289204
16485,0.001776,172.31.40.0-255,66,241180,77,289204
16486,0.001804,172.217.194.0-255,5738,246918,77,289204
16487,0.001806,172.31.40.0-255,66,246984,77,289204
16488,0.001823,172.217.194.0-255,7156,254140,77,289204
16489,0.001826,172.31.40.0-255,66,254206,77,289204
16490,0.001845,172.217.194.0-255,5738,259944,77,289204
16491,0.001849,172.217.194.0-255,2902,262846,77,289204
16492,0.001864,172.31.40.0-255,66,262912,77,289204
16493,0.001926,172.217.194.0-255,9274,272186,77,289204
16494,0.001958,172.217.194.0-255,5738,277924,77,289204
16495,0.001962,172.31.40.0-255,66,277990,77,289204
16496,0.001997,172.217.194.0-255,1484,279474,77,289204
16497,0.002032,172.31.40.0-255,66,279540,77,289204
16498,0.002119,172.31.40.0-255,66,279606,77,289204
16499,0.002127,172.217.194.0-255,6438,286044,77,289204
16500,0.002129,172.217.194.0-255,1484,287528,77,289204
16501,0.002135,172.217.194.0-255,1268,288796,77,289204
16502,0.002137,172.217.194.0-255,105,288901,77,289204
16503,0.002145,172.31.40.0-255,66,288967,77,289204
16504,0.003304,172.217.194.0-255,66,289033,77,289204
16505,0.013265,172.31.40.0-255,105,289138,77,289204
16506,0.015516,172.217.194.0-255,66,289204,77,289204
16507,0.0,172.217.194.0-255,153,153,77,189926
16508,2.4e-05,172.31.40.0-255,66,219,77,189926
16509,3.1e-05,172.217.194.0-255,1484,1703,77,189926
16510,3.7e-05,172.31.40.0-255,66,1769,77,189926
16511,4.2e-05,172.217.194.0-255,2902,4671,77,189926
16512,4.7e-05,172.31.40.0-255,66,4737,77,189926
16513,5.4e-05,172.217.194.0-255,7156,11893,77,189926
16514,5.8e-05,172.31.40.0-255,66,11959,77,189926
16515,6.3e-05,172.217.194.0-255,1981,13940,77,189926
16516,6.5e-05,172.31.40.0-255,66,14006,77,189926
16517,0.000118,172.217.194.0-255,4320,18326,77,189926
16518,0.000121,172.31.40.0-255,66,18392,77,189926
16519,0.000137,172.217.194.0-255,4320,22712,77,189926
16520,0.000139,172.31.40.0-255,66,22778,77,189926
16521,0.000182,172.217.194.0-255,8215,30993,77,189926
16522,0.000185,172.31.40.0-255,66,31059,77,189926
16523,0.000266,172.217.194.0-255,1484,32543,77,189926
16524,0.00027,172.31.40.0-255,66,32609,77,189926
16525,0.000275,172.217.194.0-255,2902,35511,77,189926
16526,0.000277,172.31.40.0-255,66,35577,77,189926
16527,0.000281,172.217.194.0-255,1484,37061,77,189926
16528,0.000283,172.31.40.0-255,66,37127,77,189926
16529,0.000299,172.217.194.0-255,4320,41447,77,189926
16530,0.000301,172.31.40.0-255,66,41513,77,189926
16531,0.000315,172.217.194.0-255,1484,42997,77,189926
16532,0.000317,172.31.40.0-255,66,43063,77,189926
16533,0.000346,172.217.194.0-255,9633,52696,77,189926
16534,0.000348,172.31.40.0-255,66,52762,77,189926
16535,0.000359,172.217.194.0-255,11410,64172,77,189926
16536,0.000361,172.31.40.0-255,66,64238,77,189926
16537,0.000364,172.217.194.0-255,1125,65363,77,189926
16538,0.000366,172.31.40.0-255,66,65429,77,189926
16539,0.000641,172.217.194.0-255,645,66074,77,189926
16540,0.000799,172.217.194.0-255,1484,67558,77,189926
16541,0.000805,172.217.194.0-255,2902,70460,77,189926
16542,0.00082,172.217.194.0-255,2902,73362,77,189926
16543,0.000837,172.31.40.0-255,66,73428,77,189926
16544,0.000842,172.217.194.0-255,2902,76330,77,189926
16545,0.000846,172.217.194.0-255,2902,79232,77,189926
16546,0.000851,172.31.40.0-255,66,79298,77,189926
16547,0.000865,172.217.194.0-255,8574,87872,77,189926
16548,0.000877,172.217.194.0-255,1484,89356,77,189926
16549,0.000905,172.217.194.0-255,5738,95094,77,189926
16550,0.00092,172.217.194.0-255,5020,100114,77,189926
16551,0.000934,172.31.40.0-255,66,100180,77,189926
16552,0.0021,172.217.194.0-255,1484,101664,77,189926
16553,0.002111,172.217.194.0-255,2902,104566,77,189926
16554,0.002116,172.31.40.0-255,66,104632,77,189926
16555,0.002123,172.217.194.0-255,4320,108952,77,189926
16556,0.002135,172.217.194.0-255,1484,110436,77,189926
16557,0.002139,172.217.194.0-255,2902,113338,77,189926
16558,0.002165,172.217.194.0-255,9992,123330,77,189926
16559,0.002171,172.217.194.0-255,5738,129068,77,189926
16560,0.002184,172.217.194.0-255,2902,131970,77,189926
16561,0.002203,172.217.194.0-255,2184,134154,77,189926
16562,0.002557,172.217.194.0-255,1484,135638,77,189926
16563,0.002561,172.217.194.0-255,2902,138540,77,189926
16564,0.002564,172.217.194.0-255,1484,140024,77,189926
16565,0.002583,172.217.194.0-255,4320,144344,77,189926
16566,0.0026,172.217.194.0-255,5738,150082,77,189926
16567,0.002624,172.217.194.0-255,7156,157238,77,189926
16568,0.00263,172.217.194.0-255,5738,162976,77,189926
16569,0.002646,172.217.194.0-255,5020,167996,77,189926
16570,0.007375,172.31.40.0-255,66,168062,77,189926
16571,0.00999,172.217.194.0-255,4320,172382,77,189926
16572,0.009998,172.31.40.0-255,66,172448,77,189926
16573,0.010017,172.217.194.0-255,1484,173932,77,189926
16574,0.012605,172.217.194.0-255,4320,178252,77,189926
16575,0.012613,172.31.40.0-255,66,178318,77,189926
16576,0.015225,172.217.194.0-255,5738,184056,77,189926
16577,0.015285,172.31.40.0-255,66,184122,77,189926
16578,0.017904,172.217.194.0-255,5738,189860,77,189926
16579,0.017912,172.31.40.0-255,66,189926,77,189926
16580,0.0,74.125.130.0-255,298,298,77,140247
16581,2.3e-05,172.31.40.0-255,66,364,77,140247
16582,2.9e-05,74.125.130.0-255,1484,1848,77,140247
16583,3.3e-05,172.31.40.0-255,66,1914,77,140247
16584,3.9e-05,74.125.130.0-255,2902,4816,77,140247
16585,5e-05,172.31.40.0-255,66,4882,77,140247
16586,5.6e-05,74.125.130.0-255,4320,9202,77,140247
16587,5.9e-05,172.31.40.0-255,66,9268,77,140247
16588,9.4e-05,74.125.130.0-255,4671,13939,77,140247
16589,9.9e-05,172.31.40.0-255,66,14005,77,140247
16590,0.000319,74.125.130.0-255,1484,15489,77,140247
16591,0.000325,172.31.40.0-255,66,15555,77,140247
16592,0.000331,74.125.130.0-255,2902,18457,77,140247
16593,0.000333,172.31.40.0-255,66,18523,77,140247
16594,0.00034,74.125.130.0-255,5738,24261,77,140247
16595,0.000348,172.31.40.0-255,66,24327,77,140247
16596,0.00038,74.125.130.0-255,4320,28647,77,140247
16597,0.000383,172.31.40.0-255,66,28713,77,140247
16598,0.000412,74.125.130.0-255,2543,31256,77,140247
16599,0.000415,172.31.40.0-255,66,31322,77,140247
16600,0.000754,74.125.130.0-255,1484,32806,77,140247
16601,0.000758,172.31.40.0-255,66,32872,77,140247
16602,0.000764,74.125.130.0-255,2902,35774,77,140247
16603,0.000767,172.31.40.0-255,66,35840,77,140247
16604,0.000787,74.125.130.0-255,1484,37324,77,140247
16605,0.000789,172.31.40.0-255,66,37390,77,140247
16606,0.000822,74.125.130.0-255,4320,41710,77,140247
16607,0.000824,172.31.40.0-255,66,41776,77,140247
16608,0.000827,74.125.130.0-255,1484,43260,77,140247
16609,0.000829,172.31.40.0-255,66,43326,77,140247
16610,0.000835,74.125.130.0-255,4320,47646,77,140247
16611,0.000837,172.31.40.0-255,66,47712,77,140247
16612,0.000861,74.125.130.0-255,1125,48837,77,140247
16613,0.000921,74.125.130.0-255,1484,50321,77,140247
16614,0.000924,172.31.40.0-255,66,50387,77,140247
16615,0.00093,74.125.130.0-255,2902,53289,77,140247
16616,0.000932,172.31.40.0-255,66,53355,77,140247
16617,0.000935,74.125.130.0-255,1484,54839,77,140247
16618,0.000962,74.125.130.0-255,4320,59159,77,140247
16619,0.000965,172.31.40.0-255,66,59225,77,140247
16620,0.000995,74.125.130.0-255,6797,66022,77,140247
16621,0.000998,172.31.40.0-255,66,66088,77,140247
16622,0.001673,74.125.130.0-255,645,66733,77,140247
16623,0.001991,74.125.130.0-255,1484,68217,77,140247
16624,0.001998,172.31.40.0-255,66,68283,77,140247
16625,0.002006,74.125.130.0-255,2902,71185,77,140247
16626,0.002008,172.31.40.0-255,66,71251,77,140247
16627,0.00202,74.125.130.0-255,5738,76989,77,140247
16628,0.002022,172.31.40.0-255,66,77055,77,140247
16629,0.002062,74.125.130.0-255,12828,89883,77,140247
16630,0.002065,172.31.40.0-255,66,89949,77,140247
16631,0.002072,74.125.130.0-255,5738,95687,77,140247
16632,0.002073,172.31.40.0-255,66,95753,77,140247
16633,0.002095,74.125.130.0-255,2902,98655,77,140247
16634,0.002097,172.31.40.0-255,66,98721,77,140247
16635,0.002125,74.125.130.0-255,2184,100905,77,140247
16636,0.00213,172.31.40.0-255,66,100971,77,140247
16637,0.004428,74.125.130.0-255,4320,105291,77,140247
16638,0.004435,172.31.40.0-255,66,105357,77,140247
16639,0.004453,74.125.130.0-255,1484,106841,77,140247
16640,0.006762,74.125.130.0-255,4320,111161,77,140247
16641,0.006769,172.31.40.0-255,66,111227,77,140247
16642,0.009142,74.125.130.0-255,5738,116965,77,140247
16643,0.00915,172.31.40.0-255,66,117031,77,140247
16644,0.011495,74.125.130.0-255,5738,122769,77,140247
16645,0.011504,172.31.40.0-255,66,122835,77,140247
16646,0.013825,74.125.130.0-255,5738,128573,77,140247
16647,0.013832,172.31.40.0-255,66,128639,77,140247
16648,0.016173,74.125.130.0-255,5738,134377,77,140247
16649,0.016185,172.31.40.0-255,66,134443,77,140247
16650,0.018509,74.125.130.0-255,5738,140181,77,140247
16651,0.018522,172.31.40.0-255,66,140247,77,140247
16652,0.0,172.31.40.0-255,105,105,77,525
16653,0.000244,172.31.40.0-255,90,195,77,525
16654,0.000255,172.31.40.0-255,66,261,77,525
16655,0.002452,172.217.194.0-255,66,327,77,525
16656,0.002485,172.217.194.0-255,66,393,77,525
16657,0.0025,172.31.40.0-255,66,459,77,525
16658,0.002503,172.217.194.0-255,66,525,77,525
16659,0.0,172.217.194.0-255,156,156,77,339410
16660,2.2e-05,172.31.40.0-255,66,222,77,339410
16661,2.9e-05,172.217.194.0-255,1484,1706,77,339410
16662,3.3e-05,172.31.40.0-255,66,1772,77,339410
16663,3.8e-05,172.217.194.0-255,2902,4674,77,339410
16664,4.2e-05,172.31.40.0-255,66,4740,77,339410
16665,5.6e-05,172.217.194.0-255,7156,11896,77,339410
16666,5.9e-05,172.31.40.0-255,66,11962,77,339410
16667,6.3e-05,172.217.194.0-255,2037,13999,77,339410
16668,6.5e-05,172.31.40.0-255,66,14065,77,339410
16669,9.4e-05,172.217.194.0-255,1484,15549,77,339410
16670,9.6e-05,172.31.40.0-255,66,15615,77,339410
16671,0.000101,172.217.194.0-255,2902,18517,77,339410
16672,0.000103,172.31.40.0-255,66,18583,77,339410
16673,0.000124,172.217.194.0-255,5738,24321,77,339410
16674,0.000127,172.31.40.0-255,66,24387,77,339410
16675,0.000162,172.217.194.0-255,6797,31184,77,339410
16676,0.000164,172.31.40.0-255,66,31250,77,339410
16677,0.00017,172.217.194.0-255,7156,38406,77,339410
16678,0.000172,172.31.40.0-255,66,38472,77,339410
16679,0.000199,172.217.194.0-255,5738,44210,77,339410
16680,0.000201,172.31.40.0-255,66,44276,77,339410
16681,0.000219,172.217.194.0-255,3961,48237,77,339410
16682,0.000221,172.31.40.0-255,66,48303,77,339410
16683,0.000265,172.217.194.0-255,9992,58295,77,339410
16684,0.000267,172.31.40.0-255,66,58361,77,339410
16685,0.000274,172.217.194.0-255,6797,65158,77,339410
16686,0.000276,172.31.40.0-255,66,65224,77,339410
16687,0.000278,172.217.194.0-255,376,65600,77,339410
16688,0.00028,172.31.40.0-255,66,65666,77,339410
16689,0.000305,172.217.194.0-255,99,65765,77,339410
16690,0.000307,172.31.40.0-255,66,65831,77,339410
16691,0.000397,172.217.194.0-255,1484,67315,77,339410
16692,0.000404,172.217.194.0-255,2902,70217,77,339410
16693,0.000406,172.31.40.0-255,66,70283,77,339410
16694,0.000435,172.217.194.0-255,5738,76021,77,339410
16695,0.000438,172.31.40.0-255,66,76087,77,339410
16696,0.000443,172.217.194.0-255,4320,80407,77,339410
16697,0.000445,172.31.40.0-255,66,80473,77,339410
16698,0.00048,172.217.194.0-255,9633,90106,77,339410
16699,0.000483,172.31.40.0-255,66,90172,77,339410
16700,0.000491,172.217.194.0-255,9910,100082,77,339410
16701,0.000493,172.31.40.0-255,66,100148,77,339410
16702,0.001015,172.217.194.0-255,1484,101632,77,339410
16703,0.00102,172.217.194.0-255,1484,103116,77,339410
16704,0.001023,172.31.40.0-255,66,103182,77,339410
16705,0.001037,172.217.194.0-255,1484,104666,77,339410
16706,0.001047,172.217.194.0-255,5738,110404,77,339410
16707,0.001049,172.31.40.0-255,66,110470,77,339410
16708,0.001052,172.217.194.0-255,1484,111954,77,339410
16709,0.001072,172.217.194.0-255,11410,123364,77,339410
16710,0.001073,172.31.40.0-255,66,123430,77,339410
16711,0.001114,172.217.194.0-255,2902,126332,77,339410
16712,0.001116,172.31.40.0-255,66,126398,77,339410
16713,0.001148,172.217.194.0-255,7856,134254,77,339410
16714,0.001151,172.31.40.0-255,66,134320,77,339410
16715,0.001157,172.217.194.0-255,5738,140058,77,339410
16716,0.001159,172.31.40.0-255,66,140124,77,339410
16717,0.001191,172.217.194.0-255,5738,145862,77,339410
16718,0.001194,172.31.40.0-255,66,145928,77,339410
16719,0.001201,172.217.194.0-255,5738,151666,77,339410
16720,0.001203,172.31.40.0-255,66,151732,77,339410
16721,0.001239,172.217.194.0-255,12828,164560,77,339410
16722,0.001242,172.31.40.0-255,66,164626,77,339410
16723,0.001266,172.217.194.0-255,3602,168228,77,339410
16724,0.001268,172.31.40.0-255,66,168294,77,339410
16725,0.001737,172.217.194.0-255,1484,169778,77,339410
16726,0.001745,172.217.194.0-255,2902,172680,77,339410
16727,0.001749,172.31.40.0-255,66,172746,77,339410
16728,0.001757,172.217.194.0-255,5738,178484,77,339410
16729,0.001759,172.31.40.0-255,66,178550,77,339410
16730,0.001789,172.217.194.0-255,12828,191378,77,339410
16731,0.001796,172.31.40.0-255,66,191444,77,339410
16732,0.001806,172.217.194.0-255,9992,201436,77,339410
16733,0.001809,172.31.40.0-255,66,201502,77,339410
16734,0.001812,172.217.194.0-255,766,202268,77,339410
16735,0.002209,172.217.194.0-255,1484,203752,77,339410
16736,0.002216,172.31.40.0-255,66,203818,77,339410
16737,0.002223,172.217.194.0-255,2902,206720,77,339410
16738,0.002225,172.31.40.0-255,66,206786,77,339410
16739,0.002236,172.217.194.0-255,4320,211106,77,339410
16740,0.002239,172.31.40.0-255,66,211172,77,339410
16741,0.002274,172.217.194.0-255,1484,212656,77,339410
16742,0.00228,172.217.194.0-255,4320,216976,77,339410
16743,0.002282,172.31.40.0-255,66,217042,77,339410
16744,0.002289,172.217.194.0-255,5738,222780,77,339410
16745,0.002291,172.31.40.0-255,66,222846,77,339410
16746,0.002301,172.217.194.0-255,11410,234256,77,339410
16747,0.002304,172.31.40.0-255,66,234322,77,339410
16748,0.002308,172.217.194.0-255,2184,236506,77,339410
16749,0.002314,172.217.194.0-255,2902,239408,77,339410
16750,0.002352,172.31.40.0-255,66,239474,77,339410
16751,0.00236,172.31.40.0-255,66,239540,77,339410
16752,0.002366,172.217.194.0-255,7156,246696,77,339410
16753,0.002369,172.31.40.0-255,66,246762,77,339410
16754,0.002388,172.217.194.0-255,9992,256754,77,339410
16755,0.002391,172.31.40.0-255,66,256820,77,339410
16756,0.002404,172.217.194.0-255,4320,261140,77,339410
16757,0.002407,172.31.40.0-255,66,261206,77,339410
16758,0.002445,172.217.194.0-255,9274,270480,77,339410
16759,0.002448,172.31.40.0-255,66,270546,77,339410
16760,0.002451,172.217.194.0-255,1484,272030,77,339410
16761,0.002456,172.217.194.0-255,2902,274932,77,339410
16762,0.002459,172.31.40.0-255,66,274998,77,339410
16763,0.002495,172.217.194.0-255,5738,280736,77,339410
16764,0.002498,172.31.40.0-255,66,280802,77,339410
16765,0.002503,172.217.194.0-255,4320,285122,77,339410
16766,0.002505,172.31.40.0-255,66,285188,77,339410
16767,0.002534,172.217.194.0-255,8574,293762,77,339410
16768,0.002536,172.31.40.0-255,66,293828,77,339410
16769,0.002568,172.217.194.0-255,10692,304520,77,339410
16770,0.002571,172.31.40.0-255,66,304586,77,339410
16771,0.005133,172.217.194.0-255,5738,310324,77,339410
16772,0.005139,172.31.40.0-255,66,310390,77,339410
16773,0.007703,172.217.194.0-255,5738,316128,77,339410
16774,0.00771,172.31.40.0-255,66,316194,77,339410
16775,0.010277,172.217.194.0-255,5738,321932,77,339410
16776,0.010283,172.31.40.0-255,66,321998,77,339410
16777,0.012866,172.217.194.0-255,5738,327736,77,339410
16778,0.012883,172.31.40.0-255,66,327802,77,339410
16779,0.015467,172.217.194.0-255,5738,333540,77,339410
16780,0.015482,172.31.40.0-255,66,333606,77,339410
16781,0.018077,172.217.194.0-255,5738,339344,77,339410
16782,0.018086,172.31.40.0-255,66,339410,77,339410
16783,0.0,172.217.194.0-255,152,152,77,183981
16784,2.4e-05,172.31.40.0-255,66,218,77,183981
16785,3.2e-05,172.217.194.0-255,1484,1702,77,183981
16786,3.7e-05,172.31.40.0-255,66,1768,77,183981
16787,4.4e-05,172.217.194.0-255,2902,4670,77,183981
16788,4.7e-05,172.31.40.0-255,66,4736,77,183981
16789,5.5e-05,172.217.194.0-255,7156,11892,77,183981
16790,5.8e-05,172.31.40.0-255,66,11958,77,183981
16791,7.5e-05,172.31.40.0-255,66,12024,77,183981
16792,8e-05,172.217.194.0-255,2543,14567,77,183981
16793,8.3e-05,172.31.40.0-255,66,14633,77,183981
16794,0.000493,172.217.194.0-255,1484,16117,77,183981
16795,0.000499,172.31.40.0-255,66,16183,77,183981
16796,0.000505,172.217.194.0-255,2902,19085,77,183981
16797,0.000508,172.31.40.0-255,66,19151,77,183981
16798,0.000515,172.217.194.0-255,5738,24889,77,183981
16799,0.000517,172.31.40.0-255,66,24955,77,183981
16800,0.000523,172.217.194.0-255,4320,29275,77,183981
16801,0.000525,172.31.40.0-255,66,29341,77,183981
16802,0.00055,172.217.194.0-255,2543,31884,77,183981
16803,0.000554,172.31.40.0-255,66,31950,77,183981
16804,0.00061,172.217.194.0-255,1484,33434,77,183981
16805,0.000614,172.31.40.0-255,66,33500,77,183981
16806,0.000619,172.217.194.0-255,2902,36402,77,183981
16807,0.000621,172.31.40.0-255,66,36468,77,183981
16808,0.000651,172.217.194.0-255,5738,42206,77,183981
16809,0.000655,172.31.40.0-255,66,42272,77,183981
16810,0.000672,172.217.194.0-255,1484,43756,77,183981
16811,0.000675,172.31.40.0-255,66,43822,77,183981
16812,0.000699,172.217.194.0-255,5379,49201,77,183981
16813,0.000702,172.31.40.0-255,66,49267,77,183981
16814,0.0008,172.217.194.0-255,646,49913,77,183981
16815,0.000978,172.217.194.0-255,1484,51397,77,183981
16816,0.000983,172.31.40.0-255,66,51463,77,183981
16817,0.000987,172.217.194.0-255,1484,52947,77,183981
16818,0.001003,172.217.194.0-255,1484,54431,77,183981
16819,0.001005,172.31.40.0-255,66,54497,77,183981
16820,0.001014,172.217.194.0-255,5738,60235,77,183981
16821,0.001016,172.31.40.0-255,66,60301,77,183981
16822,0.001061,172.217.194.0-255,6797,67098,77,183981
16823,0.001064,172.31.40.0-255,66,67164,77,183981
16824,0.001102,172.217.194.0-255,5738,72902,77,183981
16825,0.001105,172.31.40.0-255,66,72968,77,183981
16826,0.001119,172.217.194.0-255,1484,74452,77,183981
16827,0.001122,172.217.194.0-255,1484,75936,77,183981
16828,0.001128,172.31.40.0-255,66,76002,77,183981
16829,0.00114,172.217.194.0-255,7156,83158,77,183981
16830,0.001142,172.31.40.0-255,66,83224,77,183981
16831,0.001146,172.217.194.0-255,1125,84349,77,183981
16832,0.001495,172.31.40.0-255,66,84415,77,183981
16833,0.00209,172.217.194.0-255,1484,85899,77,183981
16834,0.0021,172.217.194.0-255,2902,88801,77,183981
16835,0.002106,172.31.40.0-255,66,88867,77,183981
16836,0.002114,172.217.194.0-255,5738,94605,77,183981
16837,0.002116,172.31.40.0-255,66,94671,77,183981
16838,0.00212,172.217.194.0-255,1484,96155,77,183981
16839,0.002152,172.217.194.0-255,11410,107565,77,183981
16840,0.002154,172.31.40.0-255,66,107631,77,183981
16841,0.002157,172.217.194.0-255,1484,109115,77,183981
16842,0.00218,172.217.194.0-255,2902,112017,77,183981
16843,0.002182,172.31.40.0-255,66,112083,77,183981
16844,0.002205,172.217.194.0-255,6438,118521,77,183981
16845,0.002207,172.31.40.0-255,66,118587,77,183981
16846,0.002261,172.217.194.0-255,1484,120071,77,183981
16847,0.002266,172.217.194.0-255,2902,122973,77,183981
16848,0.002269,172.31.40.0-255,66,123039,77,183981
16849,0.002306,172.217.194.0-255,4320,127359,77,183981
16850,0.002308,172.31.40.0-255,66,127425,77,183981
16851,0.002332,172.217.194.0-255,1484,128909,77,183981
16852,0.002342,172.217.194.0-255,9992,138901,77,183981
16853,0.002344,172.31.40.0-255,66,138967,77,183981
16854,0.002349,172.217.194.0-255,4320,143287,77,183981
16855,0.002353,172.31.40.0-255,66,143353,77,183981
16856,0.004654,172.217.194.0-255,5738,149091,77,183981
16857,0.004668,172.31.40.0-255,66,149157,77,183981
16858,0.006974,172.217.194.0-255,5738,154895,77,183981
16859,0.00698,172.31.40.0-255,66,154961,77,183981
16860,0.009265,172.217.194.0-255,5738,160699,77,183981
16861,0.009272,172.31.40.0-255,66,160765,77,183981
16862,0.011577,172.217.194.0-255,5738,166503,77,183981
16863,0.011585,172.31.40.0-255,66,166569,77,183981
16864,0.013894,172.217.194.0-255,5738,172307,77,183981
16865,0.013902,172.31.40.0-255,66,172373,77,183981
16866,0.01621,172.217.194.0-255,5738,178111,77,183981
16867,0.016218,172.31.40.0-255,66,178177,77,183981
16868,0.018532,172.217.194.0-255,5738,183915,77,183981
16869,0.018541,172.31.40.0-255,66,183981,77,183981
16870,0.0,172.217.194.0-255,150,150,77,342088
16871,2.3e-05,172.31.40.0-255,66,216,77,342088
16872,3e-05,172.217.194.0-255,1484,1700,77,342088
16873,3.4e-05,172.31.40.0-255,66,1766,77,342088
16874,3.9e-05,172.217.194.0-255,2902,4668,77,342088
16875,4.4e-05,172.31.40.0-255,66,4734,77,342088
16876,5.1e-05,172.217.194.0-255,7156,11890,77,342088
16877,5.4e-05,172.31.40.0-255,66,11956,77,342088
16878,6.2e-05,172.217.194.0-255,7656,19612,77,342088
16879,6.6e-05,172.31.40.0-255,66,19678,77,342088
16880,9.4e-05,172.217.194.0-255,7156,26834,77,342088
16881,9.7e-05,172.31.40.0-255,66,26900,77,342088
16882,0.000113,172.217.194.0-255,3961,30861,77,342088
16883,0.000116,172.31.40.0-255,66,30927,77,342088
16884,0.00015,172.217.194.0-255,1484,32411,77,342088
16885,0.000152,172.31.40.0-255,66,32477,77,342088
16886,0.000157,172.217.194.0-255,2902,35379,77,342088
16887,0.000159,172.31.40.0-255,66,35445,77,342088
16888,0.000166,172.217.194.0-255,5738,41183,77,342088
16889,0.000168,172.31.40.0-255,66,41249,77,342088
16890,0.000206,172.217.194.0-255,9633,50882,77,342088
16891,0.000209,172.31.40.0-255,66,50948,77,342088
16892,0.000218,172.217.194.0-255,9992,60940,77,342088
16893,0.000221,172.31.40.0-255,66,61006,77,342088
16894,0.000248,172.217.194.0-255,4252,65258,77,342088
16895,0.00025,172.217.194.0-255,98,65356,77,342088
16896,0.000254,172.31.40.0-255,66,65422,77,342088
16897,0.000261,172.31.40.0-255,66,65488,77,342088
16898,0.000285,172.217.194.0-255,365,65853,77,342088
16899,0.000287,172.31.40.0-255,66,65919,77,342088
16900,0.000553,172.217.194.0-255,1484,67403,77,342088
16901,0.000559,172.31.40.0-255,66,67469,77,342088
16902,0.000566,172.217.194.0-255,2902,70371,77,342088
16903,0.000569,172.31.40.0-255,66,70437,77,342088
16904,0.000575,172.217.194.0-255,5738,76175,77,342088
16905,0.000578,172.31.40.0-255,66,76241,77,342088
16906,0.000594,172.217.194.0-255,1484,77725,77,342088
16907,0.000628,172.217.194.0-255,11410,89135,77,342088
16908,0.000632,172.31.40.0-255,66,89201,77,342088
16909,0.000654,172.217.194.0-255,10692,99893,77,342088
16910,0.000657,172.31.40.0-255,66,99959,77,342088
16911,0.000885,172.217.194.0-255,1484,101443,77,342088
16912,0.000892,172.217.194.0-255,2902,104345,77,342088
16913,0.000895,172.31.40.0-255,66,104411,77,342088
16914,0.000899,172.217.194.0-255,1484,105895,77,342088
16915,0.000918,172.217.194.0-255,4320,110215,77,342088
16916,0.000921,172.31.40.0-255,66,110281,77,342088
16917,0.000926,172.217.194.0-255,2902,113183,77,342088
16918,0.000928,172.31.40.0-255,66,113249,77,342088
16919,0.000954,172.217.194.0-255,9992,123241,77,342088
16920,0.000957,172.31.40.0-255,66,123307,77,342088
16921,0.000966,172.217.194.0-255,10692,133999,77,342088
16922,0.000969,172.31.40.0-255,66,134065,77,342088
16923,0.001034,172.217.194.0-255,1484,135549,77,342088
16924,0.001039,172.217.194.0-255,2902,138451,77,342088
16925,0.001041,172.31.40.0-255,66,138517,77,342088
16926,0.001046,172.217.194.0-255,2902,141419,77,342088
16927,0.001048,172.31.40.0-255,66,141485,77,342088
16928,0.001066,172.217.194.0-255,2902,144387,77,342088
16929,0.001072,172.217.194.0-255,5738,150125,77,342088
16930,0.001076,172.31.40.0-255,66,150191,77,342088
16931,0.001079,172.31.40.0-255,66,150257,77,342088
16932,0.0011,172.217.194.0-255,7156,157413,77,342088
16933,0.001102,172.31.40.0-255,66,157479,77,342088
16934,0.001114,172.217.194.0-255,10692,168171,77,342088
16935,0.001117,172.31.40.0-255,66,168237,77,342088
16936,0.001178,172.217.194.0-255,11410,179647,77,342088
16937,0.001181,172.31.40.0-255,66,179713,77,342088
16938,0.001188,172.217.194.0-255,7156,186869,77,342088
16939,0.00119,172.31.40.0-255,66,186935,77,342088
16940,0.001207,172.217.194.0-255,4320,191255,77,342088
16941,0.00121,172.31.40.0-255,66,191321,77,342088
16942,0.001246,172.217.194.0-255,10692,202013,77,342088
16943,0.001249,172.31.40.0-255,66,202079,77,342088
16944,0.001286,172.217.194.0-255,1484,203563,77,342088
16945,0.00129,172.217.194.0-255,1484,205047,77,342088
16946,0.001293,172.31.40.0-255,66,205113,77,342088
16947,0.001303,172.217.194.0-255,1484,206597,77,342088
16948,0.001311,172.217.194.0-255,5738,212335,77,342088
16949,0.001314,172.31.40.0-255,66,212401,77,342088
16950,0.001332,172.217.194.0-255,2902,215303,77,342088
16951,0.001335,172.31.40.0-255,66,215369,77,342088
16952,0.001368,172.217.194.0-255,9992,225361,77,342088
16953,0.001371,172.31.40.0-255,66,225427,77,342088
16954,0.001382,172.217.194.0-255,10692,236119,77,342088
16955,0.001384,172.31.40.0-255,66,236185,77,342088
16956,0.001471,172.217.194.0-255,1484,237669,77,342088
16957,0.001476,172.217.194.0-255,2902,240571,77,342088
16958,0.001481,172.31.40.0-255,66,240637,77,342088
16959,0.001502,172.217.194.0-255,5738,246375,77,342088
16960,0.001505,172.31.40.0-255,66,246441,77,342088
16961,0.001512,172.217.194.0-255,5738,252179,77,342088
16962,0.001514,172.31.40.0-255,66,252245,77,342088
16963,0.001526,172.217.194.0-255,5738,257983,77,342088
16964,0.001529,172.31.40.0-255,66,258049,77,342088
16965,0.00155,172.217.194.0-255,1484,259533,77,342088
16966,0.001556,172.217.194.0-255,4320,263853,77,342088
16967,0.001559,172.31.40.0-255,66,263919,77,342088
16968,0.001581,172.217.194.0-255,6438,270357,77,342088
16969,0.001584,172.31.40.0-255,66,270423,77,342088
16970,0.001612,172.217.194.0-255,1484,271907,77,342088
16971,0.001626,172.217.194.0-255,2902,274809,77,342088
16972,0.001629,172.31.40.0-255,66,274875,77,342088
16973,0.001654,172.217.194.0-255,5738,280613,77,342088
16974,0.001657,172.31.40.0-255,66,280679,77,342088
16975,0.001683,172.217.194.0-255,9992,290671,77,342088
16976,0.001686,172.31.40.0-255,66,290737,77,342088
16977,0.001694,172.217.194.0-255,7156,297893,77,342088
16978,0.001696,172.31.40.0-255,66,297959,77,342088
16979,0.001711,172.217.194.0-255,4320,302279,77,342088
16980,0.001713,172.31.40.0-255,66,302345,77,342088
16981,0.001721,172.217.194.0-255,7856,310201,77,342088
16982,0.001724,172.31.40.0-255,66,310267,77,342088
16983,0.001728,172.217.194.0-255,2902,313169,77,342088
16984,0.001731,172.31.40.0-255,66,313235,77,342088
16985,0.001748,172.217.194.0-255,5738,318973,77,342088
16986,0.001751,172.31.40.0-255,66,319039,77,342088
16987,0.001756,172.217.194.0-255,2902,321941,77,342088
16988,0.001758,172.31.40.0-255,66,322007,77,342088
16989,0.001795,172.31.40.0-255,66,322073,77,342088
16990,0.001803,172.217.194.0-255,7856,329929,77,342088
16991,0.001806,172.31.40.0-255,66,329995,77,342088
16992,0.001879,172.31.40.0-255,66,330061,77,342088
16993,0.001908,172.217.194.0-255,10692,340753,77,342088
16994,0.001912,172.31.40.0-255,66,340819,77,342088
16995,0.001928,172.31.40.0-255,66,340885,77,342088
16996,0.001948,172.31.40.0-255,66,340951,77,342088
16997,0.00195,172.217.194.0-255,105,341056,77,342088
16998,0.001953,172.217.194.0-255,129,341185,77,342088
16999,0.010413,172.31.40.0-255,105,341290,77,342088
17000,0.010454,172.31.40.0-255,105,341395,77,342088
17001,0.010673,172.31.40.0-255,90,341485,77,342088
17002,0.010683,172.31.40.0-255,66,341551,77,342088
17003,0.011274,172.217.194.0-255,129,341680,77,342088
17004,0.011284,172.31.40.0-255,78,341758,77,342088
17005,0.012429,172.217.194.0-255,66,341824,77,342088
17006,0.012451,172.217.194.0-255,66,341890,77,342088
17007,0.012668,172.217.194.0-255,66,341956,77,342088
17008,0.012687,172.217.194.0-255,66,342022,77,342088
17009,0.012694,172.31.40.0-255,66,342088,77,342088
17010,0.0,172.217.194.0-255,150,150,77,209574
17011,1.8e-05,172.31.40.0-255,66,216,77,209574
17012,2.5e-05,172.217.194.0-255,1484,1700,77,209574
17013,3e-05,172.31.40.0-255,66,1766,77,209574
17014,3.6e-05,172.217.194.0-255,2902,4668,77,209574
17015,4.8e-05,172.31.40.0-255,66,4734,77,209574
17016,5.2e-05,172.217.194.0-255,2902,7636,77,209574
17017,5.5e-05,172.31.40.0-255,66,7702,77,209574
17018,9.6e-05,172.217.194.0-255,6363,14065,77,209574
17019,0.0001,172.31.40.0-255,66,14131,77,209574
17020,0.000239,172.217.194.0-255,1484,15615,77,209574
17021,0.000244,172.31.40.0-255,66,15681,77,209574
17022,0.000274,172.217.194.0-255,2902,18583,77,209574
17023,0.000277,172.31.40.0-255,66,18649,77,209574
17024,0.000283,172.217.194.0-255,5738,24387,77,209574
17025,0.000286,172.31.40.0-255,66,24453,77,209574
17026,0.000297,172.217.194.0-255,5738,30191,77,209574
17027,0.0003,172.31.40.0-255,66,30257,77,209574
17028,0.000323,172.217.194.0-255,1125,31382,77,209574
17029,0.000325,172.31.40.0-255,66,31448,77,209574
17030,0.000472,172.217.194.0-255,1484,32932,77,209574
17031,0.000477,172.31.40.0-255,66,32998,77,209574
17032,0.000483,172.217.194.0-255,2902,35900,77,209574
17033,0.000486,172.31.40.0-255,66,35966,77,209574
17034,0.000506,172.217.194.0-255,1484,37450,77,209574
17035,0.000508,172.31.40.0-255,66,37516,77,209574
17036,0.000539,172.217.194.0-255,4320,41836,77,209574
17037,0.000542,172.31.40.0-255,66,41902,77,209574
17038,0.000549,172.217.194.0-255,5738,47640,77,209574
17039,0.000552,172.31.40.0-255,66,47706,77,209574
17040,0.000583,172.217.194.0-255,8215,55921,77,209574
17041,0.000586,172.31.40.0-255,66,55987,77,209574
17042,0.000589,172.217.194.0-255,1484,57471,77,209574
17043,0.00062,172.217.194.0-255,8215,65686,77,209574
17044,0.000623,172.31.40.0-255,66,65752,77,209574
17045,0.001016,172.217.194.0-255,382,66134,77,209574
17046,0.001037,172.217.194.0-255,362,66496,77,209574
17047,0.001143,172.31.40.0-255,66,66562,77,209574
17048,0.001522,172.217.194.0-255,1484,68046,77,209574
17049,0.001537,172.217.194.0-255,2902,70948,77,209574
17050,0.001542,172.31.40.0-255,66,71014,77,209574
17051,0.001551,172.217.194.0-255,5738,76752,77,209574
17052,0.001553,172.31.40.0-255,66,76818,77,209574
17053,0.001564,172.217.194.0-255,4320,81138,77,209574
17054,0.001566,172.31.40.0-255,66,81204,77,209574
17055,0.001593,172.217.194.0-255,1484,82688,77,209574
17056,0.001607,172.217.194.0-255,9992,92680,77,209574
17057,0.00161,172.31.40.0-255,66,92746,77,209574
17058,0.001641,172.217.194.0-255,7156,99902,77,209574
17059,0.001644,172.31.40.0-255,66,99968,77,209574
17060,0.001647,172.217.194.0-255,766,100734,77,209574
17061,0.001794,172.217.194.0-255,1484,102218,77,209574
17062,0.0018,172.31.40.0-255,66,102284,77,209574
17063,0.001806,172.217.194.0-255,2902,105186,77,209574
17064,0.001808,172.31.40.0-255,66,105252,77,209574
17065,0.001815,172.217.194.0-255,5738,110990,77,209574
17066,0.001822,172.31.40.0-255,66,111056,77,209574
17067,0.001863,172.217.194.0-255,12828,123884,77,209574
17068,0.001865,172.31.40.0-255,66,123950,77,209574
17069,0.001902,172.217.194.0-255,10692,134642,77,209574
17070,0.001904,172.31.40.0-255,66,134708,77,209574
17071,0.001983,172.217.194.0-255,1484,136192,77,209574
17072,0.00199,172.217.194.0-255,2902,139094,77,209574
17073,0.001994,172.31.40.0-255,66,139160,77,209574
17074,0.002002,172.217.194.0-255,5738,144898,77,209574
17075,0.002005,172.31.40.0-255,66,144964,77,209574
17076,0.002034,172.217.194.0-255,5738,150702,77,209574
17077,0.002037,172.31.40.0-255,66,150768,77,209574
17078,0.00207,172.217.194.0-255,7156,157924,77,209574
17079,0.002073,172.31.40.0-255,66,157990,77,209574
17080,0.002076,172.217.194.0-255,1484,159474,77,209574
17081,0.002086,172.217.194.0-255,9274,168748,77,209574
17082,0.002093,172.31.40.0-255,66,168814,77,209574
17083,0.004557,172.217.194.0-255,2902,171716,77,209574
17084,0.004561,172.31.40.0-255,66,171782,77,209574
17085,0.004579,172.217.194.0-255,2902,174684,77,209574
17086,0.004582,172.31.40.0-255,66,174750,77,209574
17087,0.007025,172.217.194.0-255,5738,180488,77,209574
17088,0.007034,172.31.40.0-255,66,180554,77,209574
17089,0.009501,172.217.194.0-255,5738,186292,77,209574
17090,0.009508,172.31.40.0-255,66,186358,77,209574
17091,0.011981,172.217.194.0-255,5738,192096,77,209574
17092,0.01199,172.31.40.0-255,66,192162,77,209574
17093,0.014465,172.217.194.0-255,5738,197900,77,209574
17094,0.014475,172.31.40.0-255,66,197966,77,209574
17095,0.016928,172.217.194.0-255,5738,203704,77,209574
17096,0.016943,172.31.40.0-255,66,203770,77,209574
17097,0.019412,172.217.194.0-255,5738,209508,77,209574
17098,0.01942,172.31.40.0-255,66,209574,77,209574
17099,0.0,172.31.40.0-255,105,105,77,459
17100,0.000222,172.31.40.0-255,90,195,77,459
17101,0.000231,172.31.40.0-255,66,261,77,459
17102,0.002491,172.217.194.0-255,66,327,77,459
17103,0.002518,172.217.194.0-255,66,393,77,459
17104,0.00254,172.31.40.0-255,66,459,77,459
17105,0.0,172.217.194.0-255,153,153,77,343028
17106,2.3e-05,172.31.40.0-255,66,219,77,343028
17107,3.1e-05,172.217.194.0-255,1484,1703,77,343028
17108,3.5e-05,172.31.40.0-255,66,1769,77,343028
17109,4e-05,172.217.194.0-255,2902,4671,77,343028
17110,5.2e-05,172.31.40.0-255,66,4737,77,343028
17111,6e-05,172.217.194.0-255,7156,11893,77,343028
17112,6.4e-05,172.31.40.0-255,66,11959,77,343028
17113,6.8e-05,172.217.194.0-255,2040,13999,77,343028
17114,7e-05,172.31.40.0-255,66,14065,77,343028
17115,0.000113,172.217.194.0-255,1484,15549,77,343028
17116,0.000116,172.31.40.0-255,66,15615,77,343028
17117,0.000142,172.217.194.0-255,2902,18517,77,343028
17118,0.000145,172.31.40.0-255,66,18583,77,343028
17119,0.00015,172.217.194.0-255,4320,22903,77,343028
17120,0.000153,172.31.40.0-255,66,22969,77,343028
17121,0.000156,172.217.194.0-255,1484,24453,77,343028
17122,0.000158,172.31.40.0-255,66,24519,77,343028
17123,0.000196,172.217.194.0-255,4320,28839,77,343028
17124,0.000199,172.31.40.0-255,66,28905,77,343028
17125,0.000204,172.217.194.0-255,2543,31448,77,343028
17126,0.000206,172.31.40.0-255,66,31514,77,343028
17127,0.00021,172.217.194.0-255,2902,34416,77,343028
17128,0.000212,172.31.40.0-255,66,34482,77,343028
17129,0.000216,172.217.194.0-255,2902,37384,77,343028
17130,0.000218,172.31.40.0-255,66,37450,77,343028
17131,0.000248,172.217.194.0-255,4320,41770,77,343028
17132,0.000251,172.31.40.0-255,66,41836,77,343028
17133,0.000258,172.217.194.0-255,6797,48633,77,343028
17134,0.000261,172.31.40.0-255,66,48699,77,343028
17135,0.0003,172.217.194.0-255,1484,50183,77,343028
17136,0.000303,172.31.40.0-255,66,50249,77,343028
17137,0.000308,172.217.194.0-255,2902,53151,77,343028
17138,0.000315,172.217.194.0-255,5738,58889,77,343028
17139,0.000347,172.217.194.0-255,5738,64627,77,343028
17140,0.000349,172.31.40.0-255,66,64693,77,343028
17141,0.000355,172.31.40.0-255,66,64759,77,343028
17142,0.000375,172.217.194.0-255,1125,65884,77,343028
17143,0.000378,172.217.194.0-255,365,66249,77,343028
17144,0.000451,172.217.194.0-255,379,66628,77,343028
17145,0.000803,172.217.194.0-255,1484,68112,77,343028
17146,0.00081,172.217.194.0-255,2902,71014,77,343028
17147,0.000817,172.217.194.0-255,5738,76752,77,343028
17148,0.00082,172.217.194.0-255,1484,78236,77,343028
17149,0.000846,172.217.194.0-255,8574,86810,77,343028
17150,0.000882,172.217.194.0-255,5738,92548,77,343028
17151,0.000907,172.217.194.0-255,7856,100404,77,343028
17152,0.001525,172.217.194.0-255,1484,101888,77,343028
17153,0.001532,172.217.194.0-255,2902,104790,77,343028
17154,0.001536,172.217.194.0-255,2902,107692,77,343028
17155,0.001552,172.217.194.0-255,2902,110594,77,343028
17156,0.001584,172.217.194.0-255,12828,123422,77,343028
17157,0.001593,172.217.194.0-255,8574,131996,77,343028
17158,0.001608,172.217.194.0-255,2184,134180,77,343028
17159,0.001646,172.217.194.0-255,7156,141336,77,343028
17160,0.001663,172.217.194.0-255,2902,144238,77,343028
17161,0.00168,172.217.194.0-255,5738,149976,77,343028
17162,0.001723,172.217.194.0-255,4320,154296,77,343028
17163,0.001748,172.217.194.0-255,7156,161452,77,343028
17164,0.001778,172.217.194.0-255,12828,174280,77,343028
17165,0.001789,172.217.194.0-255,1484,175764,77,343028
17166,0.001812,172.217.194.0-255,3602,179366,77,343028
17167,0.001818,172.217.194.0-255,5738,185104,77,343028
17168,0.001847,172.217.194.0-255,12828,197932,77,343028
17169,0.001855,172.217.194.0-255,5738,203670,77,343028
17170,0.001874,172.217.194.0-255,5738,209408,77,343028
17171,0.001904,172.217.194.0-255,5020,214428,77,343028
17172,0.001911,172.217.194.0-255,5738,220166,77,343028
17173,0.001926,172.217.194.0-255,1484,221650,77,343028
17174,0.001948,172.217.194.0-255,11410,233060,77,343028
17175,0.001958,172.217.194.0-255,9992,243052,77,343028
17176,0.001967,172.217.194.0-255,1484,244536,77,343028
17177,0.002009,172.217.194.0-255,5738,250274,77,343028
17178,0.00203,172.217.194.0-255,2184,252458,77,343028
17179,0.002038,172.217.194.0-255,8574,261032,77,343028
17180,0.002056,172.217.194.0-255,4320,265352,77,343028
17181,0.002087,172.217.194.0-255,9992,275344,77,343028
17182,0.002104,172.217.194.0-255,5020,280364,77,343028
17183,0.00214,172.217.194.0-255,2902,283266,77,343028
17184,0.002155,172.217.194.0-255,2902,286168,77,343028
17185,0.00216,172.217.194.0-255,4320,290488,77,343028
17186,0.002197,172.217.194.0-255,11410,301898,77,343028
17187,0.002229,172.217.194.0-255,12110,314008,77,343028
17188,0.005113,172.31.40.0-255,66,314074,77,343028
17189,0.007377,172.217.194.0-255,5738,319812,77,343028
17190,0.007388,172.31.40.0-255,66,319878,77,343028
17191,0.009621,172.217.194.0-255,5738,325616,77,343028
17192,0.009629,172.31.40.0-255,66,325682,77,343028
17193,0.011869,172.217.194.0-255,5738,331420,77,343028
17194,0.012267,172.31.40.0-255,66,331486,77,343028
17195,0.014516,172.217.194.0-255,5738,337224,77,343028
17196,0.014532,172.31.40.0-255,66,337290,77,343028
17197,0.016759,172.217.194.0-255,5738,343028,77,343028
17198,0.0,172.217.194.0-255,153,153,77,346543
17199,2.3e-05,172.31.40.0-255,66,219,77,346543
17200,3.1e-05,172.217.194.0-255,1484,1703,77,346543
17201,3.6e-05,172.31.40.0-255,66,1769,77,346543
17202,4.2e-05,172.217.194.0-255,2902,4671,77,346543
17203,5.3e-05,172.31.40.0-255,66,4737,77,346543
17204,6.2e-05,172.217.194.0-255,7156,11893,77,346543
17205,6.5e-05,172.31.40.0-255,66,11959,77,346543
17206,8.2e-05,172.31.40.0-255,66,12025,77,346543
17207,8.6e-05,172.217.194.0-255,2543,14568,77,346543
17208,9e-05,172.31.40.0-255,66,14634,77,346543
17209,0.000177,172.217.194.0-255,1484,16118,77,346543
17210,0.000181,172.31.40.0-255,66,16184,77,346543
17211,0.000185,172.217.194.0-255,1484,17668,77,346543
17212,0.000187,172.31.40.0-255,66,17734,77,346543
17213,0.000232,172.217.194.0-255,1484,19218,77,346543
17214,0.000235,172.31.40.0-255,66,19284,77,346543
17215,0.000242,172.217.194.0-255,5738,25022,77,346543
17216,0.000244,172.31.40.0-255,66,25088,77,346543
17217,0.000251,172.217.194.0-255,6797,31885,77,346543
17218,0.000253,172.31.40.0-255,66,31951,77,346543
17219,0.000268,172.31.40.0-255,66,32017,77,346543
17220,0.000272,172.217.194.0-255,2543,34560,77,346543
17221,0.000274,172.31.40.0-255,66,34626,77,346543
17222,0.000364,172.217.194.0-255,647,35273,77,346543
17223,0.000368,172.31.40.0-255,66,35339,77,346543
17224,0.000507,172.217.194.0-255,1484,36823,77,346543
17225,0.000513,172.31.40.0-255,66,36889,77,346543
17226,0.000544,172.217.194.0-255,2902,39791,77,346543
17227,0.000547,172.31.40.0-255,66,39857,77,346543
17228,0.000585,172.217.194.0-255,5738,45595,77,346543
17229,0.000589,172.31.40.0-255,66,45661,77,346543
17230,0.000592,172.217.194.0-255,1484,47145,77,346543
17231,0.000602,172.217.194.0-255,8574,55719,77,346543
17232,0.000609,172.31.40.0-255,66,55785,77,346543
17233,0.00062,172.217.194.0-255,11410,67195,77,346543
17234,0.000623,172.31.40.0-255,66,67261,77,346543
17235,0.00065,172.217.194.0-255,2184,69445,77,346543
17236,0.000653,172.31.40.0-255,66,69511,77,346543
17237,0.000678,172.217.194.0-255,1484,70995,77,346543
17238,0.000698,172.217.194.0-255,1484,72479,77,346543
17239,0.0007,172.31.40.0-255,66,72545,77,346543
17240,0.000706,172.217.194.0-255,4320,76865,77,346543
17241,0.000708,172.31.40.0-255,66,76931,77,346543
17242,0.000711,172.217.194.0-255,1484,78415,77,346543
17243,0.000746,172.217.194.0-255,7156,85571,77,346543
17244,0.000749,172.31.40.0-255,66,85637,77,346543
17245,0.000754,172.217.194.0-255,2902,88539,77,346543
17246,0.000756,172.31.40.0-255,66,88605,77,346543
17247,0.000786,172.217.194.0-255,9992,98597,77,346543
17248,0.000789,172.31.40.0-255,66,98663,77,346543
17249,0.000793,172.217.194.0-255,1484,100147,77,346543
17250,0.000819,172.217.194.0-255,3602,103749,77,346543
17251,0.000822,172.31.40.0-255,66,103815,77,346543
17252,0.000852,172.217.194.0-255,1484,105299,77,346543
17253,0.000872,172.217.194.0-255,2902,108201,77,346543
17254,0.000875,172.31.40.0-255,66,108267,77,346543
17255,0.000908,172.217.194.0-255,5738,114005,77,346543
17256,0.000911,172.31.40.0-255,66,114071,77,346543
17257,0.000937,172.217.194.0-255,4320,118391,77,346543
17258,0.00094,172.31.40.0-255,66,118457,77,346543
17259,0.000949,172.217.194.0-255,11410,129867,77,346543
17260,0.000951,172.31.40.0-255,66,129933,77,346543
17261,0.000954,172.217.194.0-255,1484,131417,77,346543
17262,0.000991,172.217.194.0-255,6438,137855,77,346543
17263,0.000993,172.31.40.0-255,66,137921,77,346543
17264,0.001001,172.217.194.0-255,8574,146495,77,346543
17265,0.001003,172.31.40.0-255,66,146561,77,346543
17266,0.00101,172.217.194.0-255,7156,153717,77,346543
17267,0.001013,172.31.40.0-255,66,153783,77,346543
17268,0.001043,172.217.194.0-255,9992,163775,77,346543
17269,0.001045,172.31.40.0-255,66,163841,77,346543
17270,0.001049,172.217.194.0-255,2902,166743,77,346543
17271,0.00108,172.217.194.0-255,5020,171763,77,346543
17272,0.001099,172.217.194.0-255,1484,173247,77,346543
17273,0.001111,172.217.194.0-255,2902,176149,77,346543
17274,0.001126,172.217.194.0-255,5738,181887,77,346543
17275,0.001146,172.217.194.0-255,5738,187625,77,346543
17276,0.001169,172.217.194.0-255,7156,194781,77,346543
17277,0.001177,172.217.194.0-255,9992,204773,77,346543
17278,0.001207,172.217.194.0-255,2902,207675,77,346543
17279,0.001301,172.217.194.0-255,5020,212695,77,346543
17280,0.001309,172.217.194.0-255,9274,221969,77,346543
17281,0.001577,172.217.194.0-255,1484,223453,77,346543
17282,0.001583,172.217.194.0-255,2902,226355,77,346543
17283,0.001605,172.217.194.0-255,5738,232093,77,346543
17284,0.00162,172.217.194.0-255,2902,234995,77,346543
17285,0.001635,172.217.194.0-255,1484,236479,77,346543
17286,0.001641,172.217.194.0-255,5738,242217,77,346543
17287,0.001643,172.217.194.0-255,1484,243701,77,346543
17288,0.001659,172.217.194.0-255,8574,252275,77,346543
17289,0.001668,172.217.194.0-255,1484,253759,77,346543
17290,0.001672,172.217.194.0-255,2184,255943,77,346543
17291,0.001804,172.217.194.0-255,1484,257427,77,346543
17292,0.001809,172.217.194.0-255,2902,260329,77,346543
17293,0.001812,172.217.194.0-255,1484,261813,77,346543
17294,0.001835,172.217.194.0-255,4320,266133,77,346543
17295,0.00184,172.217.194.0-255,5738,271871,77,346543
17296,0.001865,172.217.194.0-255,8574,280445,77,346543
17297,0.001898,172.217.194.0-255,4320,284765,77,346543
17298,0.001903,172.217.194.0-255,5020,289785,77,346543
17299,0.001935,172.217.194.0-255,2902,292687,77,346543
17300,0.001948,172.217.194.0-255,1484,294171,77,346543
17301,0.001962,172.217.194.0-255,2902,297073,77,346543
17302,0.001966,172.217.194.0-255,2902,299975,77,346543
17303,0.002018,172.217.194.0-255,5738,305713,77,346543
17304,0.002025,172.217.194.0-255,7156,312869,77,346543
17305,0.00204,172.217.194.0-255,2902,315771,77,346543
17306,0.002091,172.217.194.0-255,13528,329299,77,346543
17307,0.002113,172.217.194.0-255,10692,339991,77,346543
17308,0.002145,172.217.194.0-255,4320,344311,77,346543
17309,0.002162,172.217.194.0-255,1890,346201,77,346543
17310,0.002165,172.217.194.0-255,105,346306,77,346543
17311,0.002244,172.31.40.0-255,66,346372,77,346543
17312,0.009182,172.31.40.0-255,105,346477,77,346543
17313,0.011704,172.217.194.0-255,66,346543,77,346543
17314,0.0,172.217.194.0-255,150,150,77,165196
17315,2.2e-05,172.31.40.0-255,66,216,77,165196
17316,2.9e-05,172.217.194.0-255,1484,1700,77,165196
17317,3.5e-05,172.31.40.0-255,66,1766,77,165196
17318,4.1e-05,172.217.194.0-255,2902,4668,77,165196
17319,4.5e-05,172.31.40.0-255,66,4734,77,165196
17320,5.2e-05,172.217.194.0-255,7156,11890,77,165196
17321,5.5e-05,172.31.40.0-255,66,11956,77,165196
17322,6e-05,172.217.194.0-255,2038,13994,77,165196
17323,6.3e-05,172.31.40.0-255,66,14060,77,165196
17324,0.000105,172.217.194.0-255,1484,15544,77,165196
17325,0.000108,172.31.40.0-255,66,15610,77,165196
17326,0.000113,172.217.194.0-255,2902,18512,77,165196
17327,0.000116,172.31.40.0-255,66,18578,77,165196
17328,0.000119,172.217.194.0-255,1484,20062,77,165196
17329,0.000121,172.31.40.0-255,66,20128,77,165196
17330,0.000137,172.217.194.0-255,4320,24448,77,165196
17331,0.00014,172.31.40.0-255,66,24514,77,165196
17332,0.000146,172.217.194.0-255,4320,28834,77,165196
17333,0.000148,172.31.40.0-255,66,28900,77,165196
17334,0.000167,172.217.194.0-255,2543,31443,77,165196
17335,0.000169,172.31.40.0-255,66,31509,77,165196
17336,0.000345,172.217.194.0-255,1484,32993,77,165196
17337,0.000351,172.31.40.0-255,66,33059,77,165196
17338,0.000356,172.217.194.0-255,2902,35961,77,165196
17339,0.000359,172.31.40.0-255,66,36027,77,165196
17340,0.000362,172.217.194.0-255,1484,37511,77,165196
17341,0.000364,172.31.40.0-255,66,37577,77,165196
17342,0.000385,172.217.194.0-255,4320,41897,77,165196
17343,0.000388,172.31.40.0-255,66,41963,77,165196
17344,0.000392,172.217.194.0-255,2902,44865,77,165196
17345,0.000394,172.31.40.0-255,66,44931,77,165196
17346,0.000419,172.217.194.0-255,3961,48892,77,165196
17347,0.000422,172.31.40.0-255,66,48958,77,165196
17348,0.000429,172.217.194.0-255,7156,56114,77,165196
17349,0.000431,172.31.40.0-255,66,56180,77,165196
17350,0.000456,172.217.194.0-255,9633,65813,77,165196
17351,0.000458,172.31.40.0-255,66,65879,77,165196
17352,0.000474,172.217.194.0-255,339,66218,77,165196
17353,0.00056,172.217.194.0-255,120,66338,77,165196
17354,0.000577,172.217.194.0-255,380,66718,77,165196
17355,0.000875,172.217.194.0-255,1484,68202,77,165196
17356,0.000881,172.31.40.0-255,66,68268,77,165196
17357,0.000887,172.217.194.0-255,2902,71170,77,165196
17358,0.000889,172.31.40.0-255,66,71236,77,165196
17359,0.000892,172.217.194.0-255,1484,72720,77,165196
17360,0.000917,172.217.194.0-255,4320,77040,77,165196
17361,0.00092,172.31.40.0-255,66,77106,77,165196
17362,0.000926,172.217.194.0-255,5738,82844,77,165196
17363,0.000929,172.31.40.0-255,66,82910,77,165196
17364,0.000953,172.217.194.0-255,7156,90066,77,165196
17365,0.000955,172.31.40.0-255,66,90132,77,165196
17366,0.00096,172.217.194.0-255,2902,93034,77,165196
17367,0.000963,172.31.40.0-255,66,93100,77,165196
17368,0.000993,172.217.194.0-255,7856,100956,77,165196
17369,0.000998,172.31.40.0-255,66,101022,77,165196
17370,0.001646,172.217.194.0-255,1484,102506,77,165196
17371,0.001656,172.217.194.0-255,2902,105408,77,165196
17372,0.00166,172.31.40.0-255,66,105474,77,165196
17373,0.001668,172.217.194.0-255,5738,111212,77,165196
17374,0.00167,172.31.40.0-255,66,111278,77,165196
17375,0.001675,172.217.194.0-255,2902,114180,77,165196
17376,0.001677,172.31.40.0-255,66,114246,77,165196
17377,0.001704,172.217.194.0-255,5738,119984,77,165196
17378,0.001707,172.31.40.0-255,66,120050,77,165196
17379,0.001767,172.31.40.0-255,66,120116,77,165196
17380,0.003838,172.217.194.0-255,5738,125854,77,165196
17381,0.003845,172.31.40.0-255,66,125920,77,165196
17382,0.005921,172.217.194.0-255,4320,130240,77,165196
17383,0.005925,172.31.40.0-255,66,130306,77,165196
17384,0.005936,172.217.194.0-255,1484,131790,77,165196
17385,0.007996,172.217.194.0-255,4320,136110,77,165196
17386,0.008003,172.31.40.0-255,66,136176,77,165196
17387,0.010065,172.217.194.0-255,5738,141914,77,165196
17388,0.010073,172.31.40.0-255,66,141980,77,165196
17389,0.012138,172.217.194.0-255,5738,147718,77,165196
17390,0.012147,172.31.40.0-255,66,147784,77,165196
17391,0.014203,172.217.194.0-255,5738,153522,77,165196
17392,0.014211,172.31.40.0-255,66,153588,77,165196
17393,0.016274,172.217.194.0-255,5738,159326,77,165196
17394,0.016283,172.31.40.0-255,66,159392,77,165196
17395,0.018356,172.217.194.0-255,5738,165130,77,165196
17396,0.018365,172.31.40.0-255,66,165196,77,165196
17397,0.0,172.217.194.0-255,150,150,77,363314
17398,2.6e-05,172.31.40.0-255,66,216,77,363314
17399,3.4e-05,172.217.194.0-255,1484,1700,77,363314
17400,3.9e-05,172.31.40.0-255,66,1766,77,363314
17401,5.3e-05,172.217.194.0-255,2902,4668,77,363314
17402,5.7e-05,172.31.40.0-255,66,4734,77,363314
17403,6.5e-05,172.217.194.0-255,7156,11890,77,363314
17404,6.8e-05,172.31.40.0-255,66,11956,77,363314
17405,7.2e-05,172.217.194.0-255,2066,14022,77,363314
17406,7.5e-05,172.31.40.0-255,66,14088,77,363314
17407,0.000106,172.217.194.0-255,11410,25498,77,363314
17408,0.000114,172.31.40.0-255,66,25564,77,363314
17409,0.000117,172.217.194.0-255,1484,27048,77,363314
17410,0.000119,172.31.40.0-255,66,27114,77,363314
17411,0.000144,172.217.194.0-255,3961,31075,77,363314
17412,0.000147,172.31.40.0-255,66,31141,77,363314
17413,0.000191,172.217.194.0-255,4320,35461,77,363314
17414,0.000193,172.31.40.0-255,66,35527,77,363314
17415,0.000199,172.217.194.0-255,4320,39847,77,363314
17416,0.000201,172.31.40.0-255,66,39913,77,363314
17417,0.000228,172.217.194.0-255,4320,44233,77,363314
17418,0.000231,172.31.40.0-255,66,44299,77,363314
17419,0.000255,172.217.194.0-255,6797,51096,77,363314
17420,0.000258,172.31.40.0-255,66,51162,77,363314
17421,0.00027,172.217.194.0-255,13887,65049,77,363314
17422,0.000272,172.31.40.0-255,66,65115,77,363314
17423,0.0003,172.217.194.0-255,339,65454,77,363314
17424,0.000302,172.31.40.0-255,66,65520,77,363314
17425,0.000327,172.217.194.0-255,436,65956,77,363314
17426,0.000329,172.31.40.0-255,66,66022,77,363314
17427,0.000539,172.217.194.0-255,1484,67506,77,363314
17428,0.000545,172.31.40.0-255,66,67572,77,363314
17429,0.000551,172.217.194.0-255,2902,70474,77,363314
17430,0.000553,172.31.40.0-255,66,70540,77,363314
17431,0.000587,172.217.194.0-255,5738,76278,77,363314
17432,0.00059,172.31.40.0-255,66,76344,77,363314
17433,0.0006,172.217.194.0-255,11410,87754,77,363314
17434,0.000602,172.31.40.0-255,66,87820,77,363314
17435,0.000628,172.217.194.0-255,1484,89304,77,363314
17436,0.000639,172.217.194.0-255,10692,99996,77,363314
17437,0.000642,172.31.40.0-255,66,100062,77,363314
17438,0.000701,172.217.194.0-255,1484,101546,77,363314
17439,0.000728,172.217.194.0-255,2902,104448,77,363314
17440,0.000731,172.31.40.0-255,66,104514,77,363314
17441,0.000738,172.217.194.0-255,5738,110252,77,363314
17442,0.000741,172.31.40.0-255,66,110318,77,363314
17443,0.000749,172.217.194.0-255,2902,113220,77,363314
17444,0.000752,172.31.40.0-255,66,113286,77,363314
17445,0.000786,172.217.194.0-255,9992,123278,77,363314
17446,0.000789,172.31.40.0-255,66,123344,77,363314
17447,0.000798,172.217.194.0-255,9992,133336,77,363314
17448,0.0008,172.31.40.0-255,66,133402,77,363314
17449,0.000803,172.217.194.0-255,766,134168,77,363314
17450,0.001043,172.217.194.0-255,1484,135652,77,363314
17451,0.00105,172.31.40.0-255,66,135718,77,363314
17452,0.001056,172.217.194.0-255,2902,138620,77,363314
17453,0.001059,172.31.40.0-255,66,138686,77,363314
17454,0.001071,172.217.194.0-255,5738,144424,77,363314
17455,0.001073,172.31.40.0-255,66,144490,77,363314
17456,0.001076,172.217.194.0-255,1484,145974,77,363314
17457,0.001107,172.217.194.0-255,4320,150294,77,363314
17458,0.00111,172.31.40.0-255,66,150360,77,363314
17459,0.001141,172.217.194.0-255,4320,154680,77,363314
17460,0.001145,172.31.40.0-255,66,154746,77,363314
17461,0.001163,172.217.194.0-255,4320,159066,77,363314
17462,0.001166,172.31.40.0-255,66,159132,77,363314
17463,0.001212,172.217.194.0-255,7156,166288,77,363314
17464,0.001215,172.31.40.0-255,66,166354,77,363314
17465,0.001245,172.217.194.0-255,2184,168538,77,363314
17466,0.001247,172.31.40.0-255,66,168604,77,363314
17467,0.001257,172.217.194.0-255,9992,178596,77,363314
17468,0.00126,172.31.40.0-255,66,178662,77,363314
17469,0.001267,172.217.194.0-255,5738,184400,77,363314
17470,0.00127,172.31.40.0-255,66,184466,77,363314
17471,0.001287,172.31.40.0-255,66,184532,77,363314
17472,0.00129,172.217.194.0-255,766,185298,77,363314
17473,0.001519,172.217.194.0-255,1484,186782,77,363314
17474,0.001523,172.31.40.0-255,66,186848,77,363314
17475,0.001529,172.217.194.0-255,2902,189750,77,363314
17476,0.001532,172.31.40.0-255,66,189816,77,363314
17477,0.001568,172.217.194.0-255,5738,195554,77,363314
17478,0.001571,172.31.40.0-255,66,195620,77,363314
17479,0.001583,172.217.194.0-255,12828,208448,77,363314
17480,0.001586,172.31.40.0-255,66,208514,77,363314
17481,0.00159,172.217.194.0-255,2902,211416,77,363314
17482,0.001592,172.31.40.0-255,66,211482,77,363314
17483,0.001644,172.217.194.0-255,2902,214384,77,363314
17484,0.001648,172.31.40.0-255,66,214450,77,363314
17485,0.001689,172.217.194.0-255,12110,226560,77,363314
17486,0.001692,172.31.40.0-255,66,226626,77,363314
17487,0.001721,172.31.40.0-255,66,226692,77,363314
17488,0.001731,172.217.194.0-255,10692,237384,77,363314
17489,0.001734,172.31.40.0-255,66,237450,77,363314
17490,0.001973,172.217.194.0-255,1484,238934,77,363314
17491,0.001989,172.217.194.0-255,2902,241836,77,363314
17492,0.001995,172.217.194.0-255,4320,246156,77,363314
17493,0.002,172.31.40.0-255,66,246222,77,363314
17494,0.002008,172.31.40.0-255,66,246288,77,363314
17495,0.002011,172.217.194.0-255,1484,247772,77,363314
17496,0.002036,172.217.194.0-255,5738,253510,77,363314
17497,0.002043,172.31.40.0-255,66,253576,77,363314
17498,0.002077,172.217.194.0-255,7156,260732,77,363314
17499,0.00208,172.31.40.0-255,66,260798,77,363314
17500,0.00209,172.217.194.0-255,9992,270790,77,363314
17501,0.002092,172.31.40.0-255,66,270856,77,363314
17502,0.002097,172.217.194.0-255,2184,273040,77,363314
17503,0.002099,172.31.40.0-255,66,273106,77,363314
17504,0.00214,172.217.194.0-255,2902,276008,77,363314
17505,0.002143,172.31.40.0-255,66,276074,77,363314
17506,0.002151,172.217.194.0-255,7156,283230,77,363314
17507,0.002153,172.31.40.0-255,66,283296,77,363314
17508,0.002157,172.217.194.0-255,2902,286198,77,363314
17509,0.00216,172.31.40.0-255,66,286264,77,363314
17510,0.002163,172.217.194.0-255,1484,287748,77,363314
17511,0.00221,172.217.194.0-255,9992,297740,77,363314
17512,0.002214,172.31.40.0-255,66,297806,77,363314
17513,0.002222,172.217.194.0-255,7856,305662,77,363314
17514,0.002225,172.31.40.0-255,66,305728,77,363314
17515,0.002268,172.217.194.0-255,5738,311466,77,363314
17516,0.002272,172.31.40.0-255,66,311532,77,363314
17517,0.002296,172.217.194.0-255,1484,313016,77,363314
17518,0.002304,172.217.194.0-255,8574,321590,77,363314
17519,0.002307,172.31.40.0-255,66,321656,77,363314
17520,0.002342,172.217.194.0-255,1484,323140,77,363314
17521,0.002382,172.31.40.0-255,66,323206,77,363314
17522,0.002384,172.217.194.0-255,766,323972,77,363314
17523,0.004579,172.31.40.0-255,66,324038,77,363314
17524,0.004644,172.217.194.0-255,4320,328358,77,363314
17525,0.004648,172.31.40.0-255,66,328424,77,363314
17526,0.006859,172.217.194.0-255,1484,329908,77,363314
17527,0.006908,172.217.194.0-255,4320,334228,77,363314
17528,0.006919,172.31.40.0-255,66,334294,77,363314
17529,0.009203,172.217.194.0-255,5738,340032,77,363314
17530,0.009218,172.31.40.0-255,66,340098,77,363314
17531,0.011494,172.217.194.0-255,5738,345836,77,363314
17532,0.011501,172.31.40.0-255,66,345902,77,363314
17533,0.013776,172.217.194.0-255,5738,351640,77,363314
17534,0.013793,172.31.40.0-255,66,351706,77,363314
17535,0.016086,172.217.194.0-255,5738,357444,77,363314
17536,0.016104,172.31.40.0-255,66,357510,77,363314
17537,0.018416,172.217.194.0-255,5738,363248,77,363314
17538,0.018431,172.31.40.0-255,66,363314,77,363314
17539,0.0,74.125.24.0-255,150,150,77,365867
17540,2.4e-05,172.31.40.0-255,66,216,77,365867
17541,3.1e-05,74.125.24.0-255,1484,1700,77,365867
17542,3.6e-05,172.31.40.0-255,66,1766,77,365867
17543,4.1e-05,74.125.24.0-255,2902,4668,77,365867
17544,4.4e-05,172.31.40.0-255,66,4734,77,365867
17545,5.3e-05,74.125.24.0-255,7156,11890,77,365867
17546,5.5e-05,172.31.40.0-255,66,11956,77,365867
17547,7.6e-05,74.125.24.0-255,2009,13965,77,365867
17548,7.8e-05,172.31.40.0-255,66,14031,77,365867
17549,0.000115,74.125.24.0-255,1484,15515,77,365867
17550,0.000117,172.31.40.0-255,66,15581,77,365867
17551,0.000121,74.125.24.0-255,1484,17065,77,365867
17552,0.000123,172.31.40.0-255,66,17131,77,365867
17553,0.000139,74.125.24.0-255,1484,18615,77,365867
17554,0.000141,172.31.40.0-255,66,18681,77,365867
17555,0.000149,74.125.24.0-255,5738,24419,77,365867
17556,0.000153,172.31.40.0-255,66,24485,77,365867
17557,0.000193,74.125.24.0-255,6797,31282,77,365867
17558,0.000196,172.31.40.0-255,66,31348,77,365867
17559,0.00038,74.125.24.0-255,1484,32832,77,365867
17560,0.000384,172.31.40.0-255,66,32898,77,365867
17561,0.000391,74.125.24.0-255,2902,35800,77,365867
17562,0.000393,172.31.40.0-255,66,35866,77,365867
17563,0.000397,74.125.24.0-255,2902,38768,77,365867
17564,0.0004,172.31.40.0-255,66,38834,77,365867
17565,0.000419,74.125.24.0-255,2902,41736,77,365867
17566,0.000422,172.31.40.0-255,66,41802,77,365867
17567,0.000428,74.125.24.0-255,5738,47540,77,365867
17568,0.000431,172.31.40.0-255,66,47606,77,365867
17569,0.00046,74.125.24.0-255,3961,51567,77,365867
17570,0.000463,172.31.40.0-255,66,51633,77,365867
17571,0.000473,74.125.24.0-255,9992,61625,77,365867
17572,0.000475,172.31.40.0-255,66,61691,77,365867
17573,0.000481,74.125.24.0-255,3961,65652,77,365867
17574,0.000482,172.31.40.0-255,66,65718,77,365867
17575,0.000505,74.125.24.0-255,401,66119,77,365867
17576,0.000769,74.125.24.0-255,108,66227,77,365867
17577,0.001056,172.31.40.0-255,66,66293,77,365867
17578,0.00113,74.125.24.0-255,1484,67777,77,365867
17579,0.001135,74.125.24.0-255,1484,69261,77,365867
17580,0.001138,172.31.40.0-255,66,69327,77,365867
17581,0.001149,74.125.24.0-255,1484,70811,77,365867
17582,0.001168,74.125.24.0-255,5738,76549,77,365867
17583,0.00117,172.31.40.0-255,66,76615,77,365867
17584,0.001178,74.125.24.0-255,6797,83412,77,365867
17585,0.00118,172.31.40.0-255,66,83478,77,365867
17586,0.001226,74.125.24.0-255,1484,84962,77,365867
17587,0.001246,74.125.24.0-255,2902,87864,77,365867
17588,0.001249,172.31.40.0-255,66,87930,77,365867
17589,0.001271,74.125.24.0-255,5738,93668,77,365867
17590,0.001274,172.31.40.0-255,66,93734,77,365867
17591,0.001277,74.125.24.0-255,1484,95218,77,365867
17592,0.001296,74.125.24.0-255,5379,100597,77,365867
17593,0.001298,172.31.40.0-255,66,100663,77,365867
17594,0.002586,74.125.24.0-255,1484,102147,77,365867
17595,0.002598,74.125.24.0-255,2902,105049,77,365867
17596,0.002602,172.31.40.0-255,66,105115,77,365867
17597,0.002609,74.125.24.0-255,2902,108017,77,365867
17598,0.002611,172.31.40.0-255,66,108083,77,365867
17599,0.002619,74.125.24.0-255,7156,115239,77,365867
17600,0.002622,172.31.40.0-255,66,115305,77,365867
17601,0.00263,74.125.24.0-255,8574,123879,77,365867
17602,0.002632,172.31.40.0-255,66,123945,77,365867
17603,0.002653,74.125.24.0-255,7156,131101,77,365867
17604,0.002656,172.31.40.0-255,66,131167,77,365867
17605,0.002661,74.125.24.0-255,3602,134769,77,365867
17606,0.002663,172.31.40.0-255,66,134835,77,365867
17607,0.002781,74.125.24.0-255,1484,136319,77,365867
17608,0.002796,74.125.24.0-255,1484,137803,77,365867
17609,0.002798,172.31.40.0-255,66,137869,77,365867
17610,0.00282,74.125.24.0-255,1484,139353,77,365867
17611,0.002826,74.125.24.0-255,5738,145091,77,365867
17612,0.002828,172.31.40.0-255,66,145157,77,365867
17613,0.002848,74.125.24.0-255,5738,150895,77,365867
17614,0.00285,172.31.40.0-255,66,150961,77,365867
17615,0.002868,74.125.24.0-255,7156,158117,77,365867
17616,0.00287,172.31.40.0-255,66,158183,77,365867
17617,0.002874,74.125.24.0-255,1484,159667,77,365867
17618,0.002903,74.125.24.0-255,12110,171777,77,365867
17619,0.002906,172.31.40.0-255,66,171843,77,365867
17620,0.002914,74.125.24.0-255,8574,180417,77,365867
17621,0.002916,172.31.40.0-255,66,180483,77,365867
17622,0.002952,74.125.24.0-255,2902,183385,77,365867
17623,0.002955,172.31.40.0-255,66,183451,77,365867
17624,0.00299,172.31.40.0-255,66,183517,77,365867
17625,0.003028,74.125.24.0-255,5738,189255,77,365867
17626,0.00303,172.31.40.0-255,66,189321,77,365867
17627,0.003072,172.31.40.0-255,66,189387,77,365867
17628,0.003079,74.125.24.0-255,7156,196543,77,365867
17629,0.003081,172.31.40.0-255,66,196609,77,365867
17630,0.003085,74.125.24.0-255,3602,200211,77,365867
17631,0.003318,74.125.24.0-255,1484,201695,77,365867
17632,0.003332,74.125.24.0-255,2902,204597,77,365867
17633,0.003349,74.125.24.0-255,1484,206081,77,365867
17634,0.003351,74.125.24.0-255,1484,207565,77,365867
17635,0.003355,74.125.24.0-255,1484,209049,77,365867
17636,0.003373,74.125.24.0-255,2902,211951,77,365867
17637,0.003385,74.125.24.0-255,7156,219107,77,365867
17638,0.003406,74.125.24.0-255,2902,222009,77,365867
17639,0.003417,74.125.24.0-255,12110,234119,77,365867
17640,0.003477,74.125.24.0-255,1484,235603,77,365867
17641,0.003497,74.125.24.0-255,2902,238505,77,365867
17642,0.003501,74.125.24.0-255,2902,241407,77,365867
17643,0.003516,74.125.24.0-255,2902,244309,77,365867
17644,0.00352,74.125.24.0-255,1484,245793,77,365867
17645,0.003545,74.125.24.0-255,11410,257203,77,365867
17646,0.00355,74.125.24.0-255,2902,260105,77,365867
17647,0.003568,74.125.24.0-255,7856,267961,77,365867
17648,0.003608,74.125.24.0-255,1484,269445,77,365867
17649,0.003613,74.125.24.0-255,2902,272347,77,365867
17650,0.00363,74.125.24.0-255,5738,278085,77,365867
17651,0.003656,74.125.24.0-255,4320,282405,77,365867
17652,0.003694,74.125.24.0-255,8574,290979,77,365867
17653,0.003701,74.125.24.0-255,7156,298135,77,365867
17654,0.003704,74.125.24.0-255,1484,299619,77,365867
17655,0.003726,74.125.24.0-255,2184,301803,77,365867
17656,0.003732,74.125.24.0-255,4320,306123,77,365867
17657,0.00375,74.125.24.0-255,8574,314697,77,365867
17658,0.003777,74.125.24.0-255,1484,316181,77,365867
17659,0.003786,74.125.24.0-255,8574,324755,77,365867
17660,0.003815,74.125.24.0-255,4320,329075,77,365867
17661,0.003829,74.125.24.0-255,6438,335513,77,365867
17662,0.003864,74.125.24.0-255,7156,342669,77,365867
17663,0.003891,74.125.24.0-255,8574,351243,77,365867
17664,0.003948,74.125.24.0-255,2902,354145,77,365867
17665,0.003986,74.125.24.0-255,3602,357747,77,365867
17666,0.003991,74.125.24.0-255,4320,362067,77,365867
17667,0.004016,74.125.24.0-255,3458,365525,77,365867
17668,0.004049,74.125.24.0-255,105,365630,77,365867
17669,0.004272,172.31.40.0-255,66,365696,77,365867
17670,0.012757,172.31.40.0-255,105,365801,77,365867
17671,0.014785,74.125.24.0-255,66,365867,77,365867
17672,0.0,172.31.40.0-255,105,105,77,525
17673,0.000227,172.31.40.0-255,90,195,77,525
17674,0.000236,172.31.40.0-255,66,261,77,525
17675,0.002431,74.125.24.0-255,66,327,77,525
17676,0.002465,74.125.24.0-255,66,393,77,525
17677,0.00247,172.31.40.0-255,66,459,77,525
17678,0.002474,74.125.24.0-255,66,525,77,525
17679,0.0,74.125.24.0-255,153,153,77,173687
17680,2.3e-05,172.31.40.0-255,66,219,77,173687
17681,3.1e-05,74.125.24.0-255,1484,1703,77,173687
17682,3.5e-05,172.31.40.0-255,66,1769,77,173687
17683,5e-05,74.125.24.0-255,2902,4671,77,173687
17684,5.2e-05,172.31.40.0-255,66,4737,77,173687
17685,5.8e-05,74.125.24.0-255,4320,9057,77,173687
17686,6.1e-05,172.31.40.0-255,66,9123,77,173687
17687,8.7e-05,74.125.24.0-255,4837,13960,77,173687
17688,9e-05,172.31.40.0-255,66,14026,77,173687
17689,0.000121,74.125.24.0-255,5738,19764,77,173687
17690,0.000124,172.31.40.0-255,66,19830,77,173687
17691,0.000128,74.125.24.0-255,1484,21314,77,173687
17692,0.00013,172.31.40.0-255,66,21380,77,173687
17693,0.000155,74.125.24.0-255,4320,25700,77,173687
17694,0.000158,172.31.40.0-255,66,25766,77,173687
17695,0.000165,74.125.24.0-255,7156,32922,77,173687
17696,0.000168,172.31.40.0-255,66,32988,77,173687
17697,0.000201,74.125.24.0-255,9992,42980,77,173687
17698,0.000203,172.31.40.0-255,66,43046,77,173687
17699,0.000231,74.125.24.0-255,2902,45948,77,173687
17700,0.000233,172.31.40.0-255,66,46014,77,173687
17701,0.000254,74.125.24.0-255,2184,48198,77,173687
17702,0.000257,172.31.40.0-255,66,48264,77,173687
17703,0.000372,74.125.24.0-255,1484,49748,77,173687
17704,0.000379,172.31.40.0-255,66,49814,77,173687
17705,0.000384,74.125.24.0-255,2902,52716,77,173687
17706,0.000386,172.31.40.0-255,66,52782,77,173687
17707,0.000411,74.125.24.0-255,4320,57102,77,173687
17708,0.000414,172.31.40.0-255,66,57168,77,173687
17709,0.000421,74.125.24.0-255,1484,58652,77,173687
17710,0.000424,172.31.40.0-255,66,58718,77,173687
17711,0.00045,74.125.24.0-255,7103,65821,77,173687
17712,0.000453,172.31.40.0-255,66,65887,77,173687
17713,0.001229,74.125.24.0-255,114,66001,77,173687
17714,0.001275,74.125.24.0-255,1484,67485,77,173687
17715,0.00128,172.31.40.0-255,66,67551,77,173687
17716,0.001287,74.125.24.0-255,2902,70453,77,173687
17717,0.001289,172.31.40.0-255,66,70519,77,173687
17718,0.001323,74.125.24.0-255,4320,74839,77,173687
17719,0.001326,172.31.40.0-255,66,74905,77,173687
17720,0.001351,74.125.24.0-255,2902,77807,77,173687
17721,0.001353,172.31.40.0-255,66,77873,77,173687
17722,0.001383,74.125.24.0-255,2902,80775,77,173687
17723,0.001386,172.31.40.0-255,66,80841,77,173687
17724,0.001394,74.125.24.0-255,7156,87997,77,173687
17725,0.001396,172.31.40.0-255,66,88063,77,173687
17726,0.001441,74.125.24.0-255,12110,100173,77,173687
17727,0.001444,172.31.40.0-255,66,100239,77,173687
17728,0.002301,74.125.24.0-255,1484,101723,77,173687
17729,0.002307,74.125.24.0-255,2902,104625,77,173687
17730,0.002311,172.31.40.0-255,66,104691,77,173687
17731,0.002316,74.125.24.0-255,2902,107593,77,173687
17732,0.002318,172.31.40.0-255,66,107659,77,173687
17733,0.002349,74.125.24.0-255,2902,110561,77,173687
17734,0.002351,172.31.40.0-255,66,110627,77,173687
17735,0.002359,74.125.24.0-255,9992,120619,77,173687
17736,0.002361,172.31.40.0-255,66,120685,77,173687
17737,0.002388,74.125.24.0-255,9992,130677,77,173687
17738,0.00239,172.31.40.0-255,66,130743,77,173687
17739,0.002413,74.125.24.0-255,3602,134345,77,173687
17740,0.002415,172.31.40.0-255,66,134411,77,173687
17741,0.004789,74.125.24.0-255,4320,138731,77,173687
17742,0.004794,172.31.40.0-255,66,138797,77,173687
17743,0.004819,74.125.24.0-255,1484,140281,77,173687
17744,0.007148,74.125.24.0-255,4320,144601,77,173687
17745,0.007155,172.31.40.0-255,66,144667,77,173687
17746,0.009509,74.125.24.0-255,5738,150405,77,173687
17747,0.009516,172.31.40.0-255,66,150471,77,173687
17748,0.011861,74.125.24.0-255,5738,156209,77,173687
17749,0.011868,172.31.40.0-255,66,156275,77,173687
17750,0.014218,74.125.24.0-255,5738,162013,77,173687
17751,0.014226,172.31.40.0-255,66,162079,77,173687
17752,0.016583,74.125.24.0-255,5738,167817,77,173687
17753,0.016592,172.31.40.0-255,66,167883,77,173687
17754,0.018964,74.125.24.0-255,5738,173621,77,173687
17755,0.018975,172.31.40.0-255,66,173687,77,173687
17756,0.0,172.217.26.0-255,153,153,77,227435
17757,3.2e-05,172.31.40.0-255,66,219,77,227435
17758,3.9e-05,172.217.26.0-255,1484,1703,77,227435
17759,4.3e-05,172.31.40.0-255,66,1769,77,227435
17760,4.8e-05,172.217.26.0-255,2902,4671,77,227435
17761,5.8e-05,172.31.40.0-255,66,4737,77,227435
17762,6.5e-05,172.217.26.0-255,5738,10475,77,227435
17763,6.8e-05,172.31.40.0-255,66,10541,77,227435
17764,7.3e-05,172.217.26.0-255,3447,13988,77,227435
17765,7.5e-05,172.31.40.0-255,66,14054,77,227435
17766,0.000107,172.217.26.0-255,2902,16956,77,227435
17767,0.00011,172.31.40.0-255,66,17022,77,227435
17768,0.000134,172.217.26.0-255,1484,18506,77,227435
17769,0.000137,172.31.40.0-255,66,18572,77,227435
17770,0.000144,172.217.26.0-255,4320,22892,77,227435
17771,0.000146,172.31.40.0-255,66,22958,77,227435
17772,0.000151,172.217.26.0-255,5738,28696,77,227435
17773,0.000154,172.31.40.0-255,66,28762,77,227435
17774,0.000188,172.217.26.0-255,2543,31305,77,227435
17775,0.000192,172.31.40.0-255,66,31371,77,227435
17776,0.000222,172.217.26.0-255,1484,32855,77,227435
17777,0.000225,172.31.40.0-255,66,32921,77,227435
17778,0.000228,172.217.26.0-255,1484,34405,77,227435
17779,0.00023,172.31.40.0-255,66,34471,77,227435
17780,0.000234,172.217.26.0-255,2902,37373,77,227435
17781,0.000236,172.31.40.0-255,66,37439,77,227435
17782,0.000244,172.217.26.0-255,5738,43177,77,227435
17783,0.000247,172.31.40.0-255,66,43243,77,227435
17784,0.000294,172.217.26.0-255,5379,48622,77,227435
17785,0.000298,172.31.40.0-255,66,48688,77,227435
17786,0.000333,172.217.26.0-255,1484,50172,77,227435
17787,0.000337,172.31.40.0-255,66,50238,77,227435
17788,0.000342,172.217.26.0-255,2902,53140,77,227435
17789,0.000344,172.31.40.0-255,66,53206,77,227435
17790,0.000375,172.217.26.0-255,4320,57526,77,227435
17791,0.000379,172.31.40.0-255,66,57592,77,227435
17792,0.000385,172.217.26.0-255,5738,63330,77,227435
17793,0.000387,172.31.40.0-255,66,63396,77,227435
17794,0.000429,172.217.26.0-255,2872,66268,77,227435
17795,0.000433,172.31.40.0-255,66,66334,77,227435
17796,0.000995,172.217.26.0-255,115,66449,77,227435
17797,0.001149,172.217.26.0-255,1484,67933,77,227435
17798,0.001155,172.31.40.0-255,66,67999,77,227435
17799,0.001162,172.217.26.0-255,2902,70901,77,227435
17800,0.001165,172.31.40.0-255,66,70967,77,227435
17801,0.001194,172.217.26.0-255,1484,72451,77,227435
17802,0.00124,172.217.26.0-255,4320,76771,77,227435
17803,0.001243,172.31.40.0-255,66,76837,77,227435
17804,0.001248,172.217.26.0-255,2902,79739,77,227435
17805,0.00125,172.31.40.0-255,66,79805,77,227435
17806,0.00126,172.217.26.0-255,11051,90856,77,227435
17807,0.001262,172.31.40.0-255,66,90922,77,227435
17808,0.001271,172.217.26.0-255,9633,100555,77,227435
17809,0.001273,172.31.40.0-255,66,100621,77,227435
17810,0.001332,172.217.26.0-255,1484,102105,77,227435
17811,0.001337,172.217.26.0-255,1484,103589,77,227435
17812,0.001339,172.31.40.0-255,66,103655,77,227435
17813,0.001366,172.217.26.0-255,1484,105139,77,227435
17814,0.001373,172.217.26.0-255,5738,110877,77,227435
17815,0.001375,172.31.40.0-255,66,110943,77,227435
17816,0.001381,172.217.26.0-255,4320,115263,77,227435
17817,0.001383,172.31.40.0-255,66,115329,77,227435
17818,0.001408,172.217.26.0-255,8574,123903,77,227435
17819,0.00141,172.31.40.0-255,66,123969,77,227435
17820,0.001421,172.217.26.0-255,7156,131125,77,227435
17821,0.001424,172.31.40.0-255,66,131191,77,227435
17822,0.001453,172.217.26.0-255,3602,134793,77,227435
17823,0.001457,172.31.40.0-255,66,134859,77,227435
17824,0.001518,172.217.26.0-255,1484,136343,77,227435
17825,0.001534,172.217.26.0-255,2902,139245,77,227435
17826,0.001539,172.31.40.0-255,66,139311,77,227435
17827,0.001543,172.217.26.0-255,1484,140795,77,227435
17828,0.001546,172.217.26.0-255,1484,142279,77,227435
17829,0.001548,172.31.40.0-255,66,142345,77,227435
17830,0.001564,172.217.26.0-255,1484,143829,77,227435
17831,0.00157,172.217.26.0-255,5738,149567,77,227435
17832,0.001578,172.31.40.0-255,66,149633,77,227435
17833,0.001616,172.217.26.0-255,9992,159625,77,227435
17834,0.001618,172.31.40.0-255,66,159691,77,227435
17835,0.001649,172.217.26.0-255,2902,162593,77,227435
17836,0.001651,172.31.40.0-255,66,162659,77,227435
17837,0.00168,172.217.26.0-255,6438,169097,77,227435
17838,0.001683,172.31.40.0-255,66,169163,77,227435
17839,0.001685,172.217.26.0-255,330,169493,77,227435
17840,0.001892,172.217.26.0-255,1484,170977,77,227435
17841,0.001895,172.31.40.0-255,66,171043,77,227435
17842,0.001907,172.217.26.0-255,2902,173945,77,227435
17843,0.001913,172.31.40.0-255,66,174011,77,227435
17844,0.003771,172.217.26.0-255,2902,176913,77,227435
17845,0.003773,172.31.40.0-255,66,176979,77,227435
17846,0.003798,172.217.26.0-255,2902,179881,77,227435
17847,0.003801,172.31.40.0-255,66,179947,77,227435
17848,0.005663,172.217.26.0-255,2902,182849,77,227435
17849,0.005667,172.31.40.0-255,66,182915,77,227435
17850,0.005694,172.217.26.0-255,2902,185817,77,227435
17851,0.005696,172.31.40.0-255,66,185883,77,227435
17852,0.007555,172.217.26.0-255,2902,188785,77,227435
17853,0.007562,172.31.40.0-255,66,188851,77,227435
17854,0.007592,172.217.26.0-255,2902,191753,77,227435
17855,0.007595,172.31.40.0-255,66,191819,77,227435
17856,0.009455,172.217.26.0-255,2902,194721,77,227435
17857,0.009462,172.31.40.0-255,66,194787,77,227435
17858,0.009496,172.217.26.0-255,2902,197689,77,227435
17859,0.009499,172.31.40.0-255,66,197755,77,227435
17860,0.011353,172.217.26.0-255,2902,200657,77,227435
17861,0.011361,172.31.40.0-255,66,200723,77,227435
17862,0.011393,172.217.26.0-255,2902,203625,77,227435
17863,0.011396,172.31.40.0-255,66,203691,77,227435
17864,0.013245,172.217.26.0-255,2902,206593,77,227435
17865,0.013252,172.31.40.0-255,66,206659,77,227435
17866,0.01328,172.217.26.0-255,2902,209561,77,227435
17867,0.013283,172.31.40.0-255,66,209627,77,227435
17868,0.015141,172.217.26.0-255,2902,212529,77,227435
17869,0.015147,172.31.40.0-255,66,212595,77,227435
17870,0.015176,172.217.26.0-255,2902,215497,77,227435
17871,0.015179,172.31.40.0-255,66,215563,77,227435
17872,0.017034,172.217.26.0-255,2902,218465,77,227435
17873,0.017041,172.31.40.0-255,66,218531,77,227435
17874,0.017079,172.217.26.0-255,2902,221433,77,227435
17875,0.017083,172.31.40.0-255,66,221499,77,227435
17876,0.018942,172.217.26.0-255,2902,224401,77,227435
17877,0.01895,172.31.40.0-255,66,224467,77,227435
17878,0.018991,172.217.26.0-255,2902,227369,77,227435
17879,0.018995,172.31.40.0-255,66,227435,77,227435
17880,0.0,74.125.24.0-255,150,150,77,313071
17881,1.4e-05,172.31.40.0-255,66,216,77,313071
17882,4.8e-05,74.125.24.0-255,1484,1700,77,313071
17883,5.3e-05,172.31.40.0-255,66,1766,77,313071
17884,5.9e-05,74.125.24.0-255,2902,4668,77,313071
17885,6.2e-05,172.31.40.0-255,66,4734,77,313071
17886,7.4e-05,74.125.24.0-255,7156,11890,77,313071
17887,7.7e-05,172.31.40.0-255,66,11956,77,313071
17888,0.000108,74.125.24.0-255,1981,13937,77,313071
17889,0.00011,172.31.40.0-255,66,14003,77,313071
17890,0.000608,74.125.24.0-255,1484,15487,77,313071
17891,0.000615,172.31.40.0-255,66,15553,77,313071
17892,0.000625,74.125.24.0-255,2902,18455,77,313071
17893,0.000627,172.31.40.0-255,66,18521,77,313071
17894,0.00064,74.125.24.0-255,5738,24259,77,313071
17895,0.000643,172.31.40.0-255,66,24325,77,313071
17896,0.000687,74.125.24.0-255,5738,30063,77,313071
17897,0.00069,172.31.40.0-255,66,30129,77,313071
17898,0.000712,74.125.24.0-255,1125,31254,77,313071
17899,0.000716,172.31.40.0-255,66,31320,77,313071
17900,0.000719,74.125.24.0-255,1484,32804,77,313071
17901,0.000721,172.31.40.0-255,66,32870,77,313071
17902,0.000744,74.125.24.0-255,4320,37190,77,313071
17903,0.000747,172.31.40.0-255,66,37256,77,313071
17904,0.000759,74.125.24.0-255,7156,44412,77,313071
17905,0.000761,172.31.40.0-255,66,44478,77,313071
17906,0.000789,74.125.24.0-255,5738,50216,77,313071
17907,0.000792,172.31.40.0-255,66,50282,77,313071
17908,0.000829,74.125.24.0-255,9633,59915,77,313071
17909,0.000832,172.31.40.0-255,66,59981,77,313071
17910,0.000837,74.125.24.0-255,2902,62883,77,313071
17911,0.000839,172.31.40.0-255,66,62949,77,313071
17912,0.00087,74.125.24.0-255,2877,65826,77,313071
17913,0.000873,172.31.40.0-255,66,65892,77,313071
17914,0.000908,74.125.24.0-255,110,66002,77,313071
17915,0.001029,74.125.24.0-255,1484,67486,77,313071
17916,0.001035,172.31.40.0-255,66,67552,77,313071
17917,0.00104,74.125.24.0-255,2902,70454,77,313071
17918,0.001042,172.31.40.0-255,66,70520,77,313071
17919,0.00108,74.125.24.0-255,5738,76258,77,313071
17920,0.001083,172.31.40.0-255,66,76324,77,313071
17921,0.001125,74.125.24.0-255,8215,84539,77,313071
17922,0.001128,172.31.40.0-255,66,84605,77,313071
17923,0.001137,74.125.24.0-255,8574,93179,77,313071
17924,0.001139,172.31.40.0-255,66,93245,77,313071
17925,0.001151,74.125.24.0-255,6797,100042,77,313071
17926,0.001154,172.31.40.0-255,66,100108,77,313071
17927,0.001664,74.125.24.0-255,1484,101592,77,313071
17928,0.001672,74.125.24.0-255,2902,104494,77,313071
17929,0.001676,172.31.40.0-255,66,104560,77,313071
17930,0.001681,74.125.24.0-255,1484,106044,77,313071
17931,0.001705,74.125.24.0-255,4320,110364,77,313071
17932,0.001707,172.31.40.0-255,66,110430,77,313071
17933,0.001718,74.125.24.0-255,11410,121840,77,313071
17934,0.001726,172.31.40.0-255,66,121906,77,313071
17935,0.001731,74.125.24.0-255,4320,126226,77,313071
17936,0.001733,172.31.40.0-255,66,126292,77,313071
17937,0.001758,74.125.24.0-255,7856,134148,77,313071
17938,0.001765,172.31.40.0-255,66,134214,77,313071
17939,0.001802,74.125.24.0-255,1484,135698,77,313071
17940,0.001805,74.125.24.0-255,1484,137182,77,313071
17941,0.001808,172.31.40.0-255,66,137248,77,313071
17942,0.001832,74.125.24.0-255,1484,138732,77,313071
17943,0.001839,74.125.24.0-255,5738,144470,77,313071
17944,0.001841,172.31.40.0-255,66,144536,77,313071
17945,0.001848,74.125.24.0-255,5738,150274,77,313071
17946,0.00185,172.31.40.0-255,66,150340,77,313071
17947,0.001885,74.125.24.0-255,7156,157496,77,313071
17948,0.001888,172.31.40.0-255,66,157562,77,313071
17949,0.0019,74.125.24.0-255,10692,168254,77,313071
17950,0.001906,172.31.40.0-255,66,168320,77,313071
17951,0.002424,74.125.24.0-255,1484,169804,77,313071
17952,0.002428,74.125.24.0-255,2902,172706,77,313071
17953,0.002431,172.31.40.0-255,66,172772,77,313071
17954,0.002476,74.125.24.0-255,4320,177092,77,313071
17955,0.002479,172.31.40.0-255,66,177158,77,313071
17956,0.002491,74.125.24.0-255,1484,178642,77,313071
17957,0.002505,74.125.24.0-255,11410,190052,77,313071
17958,0.002508,172.31.40.0-255,66,190118,77,313071
17959,0.002515,74.125.24.0-255,7156,197274,77,313071
17960,0.002518,172.31.40.0-255,66,197340,77,313071
17961,0.002552,74.125.24.0-255,5020,202360,77,313071
17962,0.002555,172.31.40.0-255,66,202426,77,313071
17963,0.002741,74.125.24.0-255,1484,203910,77,313071
17964,0.002761,74.125.24.0-255,2902,206812,77,313071
17965,0.002763,172.31.40.0-255,66,206878,77,313071
17966,0.002768,74.125.24.0-255,2902,209780,77,313071
17967,0.00277,172.31.40.0-255,66,209846,77,313071
17968,0.0028,74.125.24.0-255,2902,212748,77,313071
17969,0.002802,172.31.40.0-255,66,212814,77,313071
17970,0.002808,74.125.24.0-255,5738,218552,77,313071
17971,0.002811,172.31.40.0-255,66,218618,77,313071
17972,0.002826,74.125.24.0-255,12828,231446,77,313071
17973,0.002828,172.31.40.0-255,66,231512,77,313071
17974,0.002834,74.125.24.0-255,5020,236532,77,313071
17975,0.002837,172.31.40.0-255,66,236598,77,313071
17976,0.002843,74.125.24.0-255,5738,242336,77,313071
17977,0.002848,172.31.40.0-255,66,242402,77,313071
17978,0.002902,74.125.24.0-255,12828,255230,77,313071
17979,0.002904,172.31.40.0-255,66,255296,77,313071
17980,0.002915,74.125.24.0-255,12828,268124,77,313071
17981,0.002923,172.31.40.0-255,66,268190,77,313071
17982,0.002969,172.31.40.0-255,66,268256,77,313071
17983,0.002972,74.125.24.0-255,1484,269740,77,313071
17984,0.003032,172.31.40.0-255,66,269806,77,313071
17985,0.003051,172.31.40.0-255,66,269872,77,313071
17986,0.003055,74.125.24.0-255,2902,272774,77,313071
17987,0.003058,172.31.40.0-255,66,272840,77,313071
17988,0.003111,172.31.40.0-255,66,272906,77,313071
17989,0.003158,74.125.24.0-255,9992,282898,77,313071
17990,0.003161,172.31.40.0-255,66,282964,77,313071
17991,0.003195,74.125.24.0-255,9274,292238,77,313071
17992,0.003199,172.31.40.0-255,66,292304,77,313071
17993,0.003222,172.31.40.0-255,66,292370,77,313071
17994,0.003233,74.125.24.0-255,13528,305898,77,313071
17995,0.003236,172.31.40.0-255,66,305964,77,313071
17996,0.003241,74.125.24.0-255,4320,310284,77,313071
17997,0.003244,172.31.40.0-255,66,310350,77,313071
17998,0.003248,74.125.24.0-255,2313,312663,77,313071
17999,0.00325,172.31.40.0-255,66,312729,77,313071
18000,0.003298,74.125.24.0-255,105,312834,77,313071
18001,0.006538,172.31.40.0-255,66,312900,77,313071
18002,0.006577,172.31.40.0-255,105,313005,77,313071
18003,0.009145,74.125.24.0-255,66,313071,77,313071
18004,0.0,172.217.194.0-255,153,153,77,311186
18005,1.7e-05,172.31.40.0-255,66,219,77,311186
18006,2.4e-05,172.217.194.0-255,1484,1703,77,311186
18007,3e-05,172.31.40.0-255,66,1769,77,311186
18008,3.6e-05,172.217.194.0-255,2902,4671,77,311186
18009,4.5e-05,172.31.40.0-255,66,4737,77,311186
18010,5.3e-05,172.217.194.0-255,7156,11893,77,311186
18011,5.6e-05,172.31.40.0-255,66,11959,77,311186
18012,6e-05,172.217.194.0-255,2103,14062,77,311186
18013,6.2e-05,172.31.40.0-255,66,14128,77,311186
18014,0.000114,172.217.194.0-255,1484,15612,77,311186
18015,0.000116,172.31.40.0-255,66,15678,77,311186
18016,0.000121,172.217.194.0-255,2902,18580,77,311186
18017,0.000123,172.31.40.0-255,66,18646,77,311186
18018,0.000151,172.217.194.0-255,5738,24384,77,311186
18019,0.000154,172.31.40.0-255,66,24450,77,311186
18020,0.000159,172.217.194.0-255,4320,28770,77,311186
18021,0.000161,172.31.40.0-255,66,28836,77,311186
18022,0.000196,172.217.194.0-255,2543,31379,77,311186
18023,0.000199,172.31.40.0-255,66,31445,77,311186
18024,0.000207,172.217.194.0-255,8574,40019,77,311186
18025,0.00021,172.31.40.0-255,66,40085,77,311186
18026,0.000241,172.217.194.0-255,5738,45823,77,311186
18027,0.000244,172.31.40.0-255,66,45889,77,311186
18028,0.000248,172.217.194.0-255,2543,48432,77,311186
18029,0.000251,172.31.40.0-255,66,48498,77,311186
18030,0.000288,172.31.40.0-255,66,48564,77,311186
18031,0.000291,172.217.194.0-255,678,49242,77,311186
18032,0.000293,172.31.40.0-255,66,49308,77,311186
18033,0.000464,172.217.194.0-255,1484,50792,77,311186
18034,0.000468,172.31.40.0-255,66,50858,77,311186
18035,0.000474,172.217.194.0-255,2902,53760,77,311186
18036,0.000478,172.217.194.0-255,1484,55244,77,311186
18037,0.000498,172.217.194.0-255,4320,59564,77,311186
18038,0.000504,172.217.194.0-255,4320,63884,77,311186
18039,0.000525,172.217.194.0-255,8574,72458,77,311186
18040,0.00057,172.217.194.0-255,10692,83150,77,311186
18041,0.000622,172.31.40.0-255,66,83216,77,311186
18042,0.000775,172.217.194.0-255,1484,84700,77,311186
18043,0.000781,172.217.194.0-255,2902,87602,77,311186
18044,0.000788,172.31.40.0-255,66,87668,77,311186
18045,0.000817,172.217.194.0-255,5738,93406,77,311186
18046,0.00083,172.217.194.0-255,12828,106234,77,311186
18047,0.000837,172.217.194.0-255,8574,114808,77,311186
18048,0.000851,172.31.40.0-255,66,114874,77,311186
18049,0.00089,172.217.194.0-255,2184,117058,77,311186
18050,0.000911,172.31.40.0-255,66,117124,77,311186
18051,0.000921,172.217.194.0-255,2902,120026,77,311186
18052,0.000934,172.217.194.0-255,2902,122928,77,311186
18053,0.000946,172.217.194.0-255,1484,124412,77,311186
18054,0.000952,172.217.194.0-255,5738,130150,77,311186
18055,0.000971,172.217.194.0-255,2902,133052,77,311186
18056,0.000977,172.31.40.0-255,66,133118,77,311186
18057,0.001017,172.31.40.0-255,66,133184,77,311186
18058,0.001026,172.217.194.0-255,2184,135368,77,311186
18059,0.001036,172.31.40.0-255,66,135434,77,311186
18060,0.001094,172.217.194.0-255,1484,136918,77,311186
18061,0.001099,172.217.194.0-255,2902,139820,77,311186
18062,0.001115,172.31.40.0-255,66,139886,77,311186
18063,0.001126,172.217.194.0-255,5738,145624,77,311186
18064,0.001141,172.217.194.0-255,9992,155616,77,311186
18065,0.001153,172.217.194.0-255,1484,157100,77,311186
18066,0.00117,172.31.40.0-255,66,157166,77,311186
18067,0.001195,172.217.194.0-255,12110,169276,77,311186
18068,0.001225,172.217.194.0-255,12828,182104,77,311186
18069,0.001247,172.217.194.0-255,9992,192096,77,311186
18070,0.00125,172.31.40.0-255,66,192162,77,311186
18071,0.001266,172.217.194.0-255,5738,197900,77,311186
18072,0.001272,172.31.40.0-255,66,197966,77,311186
18073,0.001284,172.217.194.0-255,5020,202986,77,311186
18074,0.001311,172.31.40.0-255,66,203052,77,311186
18075,0.001408,172.217.194.0-255,1484,204536,77,311186
18076,0.001414,172.217.194.0-255,2902,207438,77,311186
18077,0.001429,172.217.194.0-255,1484,208922,77,311186
18078,0.001431,172.217.194.0-255,1484,210406,77,311186
18079,0.00144,172.217.194.0-255,1484,211890,77,311186
18080,0.001444,172.31.40.0-255,66,211956,77,311186
18081,0.001455,172.217.194.0-255,5738,217694,77,311186
18082,0.001465,172.31.40.0-255,66,217760,77,311186
18083,0.001512,172.217.194.0-255,11410,229170,77,311186
18084,0.001522,172.31.40.0-255,66,229236,77,311186
18085,0.001532,172.217.194.0-255,1484,230720,77,311186
18086,0.001541,172.217.194.0-255,2902,233622,77,311186
18087,0.001546,172.31.40.0-255,66,233688,77,311186
18088,0.001572,172.217.194.0-255,3602,237290,77,311186
18089,0.001582,172.31.40.0-255,66,237356,77,311186
18090,0.001725,172.217.194.0-255,1484,238840,77,311186
18091,0.001761,172.217.194.0-255,1484,240324,77,311186
18092,0.001772,172.31.40.0-255,66,240390,77,311186
18093,0.001783,172.217.194.0-255,1484,241874,77,311186
18094,0.001795,172.217.194.0-255,5738,247612,77,311186
18095,0.001806,172.217.194.0-255,12828,260440,77,311186
18096,0.001818,172.217.194.0-255,11410,271850,77,311186
18097,0.001833,172.217.194.0-255,3602,275452,77,311186
18098,0.001842,172.217.194.0-255,9992,285444,77,311186
18099,0.00186,172.31.40.0-255,66,285510,77,311186
18100,0.001867,172.217.194.0-255,5738,291248,77,311186
18101,0.001883,172.217.194.0-255,13528,304776,77,311186
18102,0.001898,172.31.40.0-255,66,304842,77,311186
18103,0.001915,172.217.194.0-255,2902,307744,77,311186
18104,0.001928,172.31.40.0-255,66,307810,77,311186
18105,0.001995,172.217.194.0-255,1484,309294,77,311186
18106,0.001998,172.217.194.0-255,1484,310778,77,311186
18107,0.002005,172.31.40.0-255,66,310844,77,311186
18108,0.002047,172.217.194.0-255,105,310949,77,311186
18109,0.00206,172.31.40.0-255,66,311015,77,311186
18110,0.004383,172.31.40.0-255,105,311120,77,311186
18111,0.006623,172.217.194.0-255,66,311186,77,311186
18112,0.0,74.125.68.0-255,153,153,77,237405
18113,2.5e-05,172.31.40.0-255,66,219,77,237405
18114,3.3e-05,74.125.68.0-255,1484,1703,77,237405
18115,3.7e-05,172.31.40.0-255,66,1769,77,237405
18116,4.4e-05,74.125.68.0-255,2902,4671,77,237405
18117,4.7e-05,172.31.40.0-255,66,4737,77,237405
18118,5.4e-05,74.125.68.0-255,5738,10475,77,237405
18119,5.7e-05,172.31.40.0-255,66,10541,77,237405
18120,6.3e-05,74.125.68.0-255,4320,14861,77,237405
18121,6.6e-05,172.31.40.0-255,66,14927,77,237405
18122,9.1e-05,74.125.68.0-255,2092,17019,77,237405
18123,9.4e-05,172.31.40.0-255,66,17085,77,237405
18124,0.000101,74.125.68.0-255,7156,24241,77,237405
18125,0.000103,172.31.40.0-255,66,24307,77,237405
18126,0.000107,74.125.68.0-255,2902,27209,77,237405
18127,0.000109,172.31.40.0-255,66,27275,77,237405
18128,0.000134,74.125.68.0-255,3961,31236,77,237405
18129,0.000137,172.31.40.0-255,66,31302,77,237405
18130,0.000201,74.125.68.0-255,1484,32786,77,237405
18131,0.000203,172.31.40.0-255,66,32852,77,237405
18132,0.000208,74.125.68.0-255,2902,35754,77,237405
18133,0.00021,172.31.40.0-255,66,35820,77,237405
18134,0.000244,74.125.68.0-255,2902,38722,77,237405
18135,0.000246,172.31.40.0-255,66,38788,77,237405
18136,0.000251,74.125.68.0-255,4320,43108,77,237405
18137,0.000254,172.31.40.0-255,66,43174,77,237405
18138,0.000285,74.125.68.0-255,5379,48553,77,237405
18139,0.000288,172.31.40.0-255,66,48619,77,237405
18140,0.000332,74.125.68.0-255,1484,50103,77,237405
18141,0.000335,172.31.40.0-255,66,50169,77,237405
18142,0.000339,74.125.68.0-255,1484,51653,77,237405
18143,0.000341,172.31.40.0-255,66,51719,77,237405
18144,0.000355,74.125.68.0-255,1484,53203,77,237405
18145,0.000369,74.125.68.0-255,1484,54687,77,237405
18146,0.000371,172.31.40.0-255,66,54753,77,237405
18147,0.000386,74.125.68.0-255,4320,59073,77,237405
18148,0.000389,172.31.40.0-255,66,59139,77,237405
18149,0.000417,74.125.68.0-255,6797,65936,77,237405
18150,0.000419,172.31.40.0-255,66,66002,77,237405
18151,0.000423,74.125.68.0-255,649,66651,77,237405
18152,0.000547,74.125.68.0-255,1484,68135,77,237405
18153,0.000551,172.31.40.0-255,66,68201,77,237405
18154,0.000556,74.125.68.0-255,2902,71103,77,237405
18155,0.000559,172.31.40.0-255,66,71169,77,237405
18156,0.00057,74.125.68.0-255,1484,72653,77,237405
18157,0.000589,74.125.68.0-255,2902,75555,77,237405
18158,0.000592,172.31.40.0-255,66,75621,77,237405
18159,0.000609,74.125.68.0-255,5738,81359,77,237405
18160,0.000612,172.31.40.0-255,66,81425,77,237405
18161,0.000635,74.125.68.0-255,3961,85386,77,237405
18162,0.000638,172.31.40.0-255,66,85452,77,237405
18163,0.000642,74.125.68.0-255,2902,88354,77,237405
18164,0.000644,172.31.40.0-255,66,88420,77,237405
18165,0.000682,74.125.68.0-255,4320,92740,77,237405
18166,0.000687,172.31.40.0-255,66,92806,77,237405
18167,0.000709,74.125.68.0-255,8215,101021,77,237405
18168,0.000712,172.31.40.0-255,66,101087,77,237405
18169,0.001721,74.125.68.0-255,1484,102571,77,237405
18170,0.001746,74.125.68.0-255,2902,105473,77,237405
18171,0.00175,172.31.40.0-255,66,105539,77,237405
18172,0.001757,74.125.68.0-255,4320,109859,77,237405
18173,0.00176,172.31.40.0-255,66,109925,77,237405
18174,0.00178,74.125.68.0-255,1484,111409,77,237405
18175,0.001794,74.125.68.0-255,2902,114311,77,237405
18176,0.001796,172.31.40.0-255,66,114377,77,237405
18177,0.001822,74.125.68.0-255,5738,120115,77,237405
18178,0.001824,172.31.40.0-255,66,120181,77,237405
18179,0.001878,74.125.68.0-255,8574,128755,77,237405
18180,0.001881,172.31.40.0-255,66,128821,77,237405
18181,0.001893,74.125.68.0-255,1484,130305,77,237405
18182,0.001911,74.125.68.0-255,5020,135325,77,237405
18183,0.001913,172.31.40.0-255,66,135391,77,237405
18184,0.001917,74.125.68.0-255,2902,138293,77,237405
18185,0.001918,172.31.40.0-255,66,138359,77,237405
18186,0.001934,74.125.68.0-255,4320,142679,77,237405
18187,0.001937,172.31.40.0-255,66,142745,77,237405
18188,0.001945,74.125.68.0-255,2902,145647,77,237405
18189,0.001946,172.31.40.0-255,66,145713,77,237405
18190,0.001965,74.125.68.0-255,4320,150033,77,237405
18191,0.001967,172.31.40.0-255,66,150099,77,237405
18192,0.001974,74.125.68.0-255,8574,158673,77,237405
18193,0.001977,172.31.40.0-255,66,158739,77,237405
18194,0.002003,74.125.68.0-255,4320,163059,77,237405
18195,0.002005,172.31.40.0-255,66,163125,77,237405
18196,0.00201,74.125.68.0-255,4320,167445,77,237405
18197,0.002012,172.31.40.0-255,66,167511,77,237405
18198,0.002023,74.125.68.0-255,1484,168995,77,237405
18199,0.002048,74.125.68.0-255,5020,174015,77,237405
18200,0.00205,172.31.40.0-255,66,174081,77,237405
18201,0.002073,74.125.68.0-255,5738,179819,77,237405
18202,0.002075,172.31.40.0-255,66,179885,77,237405
18203,0.002077,74.125.68.0-255,1484,181369,77,237405
18204,0.002103,74.125.68.0-255,11410,192779,77,237405
18205,0.002105,172.31.40.0-255,66,192845,77,237405
18206,0.00211,74.125.68.0-255,4320,197165,77,237405
18207,0.002112,172.31.40.0-255,66,197231,77,237405
18208,0.002148,74.125.68.0-255,2902,200133,77,237405
18209,0.002151,172.31.40.0-255,66,200199,77,237405
18210,0.002168,74.125.68.0-255,3602,203801,77,237405
18211,0.002171,172.31.40.0-255,66,203867,77,237405
18212,0.004685,74.125.68.0-255,1484,205351,77,237405
18213,0.004705,74.125.68.0-255,4320,209671,77,237405
18214,0.00471,172.31.40.0-255,66,209737,77,237405
18215,0.007239,74.125.68.0-255,4320,214057,77,237405
18216,0.007243,172.31.40.0-255,66,214123,77,237405
18217,0.007256,74.125.68.0-255,1484,215607,77,237405
18218,0.009888,74.125.68.0-255,4320,219927,77,237405
18219,0.009897,172.31.40.0-255,66,219993,77,237405
18220,0.012446,74.125.68.0-255,5738,225731,77,237405
18221,0.012457,172.31.40.0-255,66,225797,77,237405
18222,0.015013,74.125.68.0-255,5738,231535,77,237405
18223,0.015021,172.31.40.0-255,66,231601,77,237405
18224,0.017598,74.125.68.0-255,5738,237339,77,237405
18225,0.017611,172.31.40.0-255,66,237405,77,237405
18226,0.0,74.125.24.0-255,154,154,77,365433
18227,2.6e-05,172.31.40.0-255,66,220,77,365433
18228,3.5e-05,74.125.24.0-255,1484,1704,77,365433
18229,4e-05,172.31.40.0-255,66,1770,77,365433
18230,5.3e-05,74.125.24.0-255,2902,4672,77,365433
18231,5.6e-05,172.31.40.0-255,66,4738,77,365433
18232,6.1e-05,74.125.24.0-255,2902,7640,77,365433
18233,6.4e-05,172.31.40.0-255,66,7706,77,365433
18234,9.8e-05,74.125.24.0-255,4320,12026,77,365433
18235,0.000102,172.31.40.0-255,66,12092,77,365433
18236,0.000106,74.125.24.0-255,2103,14195,77,365433
18237,0.000108,172.31.40.0-255,66,14261,77,365433
18238,0.000532,74.125.24.0-255,1484,15745,77,365433
18239,0.000538,172.31.40.0-255,66,15811,77,365433
18240,0.000544,74.125.24.0-255,2902,18713,77,365433
18241,0.000547,172.31.40.0-255,66,18779,77,365433
18242,0.000581,74.125.24.0-255,5738,24517,77,365433
18243,0.000586,172.31.40.0-255,66,24583,77,365433
18244,0.000604,74.125.24.0-255,4320,28903,77,365433
18245,0.000606,172.31.40.0-255,66,28969,77,365433
18246,0.000632,74.125.24.0-255,2543,31512,77,365433
18247,0.000635,172.31.40.0-255,66,31578,77,365433
18248,0.000643,74.125.24.0-255,7156,38734,77,365433
18249,0.000645,172.31.40.0-255,66,38800,77,365433
18250,0.00068,74.125.24.0-255,9633,48433,77,365433
18251,0.000683,172.31.40.0-255,66,48499,77,365433
18252,0.000707,74.125.24.0-255,1484,49983,77,365433
18253,0.000709,172.31.40.0-255,66,50049,77,365433
18254,0.000714,74.125.24.0-255,2902,52951,77,365433
18255,0.000716,172.31.40.0-255,66,53017,77,365433
18256,0.000751,74.125.24.0-255,5738,58755,77,365433
18257,0.000755,74.125.24.0-255,2902,61657,77,365433
18258,0.000763,172.31.40.0-255,101,61758,77,365433
18259,0.000768,172.31.40.0-255,66,61824,77,365433
18260,0.000785,172.31.40.0-255,66,61890,77,365433
18261,0.000791,74.125.24.0-255,3961,65851,77,365433
18262,0.000793,172.31.40.0-255,66,65917,77,365433
18263,0.000911,74.125.24.0-255,410,66327,77,365433
18264,0.000968,74.125.24.0-255,1484,67811,77,365433
18265,0.000972,172.31.40.0-255,66,67877,77,365433
18266,0.000979,74.125.24.0-255,4320,72197,77,365433
18267,0.00098,172.31.40.0-255,66,72263,77,365433
18268,0.000991,74.125.24.0-255,5738,78001,77,365433
18269,0.000993,172.31.40.0-255,66,78067,77,365433
18270,0.000996,74.125.24.0-255,1484,79551,77,365433
18271,0.001034,74.125.24.0-255,6797,86348,77,365433
18272,0.001042,74.125.24.0-255,8574,94922,77,365433
18273,0.001047,74.125.24.0-255,5625,100547,77,365433
18274,0.001052,172.31.40.0-255,66,100613,77,365433
18275,0.001062,172.31.40.0-255,66,100679,77,365433
18276,0.001068,172.31.40.0-255,66,100745,77,365433
18277,0.001173,74.125.24.0-255,1484,102229,77,365433
18278,0.001187,74.125.24.0-255,2902,105131,77,365433
18279,0.001191,172.31.40.0-255,66,105197,77,365433
18280,0.001197,74.125.24.0-255,4320,109517,77,365433
18281,0.001199,172.31.40.0-255,66,109583,77,365433
18282,0.001232,74.125.24.0-255,1484,111067,77,365433
18283,0.001242,74.125.24.0-255,11410,122477,77,365433
18284,0.001245,172.31.40.0-255,66,122543,77,365433
18285,0.001263,74.125.24.0-255,1484,124027,77,365433
18286,0.001269,74.125.24.0-255,4320,128347,77,365433
18287,0.001272,172.31.40.0-255,66,128413,77,365433
18288,0.0013,74.125.24.0-255,5738,134151,77,365433
18289,0.001304,172.31.40.0-255,66,134217,77,365433
18290,0.001326,74.125.24.0-255,766,134983,77,365433
18291,0.001595,74.125.24.0-255,1484,136467,77,365433
18292,0.0016,172.31.40.0-255,66,136533,77,365433
18293,0.001605,74.125.24.0-255,2902,139435,77,365433
18294,0.001607,172.31.40.0-255,66,139501,77,365433
18295,0.001629,74.125.24.0-255,5738,145239,77,365433
18296,0.001631,172.31.40.0-255,66,145305,77,365433
18297,0.001661,74.125.24.0-255,5738,151043,77,365433
18298,0.001663,172.31.40.0-255,66,151109,77,365433
18299,0.001675,74.125.24.0-255,1484,152593,77,365433
18300,0.001687,74.125.24.0-255,7156,159749,77,365433
18301,0.001689,172.31.40.0-255,66,159815,77,365433
18302,0.001726,74.125.24.0-255,7156,166971,77,365433
18303,0.001729,172.31.40.0-255,66,167037,77,365433
18304,0.001733,74.125.24.0-255,2184,169221,77,365433
18305,0.001735,172.31.40.0-255,66,169287,77,365433
18306,0.001756,74.125.24.0-255,1484,170771,77,365433
18307,0.001758,74.125.24.0-255,1484,172255,77,365433
18308,0.001761,172.31.40.0-255,66,172321,77,365433
18309,0.001788,74.125.24.0-255,1484,173805,77,365433
18310,0.001794,74.125.24.0-255,5738,179543,77,365433
18311,0.001797,172.31.40.0-255,66,179609,77,365433
18312,0.001802,74.125.24.0-255,4320,183929,77,365433
18313,0.001804,172.31.40.0-255,66,183995,77,365433
18314,0.001825,74.125.24.0-255,4320,188315,77,365433
18315,0.001827,172.31.40.0-255,66,188381,77,365433
18316,0.001875,172.31.40.0-255,66,188447,77,365433
18317,0.001881,74.125.24.0-255,7156,195603,77,365433
18318,0.001885,172.31.40.0-255,66,195669,77,365433
18319,0.001956,172.31.40.0-255,66,195735,77,365433
18320,0.001994,74.125.24.0-255,1484,197219,77,365433
18321,0.001998,74.125.24.0-255,1484,198703,77,365433
18322,0.002001,172.31.40.0-255,66,198769,77,365433
18323,0.002015,74.125.24.0-255,1484,200253,77,365433
18324,0.002026,74.125.24.0-255,5738,205991,77,365433
18325,0.002029,172.31.40.0-255,66,206057,77,365433
18326,0.002075,74.125.24.0-255,12828,218885,77,365433
18327,0.002079,172.31.40.0-255,66,218951,77,365433
18328,0.00209,74.125.24.0-255,10692,229643,77,365433
18329,0.002092,172.31.40.0-255,66,229709,77,365433
18330,0.002212,74.125.24.0-255,1484,231193,77,365433
18331,0.002218,74.125.24.0-255,2902,234095,77,365433
18332,0.002221,172.31.40.0-255,66,234161,77,365433
18333,0.002241,74.125.24.0-255,5738,239899,77,365433
18334,0.002245,172.31.40.0-255,66,239965,77,365433
18335,0.002257,74.125.24.0-255,2902,242867,77,365433
18336,0.00226,172.31.40.0-255,66,242933,77,365433
18337,0.002288,74.125.24.0-255,8574,251507,77,365433
18338,0.002292,172.31.40.0-255,66,251573,77,365433
18339,0.002302,74.125.24.0-255,12110,263683,77,365433
18340,0.002306,172.31.40.0-255,66,263749,77,365433
18341,0.002354,74.125.24.0-255,1484,265233,77,365433
18342,0.00236,74.125.24.0-255,2902,268135,77,365433
18343,0.002363,172.31.40.0-255,66,268201,77,365433
18344,0.00237,74.125.24.0-255,5738,273939,77,365433
18345,0.002372,172.31.40.0-255,66,274005,77,365433
18346,0.002404,74.125.24.0-255,11410,285415,77,365433
18347,0.002406,172.31.40.0-255,66,285481,77,365433
18348,0.002437,74.125.24.0-255,1484,286965,77,365433
18349,0.002448,74.125.24.0-255,10692,297657,77,365433
18350,0.002451,172.31.40.0-255,66,297723,77,365433
18351,0.002515,74.125.24.0-255,1484,299207,77,365433
18352,0.002519,74.125.24.0-255,1484,300691,77,365433
18353,0.002522,172.31.40.0-255,66,300757,77,365433
18354,0.002542,74.125.24.0-255,1484,302241,77,365433
18355,0.002548,74.125.24.0-255,5738,307979,77,365433
18356,0.002551,172.31.40.0-255,66,308045,77,365433
18357,0.002554,74.125.24.0-255,1484,309529,77,365433
18358,0.002596,74.125.24.0-255,11410,320939,77,365433
18359,0.0026,172.31.40.0-255,66,321005,77,365433
18360,0.002607,74.125.24.0-255,7156,328161,77,365433
18361,0.00261,172.31.40.0-255,66,328227,77,365433
18362,0.002615,74.125.24.0-255,3602,331829,77,365433
18363,0.002617,172.31.40.0-255,66,331895,77,365433
18364,0.003349,74.125.24.0-255,66,331961,77,365433
18365,0.005226,74.125.24.0-255,4320,336281,77,365433
18366,0.005234,172.31.40.0-255,66,336347,77,365433
18367,0.005262,74.125.24.0-255,1484,337831,77,365433
18368,0.007874,74.125.24.0-255,4320,342151,77,365433
18369,0.007881,172.31.40.0-255,66,342217,77,365433
18370,0.010529,74.125.24.0-255,5738,347955,77,365433
18371,0.010536,172.31.40.0-255,66,348021,77,365433
18372,0.013163,74.125.24.0-255,5738,353759,77,365433
18373,0.013172,172.31.40.0-255,66,353825,77,365433
18374,0.015801,74.125.24.0-255,5738,359563,77,365433
18375,0.01581,172.31.40.0-255,66,359629,77,365433
18376,0.01846,74.125.24.0-255,5738,365367,77,365433
18377,0.018468,172.31.40.0-255,66,365433,77,365433
18378,0.0,74.125.24.0-255,153,153,77,273856
18379,1.6e-05,172.31.40.0-255,66,219,77,273856
18380,2.4e-05,74.125.24.0-255,1484,1703,77,273856
18381,2.8e-05,172.31.40.0-255,66,1769,77,273856
18382,3.4e-05,74.125.24.0-255,2902,4671,77,273856
18383,4.6e-05,172.31.40.0-255,66,4737,77,273856
18384,5.2e-05,74.125.24.0-255,5738,10475,77,273856
18385,5.6e-05,172.31.40.0-255,66,10541,77,273856
18386,0.000109,74.125.24.0-255,3320,13861,77,273856
18387,0.000113,172.31.40.0-255,66,13927,77,273856
18388,0.00014,74.125.24.0-255,1484,15411,77,273856
18389,0.000143,172.31.40.0-255,66,15477,77,273856
18390,0.000148,74.125.24.0-255,2902,18379,77,273856
18391,0.00015,172.31.40.0-255,66,18445,77,273856
18392,0.000157,74.125.24.0-255,5738,24183,77,273856
18393,0.000164,172.31.40.0-255,66,24249,77,273856
18394,0.000197,74.125.24.0-255,6797,31046,77,273856
18395,0.0002,172.31.40.0-255,66,31112,77,273856
18396,0.000398,74.125.24.0-255,1484,32596,77,273856
18397,0.000404,172.31.40.0-255,66,32662,77,273856
18398,0.000409,74.125.24.0-255,2902,35564,77,273856
18399,0.000411,172.31.40.0-255,66,35630,77,273856
18400,0.000419,74.125.24.0-255,5738,41368,77,273856
18401,0.000427,172.31.40.0-255,66,41434,77,273856
18402,0.000467,74.125.24.0-255,6797,48231,77,273856
18403,0.00047,172.31.40.0-255,66,48297,77,273856
18404,0.000491,172.31.40.0-255,66,48363,77,273856
18405,0.000495,74.125.24.0-255,2543,50906,77,273856
18406,0.000497,172.31.40.0-255,66,50972,77,273856
18407,0.000557,74.125.24.0-255,399,51371,77,273856
18408,0.000561,172.31.40.0-255,66,51437,77,273856
18409,0.000621,74.125.24.0-255,345,51782,77,273856
18410,0.001034,172.31.40.0-255,66,51848,77,273856
18411,0.00122,74.125.24.0-255,1484,53332,77,273856
18412,0.001231,74.125.24.0-255,2902,56234,77,273856
18413,0.001235,172.31.40.0-255,66,56300,77,273856
18414,0.001241,74.125.24.0-255,2902,59202,77,273856
18415,0.001243,172.31.40.0-255,66,59268,77,273856
18416,0.00127,74.125.24.0-255,2902,62170,77,273856
18417,0.001272,172.31.40.0-255,66,62236,77,273856
18418,0.001284,74.125.24.0-255,12828,75064,77,273856
18419,0.001286,172.31.40.0-255,66,75130,77,273856
18420,0.001298,74.125.24.0-255,7156,82286,77,273856
18421,0.0013,172.31.40.0-255,66,82352,77,273856
18422,0.001325,74.125.24.0-255,1484,83836,77,273856
18423,0.001358,74.125.24.0-255,2184,86020,77,273856
18424,0.001361,172.31.40.0-255,66,86086,77,273856
18425,0.001408,74.125.24.0-255,1484,87570,77,273856
18426,0.001412,74.125.24.0-255,1484,89054,77,273856
18427,0.001415,172.31.40.0-255,66,89120,77,273856
18428,0.00144,74.125.24.0-255,1484,90604,77,273856
18429,0.001447,74.125.24.0-255,5738,96342,77,273856
18430,0.00145,172.31.40.0-255,66,96408,77,273856
18431,0.001459,74.125.24.0-255,8574,104982,77,273856
18432,0.001461,172.31.40.0-255,66,105048,77,273856
18433,0.001482,74.125.24.0-255,4320,109368,77,273856
18434,0.001484,172.31.40.0-255,66,109434,77,273856
18435,0.001499,74.125.24.0-255,10692,120126,77,273856
18436,0.001501,172.31.40.0-255,66,120192,77,273856
18437,0.001621,74.125.24.0-255,1484,121676,77,273856
18438,0.001628,74.125.24.0-255,2902,124578,77,273856
18439,0.001632,172.31.40.0-255,66,124644,77,273856
18440,0.001638,74.125.24.0-255,4320,128964,77,273856
18441,0.00164,172.31.40.0-255,66,129030,77,273856
18442,0.001658,74.125.24.0-255,1484,130514,77,273856
18443,0.001665,74.125.24.0-255,5738,136252,77,273856
18444,0.001667,172.31.40.0-255,66,136318,77,273856
18445,0.001704,74.125.24.0-255,7156,143474,77,273856
18446,0.001708,172.31.40.0-255,66,143540,77,273856
18447,0.001719,74.125.24.0-255,10692,154232,77,273856
18448,0.001726,172.31.40.0-255,66,154298,77,273856
18449,0.001828,74.125.24.0-255,1484,155782,77,273856
18450,0.001835,74.125.24.0-255,2902,158684,77,273856
18451,0.001838,172.31.40.0-255,66,158750,77,273856
18452,0.00187,74.125.24.0-255,5738,164488,77,273856
18453,0.001874,172.31.40.0-255,66,164554,77,273856
18454,0.001922,74.125.24.0-255,7156,171710,77,273856
18455,0.001925,172.31.40.0-255,66,171776,77,273856
18456,0.001953,74.125.24.0-255,5738,177514,77,273856
18457,0.001956,172.31.40.0-255,66,177580,77,273856
18458,0.001964,74.125.24.0-255,8574,186154,77,273856
18459,0.001966,172.31.40.0-255,66,186220,77,273856
18460,0.001993,172.31.40.0-255,66,186286,77,273856
18461,0.002004,74.125.24.0-255,12110,198396,77,273856
18462,0.002007,172.31.40.0-255,66,198462,77,273856
18463,0.002009,74.125.24.0-255,1484,199946,77,273856
18464,0.002014,74.125.24.0-255,2902,202848,77,273856
18465,0.002022,74.125.24.0-255,5738,208586,77,273856
18466,0.002028,172.31.40.0-255,66,208652,77,273856
18467,0.00203,172.31.40.0-255,66,208718,77,273856
18468,0.002079,74.125.24.0-255,12828,221546,77,273856
18469,0.002083,172.31.40.0-255,66,221612,77,273856
18470,0.00209,74.125.24.0-255,7156,228768,77,273856
18471,0.002092,172.31.40.0-255,66,228834,77,273856
18472,0.002122,74.125.24.0-255,3602,232436,77,273856
18473,0.002125,172.31.40.0-255,66,232502,77,273856
18474,0.00437,74.125.24.0-255,1484,233986,77,273856
18475,0.004415,74.125.24.0-255,4320,238306,77,273856
18476,0.004421,172.31.40.0-255,66,238372,77,273856
18477,0.00669,74.125.24.0-255,2902,241274,77,273856
18478,0.006697,172.31.40.0-255,66,241340,77,273856
18479,0.006727,74.125.24.0-255,2902,244242,77,273856
18480,0.00673,172.31.40.0-255,66,244308,77,273856
18481,0.008988,74.125.24.0-255,1484,245792,77,273856
18482,0.009012,74.125.24.0-255,1484,247276,77,273856
18483,0.009016,172.31.40.0-255,66,247342,77,273856
18484,0.009047,74.125.24.0-255,1484,248826,77,273856
18485,0.00906,74.125.24.0-255,1484,250310,77,273856
18486,0.009063,172.31.40.0-255,66,250376,77,273856
18487,0.01128,74.125.24.0-255,2902,253278,77,273856
18488,0.011295,172.31.40.0-255,66,253344,77,273856
18489,0.011334,74.125.24.0-255,2902,256246,77,273856
18490,0.011337,172.31.40.0-255,66,256312,77,273856
18491,0.013595,74.125.24.0-255,2902,259214,77,273856
18492,0.013602,172.31.40.0-255,66,259280,77,273856
18493,0.013635,74.125.24.0-255,2902,262182,77,273856
18494,0.013638,172.31.40.0-255,66,262248,77,273856
18495,0.01589,74.125.24.0-255,5738,267986,77,273856
18496,0.015898,172.31.40.0-255,66,268052,77,273856
18497,0.018193,74.125.24.0-255,5738,273790,77,273856
18498,0.018202,172.31.40.0-255,66,273856,77,273856
18499,0.0,74.125.24.0-255,297,297,77,348952
18500,2.4e-05,172.31.40.0-255,66,363,77,348952
18501,3.1e-05,74.125.24.0-255,1484,1847,77,348952
18502,3.6e-05,172.31.40.0-255,66,1913,77,348952
18503,4.3e-05,74.125.24.0-255,4320,6233,77,348952
18504,5.4e-05,172.31.40.0-255,66,6299,77,348952
18505,6.2e-05,74.125.24.0-255,7156,13455,77,348952
18506,6.4e-05,172.31.40.0-255,66,13521,77,348952
18507,6.7e-05,74.125.24.0-255,422,13943,77,348952
18508,6.9e-05,172.31.40.0-255,66,14009,77,348952
18509,0.000142,74.125.24.0-255,1484,15493,77,348952
18510,0.000145,172.31.40.0-255,66,15559,77,348952
18511,0.000149,74.125.24.0-255,2902,18461,77,348952
18512,0.000152,172.31.40.0-255,66,18527,77,348952
18513,0.000184,74.125.24.0-255,4320,22847,77,348952
18514,0.000186,172.31.40.0-255,66,22913,77,348952
18515,0.000207,74.125.24.0-255,1484,24397,77,348952
18516,0.000209,172.31.40.0-255,66,24463,77,348952
18517,0.000221,74.125.24.0-255,6797,31260,77,348952
18518,0.000224,172.31.40.0-255,66,31326,77,348952
18519,0.000231,74.125.24.0-255,7156,38482,77,348952
18520,0.000233,172.31.40.0-255,66,38548,77,348952
18521,0.000245,74.125.24.0-255,12828,51376,77,348952
18522,0.000248,172.31.40.0-255,66,51442,77,348952
18523,0.000288,74.125.24.0-255,2902,54344,77,348952
18524,0.000291,172.31.40.0-255,66,54410,77,348952
18525,0.000304,74.125.24.0-255,8574,62984,77,348952
18526,0.000307,172.31.40.0-255,66,63050,77,348952
18527,0.000311,74.125.24.0-255,2476,65526,77,348952
18528,0.000312,172.31.40.0-255,66,65592,77,348952
18529,0.000462,74.125.24.0-255,135,65727,77,348952
18530,0.000466,172.31.40.0-255,66,65793,77,348952
18531,0.000644,74.125.24.0-255,1484,67277,77,348952
18532,0.000652,74.125.24.0-255,2902,70179,77,348952
18533,0.000656,172.31.40.0-255,66,70245,77,348952
18534,0.000663,74.125.24.0-255,5738,75983,77,348952
18535,0.000665,172.31.40.0-255,66,76049,77,348952
18536,0.00071,74.125.24.0-255,12828,88877,77,348952
18537,0.000713,172.31.40.0-255,66,88943,77,348952
18538,0.000721,74.125.24.0-255,7156,96099,77,348952
18539,0.000723,172.31.40.0-255,66,96165,77,348952
18540,0.000749,74.125.24.0-255,3602,99767,77,348952
18541,0.000752,172.31.40.0-255,66,99833,77,348952
18542,0.001403,74.125.24.0-255,1484,101317,77,348952
18543,0.001418,74.125.24.0-255,2902,104219,77,348952
18544,0.001422,172.31.40.0-255,66,104285,77,348952
18545,0.001429,74.125.24.0-255,5738,110023,77,348952
18546,0.001431,172.31.40.0-255,66,110089,77,348952
18547,0.001464,74.125.24.0-255,8574,118663,77,348952
18548,0.001468,172.31.40.0-255,66,118729,77,348952
18549,0.001497,74.125.24.0-255,2902,121631,77,348952
18550,0.0015,172.31.40.0-255,66,121697,77,348952
18551,0.001538,74.125.24.0-255,12110,133807,77,348952
18552,0.001542,172.31.40.0-255,66,133873,77,348952
18553,0.001611,74.125.24.0-255,1484,135357,77,348952
18554,0.001615,74.125.24.0-255,1484,136841,77,348952
18555,0.001618,172.31.40.0-255,66,136907,77,348952
18556,0.001643,74.125.24.0-255,1484,138391,77,348952
18557,0.001649,74.125.24.0-255,4320,142711,77,348952
18558,0.001651,172.31.40.0-255,66,142777,77,348952
18559,0.001657,74.125.24.0-255,4320,147097,77,348952
18560,0.001659,172.31.40.0-255,66,147163,77,348952
18561,0.001679,74.125.24.0-255,1484,148647,77,348952
18562,0.0017,74.125.24.0-255,5738,154385,77,348952
18563,0.001703,172.31.40.0-255,66,154451,77,348952
18564,0.001727,74.125.24.0-255,4320,158771,77,348952
18565,0.00173,172.31.40.0-255,66,158837,77,348952
18566,0.001757,74.125.24.0-255,7156,165993,77,348952
18567,0.00176,172.31.40.0-255,66,166059,77,348952
18568,0.001786,74.125.24.0-255,2184,168243,77,348952
18569,0.001789,172.31.40.0-255,66,168309,77,348952
18570,0.001792,74.125.24.0-255,1484,169793,77,348952
18571,0.00183,74.125.24.0-255,2902,172695,77,348952
18572,0.001832,172.31.40.0-255,66,172761,77,348952
18573,0.001839,74.125.24.0-255,5738,178499,77,348952
18574,0.001841,172.31.40.0-255,66,178565,77,348952
18575,0.001854,74.125.24.0-255,7156,185721,77,348952
18576,0.001857,172.31.40.0-255,66,185787,77,348952
18577,0.001879,74.125.24.0-255,5738,191525,77,348952
18578,0.001887,172.31.40.0-255,66,191591,77,348952
18579,0.001917,74.125.24.0-255,10692,202283,77,348952
18580,0.001919,172.31.40.0-255,66,202349,77,348952
18581,0.002016,74.125.24.0-255,1484,203833,77,348952
18582,0.002039,74.125.24.0-255,2902,206735,77,348952
18583,0.002043,172.31.40.0-255,66,206801,77,348952
18584,0.002062,74.125.24.0-255,5738,212539,77,348952
18585,0.002064,172.31.40.0-255,66,212605,77,348952
18586,0.00207,74.125.24.0-255,5738,218343,77,348952
18587,0.002072,172.31.40.0-255,66,218409,77,348952
18588,0.002118,74.125.24.0-255,11410,229819,77,348952
18589,0.002121,172.31.40.0-255,66,229885,77,348952
18590,0.002152,74.125.24.0-255,1484,231369,77,348952
18591,0.002162,74.125.24.0-255,5020,236389,77,348952
18592,0.002167,172.31.40.0-255,66,236455,77,348952
18593,0.002191,74.125.24.0-255,1484,237939,77,348952
18594,0.002194,74.125.24.0-255,1484,239423,77,348952
18595,0.002196,172.31.40.0-255,66,239489,77,348952
18596,0.002218,74.125.24.0-255,1484,240973,77,348952
18597,0.002224,74.125.24.0-255,5738,246711,77,348952
18598,0.002226,172.31.40.0-255,66,246777,77,348952
18599,0.002239,74.125.24.0-255,7156,253933,77,348952
18600,0.002241,172.31.40.0-255,66,253999,77,348952
18601,0.002274,74.125.24.0-255,5738,259737,77,348952
18602,0.002277,172.31.40.0-255,66,259803,77,348952
18603,0.002307,74.125.24.0-255,10692,270495,77,348952
18604,0.00231,172.31.40.0-255,66,270561,77,348952
18605,0.002333,172.31.40.0-255,66,270627,77,348952
18606,0.002337,74.125.24.0-255,1484,272111,77,348952
18607,0.002342,74.125.24.0-255,4320,276431,77,348952
18608,0.002345,172.31.40.0-255,66,276497,77,348952
18609,0.002349,74.125.24.0-255,2184,278681,77,348952
18610,0.002352,172.31.40.0-255,66,278747,77,348952
18611,0.002404,74.125.24.0-255,1484,280231,77,348952
18612,0.002427,74.125.24.0-255,2902,283133,77,348952
18613,0.002431,172.31.40.0-255,66,283199,77,348952
18614,0.002437,74.125.24.0-255,5738,288937,77,348952
18615,0.00244,172.31.40.0-255,66,289003,77,348952
18616,0.00245,74.125.24.0-255,4320,293323,77,348952
18617,0.002452,172.31.40.0-255,66,293389,77,348952
18618,0.00247,74.125.24.0-255,8574,301963,77,348952
18619,0.002472,172.31.40.0-255,66,302029,77,348952
18620,0.002483,74.125.24.0-255,5738,307767,77,348952
18621,0.002486,172.31.40.0-255,66,307833,77,348952
18622,0.002514,74.125.24.0-255,2902,310735,77,348952
18623,0.002516,172.31.40.0-255,66,310801,77,348952
18624,0.00255,172.31.40.0-255,66,310867,77,348952
18625,0.002552,74.125.24.0-255,1484,312351,77,348952
18626,0.002557,74.125.24.0-255,2902,315253,77,348952
18627,0.00256,172.31.40.0-255,66,315319,77,348952
18628,0.002609,172.31.40.0-255,66,315385,77,348952
18629,0.002617,74.125.24.0-255,7156,322541,77,348952
18630,0.002619,172.31.40.0-255,66,322607,77,348952
18631,0.002621,74.125.24.0-255,1484,324091,77,348952
18632,0.002633,74.125.24.0-255,12828,336919,77,348952
18633,0.002636,172.31.40.0-255,66,336985,77,348952
18634,0.002642,74.125.24.0-255,5020,342005,77,348952
18635,0.002645,172.31.40.0-255,66,342071,77,348952
18636,0.002675,74.125.24.0-255,6473,348544,77,348952
18637,0.002677,172.31.40.0-255,66,348610,77,348952
18638,0.002741,74.125.24.0-255,105,348715,77,348952
18639,0.016934,172.31.40.0-255,66,348781,77,348952
18640,0.016988,172.31.40.0-255,105,348886,77,348952
18641,0.019226,74.125.24.0-255,66,348952,77,348952
18642,0.0,74.125.24.0-255,153,153,77,395797
18643,2.5e-05,172.31.40.0-255,66,219,77,395797
18644,3.3e-05,74.125.24.0-255,1484,1703,77,395797
18645,3.8e-05,172.31.40.0-255,66,1769,77,395797
18646,5.2e-05,74.125.24.0-255,2902,4671,77,395797
18647,5.6e-05,172.31.40.0-255,66,4737,77,395797
18648,6.7e-05,74.125.24.0-255,7156,11893,77,395797
18649,7e-05,172.31.40.0-255,66,11959,77,395797
18650,8.1e-05,74.125.24.0-255,11410,23369,77,395797
18651,8.4e-05,172.31.40.0-255,66,23435,77,395797
18652,0.000125,74.125.24.0-255,3386,26821,77,395797
18653,0.000128,172.31.40.0-255,66,26887,77,395797
18654,0.00015,172.31.40.0-255,66,26953,77,395797
18655,0.000156,74.125.24.0-255,5020,31973,77,395797
18656,0.000159,172.31.40.0-255,66,32039,77,395797
18657,0.000166,74.125.24.0-255,5738,37777,77,395797
18658,0.000168,172.31.40.0-255,66,37843,77,395797
18659,0.000208,74.125.24.0-255,11323,49166,77,395797
18660,0.000212,172.31.40.0-255,66,49232,77,395797
18661,0.000323,74.125.24.0-255,385,49617,77,395797
18662,0.000326,172.31.40.0-255,66,49683,77,395797
18663,0.000523,74.125.24.0-255,1484,51167,77,395797
18664,0.000529,172.31.40.0-255,66,51233,77,395797
18665,0.000534,74.125.24.0-255,2902,54135,77,395797
18666,0.000536,172.31.40.0-255,66,54201,77,395797
18667,0.000568,74.125.24.0-255,5738,59939,77,395797
18668,0.000571,172.31.40.0-255,66,60005,77,395797
18669,0.00058,74.125.24.0-255,8574,68579,77,395797
18670,0.000582,172.31.40.0-255,66,68645,77,395797
18671,0.000614,74.125.24.0-255,4320,72965,77,395797
18672,0.000616,172.31.40.0-255,66,73031,77,395797
18673,0.000622,74.125.24.0-255,5738,78769,77,395797
18674,0.000624,172.31.40.0-255,66,78835,77,395797
18675,0.000635,74.125.24.0-255,5020,83855,77,395797
18676,0.000637,172.31.40.0-255,66,83921,77,395797
18677,0.00098,74.125.24.0-255,1484,85405,77,395797
18678,0.000988,74.125.24.0-255,2902,88307,77,395797
18679,0.000991,172.31.40.0-255,66,88373,77,395797
18680,0.001004,74.125.24.0-255,2902,91275,77,395797
18681,0.001011,172.31.40.0-255,66,91341,77,395797
18682,0.001035,74.125.24.0-255,2902,94243,77,395797
18683,0.001037,172.31.40.0-255,66,94309,77,395797
18684,0.001048,74.125.24.0-255,12828,107137,77,395797
18685,0.00105,172.31.40.0-255,66,107203,77,395797
18686,0.00108,74.125.24.0-255,4320,111523,77,395797
18687,0.001082,172.31.40.0-255,66,111589,77,395797
18688,0.001108,74.125.24.0-255,6438,118027,77,395797
18689,0.001111,172.31.40.0-255,66,118093,77,395797
18690,0.001498,74.125.24.0-255,1484,119577,77,395797
18691,0.001502,74.125.24.0-255,1484,121061,77,395797
18692,0.001506,172.31.40.0-255,66,121127,77,395797
18693,0.001522,74.125.24.0-255,1484,122611,77,395797
18694,0.001527,74.125.24.0-255,2902,125513,77,395797
18695,0.001529,172.31.40.0-255,66,125579,77,395797
18696,0.001557,74.125.24.0-255,2902,128481,77,395797
18697,0.00156,172.31.40.0-255,66,128547,77,395797
18698,0.001564,74.125.24.0-255,2902,131449,77,395797
18699,0.001566,172.31.40.0-255,66,131515,77,395797
18700,0.001574,74.125.24.0-255,9992,141507,77,395797
18701,0.00158,172.31.40.0-255,66,141573,77,395797
18702,0.001583,74.125.24.0-255,1484,143057,77,395797
18703,0.001618,74.125.24.0-255,8574,151631,77,395797
18704,0.001621,172.31.40.0-255,66,151697,77,395797
18705,0.00163,74.125.24.0-255,10692,162389,77,395797
18706,0.001631,172.31.40.0-255,66,162455,77,395797
18707,0.001695,74.125.24.0-255,12828,175283,77,395797
18708,0.001698,172.31.40.0-255,66,175349,77,395797
18709,0.001707,74.125.24.0-255,10692,186041,77,395797
18710,0.001709,172.31.40.0-255,66,186107,77,395797
18711,0.00175,74.125.24.0-255,1484,187591,77,395797
18712,0.00177,74.125.24.0-255,2902,190493,77,395797
18713,0.001772,172.31.40.0-255,66,190559,77,395797
18714,0.001779,74.125.24.0-255,5738,196297,77,395797
18715,0.001781,172.31.40.0-255,66,196363,77,395797
18716,0.00181,74.125.24.0-255,7156,203519,77,395797
18717,0.001813,172.31.40.0-255,66,203585,77,395797
18718,0.001816,74.125.24.0-255,1484,205069,77,395797
18719,0.001847,74.125.24.0-255,12828,217897,77,395797
18720,0.00185,172.31.40.0-255,66,217963,77,395797
18721,0.001854,74.125.24.0-255,2184,220147,77,395797
18722,0.001856,172.31.40.0-255,66,220213,77,395797
18723,0.001874,74.125.24.0-255,1484,221697,77,395797
18724,0.001892,74.125.24.0-255,1484,223181,77,395797
18725,0.001894,172.31.40.0-255,66,223247,77,395797
18726,0.001899,74.125.24.0-255,4320,227567,77,395797
18727,0.001901,172.31.40.0-255,66,227633,77,395797
18728,0.001926,74.125.24.0-255,5738,233371,77,395797
18729,0.001932,172.31.40.0-255,66,233437,77,395797
18730,0.001935,74.125.24.0-255,1484,234921,77,395797
18731,0.00197,74.125.24.0-255,9992,244913,77,395797
18732,0.001973,172.31.40.0-255,66,244979,77,395797
18733,0.002005,74.125.24.0-255,12110,257089,77,395797
18734,0.002008,172.31.40.0-255,66,257155,77,395797
18735,0.002012,74.125.24.0-255,2902,260057,77,395797
18736,0.002014,172.31.40.0-255,66,260123,77,395797
18737,0.002035,74.125.24.0-255,4320,264443,77,395797
18738,0.002038,172.31.40.0-255,66,264509,77,395797
18739,0.002071,74.125.24.0-255,12828,277337,77,395797
18740,0.002073,172.31.40.0-255,66,277403,77,395797
18741,0.002079,74.125.24.0-255,5738,283141,77,395797
18742,0.002081,172.31.40.0-255,66,283207,77,395797
18743,0.002107,74.125.24.0-255,5020,288227,77,395797
18744,0.002109,172.31.40.0-255,66,288293,77,395797
18745,0.002154,74.125.24.0-255,2902,291195,77,395797
18746,0.002157,172.31.40.0-255,66,291261,77,395797
18747,0.002185,74.125.24.0-255,1484,292745,77,395797
18748,0.002193,74.125.24.0-255,5738,298483,77,395797
18749,0.002201,74.125.24.0-255,8574,307057,77,395797
18750,0.002215,74.125.24.0-255,2902,309959,77,395797
18751,0.00222,74.125.24.0-255,4320,314279,77,395797
18752,0.002252,74.125.24.0-255,2902,317181,77,395797
18753,0.002274,74.125.24.0-255,5020,322201,77,395797
18754,0.002298,74.125.24.0-255,2902,325103,77,395797
18755,0.002316,74.125.24.0-255,5738,330841,77,395797
18756,0.002329,74.125.24.0-255,2902,333743,77,395797
18757,0.002346,74.125.24.0-255,7156,340899,77,395797
18758,0.002413,74.125.24.0-255,8574,349473,77,395797
18759,0.002431,74.125.24.0-255,4320,353793,77,395797
18760,0.002442,74.125.24.0-255,13528,367321,77,395797
18761,0.002448,74.125.24.0-255,4320,371641,77,395797
18762,0.002465,74.125.24.0-255,4320,375961,77,395797
18763,0.002485,74.125.24.0-255,12828,388789,77,395797
18764,0.00251,74.125.24.0-255,4320,393109,77,395797
18765,0.002529,74.125.24.0-255,2163,395272,77,395797
18766,0.002566,74.125.24.0-255,105,395377,77,395797
18767,0.010324,172.31.40.0-255,66,395443,77,395797
18768,0.012632,172.31.40.0-255,105,395548,77,395797
18769,0.012793,74.125.24.0-255,105,395653,77,395797
18770,0.012804,172.31.40.0-255,78,395731,77,395797
18771,0.015212,74.125.24.0-255,66,395797,77,395797
18772,0.0,74.125.68.0-255,153,153,77,175890
18773,2.6e-05,172.31.40.0-255,66,219,77,175890
18774,3.4e-05,74.125.68.0-255,1484,1703,77,175890
18775,3.8e-05,172.31.40.0-255,66,1769,77,175890
18776,4.2e-05,74.125.68.0-255,1484,3253,77,175890
18777,4.5e-05,172.31.40.0-255,66,3319,77,175890
18778,7.3e-05,74.125.68.0-255,2902,6221,77,175890
18779,7.7e-05,172.31.40.0-255,66,6287,77,175890
18780,8.1e-05,74.125.68.0-255,1484,7771,77,175890
18781,8.3e-05,172.31.40.0-255,66,7837,77,175890
18782,0.000101,74.125.68.0-255,4320,12157,77,175890
18783,0.000104,172.31.40.0-255,66,12223,77,175890
18784,0.000107,74.125.68.0-255,1484,13707,77,175890
18785,0.000109,172.31.40.0-255,66,13773,77,175890
18786,0.000133,74.125.68.0-255,682,14455,77,175890
18787,0.000136,172.31.40.0-255,66,14521,77,175890
18788,0.000252,74.125.68.0-255,1484,16005,77,175890
18789,0.000257,172.31.40.0-255,66,16071,77,175890
18790,0.000276,74.125.68.0-255,2902,18973,77,175890
18791,0.000279,172.31.40.0-255,66,19039,77,175890
18792,0.00032,74.125.68.0-255,4320,23359,77,175890
18793,0.000324,172.31.40.0-255,66,23425,77,175890
18794,0.00033,74.125.68.0-255,5738,29163,77,175890
18795,0.000333,172.31.40.0-255,66,29229,77,175890
18796,0.000351,74.125.68.0-255,2543,31772,77,175890
18797,0.000353,172.31.40.0-255,66,31838,77,175890
18798,0.000373,74.125.68.0-255,1484,33322,77,175890
18799,0.000376,172.31.40.0-255,66,33388,77,175890
18800,0.000396,74.125.68.0-255,1484,34872,77,175890
18801,0.000399,172.31.40.0-255,66,34938,77,175890
18802,0.000409,74.125.68.0-255,7156,42094,77,175890
18803,0.000412,172.31.40.0-255,66,42160,77,175890
18804,0.000456,74.125.68.0-255,2902,45062,77,175890
18805,0.000458,172.31.40.0-255,66,45128,77,175890
18806,0.000476,74.125.68.0-255,3961,49089,77,175890
18807,0.000479,172.31.40.0-255,66,49155,77,175890
18808,0.000513,74.125.68.0-255,1484,50639,77,175890
18809,0.000536,74.125.68.0-255,2902,53541,77,175890
18810,0.000539,172.31.40.0-255,66,53607,77,175890
18811,0.000559,74.125.68.0-255,4320,57927,77,175890
18812,0.000562,172.31.40.0-255,66,57993,77,175890
18813,0.000598,74.125.68.0-255,2902,60895,77,175890
18814,0.000601,172.31.40.0-255,66,60961,77,175890
18815,0.000626,74.125.68.0-255,5379,66340,77,175890
18816,0.000635,172.31.40.0-255,66,66406,77,175890
18817,0.000638,74.125.68.0-255,396,66802,77,175890
18818,0.000871,74.125.68.0-255,113,66915,77,175890
18819,0.001042,74.125.68.0-255,1484,68399,77,175890
18820,0.001046,172.31.40.0-255,66,68465,77,175890
18821,0.00105,74.125.68.0-255,1484,69949,77,175890
18822,0.001054,74.125.68.0-255,1484,71433,77,175890
18823,0.001056,172.31.40.0-255,66,71499,77,175890
18824,0.001069,74.125.68.0-255,1484,72983,77,175890
18825,0.001082,74.125.68.0-255,4320,77303,77,175890
18826,0.001085,172.31.40.0-255,66,77369,77,175890
18827,0.001103,74.125.68.0-255,1484,78853,77,175890
18828,0.001108,74.125.68.0-255,4320,83173,77,175890
18829,0.00111,172.31.40.0-255,66,83239,77,175890
18830,0.001118,172.31.40.0-255,101,83340,77,175890
18831,0.001151,74.125.68.0-255,1125,84465,77,175890
18832,0.001186,74.125.68.0-255,1484,85949,77,175890
18833,0.00119,172.31.40.0-255,66,86015,77,175890
18834,0.001193,74.125.68.0-255,1484,87499,77,175890
18835,0.00122,74.125.68.0-255,2902,90401,77,175890
18836,0.001223,172.31.40.0-255,66,90467,77,175890
18837,0.001245,74.125.68.0-255,2902,93369,77,175890
18838,0.001248,172.31.40.0-255,66,93435,77,175890
18839,0.001269,74.125.68.0-255,2902,96337,77,175890
18840,0.001273,172.31.40.0-255,66,96403,77,175890
18841,0.001276,74.125.68.0-255,1484,97887,77,175890
18842,0.001292,74.125.68.0-255,1484,99371,77,175890
18843,0.001294,172.31.40.0-255,66,99437,77,175890
18844,0.001309,74.125.68.0-255,1484,100921,77,175890
18845,0.001311,74.125.68.0-255,1125,102046,77,175890
18846,0.001313,172.31.40.0-255,66,102112,77,175890
18847,0.002082,74.125.68.0-255,1484,103596,77,175890
18848,0.002129,74.125.68.0-255,2902,106498,77,175890
18849,0.002136,172.31.40.0-255,66,106564,77,175890
18850,0.002142,74.125.68.0-255,2902,109466,77,175890
18851,0.002144,172.31.40.0-255,66,109532,77,175890
18852,0.002157,74.125.68.0-255,1484,111016,77,175890
18853,0.002192,74.125.68.0-255,1484,112500,77,175890
18854,0.002195,172.31.40.0-255,66,112566,77,175890
18855,0.002219,74.125.68.0-255,5738,118304,77,175890
18856,0.002222,172.31.40.0-255,66,118370,77,175890
18857,0.00223,74.125.68.0-255,8574,126944,77,175890
18858,0.002232,172.31.40.0-255,66,127010,77,175890
18859,0.002237,74.125.68.0-255,2902,129912,77,175890
18860,0.002239,172.31.40.0-255,66,129978,77,175890
18861,0.002285,74.125.68.0-255,1484,131462,77,175890
18862,0.0023,74.125.68.0-255,5020,136482,77,175890
18863,0.002303,172.31.40.0-255,66,136548,77,175890
18864,0.003417,74.125.68.0-255,66,136614,77,175890
18865,0.004606,74.125.68.0-255,4320,140934,77,175890
18866,0.004611,172.31.40.0-255,66,141000,77,175890
18867,0.004623,74.125.68.0-255,1484,142484,77,175890
18868,0.00693,74.125.68.0-255,4320,146804,77,175890
18869,0.006934,172.31.40.0-255,66,146870,77,175890
18870,0.009258,74.125.68.0-255,5738,152608,77,175890
18871,0.009266,172.31.40.0-255,66,152674,77,175890
18872,0.011616,74.125.68.0-255,5738,158412,77,175890
18873,0.011625,172.31.40.0-255,66,158478,77,175890
18874,0.013951,74.125.68.0-255,5738,164216,77,175890
18875,0.01396,172.31.40.0-255,66,164282,77,175890
18876,0.016282,74.125.68.0-255,5738,170020,77,175890
18877,0.016297,172.31.40.0-255,66,170086,77,175890
18878,0.018644,74.125.68.0-255,5738,175824,77,175890
18879,0.018663,172.31.40.0-255,66,175890,77,175890
18880,0.0,74.125.130.0-255,150,150,77,182471
18881,2.6e-05,172.31.40.0-255,66,216,77,182471
18882,3.3e-05,74.125.130.0-255,1484,1700,77,182471
18883,3.8e-05,172.31.40.0-255,66,1766,77,182471
18884,4.4e-05,74.125.130.0-255,2902,4668,77,182471
18885,4.8e-05,172.31.40.0-255,66,4734,77,182471
18886,6.6e-05,74.125.130.0-255,7156,11890,77,182471
18887,7e-05,172.31.40.0-255,66,11956,77,182471
18888,0.0001,74.125.130.0-255,1484,13440,77,182471
18889,0.000102,172.31.40.0-255,66,13506,77,182471
18890,0.000131,74.125.130.0-255,1991,15497,77,182471
18891,0.000133,172.31.40.0-255,66,15563,77,182471
18892,0.000141,74.125.130.0-255,5738,21301,77,182471
18893,0.000144,172.31.40.0-255,66,21367,77,182471
18894,0.000149,74.125.130.0-255,2902,24269,77,182471
18895,0.000151,172.31.40.0-255,66,24335,77,182471
18896,0.000175,74.125.130.0-255,4320,28655,77,182471
18897,0.000178,172.31.40.0-255,66,28721,77,182471
18898,0.000213,74.125.130.0-255,2543,31264,77,182471
18899,0.000215,172.31.40.0-255,66,31330,77,182471
18900,0.000303,74.125.130.0-255,1484,32814,77,182471
18901,0.000306,172.31.40.0-255,66,32880,77,182471
18902,0.000333,74.125.130.0-255,2902,35782,77,182471
18903,0.000336,172.31.40.0-255,66,35848,77,182471
18904,0.000354,74.125.130.0-255,1484,37332,77,182471
18905,0.000357,172.31.40.0-255,66,37398,77,182471
18906,0.000389,74.125.130.0-255,4320,41718,77,182471
18907,0.000392,172.31.40.0-255,66,41784,77,182471
18908,0.000396,74.125.130.0-255,2902,44686,77,182471
18909,0.000399,172.31.40.0-255,66,44752,77,182471
18910,0.000404,74.125.130.0-255,4320,49072,77,182471
18911,0.000406,172.31.40.0-255,66,49138,77,182471
18912,0.000415,74.125.130.0-255,8574,57712,77,182471
18913,0.000418,172.31.40.0-255,66,57778,77,182471
18914,0.000438,74.125.130.0-255,4320,62098,77,182471
18915,0.000442,172.31.40.0-255,66,62164,77,182471
18916,0.000477,74.125.130.0-255,3915,66079,77,182471
18917,0.000481,172.31.40.0-255,66,66145,77,182471
18918,0.000564,74.125.130.0-255,98,66243,77,182471
18919,0.000808,74.125.130.0-255,1484,67727,77,182471
18920,0.000814,172.31.40.0-255,66,67793,77,182471
18921,0.000818,74.125.130.0-255,1484,69277,77,182471
18922,0.000841,74.125.130.0-255,1484,70761,77,182471
18923,0.000843,172.31.40.0-255,66,70827,77,182471
18924,0.000851,74.125.130.0-255,5738,76565,77,182471
18925,0.000855,172.31.40.0-255,66,76631,77,182471
18926,0.000886,74.125.130.0-255,2902,79533,77,182471
18927,0.000889,172.31.40.0-255,66,79599,77,182471
18928,0.000904,74.125.130.0-255,2902,82501,77,182471
18929,0.000906,172.31.40.0-255,66,82567,77,182471
18930,0.000938,74.125.130.0-255,1484,84051,77,182471
18931,0.000944,74.125.130.0-255,4320,88371,77,182471
18932,0.000947,172.31.40.0-255,66,88437,77,182471
18933,0.000954,74.125.130.0-255,5738,94175,77,182471
18934,0.000957,172.31.40.0-255,66,94241,77,182471
18935,0.000962,74.125.130.0-255,4320,98561,77,182471
18936,0.000964,172.31.40.0-255,66,98627,77,182471
18937,0.001009,74.125.130.0-255,2184,100811,77,182471
18938,0.001013,172.31.40.0-255,66,100877,77,182471
18939,0.001701,74.125.130.0-255,1484,102361,77,182471
18940,0.001709,74.125.130.0-255,1484,103845,77,182471
18941,0.001712,172.31.40.0-255,66,103911,77,182471
18942,0.001742,74.125.130.0-255,2902,106813,77,182471
18943,0.001745,172.31.40.0-255,66,106879,77,182471
18944,0.001749,74.125.130.0-255,1484,108363,77,182471
18945,0.001768,74.125.130.0-255,4320,112683,77,182471
18946,0.00177,172.31.40.0-255,66,112749,77,182471
18947,0.001774,74.125.130.0-255,1484,114233,77,182471
18948,0.001797,74.125.130.0-255,2902,117135,77,182471
18949,0.0018,172.31.40.0-255,66,117201,77,182471
18950,0.001803,74.125.130.0-255,1484,118685,77,182471
18951,0.001833,74.125.130.0-255,4320,123005,77,182471
18952,0.001836,172.31.40.0-255,66,123071,77,182471
18953,0.001839,74.125.130.0-255,1484,124555,77,182471
18954,0.001843,74.125.130.0-255,2902,127457,77,182471
18955,0.001846,172.31.40.0-255,66,127523,77,182471
18956,0.001874,74.125.130.0-255,5738,133261,77,182471
18957,0.001877,172.31.40.0-255,66,133327,77,182471
18958,0.001879,74.125.130.0-255,1484,134811,77,182471
18959,0.00191,74.125.130.0-255,766,135577,77,182471
18960,0.001912,172.31.40.0-255,66,135643,77,182471
18961,0.003939,74.125.130.0-255,2902,138545,77,182471
18962,0.003953,172.31.40.0-255,66,138611,77,182471
18963,0.003987,74.125.130.0-255,2902,141513,77,182471
18964,0.00399,172.31.40.0-255,66,141579,77,182471
18965,0.006015,74.125.130.0-255,2902,144481,77,182471
18966,0.006022,172.31.40.0-255,66,144547,77,182471
18967,0.006052,74.125.130.0-255,2902,147449,77,182471
18968,0.006055,172.31.40.0-255,66,147515,77,182471
18969,0.008093,74.125.130.0-255,2902,150417,77,182471
18970,0.008101,172.31.40.0-255,66,150483,77,182471
18971,0.008132,74.125.130.0-255,2902,153385,77,182471
18972,0.008135,172.31.40.0-255,66,153451,77,182471
18973,0.010184,74.125.130.0-255,5738,159189,77,182471
18974,0.0102,172.31.40.0-255,66,159255,77,182471
18975,0.012282,74.125.130.0-255,5738,164993,77,182471
18976,0.012304,172.31.40.0-255,66,165059,77,182471
18977,0.014408,74.125.130.0-255,5738,170797,77,182471
18978,0.014428,172.31.40.0-255,66,170863,77,182471
18979,0.016499,74.125.130.0-255,5738,176601,77,182471
18980,0.016516,172.31.40.0-255,66,176667,77,182471
18981,0.018601,74.125.130.0-255,5738,182405,77,182471
18982,0.018622,172.31.40.0-255,66,182471,77,182471
18983,0.0,172.217.194.0-255,153,153,77,260630
18984,1.5e-05,172.31.40.0-255,66,219,77,260630
18985,2.2e-05,172.217.194.0-255,1484,1703,77,260630
18986,2.7e-05,172.31.40.0-255,66,1769,77,260630
18987,3.2e-05,172.217.194.0-255,2902,4671,77,260630
18988,3.5e-05,172.31.40.0-255,66,4737,77,260630
18989,4.1e-05,172.217.194.0-255,4320,9057,77,260630
18990,4.3e-05,172.31.40.0-255,66,9123,77,260630
18991,8.8e-05,172.217.194.0-255,7156,16279,77,260630
18992,9.1e-05,172.31.40.0-255,66,16345,77,260630
18993,0.000112,172.217.194.0-255,612,16957,77,260630
18994,0.000115,172.31.40.0-255,66,17023,77,260630
18995,0.000123,172.217.194.0-255,8574,25597,77,260630
18996,0.000126,172.31.40.0-255,66,25663,77,260630
18997,0.000129,172.217.194.0-255,1484,27147,77,260630
18998,0.000131,172.31.40.0-255,66,27213,77,260630
18999,0.000151,172.217.194.0-255,3961,31174,77,260630
19000,0.000154,172.31.40.0-255,66,31240,77,260630
19001,0.000177,172.217.194.0-255,5738,36978,77,260630
19002,0.00018,172.31.40.0-255,66,37044,77,260630
19003,0.000184,172.217.194.0-255,2902,39946,77,260630
19004,0.000186,172.31.40.0-255,66,40012,77,260630
19005,0.0002,172.217.194.0-255,2902,42914,77,260630
19006,0.000203,172.31.40.0-255,66,42980,77,260630
19007,0.000223,172.217.194.0-255,4320,47300,77,260630
19008,0.000226,172.31.40.0-255,66,47366,77,260630
19009,0.000247,172.217.194.0-255,9633,56999,77,260630
19010,0.000249,172.31.40.0-255,66,57065,77,260630
19011,0.000257,172.217.194.0-255,8215,65280,77,260630
19012,0.00026,172.31.40.0-255,66,65346,77,260630
19013,0.000276,172.217.194.0-255,379,65725,77,260630
19014,0.000278,172.31.40.0-255,66,65791,77,260630
19015,0.00048,172.217.194.0-255,100,65891,77,260630
19016,0.000571,172.217.194.0-255,1484,67375,77,260630
19017,0.000576,172.31.40.0-255,66,67441,77,260630
19018,0.000582,172.217.194.0-255,2902,70343,77,260630
19019,0.000585,172.31.40.0-255,66,70409,77,260630
19020,0.000589,172.217.194.0-255,2902,73311,77,260630
19021,0.000592,172.31.40.0-255,66,73377,77,260630
19022,0.000621,172.217.194.0-255,2902,76279,77,260630
19023,0.000624,172.31.40.0-255,66,76345,77,260630
19024,0.000632,172.217.194.0-255,6797,83142,77,260630
19025,0.000634,172.31.40.0-255,66,83208,77,260630
19026,0.000694,172.217.194.0-255,9992,93200,77,260630
19027,0.000697,172.31.40.0-255,66,93266,77,260630
19028,0.000705,172.217.194.0-255,7095,100361,77,260630
19029,0.000707,172.31.40.0-255,66,100427,77,260630
19030,0.001322,172.217.194.0-255,1484,101911,77,260630
19031,0.001329,172.217.194.0-255,2902,104813,77,260630
19032,0.001332,172.31.40.0-255,66,104879,77,260630
19033,0.001351,172.217.194.0-255,4320,109199,77,260630
19034,0.001354,172.31.40.0-255,66,109265,77,260630
19035,0.001373,172.217.194.0-255,1484,110749,77,260630
19036,0.00138,172.217.194.0-255,5738,116487,77,260630
19037,0.001382,172.31.40.0-255,66,116553,77,260630
19038,0.001395,172.217.194.0-255,1484,118037,77,260630
19039,0.001422,172.31.40.0-255,66,118103,77,260630
19040,0.001426,172.217.194.0-255,2184,120287,77,260630
19041,0.001428,172.31.40.0-255,66,120353,77,260630
19042,0.001527,172.31.40.0-255,101,120454,77,260630
19043,0.00192,172.217.194.0-255,1484,121938,77,260630
19044,0.001931,172.217.194.0-255,2902,124840,77,260630
19045,0.001935,172.31.40.0-255,66,124906,77,260630
19046,0.001942,172.217.194.0-255,5738,130644,77,260630
19047,0.001944,172.31.40.0-255,66,130710,77,260630
19048,0.001949,172.217.194.0-255,2902,133612,77,260630
19049,0.001951,172.31.40.0-255,66,133678,77,260630
19050,0.001978,172.217.194.0-255,9992,143670,77,260630
19051,0.00198,172.31.40.0-255,66,143736,77,260630
19052,0.001985,172.217.194.0-255,4320,148056,77,260630
19053,0.001987,172.31.40.0-255,66,148122,77,260630
19054,0.00201,172.217.194.0-255,6438,154560,77,260630
19055,0.002012,172.31.40.0-255,66,154626,77,260630
19056,0.00205,172.217.194.0-255,1484,156110,77,260630
19057,0.002056,172.217.194.0-255,2902,159012,77,260630
19058,0.002058,172.31.40.0-255,66,159078,77,260630
19059,0.002065,172.217.194.0-255,5738,164816,77,260630
19060,0.002067,172.31.40.0-255,66,164882,77,260630
19061,0.002088,172.217.194.0-255,8574,173456,77,260630
19062,0.00209,172.31.40.0-255,66,173522,77,260630
19063,0.002139,172.217.194.0-255,4320,177842,77,260630
19064,0.002142,172.31.40.0-255,66,177908,77,260630
19065,0.002172,172.217.194.0-255,10692,188600,77,260630
19066,0.002175,172.31.40.0-255,66,188666,77,260630
19067,0.002178,172.217.194.0-255,1484,190150,77,260630
19068,0.002201,172.217.194.0-255,2902,193052,77,260630
19069,0.002204,172.31.40.0-255,66,193118,77,260630
19070,0.002211,172.217.194.0-255,5738,198856,77,260630
19071,0.002213,172.31.40.0-255,66,198922,77,260630
19072,0.002216,172.217.194.0-255,1484,200406,77,260630
19073,0.002246,172.217.194.0-255,11410,211816,77,260630
19074,0.002249,172.31.40.0-255,66,211882,77,260630
19075,0.002259,172.217.194.0-255,9992,221874,77,260630
19076,0.002261,172.31.40.0-255,66,221940,77,260630
19077,0.002278,172.217.194.0-255,766,222706,77,260630
19078,0.003827,172.217.194.0-255,66,222772,77,260630
19079,0.004619,172.217.194.0-255,4320,227092,77,260630
19080,0.004625,172.31.40.0-255,66,227158,77,260630
19081,0.006998,172.217.194.0-255,4320,231478,77,260630
19082,0.007004,172.31.40.0-255,66,231544,77,260630
19083,0.007023,172.217.194.0-255,1484,233028,77,260630
19084,0.009352,172.217.194.0-255,4320,237348,77,260630
19085,0.009359,172.31.40.0-255,66,237414,77,260630
19086,0.011711,172.217.194.0-255,5738,243152,77,260630
19087,0.01172,172.31.40.0-255,66,243218,77,260630
19088,0.014077,172.217.194.0-255,5738,248956,77,260630
19089,0.014096,172.31.40.0-255,66,249022,77,260630
19090,0.01649,172.217.194.0-255,5738,254760,77,260630
19091,0.016507,172.31.40.0-255,66,254826,77,260630
19092,0.01885,172.217.194.0-255,5738,260564,77,260630
19093,0.018858,172.31.40.0-255,66,260630,77,260630
19094,0.0,74.125.24.0-255,298,298,77,394892
19095,1.9e-05,172.31.40.0-255,66,364,77,394892
19096,2.5e-05,74.125.24.0-255,1484,1848,77,394892
19097,2.9e-05,172.31.40.0-255,66,1914,77,394892
19098,3.4e-05,74.125.24.0-255,2902,4816,77,394892
19099,3.7e-05,172.31.40.0-255,66,4882,77,394892
19100,6e-05,74.125.24.0-255,1484,6366,77,394892
19101,6.2e-05,172.31.40.0-255,66,6432,77,394892
19102,7.8e-05,74.125.24.0-255,5738,12170,77,394892
19103,8e-05,172.31.40.0-255,66,12236,77,394892
19104,9.5e-05,74.125.24.0-255,3211,15447,77,394892
19105,9.7e-05,172.31.40.0-255,66,15513,77,394892
19106,0.000101,74.125.24.0-255,2902,18415,77,394892
19107,0.000103,172.31.40.0-255,66,18481,77,394892
19108,0.000131,74.125.24.0-255,7156,25637,77,394892
19109,0.000133,172.31.40.0-255,66,25703,77,394892
19110,0.000138,74.125.24.0-255,4320,30023,77,394892
19111,0.00014,172.31.40.0-255,66,30089,77,394892
19112,0.000167,74.125.24.0-255,1125,31214,77,394892
19113,0.000169,172.31.40.0-255,66,31280,77,394892
19114,0.000284,74.125.24.0-255,1484,32764,77,394892
19115,0.000288,172.31.40.0-255,66,32830,77,394892
19116,0.00031,74.125.24.0-255,2902,35732,77,394892
19117,0.000313,172.31.40.0-255,66,35798,77,394892
19118,0.000317,74.125.24.0-255,2902,38700,77,394892
19119,0.000319,172.31.40.0-255,66,38766,77,394892
19120,0.000332,74.125.24.0-255,1484,40250,77,394892
19121,0.000335,172.31.40.0-255,66,40316,77,394892
19122,0.000341,74.125.24.0-255,4320,44636,77,394892
19123,0.000343,172.31.40.0-255,66,44702,77,394892
19124,0.000364,74.125.24.0-255,1484,46186,77,394892
19125,0.000366,172.31.40.0-255,66,46252,77,394892
19126,0.00041,74.125.24.0-255,1484,47736,77,394892
19127,0.000417,74.125.24.0-255,2902,50638,77,394892
19128,0.00042,172.31.40.0-255,66,50704,77,394892
19129,0.000426,74.125.24.0-255,4320,55024,77,394892
19130,0.000428,172.31.40.0-255,66,55090,77,394892
19131,0.000442,74.125.24.0-255,1484,56574,77,394892
19132,0.000475,74.125.24.0-255,5738,62312,77,394892
19133,0.000478,172.31.40.0-255,66,62378,77,394892
19134,0.000497,74.125.24.0-255,3602,65980,77,394892
19135,0.000499,172.31.40.0-255,66,66046,77,394892
19136,0.000512,74.125.24.0-255,399,66445,77,394892
19137,0.000536,74.125.24.0-255,110,66555,77,394892
19138,0.000633,74.125.24.0-255,1484,68039,77,394892
19139,0.000637,172.31.40.0-255,66,68105,77,394892
19140,0.000673,74.125.24.0-255,1484,69589,77,394892
19141,0.000692,74.125.24.0-255,2902,72491,77,394892
19142,0.000696,172.31.40.0-255,66,72557,77,394892
19143,0.00071,74.125.24.0-255,4320,76877,77,394892
19144,0.000712,172.31.40.0-255,66,76943,77,394892
19145,0.000722,74.125.24.0-255,1484,78427,77,394892
19146,0.000728,74.125.24.0-255,4320,82747,77,394892
19147,0.00073,172.31.40.0-255,66,82813,77,394892
19148,0.000752,74.125.24.0-255,5738,88551,77,394892
19149,0.000754,172.31.40.0-255,66,88617,77,394892
19150,0.000768,74.125.24.0-255,5738,94355,77,394892
19151,0.00077,172.31.40.0-255,66,94421,77,394892
19152,0.000796,74.125.24.0-255,1484,95905,77,394892
19153,0.000813,74.125.24.0-255,5020,100925,77,394892
19154,0.000816,172.31.40.0-255,66,100991,77,394892
19155,0.000841,74.125.24.0-255,1484,102475,77,394892
19156,0.000862,74.125.24.0-255,2902,105377,77,394892
19157,0.000864,74.125.24.0-255,1484,106861,77,394892
19158,0.000867,172.31.40.0-255,66,106927,77,394892
19159,0.000882,74.125.24.0-255,1484,108411,77,394892
19160,0.000884,172.31.40.0-255,66,108477,77,394892
19161,0.000966,74.125.24.0-255,5738,114215,77,394892
19162,0.000969,172.31.40.0-255,66,114281,77,394892
19163,0.000981,74.125.24.0-255,1484,115765,77,394892
19164,0.000993,74.125.24.0-255,2228,117993,77,394892
19165,0.000994,172.31.40.0-255,66,118059,77,394892
19166,0.001041,74.125.24.0-255,2902,120961,77,394892
19167,0.001044,172.31.40.0-255,66,121027,77,394892
19168,0.001048,74.125.24.0-255,2902,123929,77,394892
19169,0.00105,172.31.40.0-255,66,123995,77,394892
19170,0.001061,74.125.24.0-255,1484,125479,77,394892
19171,0.001064,74.125.24.0-255,1484,126963,77,394892
19172,0.001066,172.31.40.0-255,66,127029,77,394892
19173,0.001096,74.125.24.0-255,7156,134185,77,394892
19174,0.001099,172.31.40.0-255,66,134251,77,394892
19175,0.001103,74.125.24.0-255,4320,138571,77,394892
19176,0.001105,172.31.40.0-255,66,138637,77,394892
19177,0.001131,74.125.24.0-255,7156,145793,77,394892
19178,0.001133,172.31.40.0-255,66,145859,77,394892
19179,0.001156,74.125.24.0-255,6438,152297,77,394892
19180,0.001158,172.31.40.0-255,66,152363,77,394892
19181,0.001217,74.125.24.0-255,1484,153847,77,394892
19182,0.001229,74.125.24.0-255,2902,156749,77,394892
19183,0.001232,172.31.40.0-255,66,156815,77,394892
19184,0.001241,74.125.24.0-255,1484,158299,77,394892
19185,0.001257,74.125.24.0-255,4320,162619,77,394892
19186,0.001259,172.31.40.0-255,66,162685,77,394892
19187,0.001267,74.125.24.0-255,8574,171259,77,394892
19188,0.001269,172.31.40.0-255,66,171325,77,394892
19189,0.001283,74.125.24.0-255,4320,175645,77,394892
19190,0.001285,172.31.40.0-255,66,175711,77,394892
19191,0.001304,74.125.24.0-255,8574,184285,77,394892
19192,0.001307,172.31.40.0-255,66,184351,77,394892
19193,0.001331,74.125.24.0-255,2184,186535,77,394892
19194,0.001333,172.31.40.0-255,66,186601,77,394892
19195,0.001373,74.125.24.0-255,1484,188085,77,394892
19196,0.001377,74.125.24.0-255,2902,190987,77,394892
19197,0.00138,172.31.40.0-255,66,191053,77,394892
19198,0.001403,74.125.24.0-255,5738,196791,77,394892
19199,0.001405,172.31.40.0-255,66,196857,77,394892
19200,0.001424,74.125.24.0-255,5738,202595,77,394892
19201,0.001426,172.31.40.0-255,66,202661,77,394892
19202,0.001462,74.125.24.0-255,7156,209817,77,394892
19203,0.001464,172.31.40.0-255,66,209883,77,394892
19204,0.001471,74.125.24.0-255,8574,218457,77,394892
19205,0.001498,74.125.24.0-255,2184,220641,77,394892
19206,0.001603,74.125.24.0-255,1484,222125,77,394892
19207,0.001616,74.125.24.0-255,2902,225027,77,394892
19208,0.001621,74.125.24.0-255,4320,229347,77,394892
19209,0.001647,74.125.24.0-255,1484,230831,77,394892
19210,0.001658,74.125.24.0-255,12828,243659,77,394892
19211,0.001671,74.125.24.0-255,10692,254351,77,394892
19212,0.001688,74.125.24.0-255,4320,258671,77,394892
19213,0.001785,74.125.24.0-255,7856,266527,77,394892
19214,0.001792,74.125.24.0-255,8574,275101,77,394892
19215,0.001828,74.125.24.0-255,5738,280839,77,394892
19216,0.001845,74.125.24.0-255,5738,286577,77,394892
19217,0.001858,74.125.24.0-255,4320,290897,77,394892
19218,0.00186,74.125.24.0-255,1484,292381,77,394892
19219,0.001877,74.125.24.0-255,7856,300237,77,394892
19220,0.001918,74.125.24.0-255,4320,304557,77,394892
19221,0.00194,74.125.24.0-255,5738,310295,77,394892
19222,0.001946,74.125.24.0-255,5738,316033,77,394892
19223,0.001965,74.125.24.0-255,5738,321771,77,394892
19224,0.00197,74.125.24.0-255,4320,326091,77,394892
19225,0.001982,74.125.24.0-255,2902,328993,77,394892
19226,0.001999,74.125.24.0-255,1484,330477,77,394892
19227,0.002015,74.125.24.0-255,7156,337633,77,394892
19228,0.002035,74.125.24.0-255,5020,342653,77,394892
19229,0.002038,74.125.24.0-255,1484,344137,77,394892
19230,0.002062,74.125.24.0-255,12828,356965,77,394892
19231,0.002069,74.125.24.0-255,7156,364121,77,394892
19232,0.00209,74.125.24.0-255,2902,367023,77,394892
19233,0.002113,74.125.24.0-255,9274,376297,77,394892
19234,0.002134,74.125.24.0-255,5738,382035,77,394892
19235,0.002161,74.125.24.0-255,7156,389191,77,394892
19236,0.002167,74.125.24.0-255,5262,394453,77,394892
19237,0.002169,74.125.24.0-255,97,394550,77,394892
19238,0.002197,74.125.24.0-255,105,394655,77,394892
19239,0.006412,172.31.40.0-255,66,394721,77,394892
19240,0.009034,172.31.40.0-255,105,394826,77,394892
19241,0.011486,74.125.24.0-255,66,394892,77,394892
19242,0.0,74.125.130.0-255,153,153,77,289030
19243,3e-05,172.31.40.0-255,66,219,77,289030
19244,3.7e-05,74.125.130.0-255,1484,1703,77,289030
19245,4e-05,172.31.40.0-255,66,1769,77,289030
19246,4.3e-05,74.125.130.0-255,1484,3253,77,289030
19247,4.5e-05,172.31.40.0-255,66,3319,77,289030
19248,4.9e-05,74.125.130.0-255,2902,6221,77,289030
19249,5.1e-05,172.31.40.0-255,66,6287,77,289030
19250,5.8e-05,74.125.130.0-255,5738,12025,77,289030
19251,6e-05,172.31.40.0-255,66,12091,77,289030
19252,8.6e-05,74.125.130.0-255,2030,14121,77,289030
19253,8.9e-05,172.31.40.0-255,66,14187,77,289030
19254,0.00022,74.125.130.0-255,1484,15671,77,289030
19255,0.000226,172.31.40.0-255,66,15737,77,289030
19256,0.000231,74.125.130.0-255,2902,18639,77,289030
19257,0.000233,172.31.40.0-255,66,18705,77,289030
19258,0.000236,74.125.130.0-255,1484,20189,77,289030
19259,0.000238,172.31.40.0-255,66,20255,77,289030
19260,0.000261,74.125.130.0-255,4320,24575,77,289030
19261,0.000266,172.31.40.0-255,66,24641,77,289030
19262,0.000284,74.125.130.0-255,2902,27543,77,289030
19263,0.000288,172.31.40.0-255,66,27609,77,289030
19264,0.000303,74.125.130.0-255,3961,31570,77,289030
19265,0.000305,172.31.40.0-255,66,31636,77,289030
19266,0.000424,74.125.130.0-255,1484,33120,77,289030
19267,0.000427,172.31.40.0-255,66,33186,77,289030
19268,0.000443,74.125.130.0-255,2902,36088,77,289030
19269,0.000446,172.31.40.0-255,66,36154,77,289030
19270,0.000452,74.125.130.0-255,5738,41892,77,289030
19271,0.000454,172.31.40.0-255,66,41958,77,289030
19272,0.000484,74.125.130.0-255,1484,43442,77,289030
19273,0.000487,172.31.40.0-255,66,43508,77,289030
19274,0.00051,74.125.130.0-255,12469,55977,77,289030
19275,0.000513,172.31.40.0-255,66,56043,77,289030
19276,0.000523,74.125.130.0-255,9921,65964,77,289030
19277,0.000526,172.31.40.0-255,66,66030,77,289030
19278,0.000528,74.125.130.0-255,99,66129,77,289030
19279,0.000799,172.31.40.0-255,66,66195,77,289030
19280,0.000858,74.125.130.0-255,365,66560,77,289030
19281,0.000887,172.31.40.0-255,66,66626,77,289030
19282,0.00109,74.125.130.0-255,1484,68110,77,289030
19283,0.0011,74.125.130.0-255,2902,71012,77,289030
19284,0.001104,172.31.40.0-255,66,71078,77,289030
19285,0.001121,74.125.130.0-255,1484,72562,77,289030
19286,0.00114,74.125.130.0-255,1484,74046,77,289030
19287,0.001143,172.31.40.0-255,66,74112,77,289030
19288,0.001148,74.125.130.0-255,4320,78432,77,289030
19289,0.001149,172.31.40.0-255,66,78498,77,289030
19290,0.001154,74.125.130.0-255,4320,82818,77,289030
19291,0.001156,172.31.40.0-255,66,82884,77,289030
19292,0.001179,74.125.130.0-255,4320,87204,77,289030
19293,0.001182,172.31.40.0-255,66,87270,77,289030
19294,0.00119,74.125.130.0-255,8574,95844,77,289030
19295,0.001191,172.31.40.0-255,66,95910,77,289030
19296,0.00123,74.125.130.0-255,5020,100930,77,289030
19297,0.001233,172.31.40.0-255,66,100996,77,289030
19298,0.001411,74.125.130.0-255,1484,102480,77,289030
19299,0.00142,74.125.130.0-255,2902,105382,77,289030
19300,0.001426,172.31.40.0-255,66,105448,77,289030
19301,0.001432,74.125.130.0-255,4320,109768,77,289030
19302,0.001434,172.31.40.0-255,66,109834,77,289030
19303,0.001448,74.125.130.0-255,1484,111318,77,289030
19304,0.001457,74.125.130.0-255,8574,119892,77,289030
19305,0.001459,172.31.40.0-255,66,119958,77,289030
19306,0.001463,74.125.130.0-255,2902,122860,77,289030
19307,0.001465,172.31.40.0-255,66,122926,77,289030
19308,0.001495,74.125.130.0-255,7156,130082,77,289030
19309,0.001498,172.31.40.0-255,66,130148,77,289030
19310,0.00151,74.125.130.0-255,2902,133050,77,289030
19311,0.001512,172.31.40.0-255,66,133116,77,289030
19312,0.001534,74.125.130.0-255,2184,135300,77,289030
19313,0.001537,172.31.40.0-255,66,135366,77,289030
19314,0.001551,74.125.130.0-255,1484,136850,77,289030
19315,0.001561,74.125.130.0-255,1484,138334,77,289030
19316,0.001563,172.31.40.0-255,66,138400,77,289030
19317,0.001568,74.125.130.0-255,4320,142720,77,289030
19318,0.00157,172.31.40.0-255,66,142786,77,289030
19319,0.001573,74.125.130.0-255,1484,144270,77,289030
19320,0.001593,74.125.130.0-255,7156,151426,77,289030
19321,0.001595,172.31.40.0-255,66,151492,77,289030
19322,0.001609,74.125.130.0-255,4320,155812,77,289030
19323,0.001611,172.31.40.0-255,66,155878,77,289030
19324,0.001636,74.125.130.0-255,8574,164452,77,289030
19325,0.001641,172.31.40.0-255,66,164518,77,289030
19326,0.001652,74.125.130.0-255,2902,167420,77,289030
19327,0.001655,172.31.40.0-255,66,167486,77,289030
19328,0.001678,74.125.130.0-255,10692,178178,77,289030
19329,0.001681,172.31.40.0-255,66,178244,77,289030
19330,0.001686,74.125.130.0-255,5738,183982,77,289030
19331,0.001688,172.31.40.0-255,66,184048,77,289030
19332,0.001715,74.125.130.0-255,2902,186950,77,289030
19333,0.001717,172.31.40.0-255,66,187016,77,289030
19334,0.001726,74.125.130.0-255,9992,197008,77,289030
19335,0.001728,172.31.40.0-255,66,197074,77,289030
19336,0.001734,74.125.130.0-255,6438,203512,77,289030
19337,0.001736,172.31.40.0-255,66,203578,77,289030
19338,0.001834,74.125.130.0-255,1484,205062,77,289030
19339,0.001851,74.125.130.0-255,2902,207964,77,289030
19340,0.001854,172.31.40.0-255,66,208030,77,289030
19341,0.001872,74.125.130.0-255,4320,212350,77,289030
19342,0.001874,172.31.40.0-255,66,212416,77,289030
19343,0.001878,74.125.130.0-255,2902,215318,77,289030
19344,0.00188,172.31.40.0-255,66,215384,77,289030
19345,0.001903,74.125.130.0-255,2902,218286,77,289030
19346,0.001905,172.31.40.0-255,66,218352,77,289030
19347,0.001908,74.125.130.0-255,1484,219836,77,289030
19348,0.001927,74.125.130.0-255,5738,225574,77,289030
19349,0.001929,172.31.40.0-255,66,225640,77,289030
19350,0.001951,74.125.130.0-255,4320,229960,77,289030
19351,0.001953,172.31.40.0-255,66,230026,77,289030
19352,0.001968,74.125.130.0-255,4320,234346,77,289030
19353,0.00197,172.31.40.0-255,66,234412,77,289030
19354,0.001996,74.125.130.0-255,3602,238014,77,289030
19355,0.001999,172.31.40.0-255,66,238080,77,289030
19356,0.003891,74.125.130.0-255,1484,239564,77,289030
19357,0.003935,74.125.130.0-255,4320,243884,77,289030
19358,0.003939,172.31.40.0-255,66,243950,77,289030
19359,0.005897,74.125.130.0-255,5738,249688,77,289030
19360,0.005901,172.31.40.0-255,66,249754,77,289030
19361,0.007849,74.125.130.0-255,5738,255492,77,289030
19362,0.007857,172.31.40.0-255,66,255558,77,289030
19363,0.009795,74.125.130.0-255,5738,261296,77,289030
19364,0.009802,172.31.40.0-255,66,261362,77,289030
19365,0.011772,74.125.130.0-255,5738,267100,77,289030
19366,0.011789,172.31.40.0-255,66,267166,77,289030
19367,0.013738,74.125.130.0-255,5738,272904,77,289030
19368,0.013753,172.31.40.0-255,66,272970,77,289030
19369,0.015692,74.125.130.0-255,4320,277290,77,289030
19370,0.015699,172.31.40.0-255,66,277356,77,289030
19371,0.015719,74.125.130.0-255,1484,278840,77,289030
19372,0.01765,74.125.130.0-255,4320,283160,77,289030
19373,0.01766,172.31.40.0-255,66,283226,77,289030
19374,0.019613,74.125.130.0-255,5738,288964,77,289030
19375,0.019629,172.31.40.0-255,66,289030,77,289030
19376,0.0,74.125.68.0-255,150,150,77,209327
19377,2.3e-05,172.31.40.0-255,66,216,77,209327
19378,3e-05,74.125.68.0-255,1484,1700,77,209327
19379,3.5e-05,172.31.40.0-255,66,1766,77,209327
19380,4.1e-05,74.125.68.0-255,2902,4668,77,209327
19381,4.5e-05,172.31.40.0-255,66,4734,77,209327
19382,5.9e-05,74.125.68.0-255,5738,10472,77,209327
19383,6.2e-05,172.31.40.0-255,66,10538,77,209327
19384,6.5e-05,74.125.68.0-255,1484,12022,77,209327
19385,6.8e-05,172.31.40.0-255,66,12088,77,209327
19386,7.3e-05,74.125.68.0-255,2031,14119,77,209327
19387,7.5e-05,172.31.40.0-255,66,14185,77,209327
19388,0.000293,74.125.68.0-255,1484,15669,77,209327
19389,0.0003,172.31.40.0-255,66,15735,77,209327
19390,0.000305,74.125.68.0-255,2902,18637,77,209327
19391,0.000308,172.31.40.0-255,66,18703,77,209327
19392,0.000311,74.125.68.0-255,1484,20187,77,209327
19393,0.000318,172.31.40.0-255,66,20253,77,209327
19394,0.000348,74.125.68.0-255,2902,23155,77,209327
19395,0.00035,172.31.40.0-255,66,23221,77,209327
19396,0.000375,74.125.68.0-255,1484,24705,77,209327
19397,0.000378,172.31.40.0-255,66,24771,77,209327
19398,0.000397,74.125.68.0-255,2902,27673,77,209327
19399,0.000399,172.31.40.0-255,66,27739,77,209327
19400,0.000439,74.125.68.0-255,3961,31700,77,209327
19401,0.000442,172.31.40.0-255,66,31766,77,209327
19402,0.000455,74.125.68.0-255,1484,33250,77,209327
19403,0.000457,172.31.40.0-255,66,33316,77,209327
19404,0.000485,74.125.68.0-255,2902,36218,77,209327
19405,0.000487,172.31.40.0-255,66,36284,77,209327
19406,0.000493,74.125.68.0-255,4320,40604,77,209327
19407,0.000495,172.31.40.0-255,66,40670,77,209327
19408,0.000502,74.125.68.0-255,5738,46408,77,209327
19409,0.000504,172.31.40.0-255,66,46474,77,209327
19410,0.00053,74.125.68.0-255,2543,49017,77,209327
19411,0.000532,172.31.40.0-255,66,49083,77,209327
19412,0.000569,74.125.68.0-255,1484,50567,77,209327
19413,0.000582,74.125.68.0-255,2902,53469,77,209327
19414,0.000585,172.31.40.0-255,66,53535,77,209327
19415,0.000612,74.125.68.0-255,5738,59273,77,209327
19416,0.000615,172.31.40.0-255,66,59339,77,209327
19417,0.00062,74.125.68.0-255,4320,63659,77,209327
19418,0.000623,172.31.40.0-255,66,63725,77,209327
19419,0.000671,74.125.68.0-255,2543,66268,77,209327
19420,0.000675,172.31.40.0-255,66,66334,77,209327
19421,0.00092,74.125.68.0-255,409,66743,77,209327
19422,0.000957,74.125.68.0-255,1484,68227,77,209327
19423,0.000961,172.31.40.0-255,66,68293,77,209327
19424,0.000965,74.125.68.0-255,1484,69777,77,209327
19425,0.000989,74.125.68.0-255,2902,72679,77,209327
19426,0.000992,172.31.40.0-255,66,72745,77,209327
19427,0.000998,74.125.68.0-255,5738,78483,77,209327
19428,0.001,172.31.40.0-255,66,78549,77,209327
19429,0.001027,74.125.68.0-255,5379,83928,77,209327
19430,0.001029,172.31.40.0-255,66,83994,77,209327
19431,0.001196,74.125.68.0-255,1484,85478,77,209327
19432,0.001202,74.125.68.0-255,2902,88380,77,209327
19433,0.001206,172.31.40.0-255,66,88446,77,209327
19434,0.001229,74.125.68.0-255,2902,91348,77,209327
19435,0.001231,172.31.40.0-255,66,91414,77,209327
19436,0.001234,74.125.68.0-255,1484,92898,77,209327
19437,0.001262,74.125.68.0-255,2902,95800,77,209327
19438,0.001264,172.31.40.0-255,66,95866,77,209327
19439,0.001307,74.125.68.0-255,5379,101245,77,209327
19440,0.00131,172.31.40.0-255,66,101311,77,209327
19441,0.001957,74.125.68.0-255,1484,102795,77,209327
19442,0.001968,74.125.68.0-255,2902,105697,77,209327
19443,0.001973,172.31.40.0-255,66,105763,77,209327
19444,0.001979,74.125.68.0-255,2902,108665,77,209327
19445,0.001981,172.31.40.0-255,66,108731,77,209327
19446,0.002015,74.125.68.0-255,2902,111633,77,209327
19447,0.002018,172.31.40.0-255,66,111699,77,209327
19448,0.002022,74.125.68.0-255,2902,114601,77,209327
19449,0.002025,172.31.40.0-255,66,114667,77,209327
19450,0.00203,74.125.68.0-255,4320,118987,77,209327
19451,0.002032,172.31.40.0-255,66,119053,77,209327
19452,0.002041,74.125.68.0-255,8574,127627,77,209327
19453,0.002043,172.31.40.0-255,66,127693,77,209327
19454,0.00205,74.125.68.0-255,5738,133431,77,209327
19455,0.002052,172.31.40.0-255,66,133497,77,209327
19456,0.002102,74.125.68.0-255,2184,135681,77,209327
19457,0.002105,172.31.40.0-255,66,135747,77,209327
19458,0.002225,74.125.68.0-255,1484,137231,77,209327
19459,0.002232,74.125.68.0-255,2902,140133,77,209327
19460,0.002235,172.31.40.0-255,66,140199,77,209327
19461,0.002242,74.125.68.0-255,5738,145937,77,209327
19462,0.002244,172.31.40.0-255,66,146003,77,209327
19463,0.002248,74.125.68.0-255,2902,148905,77,209327
19464,0.00225,172.31.40.0-255,66,148971,77,209327
19465,0.002261,74.125.68.0-255,4320,153291,77,209327
19466,0.002263,172.31.40.0-255,66,153357,77,209327
19467,0.002298,74.125.68.0-255,8574,161931,77,209327
19468,0.002301,172.31.40.0-255,66,161997,77,209327
19469,0.002308,74.125.68.0-255,5738,167735,77,209327
19470,0.00231,172.31.40.0-255,66,167801,77,209327
19471,0.002314,74.125.68.0-255,2184,169985,77,209327
19472,0.002317,172.31.40.0-255,66,170051,77,209327
19473,0.004587,74.125.68.0-255,5738,175789,77,209327
19474,0.004595,172.31.40.0-255,66,175855,77,209327
19475,0.006883,74.125.68.0-255,4320,180175,77,209327
19476,0.006887,172.31.40.0-255,66,180241,77,209327
19477,0.006911,74.125.68.0-255,1484,181725,77,209327
19478,0.009184,74.125.68.0-255,4320,186045,77,209327
19479,0.00919,172.31.40.0-255,66,186111,77,209327
19480,0.011485,74.125.68.0-255,5738,191849,77,209327
19481,0.011492,172.31.40.0-255,66,191915,77,209327
19482,0.013778,74.125.68.0-255,5738,197653,77,209327
19483,0.013786,172.31.40.0-255,66,197719,77,209327
19484,0.016067,74.125.68.0-255,5738,203457,77,209327
19485,0.016074,172.31.40.0-255,66,203523,77,209327
19486,0.018365,74.125.68.0-255,5738,209261,77,209327
19487,0.018374,172.31.40.0-255,66,209327,77,209327
19488,0.0,172.217.194.0-255,146,146,77,252102
19489,2.4e-05,172.31.40.0-255,66,212,77,252102
19490,3.2e-05,172.217.194.0-255,1484,1696,77,252102
19491,3.6e-05,172.31.40.0-255,66,1762,77,252102
19492,4.3e-05,172.217.194.0-255,2902,4664,77,252102
19493,5.5e-05,172.31.40.0-255,66,4730,77,252102
19494,6.4e-05,172.217.194.0-255,7156,11886,77,252102
19495,6.7e-05,172.31.40.0-255,66,11952,77,252102
19496,7.7e-05,172.217.194.0-255,9093,21045,77,252102
19497,8e-05,172.31.40.0-255,66,21111,77,252102
19498,8.5e-05,172.217.194.0-255,2902,24013,77,252102
19499,8.8e-05,172.31.40.0-255,66,24079,77,252102
19500,0.000122,172.217.194.0-255,6797,30876,77,252102
19501,0.000126,172.31.40.0-255,66,30942,77,252102
19502,0.000322,172.217.194.0-255,1484,32426,77,252102
19503,0.000327,172.31.40.0-255,66,32492,77,252102
19504,0.000334,172.217.194.0-255,2902,35394,77,252102
19505,0.000336,172.31.40.0-255,66,35460,77,252102
19506,0.000367,172.217.194.0-255,5738,41198,77,252102
19507,0.000371,172.31.40.0-255,66,41264,77,252102
19508,0.000381,172.217.194.0-255,9992,51256,77,252102
19509,0.000387,172.31.40.0-255,66,51322,77,252102
19510,0.000443,172.217.194.0-255,13528,64850,77,252102
19511,0.000446,172.31.40.0-255,66,64916,77,252102
19512,0.000449,172.217.194.0-255,679,65595,77,252102
19513,0.000451,172.31.40.0-255,66,65661,77,252102
19514,0.000481,172.217.194.0-255,1484,67145,77,252102
19515,0.000484,172.31.40.0-255,66,67211,77,252102
19516,0.000514,172.217.194.0-255,4320,71531,77,252102
19517,0.000517,172.31.40.0-255,66,71597,77,252102
19518,0.000521,172.217.194.0-255,2902,74499,77,252102
19519,0.000524,172.31.40.0-255,66,74565,77,252102
19520,0.000542,172.217.194.0-255,2902,77467,77,252102
19521,0.000557,172.217.194.0-255,8574,86041,77,252102
19522,0.000578,172.217.194.0-255,2902,88943,77,252102
19523,0.000589,172.217.194.0-255,10692,99635,77,252102
19524,0.000642,172.31.40.0-255,66,99701,77,252102
19525,0.001228,172.217.194.0-255,1484,101185,77,252102
19526,0.001236,172.217.194.0-255,2902,104087,77,252102
19527,0.001239,172.31.40.0-255,66,104153,77,252102
19528,0.001244,172.217.194.0-255,2902,107055,77,252102
19529,0.001269,172.217.194.0-255,2902,109957,77,252102
19530,0.001275,172.217.194.0-255,5738,115695,77,252102
19531,0.001296,172.217.194.0-255,7156,122851,77,252102
19532,0.001306,172.217.194.0-255,9992,132843,77,252102
19533,0.001308,172.217.194.0-255,766,133609,77,252102
19534,0.001328,172.31.40.0-255,66,133675,77,252102
19535,0.001505,172.217.194.0-255,1484,135159,77,252102
19536,0.001524,172.217.194.0-255,2902,138061,77,252102
19537,0.001527,172.31.40.0-255,66,138127,77,252102
19538,0.001534,172.217.194.0-255,5738,143865,77,252102
19539,0.001539,172.217.194.0-255,2902,146767,77,252102
19540,0.001563,172.217.194.0-255,2902,149669,77,252102
19541,0.001573,172.217.194.0-255,9992,159661,77,252102
19542,0.001576,172.31.40.0-255,66,159727,77,252102
19543,0.001581,172.31.40.0-255,66,159793,77,252102
19544,0.001602,172.217.194.0-255,2902,162695,77,252102
19545,0.00162,172.217.194.0-255,1484,164179,77,252102
19546,0.00168,172.217.194.0-255,7156,171335,77,252102
19547,0.001683,172.31.40.0-255,66,171401,77,252102
19548,0.001699,172.217.194.0-255,5020,176421,77,252102
19549,0.001705,172.31.40.0-255,66,176487,77,252102
19550,0.001714,172.217.194.0-255,2902,179389,77,252102
19551,0.001742,172.217.194.0-255,9992,189381,77,252102
19552,0.001776,172.31.40.0-255,66,189447,77,252102
19553,0.0018,172.217.194.0-255,4320,193767,77,252102
19554,0.001803,172.31.40.0-255,66,193833,77,252102
19555,0.001816,172.217.194.0-255,5738,199571,77,252102
19556,0.001823,172.217.194.0-255,1484,201055,77,252102
19557,0.001842,172.217.194.0-255,4320,205375,77,252102
19558,0.001863,172.217.194.0-255,5738,211113,77,252102
19559,0.001869,172.31.40.0-255,66,211179,77,252102
19560,0.001917,172.31.40.0-255,66,211245,77,252102
19561,0.001984,172.217.194.0-255,11410,222655,77,252102
19562,0.002023,172.31.40.0-255,66,222721,77,252102
19563,0.002028,172.31.40.0-255,66,222787,77,252102
19564,0.002117,172.217.194.0-255,5020,227807,77,252102
19565,0.002123,172.31.40.0-255,66,227873,77,252102
19566,0.002158,172.217.194.0-255,1484,229357,77,252102
19567,0.002163,172.217.194.0-255,2902,232259,77,252102
19568,0.002178,172.217.194.0-255,2902,235161,77,252102
19569,0.002255,172.31.40.0-255,66,235227,77,252102
19570,0.002265,172.31.40.0-255,66,235293,77,252102
19571,0.002292,172.217.194.0-255,4320,239613,77,252102
19572,0.002306,172.217.194.0-255,4320,243933,77,252102
19573,0.002321,172.217.194.0-255,5738,249671,77,252102
19574,0.002336,172.217.194.0-255,2023,251694,77,252102
19575,0.002338,172.217.194.0-255,105,251799,77,252102
19576,0.002341,172.31.40.0-255,66,251865,77,252102
19577,0.002346,172.31.40.0-255,66,251931,77,252102
19578,0.004721,172.31.40.0-255,105,252036,77,252102
19579,0.007231,172.217.194.0-255,66,252102,77,252102
19580,0.0,74.125.24.0-255,292,292,77,228106
19581,2.3e-05,172.31.40.0-255,66,358,77,228106
19582,3e-05,74.125.24.0-255,1484,1842,77,228106
19583,3.5e-05,172.31.40.0-255,66,1908,77,228106
19584,4.2e-05,74.125.24.0-255,4320,6228,77,228106
19585,4.5e-05,172.31.40.0-255,66,6294,77,228106
19586,4.9e-05,74.125.24.0-255,1484,7778,77,228106
19587,5.2e-05,172.31.40.0-255,66,7844,77,228106
19588,8.1e-05,74.125.24.0-255,4320,12164,77,228106
19589,8.5e-05,172.31.40.0-255,66,12230,77,228106
19590,9.2e-05,74.125.24.0-255,5738,17968,77,228106
19591,9.5e-05,172.31.40.0-255,66,18034,77,228106
19592,0.000117,74.125.24.0-255,6410,24444,77,228106
19593,0.00012,172.31.40.0-255,66,24510,77,228106
19594,0.000139,74.125.24.0-255,2902,27412,77,228106
19595,0.000141,172.31.40.0-255,66,27478,77,228106
19596,0.000156,74.125.24.0-255,3961,31439,77,228106
19597,0.000158,172.31.40.0-255,66,31505,77,228106
19598,0.000231,74.125.24.0-255,1484,32989,77,228106
19599,0.000234,172.31.40.0-255,66,33055,77,228106
19600,0.00025,74.125.24.0-255,2902,35957,77,228106
19601,0.000252,172.31.40.0-255,66,36023,77,228106
19602,0.000256,74.125.24.0-255,1484,37507,77,228106
19603,0.000258,172.31.40.0-255,66,37573,77,228106
19604,0.000283,74.125.24.0-255,4320,41893,77,228106
19605,0.000286,172.31.40.0-255,66,41959,77,228106
19606,0.000294,74.125.24.0-255,6797,48756,77,228106
19607,0.000297,172.31.40.0-255,66,48822,77,228106
19608,0.000328,74.125.24.0-255,7156,55978,77,228106
19609,0.000331,172.31.40.0-255,66,56044,77,228106
19610,0.000368,74.125.24.0-255,9633,65677,77,228106
19611,0.000371,172.31.40.0-255,66,65743,77,228106
19612,0.000373,74.125.24.0-255,398,66141,77,228106
19613,0.000419,74.125.24.0-255,345,66486,77,228106
19614,0.000888,74.125.24.0-255,1484,67970,77,228106
19615,0.000894,172.31.40.0-255,66,68036,77,228106
19616,0.000901,74.125.24.0-255,2902,70938,77,228106
19617,0.000904,172.31.40.0-255,66,71004,77,228106
19618,0.000946,74.125.24.0-255,5738,76742,77,228106
19619,0.000949,172.31.40.0-255,66,76808,77,228106
19620,0.000972,74.125.24.0-255,7156,83964,77,228106
19621,0.000974,172.31.40.0-255,66,84030,77,228106
19622,0.000993,74.125.24.0-255,6797,90827,77,228106
19623,0.000996,172.31.40.0-255,66,90893,77,228106
19624,0.001002,74.125.24.0-255,5738,96631,77,228106
19625,0.001004,172.31.40.0-255,66,96697,77,228106
19626,0.001029,74.125.24.0-255,8574,105271,77,228106
19627,0.001032,172.31.40.0-255,66,105337,77,228106
19628,0.001052,74.125.24.0-255,2902,108239,77,228106
19629,0.001055,172.31.40.0-255,66,108305,77,228106
19630,0.001087,74.125.24.0-255,9274,117579,77,228106
19631,0.00109,172.31.40.0-255,66,117645,77,228106
19632,0.001131,74.125.24.0-255,12828,130473,77,228106
19633,0.001134,172.31.40.0-255,66,130539,77,228106
19634,0.001182,74.125.24.0-255,3412,133951,77,228106
19635,0.00119,172.31.40.0-255,66,134017,77,228106
19636,0.002099,74.125.24.0-255,1484,135501,77,228106
19637,0.002111,74.125.24.0-255,2902,138403,77,228106
19638,0.002117,172.31.40.0-255,66,138469,77,228106
19639,0.002124,74.125.24.0-255,4320,142789,77,228106
19640,0.002126,172.31.40.0-255,66,142855,77,228106
19641,0.002161,74.125.24.0-255,8574,151429,77,228106
19642,0.002164,172.31.40.0-255,66,151495,77,228106
19643,0.002168,74.125.24.0-255,1484,152979,77,228106
19644,0.002195,172.31.40.0-255,66,153045,77,228106
19645,0.002247,74.125.24.0-255,4320,157365,77,228106
19646,0.002251,172.31.40.0-255,66,157431,77,228106
19647,0.002274,74.125.24.0-255,8574,166005,77,228106
19648,0.002276,172.31.40.0-255,66,166071,77,228106
19649,0.002307,74.125.24.0-255,4320,170391,77,228106
19650,0.00231,172.31.40.0-255,66,170457,77,228106
19651,0.002335,74.125.24.0-255,9992,180449,77,228106
19652,0.002338,172.31.40.0-255,66,180515,77,228106
19653,0.002381,74.125.24.0-255,6438,186953,77,228106
19654,0.002383,172.31.40.0-255,66,187019,77,228106
19655,0.004633,74.125.24.0-255,5738,192757,77,228106
19656,0.004643,172.31.40.0-255,66,192823,77,228106
19657,0.006688,172.31.40.0-255,105,192928,77,228106
19658,0.006832,74.125.24.0-255,5738,198666,77,228106
19659,0.006839,172.31.40.0-255,66,198732,77,228106
19660,0.006943,172.31.40.0-255,90,198822,77,228106
19661,0.006952,172.31.40.0-255,66,198888,77,228106
19662,0.009063,74.125.24.0-255,5738,204626,77,228106
19663,0.00907,172.31.40.0-255,66,204692,77,228106
19664,0.009439,74.125.68.0-255,66,204758,77,228106
19665,0.009452,74.125.68.0-255,66,204824,77,228106
19666,0.009464,172.31.40.0-255,66,204890,77,228106
19667,0.011293,74.125.24.0-255,5738,210628,77,228106
19668,0.011301,172.31.40.0-255,66,210694,77,228106
19669,0.013533,74.125.24.0-255,5738,216432,77,228106
19670,0.013547,172.31.40.0-255,66,216498,77,228106
19671,0.015798,74.125.24.0-255,5738,222236,77,228106
19672,0.015814,172.31.40.0-255,66,222302,77,228106
19673,0.018058,74.125.24.0-255,5738,228040,77,228106
19674,0.018071,172.31.40.0-255,66,228106,77,228106
19675,0.0,74.125.130.0-255,150,150,77,421096
19676,1e-05,172.31.40.0-255,66,216,77,421096
19677,4.1e-05,74.125.130.0-255,1484,1700,77,421096
19678,4.5e-05,172.31.40.0-255,66,1766,77,421096
19679,7.4e-05,74.125.130.0-255,2902,4668,77,421096
19680,7.6e-05,172.31.40.0-255,66,4734,77,421096
19681,9.1e-05,74.125.130.0-255,4320,9054,77,421096
19682,9.8e-05,172.31.40.0-255,66,9120,77,421096
19683,0.000115,74.125.130.0-255,2902,12022,77,421096
19684,0.000118,172.31.40.0-255,66,12088,77,421096
19685,0.000122,74.125.130.0-255,2016,14104,77,421096
19686,0.000124,172.31.40.0-255,66,14170,77,421096
19687,0.000128,74.125.130.0-255,2902,17072,77,421096
19688,0.00013,172.31.40.0-255,66,17138,77,421096
19689,0.000137,74.125.130.0-255,7156,24294,77,421096
19690,0.000139,172.31.40.0-255,66,24360,77,421096
19691,0.000171,74.125.130.0-255,5738,30098,77,421096
19692,0.000174,172.31.40.0-255,66,30164,77,421096
19693,0.000192,74.125.130.0-255,1125,31289,77,421096
19694,0.000194,172.31.40.0-255,66,31355,77,421096
19695,0.00026,74.125.130.0-255,1484,32839,77,421096
19696,0.000263,172.31.40.0-255,66,32905,77,421096
19697,0.000281,74.125.130.0-255,2902,35807,77,421096
19698,0.000283,172.31.40.0-255,66,35873,77,421096
19699,0.000305,74.125.130.0-255,5738,41611,77,421096
19700,0.000307,172.31.40.0-255,66,41677,77,421096
19701,0.00031,74.125.130.0-255,1484,43161,77,421096
19702,0.000312,172.31.40.0-255,66,43227,77,421096
19703,0.000334,74.125.130.0-255,5379,48606,77,421096
19704,0.00034,172.31.40.0-255,66,48672,77,421096
19705,0.000732,74.125.130.0-255,1484,50156,77,421096
19706,0.000737,172.31.40.0-255,66,50222,77,421096
19707,0.000742,74.125.130.0-255,1484,51706,77,421096
19708,0.000763,74.125.130.0-255,2902,54608,77,421096
19709,0.000781,74.125.130.0-255,1484,56092,77,421096
19710,0.000796,74.125.130.0-255,4320,60412,77,421096
19711,0.000798,74.125.130.0-255,1484,61896,77,421096
19712,0.000801,172.31.40.0-255,66,61962,77,421096
19713,0.000806,172.31.40.0-255,66,62028,77,421096
19714,0.000821,74.125.130.0-255,1484,63512,77,421096
19715,0.000848,74.125.130.0-255,2543,66055,77,421096
19716,0.000866,172.31.40.0-255,66,66121,77,421096
19717,0.001011,74.125.130.0-255,1484,67605,77,421096
19718,0.001034,74.125.130.0-255,2902,70507,77,421096
19719,0.001037,172.31.40.0-255,66,70573,77,421096
19720,0.001067,74.125.130.0-255,2902,73475,77,421096
19721,0.001073,74.125.130.0-255,4320,77795,77,421096
19722,0.00111,172.31.40.0-255,66,77861,77,421096
19723,0.001122,74.125.130.0-255,2902,80763,77,421096
19724,0.001141,74.125.130.0-255,2543,83306,77,421096
19725,0.001144,74.125.130.0-255,1484,84790,77,421096
19726,0.001163,74.125.130.0-255,4320,89110,77,421096
19727,0.001169,74.125.130.0-255,5738,94848,77,421096
19728,0.001173,74.125.130.0-255,2902,97750,77,421096
19729,0.001197,74.125.130.0-255,4320,102070,77,421096
19730,0.001203,172.31.40.0-255,66,102136,77,421096
19731,0.001213,74.125.130.0-255,4320,106456,77,421096
19732,0.001218,172.31.40.0-255,66,106522,77,421096
19733,0.001241,74.125.130.0-255,7156,113678,77,421096
19734,0.001263,74.125.130.0-255,3487,117165,77,421096
19735,0.001272,172.31.40.0-255,66,117231,77,421096
19736,0.001323,74.125.130.0-255,1484,118715,77,421096
19737,0.001327,74.125.130.0-255,1484,120199,77,421096
19738,0.001338,74.125.130.0-255,1484,121683,77,421096
19739,0.001342,74.125.130.0-255,1484,123167,77,421096
19740,0.00135,172.31.40.0-255,66,123233,77,421096
19741,0.001378,74.125.130.0-255,4320,127553,77,421096
19742,0.001383,74.125.130.0-255,2902,130455,77,421096
19743,0.001393,172.31.40.0-255,66,130521,77,421096
19744,0.001423,74.125.130.0-255,4655,135176,77,421096
19745,0.00143,172.31.40.0-255,66,135242,77,421096
19746,0.001462,74.125.130.0-255,1484,136726,77,421096
19747,0.001466,74.125.130.0-255,1484,138210,77,421096
19748,0.001469,172.31.40.0-255,66,138276,77,421096
19749,0.001477,74.125.130.0-255,1484,139760,77,421096
19750,0.001498,74.125.130.0-255,5738,145498,77,421096
19751,0.001509,172.31.40.0-255,66,145564,77,421096
19752,0.001526,74.125.130.0-255,5738,151302,77,421096
19753,0.001549,74.125.130.0-255,7156,158458,77,421096
19754,0.001556,172.31.40.0-255,66,158524,77,421096
19755,0.001563,74.125.130.0-255,1484,160008,77,421096
19756,0.001585,74.125.130.0-255,4320,164328,77,421096
19757,0.001597,172.31.40.0-255,66,164394,77,421096
19758,0.001626,74.125.130.0-255,5020,169414,77,421096
19759,0.001636,172.31.40.0-255,66,169480,77,421096
19760,0.001715,74.125.130.0-255,1484,170964,77,421096
19761,0.001735,74.125.130.0-255,2902,173866,77,421096
19762,0.00175,74.125.130.0-255,2902,176768,77,421096
19763,0.001753,172.31.40.0-255,66,176834,77,421096
19764,0.001761,74.125.130.0-255,1484,178318,77,421096
19765,0.001772,172.31.40.0-255,66,178384,77,421096
19766,0.001779,74.125.130.0-255,1484,179868,77,421096
19767,0.001781,74.125.130.0-255,1484,181352,77,421096
19768,0.00179,74.125.130.0-255,2902,184254,77,421096
19769,0.001795,74.125.130.0-255,2902,187156,77,421096
19770,0.001813,74.125.130.0-255,2902,190058,77,421096
19771,0.001819,74.125.130.0-255,5738,195796,77,421096
19772,0.001826,172.31.40.0-255,66,195862,77,421096
19773,0.001836,74.125.130.0-255,4320,200182,77,421096
19774,0.001863,172.31.40.0-255,66,200248,77,421096
19775,0.001868,74.125.130.0-255,3602,203850,77,421096
19776,0.0019,172.31.40.0-255,66,203916,77,421096
19777,0.002723,74.125.130.0-255,1484,205400,77,421096
19778,0.002732,74.125.130.0-255,2902,208302,77,421096
19779,0.002748,74.125.130.0-255,5738,214040,77,421096
19780,0.002769,74.125.130.0-255,1484,215524,77,421096
19781,0.002772,74.125.130.0-255,1484,217008,77,421096
19782,0.002788,74.125.130.0-255,2902,219910,77,421096
19783,0.002802,74.125.130.0-255,5738,225648,77,421096
19784,0.002826,74.125.130.0-255,2902,228550,77,421096
19785,0.002849,74.125.130.0-255,8574,237124,77,421096
19786,0.002853,74.125.130.0-255,766,237890,77,421096
19787,0.0031,74.125.130.0-255,1484,239374,77,421096
19788,0.003104,74.125.130.0-255,1484,240858,77,421096
19789,0.003117,74.125.130.0-255,1484,242342,77,421096
19790,0.003136,74.125.130.0-255,4320,246662,77,421096
19791,0.003161,74.125.130.0-255,2902,249564,77,421096
19792,0.003185,74.125.130.0-255,2902,252466,77,421096
19793,0.003191,74.125.130.0-255,4320,256786,77,421096
19794,0.003203,74.125.130.0-255,1484,258270,77,421096
19795,0.003217,74.125.130.0-255,5738,264008,77,421096
19796,0.00327,74.125.130.0-255,5738,269746,77,421096
19797,0.003272,74.125.130.0-255,1484,271230,77,421096
19798,0.003275,74.125.130.0-255,766,271996,77,421096
19799,0.003286,74.125.130.0-255,1484,273480,77,421096
19800,0.0033,74.125.130.0-255,1484,274964,77,421096
19801,0.003313,74.125.130.0-255,1484,276448,77,421096
19802,0.003336,74.125.130.0-255,5738,282186,77,421096
19803,0.003339,74.125.130.0-255,1484,283670,77,421096
19804,0.003358,74.125.130.0-255,2902,286572,77,421096
19805,0.003364,74.125.130.0-255,5738,292310,77,421096
19806,0.00338,74.125.130.0-255,4320,296630,77,421096
19807,0.003381,74.125.130.0-255,1484,298114,77,421096
19808,0.003386,172.31.40.0-255,78,298192,77,421096
19809,0.003394,74.125.130.0-255,5738,303930,77,421096
19810,0.003414,74.125.130.0-255,2184,306114,77,421096
19811,0.003481,74.125.130.0-255,1484,307598,77,421096
19812,0.003498,74.125.130.0-255,2902,310500,77,421096
19813,0.003519,74.125.130.0-255,5738,316238,77,421096
19814,0.003535,74.125.130.0-255,2902,319140,77,421096
19815,0.003565,74.125.130.0-255,5738,324878,77,421096
19816,0.003569,74.125.130.0-255,4320,329198,77,421096
19817,0.003593,74.125.130.0-255,5738,334936,77,421096
19818,0.003595,74.125.130.0-255,1484,336420,77,421096
19819,0.003599,74.125.130.0-255,2902,339322,77,421096
19820,0.003602,74.125.130.0-255,766,340088,77,421096
19821,0.003762,74.125.130.0-255,1484,341572,77,421096
19822,0.003783,74.125.130.0-255,1484,343056,77,421096
19823,0.0038,74.125.130.0-255,2902,345958,77,421096
19824,0.003817,74.125.130.0-255,2902,348860,77,421096
19825,0.003843,74.125.130.0-255,2902,351762,77,421096
19826,0.003859,74.125.130.0-255,2902,354664,77,421096
19827,0.003874,74.125.130.0-255,5738,360402,77,421096
19828,0.003905,74.125.130.0-255,1484,361886,77,421096
19829,0.003919,74.125.130.0-255,5738,367624,77,421096
19830,0.00394,74.125.130.0-255,4320,371944,77,421096
19831,0.003944,74.125.130.0-255,2184,374128,77,421096
19832,0.003966,74.125.130.0-255,2902,377030,77,421096
19833,0.00398,74.125.130.0-255,1484,378514,77,421096
19834,0.004,74.125.130.0-255,2902,381416,77,421096
19835,0.00401,74.125.130.0-255,1484,382900,77,421096
19836,0.004031,74.125.130.0-255,4320,387220,77,421096
19837,0.004035,74.125.130.0-255,2902,390122,77,421096
19838,0.004063,74.125.130.0-255,4320,394442,77,421096
19839,0.004079,74.125.130.0-255,1484,395926,77,421096
19840,0.004092,74.125.130.0-255,2902,398828,77,421096
19841,0.004111,74.125.130.0-255,1484,400312,77,421096
19842,0.004128,74.125.130.0-255,4320,404632,77,421096
19843,0.004152,74.125.130.0-255,3602,408234,77,421096
19844,0.00419,74.125.130.0-255,4320,412554,77,421096
19845,0.00424,74.125.130.0-255,2384,414938,77,421096
19846,0.004292,74.125.130.0-255,105,415043,77,421096
19847,0.006811,172.31.40.0-255,66,415109,77,421096
19848,0.008199,74.125.130.0-255,5738,420847,77,421096
19849,0.008204,172.31.40.0-255,78,420925,77,421096
19850,0.008807,172.31.40.0-255,105,421030,77,421096
19851,0.0108,74.125.130.0-255,66,421096,77,421096
19852,0.0,172.217.194.0-255,149,149,77,174661
19853,1.9e-05,172.31.40.0-255,66,215,77,174661
19854,2.7e-05,172.217.194.0-255,1484,1699,77,174661
19855,3.1e-05,172.31.40.0-255,66,1765,77,174661
19856,3.6e-05,172.217.194.0-255,2902,4667,77,174661
19857,3.9e-05,172.31.40.0-255,66,4733,77,174661
19858,5.5e-05,172.217.194.0-255,7156,11889,77,174661
19859,5.9e-05,172.31.40.0-255,66,11955,77,174661
19860,6.3e-05,172.217.194.0-255,2128,14083,77,174661
19861,6.5e-05,172.31.40.0-255,66,14149,77,174661
19862,9.1e-05,172.217.194.0-255,2902,17051,77,174661
19863,9.4e-05,172.31.40.0-255,66,17117,77,174661
19864,0.000105,172.217.194.0-255,4320,21437,77,174661
19865,0.000108,172.31.40.0-255,66,21503,77,174661
19866,0.000133,172.217.194.0-255,2902,24405,77,174661
19867,0.000135,172.31.40.0-255,66,24471,77,174661
19868,0.000146,172.217.194.0-255,4320,28791,77,174661
19869,0.000148,172.31.40.0-255,66,28857,77,174661
19870,0.000173,172.217.194.0-255,2543,31400,77,174661
19871,0.000175,172.31.40.0-255,66,31466,77,174661
19872,0.000182,172.217.194.0-255,1484,32950,77,174661
19873,0.000185,172.31.40.0-255,66,33016,77,174661
19874,0.000197,172.217.194.0-255,2902,35918,77,174661
19875,0.0002,172.31.40.0-255,66,35984,77,174661
19876,0.000228,172.217.194.0-255,2902,38886,77,174661
19877,0.000231,172.31.40.0-255,66,38952,77,174661
19878,0.000258,172.217.194.0-255,2902,41854,77,174661
19879,0.00026,172.31.40.0-255,66,41920,77,174661
19880,0.000267,172.217.194.0-255,6797,48717,77,174661
19881,0.00027,172.31.40.0-255,66,48783,77,174661
19882,0.000373,172.217.194.0-255,1484,50267,77,174661
19883,0.000377,172.31.40.0-255,66,50333,77,174661
19884,0.000383,172.217.194.0-255,2902,53235,77,174661
19885,0.000386,172.31.40.0-255,66,53301,77,174661
19886,0.000415,172.217.194.0-255,5738,59039,77,174661
19887,0.000417,172.31.40.0-255,66,59105,77,174661
19888,0.000421,172.217.194.0-255,1484,60589,77,174661
19889,0.000453,172.217.194.0-255,5677,66266,77,174661
19890,0.000455,172.31.40.0-255,66,66332,77,174661
19891,0.000478,172.217.194.0-255,379,66711,77,174661
19892,0.000638,172.217.194.0-255,1484,68195,77,174661
19893,0.000643,172.31.40.0-255,66,68261,77,174661
19894,0.000647,172.217.194.0-255,1484,69745,77,174661
19895,0.000671,172.217.194.0-255,1484,71229,77,174661
19896,0.000674,172.31.40.0-255,66,71295,77,174661
19897,0.00068,172.217.194.0-255,5738,77033,77,174661
19898,0.000683,172.31.40.0-255,66,77099,77,174661
19899,0.000694,172.217.194.0-255,6797,83896,77,174661
19900,0.000697,172.31.40.0-255,66,83962,77,174661
19901,0.000754,172.217.194.0-255,1484,85446,77,174661
19902,0.00076,172.217.194.0-255,2902,88348,77,174661
19903,0.000763,172.31.40.0-255,66,88414,77,174661
19904,0.000789,172.217.194.0-255,5738,94152,77,174661
19905,0.000792,172.31.40.0-255,66,94218,77,174661
19906,0.000795,172.217.194.0-255,1484,95702,77,174661
19907,0.000829,172.217.194.0-255,4320,100022,77,174661
19908,0.000832,172.31.40.0-255,66,100088,77,174661
19909,0.000854,172.217.194.0-255,1125,101213,77,174661
19910,0.001519,172.31.40.0-255,66,101279,77,174661
19911,0.001639,172.217.194.0-255,1484,102763,77,174661
19912,0.001648,172.217.194.0-255,2902,105665,77,174661
19913,0.001652,172.31.40.0-255,66,105731,77,174661
19914,0.001656,172.217.194.0-255,1484,107215,77,174661
19915,0.001686,172.217.194.0-255,4320,111535,77,174661
19916,0.001688,172.31.40.0-255,66,111601,77,174661
19917,0.001693,172.217.194.0-255,2902,114503,77,174661
19918,0.001695,172.31.40.0-255,66,114569,77,174661
19919,0.001735,172.217.194.0-255,9992,124561,77,174661
19920,0.001738,172.31.40.0-255,66,124627,77,174661
19921,0.001776,172.217.194.0-255,10692,135319,77,174661
19922,0.001779,172.31.40.0-255,66,135385,77,174661
19923,0.004144,172.217.194.0-255,5738,141123,77,174661
19924,0.004151,172.31.40.0-255,66,141189,77,174661
19925,0.00652,172.217.194.0-255,4320,145509,77,174661
19926,0.006524,172.31.40.0-255,66,145575,77,174661
19927,0.006541,172.217.194.0-255,1484,147059,77,174661
19928,0.008893,172.217.194.0-255,4320,151379,77,174661
19929,0.0089,172.31.40.0-255,66,151445,77,174661
19930,0.01125,172.217.194.0-255,5738,157183,77,174661
19931,0.011261,172.31.40.0-255,66,157249,77,174661
19932,0.013587,172.217.194.0-255,5738,162987,77,174661
19933,0.013594,172.31.40.0-255,66,163053,77,174661
19934,0.015964,172.217.194.0-255,5738,168791,77,174661
19935,0.015976,172.31.40.0-255,66,168857,77,174661
19936,0.018356,172.217.194.0-255,5738,174595,77,174661
19937,0.018368,172.31.40.0-255,66,174661,77,174661
19938,0.0,74.125.24.0-255,152,152,77,351066
19939,1.4e-05,172.31.40.0-255,66,218,77,351066
19940,2e-05,74.125.24.0-255,1484,1702,77,351066
19941,2.5e-05,172.31.40.0-255,66,1768,77,351066
19942,3.7e-05,74.125.24.0-255,2902,4670,77,351066
19943,4e-05,172.31.40.0-255,66,4736,77,351066
19944,4.4e-05,74.125.24.0-255,2902,7638,77,351066
19945,4.6e-05,172.31.40.0-255,66,7704,77,351066
19946,7.8e-05,74.125.24.0-255,2902,10606,77,351066
19947,8.1e-05,172.31.40.0-255,66,10672,77,351066
19948,9.6e-05,74.125.24.0-255,3481,14153,77,351066
19949,9.9e-05,172.31.40.0-255,66,14219,77,351066
19950,0.000132,74.125.24.0-255,4320,18539,77,351066
19951,0.000134,172.31.40.0-255,66,18605,77,351066
19952,0.00016,74.125.24.0-255,2902,21507,77,351066
19953,0.000162,172.31.40.0-255,66,21573,77,351066
19954,0.000169,74.125.24.0-255,8574,30147,77,351066
19955,0.000171,172.31.40.0-255,66,30213,77,351066
19956,0.000212,74.125.24.0-255,5379,35592,77,351066
19957,0.000216,74.125.24.0-255,5738,41330,77,351066
19958,0.000236,172.31.40.0-255,66,41396,77,351066
19959,0.000238,172.31.40.0-255,66,41462,77,351066
19960,0.000264,74.125.24.0-255,6797,48259,77,351066
19961,0.000266,172.31.40.0-255,66,48325,77,351066
19962,0.000285,74.125.24.0-255,5738,54063,77,351066
19963,0.000287,172.31.40.0-255,66,54129,77,351066
19964,0.00029,74.125.24.0-255,1484,55613,77,351066
19965,0.000292,172.31.40.0-255,66,55679,77,351066
19966,0.000324,74.125.24.0-255,5738,61417,77,351066
19967,0.000327,172.31.40.0-255,66,61483,77,351066
19968,0.000351,74.125.24.0-255,4240,65723,77,351066
19969,0.000354,172.31.40.0-255,66,65789,77,351066
19970,0.000374,74.125.24.0-255,376,66165,77,351066
19971,0.000481,74.125.24.0-255,1484,67649,77,351066
19972,0.000485,172.31.40.0-255,66,67715,77,351066
19973,0.000489,74.125.24.0-255,2902,70617,77,351066
19974,0.000491,172.31.40.0-255,66,70683,77,351066
19975,0.00052,74.125.24.0-255,5738,76421,77,351066
19976,0.000522,172.31.40.0-255,66,76487,77,351066
19977,0.000533,74.125.24.0-255,2902,79389,77,351066
19978,0.000535,172.31.40.0-255,66,79455,77,351066
19979,0.000569,74.125.24.0-255,11051,90506,77,351066
19980,0.000572,172.31.40.0-255,66,90572,77,351066
19981,0.00058,74.125.24.0-255,8574,99146,77,351066
19982,0.000582,172.31.40.0-255,66,99212,77,351066
19983,0.000602,74.125.24.0-255,1125,100337,77,351066
19984,0.000738,74.125.24.0-255,1484,101821,77,351066
19985,0.000742,172.31.40.0-255,66,101887,77,351066
19986,0.000747,74.125.24.0-255,2902,104789,77,351066
19987,0.00075,172.31.40.0-255,66,104855,77,351066
19988,0.00078,74.125.24.0-255,5738,110593,77,351066
19989,0.000783,172.31.40.0-255,66,110659,77,351066
19990,0.000805,74.125.24.0-255,8574,119233,77,351066
19991,0.000807,172.31.40.0-255,66,119299,77,351066
19992,0.000831,74.125.24.0-255,4320,123619,77,351066
19993,0.000834,172.31.40.0-255,66,123685,77,351066
19994,0.000837,74.125.24.0-255,1484,125169,77,351066
19995,0.00084,74.125.24.0-255,1484,126653,77,351066
19996,0.000843,172.31.40.0-255,66,126719,77,351066
19997,0.0009,172.31.40.0-255,66,126785,77,351066
19998,0.000909,74.125.24.0-255,9992,136777,77,351066
19999,0.000915,172.31.40.0-255,66,136843,77,351066
20000,0.000962,172.31.40.0-255,66,136909,77,351066
20001,0.001051,74.125.24.0-255,1484,138393,77,351066
20002,0.001067,74.125.24.0-255,2902,141295,77,351066
20003,0.00107,172.31.40.0-255,66,141361,77,351066
20004,0.001076,74.125.24.0-255,4320,145681,77,351066
20005,0.001078,172.31.40.0-255,66,145747,77,351066
20006,0.001093,74.125.24.0-255,1484,147231,77,351066
20007,0.001101,74.125.24.0-255,7156,154387,77,351066
20008,0.001103,172.31.40.0-255,66,154453,77,351066
20009,0.001132,74.125.24.0-255,5738,160191,77,351066
20010,0.001135,172.31.40.0-255,66,160257,77,351066
20011,0.001143,74.125.24.0-255,8574,168831,77,351066
20012,0.001145,172.31.40.0-255,66,168897,77,351066
20013,0.001156,74.125.24.0-255,2184,171081,77,351066
20014,0.001159,172.31.40.0-255,66,171147,77,351066
20015,0.001265,74.125.24.0-255,1484,172631,77,351066
20016,0.00128,74.125.24.0-255,2902,175533,77,351066
20017,0.001283,172.31.40.0-255,66,175599,77,351066
20018,0.00129,74.125.24.0-255,5738,181337,77,351066
20019,0.001292,172.31.40.0-255,66,181403,77,351066
20020,0.001328,74.125.24.0-255,12828,194231,77,351066
20021,0.00133,172.31.40.0-255,66,194297,77,351066
20022,0.001338,74.125.24.0-255,7156,201453,77,351066
20023,0.001341,172.31.40.0-255,66,201519,77,351066
20024,0.001408,74.125.24.0-255,3602,205121,77,351066
20025,0.001412,172.31.40.0-255,66,205187,77,351066
20026,0.001418,74.125.24.0-255,4320,209507,77,351066
20027,0.00142,172.31.40.0-255,66,209573,77,351066
20028,0.001428,74.125.24.0-255,9992,219565,77,351066
20029,0.00143,172.31.40.0-255,66,219631,77,351066
20030,0.001445,74.125.24.0-255,11410,231041,77,351066
20031,0.001447,172.31.40.0-255,66,231107,77,351066
20032,0.001472,74.125.24.0-255,4320,235427,77,351066
20033,0.001474,172.31.40.0-255,66,235493,77,351066
20034,0.001479,74.125.24.0-255,3602,239095,77,351066
20035,0.001482,172.31.40.0-255,66,239161,77,351066
20036,0.001487,74.125.24.0-255,4320,243481,77,351066
20037,0.001489,172.31.40.0-255,66,243547,77,351066
20038,0.001501,74.125.24.0-255,2902,246449,77,351066
20039,0.001503,172.31.40.0-255,66,246515,77,351066
20040,0.001533,74.125.24.0-255,7156,253671,77,351066
20041,0.001536,172.31.40.0-255,66,253737,77,351066
20042,0.001551,172.31.40.0-255,66,253803,77,351066
20043,0.001582,74.125.24.0-255,5020,258823,77,351066
20044,0.001585,172.31.40.0-255,66,258889,77,351066
20045,0.001612,74.125.24.0-255,5738,264627,77,351066
20046,0.001614,172.31.40.0-255,66,264693,77,351066
20047,0.001644,74.125.24.0-255,8574,273267,77,351066
20048,0.001647,172.31.40.0-255,66,273333,77,351066
20049,0.001666,74.125.24.0-255,7156,280489,77,351066
20050,0.001669,172.31.40.0-255,66,280555,77,351066
20051,0.001702,74.125.24.0-255,8574,289129,77,351066
20052,0.001706,172.31.40.0-255,66,289195,77,351066
20053,0.00171,74.125.24.0-255,3602,292797,77,351066
20054,0.001713,172.31.40.0-255,66,292863,77,351066
20055,0.001744,74.125.24.0-255,1484,294347,77,351066
20056,0.001763,74.125.24.0-255,2902,297249,77,351066
20057,0.001766,172.31.40.0-255,66,297315,77,351066
20058,0.001771,74.125.24.0-255,2902,300217,77,351066
20059,0.001772,172.31.40.0-255,66,300283,77,351066
20060,0.001796,74.125.24.0-255,2902,303185,77,351066
20061,0.001799,172.31.40.0-255,66,303251,77,351066
20062,0.001805,74.125.24.0-255,4320,307571,77,351066
20063,0.001808,172.31.40.0-255,66,307637,77,351066
20064,0.001815,74.125.24.0-255,8574,316211,77,351066
20065,0.001817,172.31.40.0-255,66,316277,77,351066
20066,0.00184,74.125.24.0-255,2902,319179,77,351066
20067,0.001843,172.31.40.0-255,66,319245,77,351066
20068,0.001853,74.125.24.0-255,7856,327101,77,351066
20069,0.001856,172.31.40.0-255,66,327167,77,351066
20070,0.001899,74.125.24.0-255,9992,337159,77,351066
20071,0.001903,172.31.40.0-255,66,337225,77,351066
20072,0.001931,74.125.24.0-255,5738,342963,77,351066
20073,0.001933,172.31.40.0-255,66,343029,77,351066
20074,0.001949,172.31.40.0-255,66,343095,77,351066
20075,0.001957,74.125.24.0-255,7365,350460,77,351066
20076,0.001959,172.31.40.0-255,66,350526,77,351066
20077,0.001962,74.125.24.0-255,97,350623,77,351066
20078,0.002024,74.125.24.0-255,105,350728,77,351066
20079,0.002489,172.31.40.0-255,101,350829,77,351066
20080,0.00465,74.125.24.0-255,66,350895,77,351066
20081,0.009555,172.31.40.0-255,105,351000,77,351066
20082,0.011744,74.125.24.0-255,66,351066,77,351066
20083,0.0,74.125.24.0-255,152,152,77,382348
20084,1.4e-05,172.31.40.0-255,66,218,77,382348
20085,2e-05,74.125.24.0-255,1484,1702,77,382348
20086,2.5e-05,172.31.40.0-255,66,1768,77,382348
20087,3e-05,74.125.24.0-255,2902,4670,77,382348
20088,3.4e-05,172.31.40.0-255,66,4736,77,382348
20089,5e-05,74.125.24.0-255,7156,11892,77,382348
20090,5.4e-05,172.31.40.0-255,66,11958,77,382348
20091,5.8e-05,74.125.24.0-255,2125,14083,77,382348
20092,6.2e-05,172.31.40.0-255,66,14149,77,382348
20093,7.1e-05,74.125.24.0-255,8574,22723,77,382348
20094,7.4e-05,172.31.40.0-255,66,22789,77,382348
20095,9.5e-05,74.125.24.0-255,2902,25691,77,382348
20096,9.8e-05,172.31.40.0-255,66,25757,77,382348
20097,0.000109,74.125.24.0-255,5379,31136,77,382348
20098,0.000112,172.31.40.0-255,66,31202,77,382348
20099,0.000149,74.125.24.0-255,1484,32686,77,382348
20100,0.000152,172.31.40.0-255,66,32752,77,382348
20101,0.000157,74.125.24.0-255,2902,35654,77,382348
20102,0.000159,172.31.40.0-255,66,35720,77,382348
20103,0.000172,74.125.24.0-255,5738,41458,77,382348
20104,0.000175,172.31.40.0-255,66,41524,77,382348
20105,0.000212,74.125.24.0-255,13887,55411,77,382348
20106,0.000215,172.31.40.0-255,66,55477,77,382348
20107,0.000227,74.125.24.0-255,7156,62633,77,382348
20108,0.00023,172.31.40.0-255,66,62699,77,382348
20109,0.000259,74.125.24.0-255,2816,65515,77,382348
20110,0.000264,172.31.40.0-255,66,65581,77,382348
20111,0.000289,74.125.24.0-255,135,65716,77,382348
20112,0.000292,172.31.40.0-255,66,65782,77,382348
20113,0.000371,74.125.24.0-255,1484,67266,77,382348
20114,0.000375,172.31.40.0-255,66,67332,77,382348
20115,0.000401,74.125.24.0-255,2902,70234,77,382348
20116,0.000408,74.125.24.0-255,5738,75972,77,382348
20117,0.000412,74.125.24.0-255,2902,78874,77,382348
20118,0.000462,74.125.24.0-255,4320,83194,77,382348
20119,0.000479,74.125.24.0-255,3961,87155,77,382348
20120,0.000488,74.125.24.0-255,8574,95729,77,382348
20121,0.000514,74.125.24.0-255,3961,99690,77,382348
20122,0.000555,74.125.24.0-255,4320,104010,77,382348
20123,0.000582,74.125.24.0-255,5738,109748,77,382348
20124,0.000613,74.125.24.0-255,11410,121158,77,382348
20125,0.000616,74.125.24.0-255,1484,122642,77,382348
20126,0.000632,74.125.24.0-255,2902,125544,77,382348
20127,0.000637,172.31.40.0-255,66,125610,77,382348
20128,0.000642,172.31.40.0-255,66,125676,77,382348
20129,0.000667,74.125.24.0-255,5738,131414,77,382348
20130,0.000685,74.125.24.0-255,2184,133598,77,382348
20131,0.0007,172.31.40.0-255,66,133664,77,382348
20132,0.000711,74.125.24.0-255,2902,136566,77,382348
20133,0.000731,74.125.24.0-255,2902,139468,77,382348
20134,0.00074,74.125.24.0-255,7156,146624,77,382348
20135,0.000811,74.125.24.0-255,5738,152362,77,382348
20136,0.00083,74.125.24.0-255,8574,160936,77,382348
20137,0.000834,172.31.40.0-255,66,161002,77,382348
20138,0.000843,74.125.24.0-255,2184,163186,77,382348
20139,0.000853,172.31.40.0-255,66,163252,77,382348
20140,0.000883,74.125.24.0-255,5449,168701,77,382348
20141,0.00089,172.31.40.0-255,66,168767,77,382348
20142,0.000962,74.125.24.0-255,1484,170251,77,382348
20143,0.000968,74.125.24.0-255,2902,173153,77,382348
20144,0.000973,172.31.40.0-255,66,173219,77,382348
20145,0.001008,74.125.24.0-255,5738,178957,77,382348
20146,0.001019,74.125.24.0-255,12828,191785,77,382348
20147,0.001025,74.125.24.0-255,4320,196105,77,382348
20148,0.001032,172.31.40.0-255,66,196171,77,382348
20149,0.001059,74.125.24.0-255,6438,202609,77,382348
20150,0.001073,172.31.40.0-255,66,202675,77,382348
20151,0.00113,74.125.24.0-255,1484,204159,77,382348
20152,0.001144,74.125.24.0-255,2902,207061,77,382348
20153,0.001164,74.125.24.0-255,4320,211381,77,382348
20154,0.001167,172.31.40.0-255,66,211447,77,382348
20155,0.001172,172.31.40.0-255,66,211513,77,382348
20156,0.001192,74.125.24.0-255,1484,212997,77,382348
20157,0.001199,74.125.24.0-255,5738,218735,77,382348
20158,0.001221,74.125.24.0-255,4320,223055,77,382348
20159,0.001231,74.125.24.0-255,11410,234465,77,382348
20160,0.001236,74.125.24.0-255,2184,236649,77,382348
20161,0.001254,172.31.40.0-255,66,236715,77,382348
20162,0.001259,74.125.24.0-255,2902,239617,77,382348
20163,0.00129,74.125.24.0-255,7156,246773,77,382348
20164,0.001297,74.125.24.0-255,5738,252511,77,382348
20165,0.001305,74.125.24.0-255,8574,261085,77,382348
20166,0.001309,172.31.40.0-255,66,261151,77,382348
20167,0.001337,74.125.24.0-255,5738,266889,77,382348
20168,0.001343,74.125.24.0-255,3602,270491,77,382348
20169,0.00136,172.31.40.0-255,66,270557,77,382348
20170,0.001396,74.125.24.0-255,1484,272041,77,382348
20171,0.001411,74.125.24.0-255,2902,274943,77,382348
20172,0.001416,74.125.24.0-255,4320,279263,77,382348
20173,0.001428,172.31.40.0-255,66,279329,77,382348
20174,0.001439,74.125.24.0-255,1484,280813,77,382348
20175,0.00145,74.125.24.0-255,4320,285133,77,382348
20176,0.001457,74.125.24.0-255,7156,292289,77,382348
20177,0.001471,74.125.24.0-255,4320,296609,77,382348
20178,0.001481,172.31.40.0-255,66,296675,77,382348
20179,0.001492,74.125.24.0-255,4320,300995,77,382348
20180,0.00151,74.125.24.0-255,3602,304597,77,382348
20181,0.001527,74.125.24.0-255,5738,310335,77,382348
20182,0.001534,172.31.40.0-255,66,310401,77,382348
20183,0.001557,74.125.24.0-255,7156,317557,77,382348
20184,0.001603,172.31.40.0-255,66,317623,77,382348
20185,0.00163,74.125.24.0-255,4320,321943,77,382348
20186,0.001637,172.31.40.0-255,66,322009,77,382348
20187,0.001648,74.125.24.0-255,2184,324193,77,382348
20188,0.001659,74.125.24.0-255,5738,329931,77,382348
20189,0.001676,74.125.24.0-255,1484,331415,77,382348
20190,0.001682,74.125.24.0-255,4320,335735,77,382348
20191,0.001694,172.31.40.0-255,66,335801,77,382348
20192,0.001719,74.125.24.0-255,11410,347211,77,382348
20193,0.001723,74.125.24.0-255,1484,348695,77,382348
20194,0.00174,74.125.24.0-255,4320,353015,77,382348
20195,0.001747,172.31.40.0-255,66,353081,77,382348
20196,0.001779,74.125.24.0-255,13528,366609,77,382348
20197,0.001785,74.125.24.0-255,4320,370929,77,382348
20198,0.001817,74.125.24.0-255,10976,381905,77,382348
20199,0.001821,74.125.24.0-255,105,382010,77,382348
20200,0.001836,172.31.40.0-255,66,382076,77,382348
20201,0.002567,172.31.40.0-255,101,382177,77,382348
20202,0.005104,74.125.24.0-255,66,382243,77,382348
20203,0.018231,172.31.40.0-255,105,382348,77,382348
20204,0.0,74.125.24.0-255,152,152,77,350921
20205,1.6e-05,172.31.40.0-255,66,218,77,350921
20206,2.2e-05,74.125.24.0-255,1484,1702,77,350921
20207,2.5e-05,172.31.40.0-255,66,1768,77,350921
20208,2.8e-05,74.125.24.0-255,1484,3252,77,350921
20209,3.2e-05,172.31.40.0-255,66,3318,77,350921
20210,6.6e-05,74.125.24.0-255,1484,4802,77,350921
20211,6.9e-05,172.31.40.0-255,66,4868,77,350921
20212,7.8e-05,74.125.24.0-255,7156,12024,77,350921
20213,8e-05,172.31.40.0-255,66,12090,77,350921
20214,8.7e-05,74.125.24.0-255,7671,19761,77,350921
20215,8.9e-05,172.31.40.0-255,66,19827,77,350921
20216,0.000118,74.125.24.0-255,7156,26983,77,350921
20217,0.00012,172.31.40.0-255,66,27049,77,350921
20218,0.000144,74.125.24.0-255,3961,31010,77,350921
20219,0.000146,172.31.40.0-255,66,31076,77,350921
20220,0.00017,74.125.24.0-255,1484,32560,77,350921
20221,0.000172,172.31.40.0-255,66,32626,77,350921
20222,0.000198,74.125.24.0-255,2902,35528,77,350921
20223,0.000201,172.31.40.0-255,66,35594,77,350921
20224,0.000206,74.125.24.0-255,5738,41332,77,350921
20225,0.000208,172.31.40.0-255,66,41398,77,350921
20226,0.000212,74.125.24.0-255,2902,44300,77,350921
20227,0.000214,172.31.40.0-255,66,44366,77,350921
20228,0.000241,74.125.24.0-255,3961,48327,77,350921
20229,0.000243,172.31.40.0-255,66,48393,77,350921
20230,0.000252,74.125.24.0-255,11410,59803,77,350921
20231,0.000255,172.31.40.0-255,66,59869,77,350921
20232,0.000272,74.125.24.0-255,2902,62771,77,350921
20233,0.000274,172.31.40.0-255,66,62837,77,350921
20234,0.000325,74.125.24.0-255,2850,65687,77,350921
20235,0.000328,172.31.40.0-255,66,65753,77,350921
20236,0.000483,74.125.24.0-255,347,66100,77,350921
20237,0.000609,74.125.24.0-255,1484,67584,77,350921
20238,0.000614,172.31.40.0-255,66,67650,77,350921
20239,0.000619,74.125.24.0-255,2902,70552,77,350921
20240,0.000621,172.31.40.0-255,66,70618,77,350921
20241,0.000648,74.125.24.0-255,5738,76356,77,350921
20242,0.000651,172.31.40.0-255,66,76422,77,350921
20243,0.000653,74.125.24.0-255,1484,77906,77,350921
20244,0.00066,172.31.40.0-255,101,78007,77,350921
20245,0.000692,74.125.24.0-255,9633,87640,77,350921
20246,0.000696,172.31.40.0-255,66,87706,77,350921
20247,0.000703,74.125.24.0-255,7156,94862,77,350921
20248,0.000705,172.31.40.0-255,66,94928,77,350921
20249,0.000734,74.125.24.0-255,5379,100307,77,350921
20250,0.000737,172.31.40.0-255,66,100373,77,350921
20251,0.001085,74.125.24.0-255,1484,101857,77,350921
20252,0.001091,74.125.24.0-255,2902,104759,77,350921
20253,0.001094,172.31.40.0-255,66,104825,77,350921
20254,0.001097,74.125.24.0-255,1484,106309,77,350921
20255,0.001124,74.125.24.0-255,4320,110629,77,350921
20256,0.001127,172.31.40.0-255,66,110695,77,350921
20257,0.001168,74.125.24.0-255,8574,119269,77,350921
20258,0.00117,172.31.40.0-255,66,119335,77,350921
20259,0.001196,74.125.24.0-255,4320,123655,77,350921
20260,0.001198,172.31.40.0-255,66,123721,77,350921
20261,0.001207,74.125.24.0-255,10692,134413,77,350921
20262,0.001209,172.31.40.0-255,66,134479,77,350921
20263,0.001216,74.125.24.0-255,7156,141635,77,350921
20264,0.001218,172.31.40.0-255,66,141701,77,350921
20265,0.001223,74.125.24.0-255,5738,147439,77,350921
20266,0.001226,172.31.40.0-255,66,147505,77,350921
20267,0.001259,74.125.24.0-255,2902,150407,77,350921
20268,0.001262,172.31.40.0-255,66,150473,77,350921
20269,0.001276,172.31.40.0-255,66,150539,77,350921
20270,0.001279,74.125.24.0-255,766,151305,77,350921
20271,0.0014,74.125.24.0-255,1484,152789,77,350921
20272,0.001404,172.31.40.0-255,66,152855,77,350921
20273,0.001424,74.125.24.0-255,2902,155757,77,350921
20274,0.001426,172.31.40.0-255,66,155823,77,350921
20275,0.00143,74.125.24.0-255,1484,157307,77,350921
20276,0.001457,74.125.24.0-255,4320,161627,77,350921
20277,0.00146,172.31.40.0-255,66,161693,77,350921
20278,0.001467,74.125.24.0-255,5738,167431,77,350921
20279,0.00147,172.31.40.0-255,66,167497,77,350921
20280,0.001473,74.125.24.0-255,1484,168981,77,350921
20281,0.001515,74.125.24.0-255,11410,180391,77,350921
20282,0.00152,172.31.40.0-255,66,180457,77,350921
20283,0.001526,74.125.24.0-255,5020,185477,77,350921
20284,0.001528,172.31.40.0-255,66,185543,77,350921
20285,0.001596,74.125.24.0-255,1484,187027,77,350921
20286,0.001601,74.125.24.0-255,2902,189929,77,350921
20287,0.001605,172.31.40.0-255,66,189995,77,350921
20288,0.001632,74.125.24.0-255,4320,194315,77,350921
20289,0.001636,172.31.40.0-255,66,194381,77,350921
20290,0.001663,74.125.24.0-255,1484,195865,77,350921
20291,0.001675,74.125.24.0-255,12828,208693,77,350921
20292,0.001678,172.31.40.0-255,66,208759,77,350921
20293,0.001681,74.125.24.0-255,1484,210243,77,350921
20294,0.001726,74.125.24.0-255,9274,219517,77,350921
20295,0.001729,172.31.40.0-255,66,219583,77,350921
20296,0.001769,74.125.24.0-255,1484,221067,77,350921
20297,0.001772,74.125.24.0-255,1484,222551,77,350921
20298,0.001775,172.31.40.0-255,66,222617,77,350921
20299,0.001796,74.125.24.0-255,1484,224101,77,350921
20300,0.001802,74.125.24.0-255,5738,229839,77,350921
20301,0.001806,172.31.40.0-255,66,229905,77,350921
20302,0.001835,74.125.24.0-255,5738,235643,77,350921
20303,0.001839,172.31.40.0-255,66,235709,77,350921
20304,0.001854,74.125.24.0-255,12828,248537,77,350921
20305,0.001857,172.31.40.0-255,66,248603,77,350921
20306,0.001862,74.125.24.0-255,2902,251505,77,350921
20307,0.001864,172.31.40.0-255,66,251571,77,350921
20308,0.001895,74.125.24.0-255,2184,253755,77,350921
20309,0.0019,172.31.40.0-255,66,253821,77,350921
20310,0.001906,74.125.24.0-255,5738,259559,77,350921
20311,0.001909,172.31.40.0-255,66,259625,77,350921
20312,0.001919,74.125.24.0-255,12828,272453,77,350921
20313,0.001922,172.31.40.0-255,66,272519,77,350921
20314,0.001933,74.125.24.0-255,11410,283929,77,350921
20315,0.001936,172.31.40.0-255,66,283995,77,350921
20316,0.002,74.125.24.0-255,4320,288315,77,350921
20317,0.002003,172.31.40.0-255,66,288381,77,350921
20318,0.002039,74.125.24.0-255,12110,300491,77,350921
20319,0.002042,172.31.40.0-255,66,300557,77,350921
20320,0.002059,172.31.40.0-255,66,300623,77,350921
20321,0.002064,74.125.24.0-255,3602,304225,77,350921
20322,0.002067,172.31.40.0-255,66,304291,77,350921
20323,0.002682,74.125.24.0-255,66,304357,77,350921
20324,0.004095,74.125.24.0-255,2902,307259,77,350921
20325,0.004101,172.31.40.0-255,66,307325,77,350921
20326,0.004124,74.125.24.0-255,2902,310227,77,350921
20327,0.004127,172.31.40.0-255,66,310293,77,350921
20328,0.006153,74.125.24.0-255,5738,316031,77,350921
20329,0.006159,172.31.40.0-255,66,316097,77,350921
20330,0.008213,74.125.24.0-255,5738,321835,77,350921
20331,0.008221,172.31.40.0-255,66,321901,77,350921
20332,0.010274,74.125.24.0-255,5738,327639,77,350921
20333,0.01028,172.31.40.0-255,66,327705,77,350921
20334,0.012342,74.125.24.0-255,5738,333443,77,350921
20335,0.012351,172.31.40.0-255,66,333509,77,350921
20336,0.014403,74.125.24.0-255,5738,339247,77,350921
20337,0.01441,172.31.40.0-255,66,339313,77,350921
20338,0.016471,74.125.24.0-255,5738,345051,77,350921
20339,0.01648,172.31.40.0-255,66,345117,77,350921
20340,0.018534,74.125.24.0-255,5738,350855,77,350921
20341,0.018541,172.31.40.0-255,66,350921,77,350921
20342,0.0,74.125.24.0-255,153,153,77,257575
20343,2.5e-05,172.31.40.0-255,66,219,77,257575
20344,3.3e-05,74.125.24.0-255,1484,1703,77,257575
20345,3.7e-05,172.31.40.0-255,66,1769,77,257575
20346,4.2e-05,74.125.24.0-255,2902,4671,77,257575
20347,4.5e-05,172.31.40.0-255,66,4737,77,257575
20348,5.9e-05,74.125.24.0-255,4320,9057,77,257575
20349,6.2e-05,172.31.40.0-255,66,9123,77,257575
20350,0.000111,74.125.24.0-255,4870,13993,77,257575
20351,0.000115,172.31.40.0-255,66,14059,77,257575
20352,0.000122,74.125.24.0-255,5738,19797,77,257575
20353,0.000124,172.31.40.0-255,66,19863,77,257575
20354,0.00016,74.125.24.0-255,9992,29855,77,257575
20355,0.000163,172.31.40.0-255,66,29921,77,257575
20356,0.000184,74.125.24.0-255,1125,31046,77,257575
20357,0.000187,172.31.40.0-255,66,31112,77,257575
20358,0.000337,74.125.24.0-255,1484,32596,77,257575
20359,0.000342,172.31.40.0-255,66,32662,77,257575
20360,0.000347,74.125.24.0-255,2902,35564,77,257575
20361,0.00035,172.31.40.0-255,66,35630,77,257575
20362,0.000353,74.125.24.0-255,1484,37114,77,257575
20363,0.00036,172.31.40.0-255,66,37180,77,257575
20364,0.000387,74.125.24.0-255,4320,41500,77,257575
20365,0.00039,172.31.40.0-255,66,41566,77,257575
20366,0.000403,74.125.24.0-255,1484,43050,77,257575
20367,0.000409,172.31.40.0-255,66,43116,77,257575
20368,0.000439,74.125.24.0-255,5379,48495,77,257575
20369,0.000442,172.31.40.0-255,66,48561,77,257575
20370,0.00045,74.125.24.0-255,7156,55717,77,257575
20371,0.000452,172.31.40.0-255,66,55783,77,257575
20372,0.000457,74.125.24.0-255,2902,58685,77,257575
20373,0.000459,172.31.40.0-255,66,58751,77,257575
20374,0.000484,74.125.24.0-255,1484,60235,77,257575
20375,0.000513,74.125.24.0-255,5651,65886,77,257575
20376,0.000516,172.31.40.0-255,66,65952,77,257575
20377,0.000518,74.125.24.0-255,383,66335,77,257575
20378,0.000618,74.125.24.0-255,1484,67819,77,257575
20379,0.000622,172.31.40.0-255,66,67885,77,257575
20380,0.000628,74.125.24.0-255,2902,70787,77,257575
20381,0.00063,172.31.40.0-255,66,70853,77,257575
20382,0.000659,74.125.24.0-255,4320,75173,77,257575
20383,0.000661,74.125.24.0-255,1484,76657,77,257575
20384,0.000666,172.31.40.0-255,66,76723,77,257575
20385,0.000687,74.125.24.0-255,4320,81043,77,257575
20386,0.00069,172.31.40.0-255,66,81109,77,257575
20387,0.000697,74.125.24.0-255,5379,86488,77,257575
20388,0.000699,172.31.40.0-255,66,86554,77,257575
20389,0.000705,74.125.24.0-255,5738,92292,77,257575
20390,0.000707,172.31.40.0-255,66,92358,77,257575
20391,0.000756,74.125.24.0-255,8215,100573,77,257575
20392,0.000759,172.31.40.0-255,66,100639,77,257575
20393,0.000921,74.125.24.0-255,1484,102123,77,257575
20394,0.000925,74.125.24.0-255,1484,103607,77,257575
20395,0.000928,172.31.40.0-255,66,103673,77,257575
20396,0.000939,74.125.24.0-255,1484,105157,77,257575
20397,0.000948,74.125.24.0-255,5738,110895,77,257575
20398,0.000949,172.31.40.0-255,66,110961,77,257575
20399,0.000975,74.125.24.0-255,7156,118117,77,257575
20400,0.000979,172.31.40.0-255,66,118183,77,257575
20401,0.001004,74.125.24.0-255,5738,123921,77,257575
20402,0.001006,172.31.40.0-255,66,123987,77,257575
20403,0.001039,74.125.24.0-255,7156,131143,77,257575
20404,0.001041,172.31.40.0-255,66,131209,77,257575
20405,0.001052,74.125.24.0-255,3602,134811,77,257575
20406,0.001054,172.31.40.0-255,66,134877,77,257575
20407,0.001063,74.125.24.0-255,11410,146287,77,257575
20408,0.001065,172.31.40.0-255,66,146353,77,257575
20409,0.001082,172.31.40.0-255,66,146419,77,257575
20410,0.001129,74.125.24.0-255,7856,154275,77,257575
20411,0.001132,172.31.40.0-255,66,154341,77,257575
20412,0.001663,74.125.24.0-255,1484,155825,77,257575
20413,0.001668,74.125.24.0-255,2902,158727,77,257575
20414,0.001676,172.31.40.0-255,66,158793,77,257575
20415,0.001681,74.125.24.0-255,2902,161695,77,257575
20416,0.001682,172.31.40.0-255,66,161761,77,257575
20417,0.001699,74.125.24.0-255,2902,164663,77,257575
20418,0.001701,172.31.40.0-255,66,164729,77,257575
20419,0.001707,74.125.24.0-255,5738,170467,77,257575
20420,0.001709,172.31.40.0-255,66,170533,77,257575
20421,0.001739,74.125.24.0-255,5738,176271,77,257575
20422,0.001742,172.31.40.0-255,66,176337,77,257575
20423,0.001771,74.125.24.0-255,7156,183493,77,257575
20424,0.001773,172.31.40.0-255,66,183559,77,257575
20425,0.001779,74.125.24.0-255,5020,188579,77,257575
20426,0.00178,172.31.40.0-255,66,188645,77,257575
20427,0.002367,74.125.24.0-255,1484,190129,77,257575
20428,0.002373,74.125.24.0-255,1484,191613,77,257575
20429,0.002391,172.31.40.0-255,66,191679,77,257575
20430,0.002417,74.125.24.0-255,1484,193163,77,257575
20431,0.002425,74.125.24.0-255,5738,198901,77,257575
20432,0.002427,172.31.40.0-255,66,198967,77,257575
20433,0.002437,74.125.24.0-255,9992,208959,77,257575
20434,0.002439,172.31.40.0-255,66,209025,77,257575
20435,0.002488,74.125.24.0-255,11410,220435,77,257575
20436,0.002491,172.31.40.0-255,66,220501,77,257575
20437,0.002496,74.125.24.0-255,2184,222685,77,257575
20438,0.002498,172.31.40.0-255,66,222751,77,257575
20439,0.005097,74.125.24.0-255,5738,228489,77,257575
20440,0.005105,172.31.40.0-255,66,228555,77,257575
20441,0.007743,74.125.24.0-255,5738,234293,77,257575
20442,0.007748,172.31.40.0-255,66,234359,77,257575
20443,0.010389,74.125.24.0-255,5738,240097,77,257575
20444,0.010397,172.31.40.0-255,66,240163,77,257575
20445,0.013019,74.125.24.0-255,5738,245901,77,257575
20446,0.013027,172.31.40.0-255,66,245967,77,257575
20447,0.015655,74.125.24.0-255,5738,251705,77,257575
20448,0.015666,172.31.40.0-255,66,251771,77,257575
20449,0.018266,74.125.24.0-255,5738,257509,77,257575
20450,0.018274,172.31.40.0-255,66,257575,77,257575
20451,0.0,74.125.200.0-255,146,146,77,209147
20452,1.5e-05,172.31.40.0-255,66,212,77,209147
20453,2.1e-05,74.125.200.0-255,1484,1696,77,209147
20454,2.5e-05,172.31.40.0-255,66,1762,77,209147
20455,3.1e-05,74.125.200.0-255,2902,4664,77,209147
20456,3.4e-05,172.31.40.0-255,66,4730,77,209147
20457,6e-05,74.125.200.0-255,5738,10468,77,209147
20458,6.3e-05,172.31.40.0-255,66,10534,77,209147
20459,8.9e-05,74.125.200.0-255,3534,14068,77,209147
20460,9.2e-05,172.31.40.0-255,66,14134,77,209147
20461,0.000109,74.125.200.0-255,1484,15618,77,209147
20462,0.000112,172.31.40.0-255,66,15684,77,209147
20463,0.000133,74.125.200.0-255,2902,18586,77,209147
20464,0.000136,172.31.40.0-255,66,18652,77,209147
20465,0.000138,74.125.200.0-255,1484,20136,77,209147
20466,0.00014,172.31.40.0-255,66,20202,77,209147
20467,0.000154,74.125.200.0-255,1484,21686,77,209147
20468,0.000157,172.31.40.0-255,66,21752,77,209147
20469,0.000183,74.125.200.0-255,5738,27490,77,209147
20470,0.000187,172.31.40.0-255,66,27556,77,209147
20471,0.000192,74.125.200.0-255,3961,31517,77,209147
20472,0.000194,172.31.40.0-255,66,31583,77,209147
20473,0.000297,74.125.200.0-255,1484,33067,77,209147
20474,0.000302,172.31.40.0-255,66,33133,77,209147
20475,0.000307,74.125.200.0-255,2902,36035,77,209147
20476,0.00031,172.31.40.0-255,66,36101,77,209147
20477,0.000341,74.125.200.0-255,2902,39003,77,209147
20478,0.000344,172.31.40.0-255,66,39069,77,209147
20479,0.000366,74.125.200.0-255,2902,41971,77,209147
20480,0.000369,172.31.40.0-255,66,42037,77,209147
20481,0.000375,74.125.200.0-255,6797,48834,77,209147
20482,0.000378,172.31.40.0-255,66,48900,77,209147
20483,0.000381,74.125.200.0-255,1484,50384,77,209147
20484,0.000409,74.125.200.0-255,9992,60376,77,209147
20485,0.000411,172.31.40.0-255,66,60442,77,209147
20486,0.000432,74.125.200.0-255,2902,63344,77,209147
20487,0.000435,172.31.40.0-255,66,63410,77,209147
20488,0.000453,74.125.200.0-255,2543,65953,77,209147
20489,0.000456,172.31.40.0-255,66,66019,77,209147
20490,0.00061,74.125.200.0-255,412,66431,77,209147
20491,0.000668,74.125.200.0-255,330,66761,77,209147
20492,0.00097,74.125.200.0-255,1484,68245,77,209147
20493,0.000975,172.31.40.0-255,66,68311,77,209147
20494,0.000991,74.125.200.0-255,2902,71213,77,209147
20495,0.000994,172.31.40.0-255,66,71279,77,209147
20496,0.000998,74.125.200.0-255,2902,74181,77,209147
20497,0.001,172.31.40.0-255,66,74247,77,209147
20498,0.001003,74.125.200.0-255,1484,75731,77,209147
20499,0.001021,74.125.200.0-255,2902,78633,77,209147
20500,0.001024,172.31.40.0-255,66,78699,77,209147
20501,0.001027,74.125.200.0-255,1484,80183,77,209147
20502,0.001052,74.125.200.0-255,7156,87339,77,209147
20503,0.001055,172.31.40.0-255,66,87405,77,209147
20504,0.001062,74.125.200.0-255,7156,94561,77,209147
20505,0.001064,172.31.40.0-255,66,94627,77,209147
20506,0.001142,74.125.200.0-255,2902,97529,77,209147
20507,0.001146,172.31.40.0-255,66,97595,77,209147
20508,0.001164,74.125.200.0-255,3602,101197,77,209147
20509,0.001167,172.31.40.0-255,66,101263,77,209147
20510,0.001604,74.125.200.0-255,1484,102747,77,209147
20511,0.001612,74.125.200.0-255,2902,105649,77,209147
20512,0.001616,172.31.40.0-255,66,105715,77,209147
20513,0.001621,74.125.200.0-255,1484,107199,77,209147
20514,0.001642,74.125.200.0-255,4320,111519,77,209147
20515,0.001646,172.31.40.0-255,66,111585,77,209147
20516,0.001666,74.125.200.0-255,5738,117323,77,209147
20517,0.001669,172.31.40.0-255,66,117389,77,209147
20518,0.0017,74.125.200.0-255,5738,123127,77,209147
20519,0.001703,172.31.40.0-255,66,123193,77,209147
20520,0.001714,74.125.200.0-255,12110,135303,77,209147
20521,0.001717,172.31.40.0-255,66,135369,77,209147
20522,0.002239,74.125.200.0-255,1484,136853,77,209147
20523,0.002254,74.125.200.0-255,2902,139755,77,209147
20524,0.002257,172.31.40.0-255,66,139821,77,209147
20525,0.002263,74.125.200.0-255,2902,142723,77,209147
20526,0.002265,172.31.40.0-255,66,142789,77,209147
20527,0.002286,74.125.200.0-255,1484,144273,77,209147
20528,0.00229,74.125.200.0-255,1484,145757,77,209147
20529,0.002292,172.31.40.0-255,66,145823,77,209147
20530,0.002312,74.125.200.0-255,7156,152979,77,209147
20531,0.002315,172.31.40.0-255,66,153045,77,209147
20532,0.002319,74.125.200.0-255,2902,155947,77,209147
20533,0.002322,172.31.40.0-255,66,156013,77,209147
20534,0.002336,74.125.200.0-255,1484,157497,77,209147
20535,0.002352,74.125.200.0-255,5738,163235,77,209147
20536,0.002354,172.31.40.0-255,66,163301,77,209147
20537,0.002367,74.125.200.0-255,1484,164785,77,209147
20538,0.002386,74.125.200.0-255,5020,169805,77,209147
20539,0.002389,172.31.40.0-255,66,169871,77,209147
20540,0.004746,74.125.200.0-255,5738,175609,77,209147
20541,0.00475,172.31.40.0-255,66,175675,77,209147
20542,0.007108,74.125.200.0-255,5738,181413,77,209147
20543,0.007114,172.31.40.0-255,66,181479,77,209147
20544,0.009468,74.125.200.0-255,5738,187217,77,209147
20545,0.009476,172.31.40.0-255,66,187283,77,209147
20546,0.011821,74.125.200.0-255,5738,193021,77,209147
20547,0.01183,172.31.40.0-255,66,193087,77,209147
20548,0.014173,74.125.200.0-255,4320,197407,77,209147
20549,0.014181,172.31.40.0-255,66,197473,77,209147
20550,0.014202,74.125.200.0-255,1484,198957,77,209147
20551,0.016551,74.125.200.0-255,4320,203277,77,209147
20552,0.016559,172.31.40.0-255,66,203343,77,209147
20553,0.018903,74.125.200.0-255,5738,209081,77,209147
20554,0.01891,172.31.40.0-255,66,209147,77,209147
20555,0.0,74.125.130.0-255,296,296,77,142223
20556,2.4e-05,172.31.40.0-255,66,362,77,142223
20557,3e-05,74.125.130.0-255,1484,1846,77,142223
20558,3.5e-05,172.31.40.0-255,66,1912,77,142223
20559,4.2e-05,74.125.130.0-255,4320,6232,77,142223
20560,4.6e-05,172.31.40.0-255,66,6298,77,142223
20561,4.9e-05,74.125.130.0-255,1484,7782,77,142223
20562,5.2e-05,172.31.40.0-255,66,7848,77,142223
20563,5.8e-05,74.125.130.0-255,2902,10750,77,142223
20564,6e-05,172.31.40.0-255,66,10816,77,142223
20565,0.00011,74.125.130.0-255,4738,15554,77,142223
20566,0.000113,172.31.40.0-255,66,15620,77,142223
20567,0.000135,74.125.130.0-255,5738,21358,77,142223
20568,0.000137,172.31.40.0-255,66,21424,77,142223
20569,0.000141,74.125.130.0-255,1484,22908,77,142223
20570,0.000143,172.31.40.0-255,66,22974,77,142223
20571,0.000161,74.125.130.0-255,4320,27294,77,142223
20572,0.000163,172.31.40.0-255,66,27360,77,142223
20573,0.0002,74.125.130.0-255,3961,31321,77,142223
20574,0.000204,172.31.40.0-255,66,31387,77,142223
20575,0.000369,74.125.130.0-255,1484,32871,77,142223
20576,0.000373,172.31.40.0-255,66,32937,77,142223
20577,0.000378,74.125.130.0-255,2902,35839,77,142223
20578,0.000381,172.31.40.0-255,66,35905,77,142223
20579,0.000404,74.125.130.0-255,4320,40225,77,142223
20580,0.000406,172.31.40.0-255,66,40291,77,142223
20581,0.00043,74.125.130.0-255,1484,41775,77,142223
20582,0.000432,172.31.40.0-255,66,41841,77,142223
20583,0.000453,74.125.130.0-255,4320,46161,77,142223
20584,0.000456,172.31.40.0-255,66,46227,77,142223
20585,0.000463,74.125.130.0-255,4320,50547,77,142223
20586,0.000465,172.31.40.0-255,66,50613,77,142223
20587,0.000486,74.125.130.0-255,1484,52097,77,142223
20588,0.000495,74.125.130.0-255,7156,59253,77,142223
20589,0.000497,172.31.40.0-255,66,59319,77,142223
20590,0.000529,74.125.130.0-255,1484,60803,77,142223
20591,0.000542,74.125.130.0-255,2902,63705,77,142223
20592,0.000544,172.31.40.0-255,66,63771,77,142223
20593,0.000563,74.125.130.0-255,2184,65955,77,142223
20594,0.000566,172.31.40.0-255,66,66021,77,142223
20595,0.000983,74.125.130.0-255,378,66399,77,142223
20596,0.001025,74.125.130.0-255,100,66499,77,142223
20597,0.001142,172.31.40.0-255,66,66565,77,142223
20598,0.002125,74.125.130.0-255,1484,68049,77,142223
20599,0.002136,74.125.130.0-255,2902,70951,77,142223
20600,0.00214,172.31.40.0-255,66,71017,77,142223
20601,0.002163,74.125.130.0-255,4320,75337,77,142223
20602,0.002165,172.31.40.0-255,66,75403,77,142223
20603,0.002186,74.125.130.0-255,1484,76887,77,142223
20604,0.002189,74.125.130.0-255,1484,78371,77,142223
20605,0.002191,172.31.40.0-255,66,78437,77,142223
20606,0.002196,74.125.130.0-255,2902,81339,77,142223
20607,0.002198,172.31.40.0-255,66,81405,77,142223
20608,0.002219,74.125.130.0-255,5738,87143,77,142223
20609,0.002221,172.31.40.0-255,66,87209,77,142223
20610,0.002256,74.125.130.0-255,4320,91529,77,142223
20611,0.002258,172.31.40.0-255,66,91595,77,142223
20612,0.002277,74.125.130.0-255,2902,94497,77,142223
20613,0.002279,172.31.40.0-255,66,94563,77,142223
20614,0.002284,74.125.130.0-255,4320,98883,77,142223
20615,0.002286,172.31.40.0-255,66,98949,77,142223
20616,0.002341,74.125.130.0-255,2184,101133,77,142223
20617,0.002343,172.31.40.0-255,66,101199,77,142223
20618,0.004606,74.125.130.0-255,2902,104101,77,142223
20619,0.004614,172.31.40.0-255,66,104167,77,142223
20620,0.004649,74.125.130.0-255,2902,107069,77,142223
20621,0.004652,172.31.40.0-255,66,107135,77,142223
20622,0.00693,74.125.130.0-255,2902,110037,77,142223
20623,0.006935,172.31.40.0-255,66,110103,77,142223
20624,0.006963,74.125.130.0-255,2902,113005,77,142223
20625,0.006965,172.31.40.0-255,66,113071,77,142223
20626,0.009264,74.125.130.0-255,2902,115973,77,142223
20627,0.009271,172.31.40.0-255,66,116039,77,142223
20628,0.009292,74.125.130.0-255,2902,118941,77,142223
20629,0.009295,172.31.40.0-255,66,119007,77,142223
20630,0.011611,74.125.130.0-255,5738,124745,77,142223
20631,0.011617,172.31.40.0-255,66,124811,77,142223
20632,0.013949,74.125.130.0-255,5738,130549,77,142223
20633,0.013958,172.31.40.0-255,66,130615,77,142223
20634,0.016289,74.125.130.0-255,5738,136353,77,142223
20635,0.016297,172.31.40.0-255,66,136419,77,142223
20636,0.018637,74.125.130.0-255,5738,142157,77,142223
20637,0.018651,172.31.40.0-255,66,142223,77,142223
20638,0.0,172.31.40.0-255,105,105,77,210
20639,0.001777,157.240.13.0-255,105,210,77,210
20640,0.0,74.125.130.0-255,153,153,77,221717
20641,2.3e-05,172.31.40.0-255,66,219,77,221717
20642,3e-05,74.125.130.0-255,1484,1703,77,221717
20643,3.5e-05,172.31.40.0-255,66,1769,77,221717
20644,4.1e-05,74.125.130.0-255,2902,4671,77,221717
20645,4.4e-05,172.31.40.0-255,66,4737,77,221717
20646,4.7e-05,74.125.130.0-255,1484,6221,77,221717
20647,5e-05,172.31.40.0-255,66,6287,77,221717
20648,5.5e-05,74.125.130.0-255,2902,9189,77,221717
20649,5.8e-05,172.31.40.0-255,66,9255,77,221717
20650,0.000109,74.125.130.0-255,4903,14158,77,221717
20651,0.000112,172.31.40.0-255,66,14224,77,221717
20652,0.000119,74.125.130.0-255,5738,19962,77,221717
20653,0.000122,172.31.40.0-255,66,20028,77,221717
20654,0.000142,74.125.130.0-255,2902,22930,77,221717
20655,0.000145,172.31.40.0-255,66,22996,77,221717
20656,0.000172,74.125.130.0-255,8215,31211,77,221717
20657,0.000175,172.31.40.0-255,66,31277,77,221717
20658,0.00026,74.125.130.0-255,1484,32761,77,221717
20659,0.000263,172.31.40.0-255,66,32827,77,221717
20660,0.00027,74.125.130.0-255,2902,35729,77,221717
20661,0.000272,172.31.40.0-255,66,35795,77,221717
20662,0.00029,74.125.130.0-255,5738,41533,77,221717
20663,0.000293,172.31.40.0-255,66,41599,77,221717
20664,0.000311,74.125.130.0-255,4320,45919,77,221717
20665,0.000314,172.31.40.0-255,66,45985,77,221717
20666,0.00033,74.125.130.0-255,2902,48887,77,221717
20667,0.000332,172.31.40.0-255,66,48953,77,221717
20668,0.000345,74.125.130.0-255,4320,53273,77,221717
20669,0.000348,172.31.40.0-255,66,53339,77,221717
20670,0.00037,74.125.130.0-255,9992,63331,77,221717
20671,0.000373,172.31.40.0-255,66,63397,77,221717
20672,0.000406,74.125.130.0-255,2512,65909,77,221717
20673,0.000409,172.31.40.0-255,66,65975,77,221717
20674,0.000624,74.125.130.0-255,1484,67459,77,221717
20675,0.000631,74.125.130.0-255,2902,70361,77,221717
20676,0.000633,172.31.40.0-255,66,70427,77,221717
20677,0.000656,74.125.130.0-255,4320,74747,77,221717
20678,0.000658,172.31.40.0-255,66,74813,77,221717
20679,0.000675,74.125.130.0-255,1484,76297,77,221717
20680,0.000706,74.125.130.0-255,7156,83453,77,221717
20681,0.000711,74.125.130.0-255,7156,90609,77,221717
20682,0.000737,74.125.130.0-255,4320,94929,77,221717
20683,0.000743,172.31.40.0-255,66,94995,77,221717
20684,0.000746,172.31.40.0-255,66,95061,77,221717
20685,0.000752,172.31.40.0-255,66,95127,77,221717
20686,0.000757,74.125.130.0-255,4320,99447,77,221717
20687,0.000759,172.31.40.0-255,66,99513,77,221717
20688,0.000761,74.125.130.0-255,766,100279,77,221717
20689,0.000841,74.125.130.0-255,1484,101763,77,221717
20690,0.000845,172.31.40.0-255,66,101829,77,221717
20691,0.000848,74.125.130.0-255,1484,103313,77,221717
20692,0.000865,74.125.130.0-255,1484,104797,77,221717
20693,0.000867,172.31.40.0-255,66,104863,77,221717
20694,0.000874,74.125.130.0-255,5738,110601,77,221717
20695,0.000876,172.31.40.0-255,66,110667,77,221717
20696,0.000904,74.125.130.0-255,8574,119241,77,221717
20697,0.000907,172.31.40.0-255,66,119307,77,221717
20698,0.000922,74.125.130.0-255,1484,120791,77,221717
20699,0.000929,74.125.130.0-255,7156,127947,77,221717
20700,0.000931,172.31.40.0-255,66,128013,77,221717
20701,0.000945,74.125.130.0-255,4320,132333,77,221717
20702,0.000947,172.31.40.0-255,66,132399,77,221717
20703,0.000951,74.125.130.0-255,2184,134583,77,221717
20704,0.000953,172.31.40.0-255,66,134649,77,221717
20705,0.001005,74.125.130.0-255,1484,136133,77,221717
20706,0.001019,74.125.130.0-255,2902,139035,77,221717
20707,0.001022,172.31.40.0-255,66,139101,77,221717
20708,0.001043,74.125.130.0-255,5738,144839,77,221717
20709,0.001046,172.31.40.0-255,66,144905,77,221717
20710,0.001048,74.125.130.0-255,1484,146389,77,221717
20711,0.001052,74.125.130.0-255,2902,149291,77,221717
20712,0.001054,172.31.40.0-255,66,149357,77,221717
20713,0.001068,74.125.130.0-255,2902,152259,77,221717
20714,0.00107,172.31.40.0-255,66,152325,77,221717
20715,0.001084,74.125.130.0-255,2902,155227,77,221717
20716,0.001087,172.31.40.0-255,66,155293,77,221717
20717,0.00111,74.125.130.0-255,11410,166703,77,221717
20718,0.001113,172.31.40.0-255,66,166769,77,221717
20719,0.001152,74.125.130.0-255,2184,168953,77,221717
20720,0.001156,172.31.40.0-255,66,169019,77,221717
20721,0.003111,74.125.130.0-255,2902,171921,77,221717
20722,0.003117,172.31.40.0-255,66,171987,77,221717
20723,0.003158,74.125.130.0-255,2902,174889,77,221717
20724,0.003161,172.31.40.0-255,66,174955,77,221717
20725,0.005124,74.125.130.0-255,2902,177857,77,221717
20726,0.00513,172.31.40.0-255,66,177923,77,221717
20727,0.005154,74.125.130.0-255,2902,180825,77,221717
20728,0.005156,172.31.40.0-255,66,180891,77,221717
20729,0.007121,74.125.130.0-255,2902,183793,77,221717
20730,0.007125,172.31.40.0-255,66,183859,77,221717
20731,0.00714,74.125.130.0-255,1484,185343,77,221717
20732,0.007152,74.125.130.0-255,1484,186827,77,221717
20733,0.007154,172.31.40.0-255,66,186893,77,221717
20734,0.009147,74.125.130.0-255,5738,192631,77,221717
20735,0.009163,172.31.40.0-255,66,192697,77,221717
20736,0.011189,74.125.130.0-255,5738,198435,77,221717
20737,0.011201,172.31.40.0-255,66,198501,77,221717
20738,0.013219,74.125.130.0-255,5738,204239,77,221717
20739,0.013233,172.31.40.0-255,66,204305,77,221717
20740,0.015292,74.125.130.0-255,5738,210043,77,221717
20741,0.015306,172.31.40.0-255,66,210109,77,221717
20742,0.017327,74.125.130.0-255,5738,215847,77,221717
20743,0.017334,172.31.40.0-255,66,215913,77,221717
20744,0.019342,74.125.130.0-255,5738,221651,77,221717
20745,0.01935,172.31.40.0-255,66,221717,77,221717
20746,0.0,74.125.24.0-255,150,150,77,390255
20747,2.4e-05,172.31.40.0-255,66,216,77,390255
20748,3.1e-05,74.125.24.0-255,1484,1700,77,390255
20749,3.5e-05,172.31.40.0-255,66,1766,77,390255
20750,8.1e-05,74.125.24.0-255,1484,3250,77,390255
20751,8.3e-05,172.31.40.0-255,66,3316,77,390255
20752,0.000102,74.125.24.0-255,2902,6218,77,390255
20753,0.000105,172.31.40.0-255,66,6284,77,390255
20754,0.00011,74.125.24.0-255,2902,9186,77,390255
20755,0.000112,172.31.40.0-255,66,9252,77,390255
20756,0.000126,74.125.24.0-255,2902,12154,77,390255
20757,0.000128,172.31.40.0-255,66,12220,77,390255
20758,0.000148,74.125.24.0-255,2154,14374,77,390255
20759,0.00015,172.31.40.0-255,66,14440,77,390255
20760,0.000277,74.125.24.0-255,1484,15924,77,390255
20761,0.000281,172.31.40.0-255,66,15990,77,390255
20762,0.000287,74.125.24.0-255,2902,18892,77,390255
20763,0.00029,172.31.40.0-255,66,18958,77,390255
20764,0.000294,74.125.24.0-255,2902,21860,77,390255
20765,0.000296,172.31.40.0-255,66,21926,77,390255
20766,0.000315,74.125.24.0-255,2902,24828,77,390255
20767,0.000317,172.31.40.0-255,66,24894,77,390255
20768,0.000353,74.125.24.0-255,2902,27796,77,390255
20769,0.000357,172.31.40.0-255,66,27862,77,390255
20770,0.000369,74.125.24.0-255,3961,31823,77,390255
20771,0.000372,172.31.40.0-255,66,31889,77,390255
20772,0.000508,74.125.24.0-255,1484,33373,77,390255
20773,0.000512,172.31.40.0-255,66,33439,77,390255
20774,0.000518,74.125.24.0-255,2902,36341,77,390255
20775,0.000521,172.31.40.0-255,66,36407,77,390255
20776,0.000524,74.125.24.0-255,1484,37891,77,390255
20777,0.000526,172.31.40.0-255,66,37957,77,390255
20778,0.000554,74.125.24.0-255,4320,42277,77,390255
20779,0.000557,172.31.40.0-255,66,42343,77,390255
20780,0.000563,74.125.24.0-255,5738,48081,77,390255
20781,0.000565,172.31.40.0-255,66,48147,77,390255
20782,0.000584,74.125.24.0-255,1484,49631,77,390255
20783,0.000616,74.125.24.0-255,11410,61041,77,390255
20784,0.000619,172.31.40.0-255,66,61107,77,390255
20785,0.000639,74.125.24.0-255,1125,62232,77,390255
20786,0.000644,74.125.24.0-255,4234,66466,77,390255
20787,0.000647,172.31.40.0-255,66,66532,77,390255
20788,0.000649,74.125.24.0-255,413,66945,77,390255
20789,0.001019,74.125.24.0-255,1484,68429,77,390255
20790,0.001024,172.31.40.0-255,66,68495,77,390255
20791,0.001029,74.125.24.0-255,2902,71397,77,390255
20792,0.001031,172.31.40.0-255,66,71463,77,390255
20793,0.001034,74.125.24.0-255,1484,72947,77,390255
20794,0.001051,74.125.24.0-255,4320,77267,77,390255
20795,0.001053,74.125.24.0-255,1484,78751,77,390255
20796,0.001056,172.31.40.0-255,66,78817,77,390255
20797,0.001075,74.125.24.0-255,8574,87391,77,390255
20798,0.001078,172.31.40.0-255,66,87457,77,390255
20799,0.001116,74.125.24.0-255,2902,90359,77,390255
20800,0.001119,172.31.40.0-255,66,90425,77,390255
20801,0.001141,74.125.24.0-255,10692,101117,77,390255
20802,0.001143,172.31.40.0-255,66,101183,77,390255
20803,0.001404,74.125.24.0-255,1484,102667,77,390255
20804,0.001421,74.125.24.0-255,2902,105569,77,390255
20805,0.001424,172.31.40.0-255,66,105635,77,390255
20806,0.001428,74.125.24.0-255,1484,107119,77,390255
20807,0.001447,74.125.24.0-255,4320,111439,77,390255
20808,0.001449,172.31.40.0-255,66,111505,77,390255
20809,0.001465,74.125.24.0-255,5738,117243,77,390255
20810,0.001467,172.31.40.0-255,66,117309,77,390255
20811,0.001492,74.125.24.0-255,5738,123047,77,390255
20812,0.001495,172.31.40.0-255,66,123113,77,390255
20813,0.001506,74.125.24.0-255,12110,135223,77,390255
20814,0.001508,172.31.40.0-255,66,135289,77,390255
20815,0.001511,74.125.24.0-255,1484,136773,77,390255
20816,0.001514,74.125.24.0-255,1484,138257,77,390255
20817,0.001516,172.31.40.0-255,66,138323,77,390255
20818,0.001539,74.125.24.0-255,1484,139807,77,390255
20819,0.001545,74.125.24.0-255,5738,145545,77,390255
20820,0.001548,172.31.40.0-255,66,145611,77,390255
20821,0.001584,74.125.24.0-255,7156,152767,77,390255
20822,0.001586,172.31.40.0-255,66,152833,77,390255
20823,0.001602,74.125.24.0-255,5738,158571,77,390255
20824,0.001604,172.31.40.0-255,66,158637,77,390255
20825,0.001612,74.125.24.0-255,8574,167211,77,390255
20826,0.001614,172.31.40.0-255,66,167277,77,390255
20827,0.001618,74.125.24.0-255,2184,169461,77,390255
20828,0.00162,172.31.40.0-255,66,169527,77,390255
20829,0.001624,74.125.24.0-255,2902,172429,77,390255
20830,0.001627,172.31.40.0-255,66,172495,77,390255
20831,0.001642,74.125.24.0-255,4320,176815,77,390255
20832,0.001644,172.31.40.0-255,66,176881,77,390255
20833,0.001658,74.125.24.0-255,2902,179783,77,390255
20834,0.00166,172.31.40.0-255,66,179849,77,390255
20835,0.001663,74.125.24.0-255,1484,181333,77,390255
20836,0.00169,74.125.24.0-255,8574,189907,77,390255
20837,0.001693,172.31.40.0-255,66,189973,77,390255
20838,0.001723,74.125.24.0-255,11410,201383,77,390255
20839,0.001727,172.31.40.0-255,66,201449,77,390255
20840,0.00173,74.125.24.0-255,2184,203633,77,390255
20841,0.001733,172.31.40.0-255,66,203699,77,390255
20842,0.001926,74.125.24.0-255,1484,205183,77,390255
20843,0.001944,74.125.24.0-255,1484,206667,77,390255
20844,0.001947,172.31.40.0-255,66,206733,77,390255
20845,0.00196,74.125.24.0-255,1484,208217,77,390255
20846,0.001967,74.125.24.0-255,5738,213955,77,390255
20847,0.001969,172.31.40.0-255,66,214021,77,390255
20848,0.001974,74.125.24.0-255,4320,218341,77,390255
20849,0.001976,172.31.40.0-255,66,218407,77,390255
20850,0.002004,74.125.24.0-255,11410,229817,77,390255
20851,0.002007,172.31.40.0-255,66,229883,77,390255
20852,0.002041,74.125.24.0-255,7856,237739,77,390255
20853,0.002044,172.31.40.0-255,66,237805,77,390255
20854,0.002073,74.125.24.0-255,4320,242125,77,390255
20855,0.002076,172.31.40.0-255,66,242191,77,390255
20856,0.0021,74.125.24.0-255,4320,246511,77,390255
20857,0.002102,172.31.40.0-255,66,246577,77,390255
20858,0.002116,74.125.24.0-255,9992,256569,77,390255
20859,0.002141,74.125.24.0-255,9992,266561,77,390255
20860,0.002157,74.125.24.0-255,5020,271581,77,390255
20861,0.002163,74.125.24.0-255,7156,278737,77,390255
20862,0.002195,74.125.24.0-255,8574,287311,77,390255
20863,0.002205,74.125.24.0-255,11410,298721,77,390255
20864,0.002234,74.125.24.0-255,6438,305159,77,390255
20865,0.002251,74.125.24.0-255,1484,306643,77,390255
20866,0.002269,74.125.24.0-255,5738,312381,77,390255
20867,0.002273,74.125.24.0-255,2902,315283,77,390255
20868,0.002301,74.125.24.0-255,2902,318185,77,390255
20869,0.002315,74.125.24.0-255,5738,323923,77,390255
20870,0.002334,74.125.24.0-255,2902,326825,77,390255
20871,0.002345,74.125.24.0-255,12110,338935,77,390255
20872,0.002398,74.125.24.0-255,1484,340419,77,390255
20873,0.002403,74.125.24.0-255,2902,343321,77,390255
20874,0.002409,74.125.24.0-255,5738,349059,77,390255
20875,0.002433,74.125.24.0-255,11410,360469,77,390255
20876,0.002448,74.125.24.0-255,1484,361953,77,390255
20877,0.002453,74.125.24.0-255,2902,364855,77,390255
20878,0.002489,74.125.24.0-255,7156,372011,77,390255
20879,0.002501,74.125.24.0-255,766,372777,77,390255
20880,0.008429,172.31.40.0-255,66,372843,77,390255
20881,0.011062,74.125.24.0-255,5738,378581,77,390255
20882,0.012642,172.31.40.0-255,66,378647,77,390255
20883,0.01525,74.125.24.0-255,5738,384385,77,390255
20884,0.015256,172.31.40.0-255,66,384451,77,390255
20885,0.017863,74.125.24.0-255,5738,390189,77,390255
20886,0.017873,172.31.40.0-255,66,390255,77,390255
20887,0.0,172.31.40.0-255,180,180,77,746
20888,2.7e-05,172.31.40.0-255,434,614,77,746
20889,0.001581,104.244.42.0-255,66,680,77,746
20890,0.001593,104.244.42.0-255,66,746,77,746
20891,0.0,172.217.194.0-255,299,299,77,237543
20892,2.1e-05,172.31.40.0-255,66,365,77,237543
20893,2.8e-05,172.217.194.0-255,1484,1849,77,237543
20894,3.3e-05,172.31.40.0-255,66,1915,77,237543
20895,3.9e-05,172.217.194.0-255,4320,6235,77,237543
20896,4.3e-05,172.31.40.0-255,66,6301,77,237543
20897,6.9e-05,172.217.194.0-255,4320,10621,77,237543
20898,7.2e-05,172.31.40.0-255,66,10687,77,237543
20899,9.5e-05,172.217.194.0-255,3331,14018,77,237543
20900,9.8e-05,172.31.40.0-255,66,14084,77,237543
20901,0.00012,172.217.194.0-255,8574,22658,77,237543
20902,0.000123,172.31.40.0-255,66,22724,77,237543
20903,0.000128,172.217.194.0-255,4320,27044,77,237543
20904,0.00013,172.31.40.0-255,66,27110,77,237543
20905,0.00019,172.217.194.0-255,8574,35684,77,237543
20906,0.000193,172.31.40.0-255,66,35750,77,237543
20907,0.000217,172.217.194.0-255,5738,41488,77,237543
20908,0.00022,172.31.40.0-255,66,41554,77,237543
20909,0.000229,172.217.194.0-255,6438,47992,77,237543
20910,0.000231,172.31.40.0-255,66,48058,77,237543
20911,0.000246,172.217.194.0-255,1484,49542,77,237543
20912,0.000248,172.31.40.0-255,66,49608,77,237543
20913,0.000253,172.217.194.0-255,2902,52510,77,237543
20914,0.000255,172.31.40.0-255,66,52576,77,237543
20915,0.000262,172.217.194.0-255,5738,58314,77,237543
20916,0.000265,172.31.40.0-255,66,58380,77,237543
20917,0.000292,172.217.194.0-255,7387,65767,77,237543
20918,0.000295,172.31.40.0-255,66,65833,77,237543
20919,0.00049,172.217.194.0-255,1484,67317,77,237543
20920,0.000496,172.31.40.0-255,66,67383,77,237543
20921,0.000502,172.217.194.0-255,2902,70285,77,237543
20922,0.000504,172.31.40.0-255,66,70351,77,237543
20923,0.000511,172.217.194.0-255,4320,74671,77,237543
20924,0.000513,172.31.40.0-255,66,74737,77,237543
20925,0.000533,172.217.194.0-255,1484,76221,77,237543
20926,0.000538,172.217.194.0-255,1484,77705,77,237543
20927,0.00054,172.31.40.0-255,66,77771,77,237543
20928,0.000548,172.217.194.0-255,8574,86345,77,237543
20929,0.00055,172.31.40.0-255,66,86411,77,237543
20930,0.000571,172.217.194.0-255,1484,87895,77,237543
20931,0.000588,172.217.194.0-255,7156,95051,77,237543
20932,0.000591,172.31.40.0-255,66,95117,77,237543
20933,0.000605,172.217.194.0-255,5020,100137,77,237543
20934,0.000608,172.31.40.0-255,66,100203,77,237543
20935,0.000627,172.217.194.0-255,4320,104523,77,237543
20936,0.000629,172.31.40.0-255,66,104589,77,237543
20937,0.00065,172.217.194.0-255,9992,114581,77,237543
20938,0.000654,172.31.40.0-255,66,114647,77,237543
20939,0.000682,172.217.194.0-255,9992,124639,77,237543
20940,0.000685,172.31.40.0-255,66,124705,77,237543
20941,0.000705,172.217.194.0-255,1484,126189,77,237543
20942,0.00072,172.217.194.0-255,5738,131927,77,237543
20943,0.000723,172.31.40.0-255,66,131993,77,237543
20944,0.000747,172.217.194.0-255,3602,135595,77,237543
20945,0.000751,172.31.40.0-255,66,135661,77,237543
20946,0.000757,172.217.194.0-255,5738,141399,77,237543
20947,0.000759,172.31.40.0-255,66,141465,77,237543
20948,0.000762,172.217.194.0-255,1484,142949,77,237543
20949,0.000807,172.31.40.0-255,66,143015,77,237543
20950,0.000816,172.217.194.0-255,7856,150871,77,237543
20951,0.000818,172.31.40.0-255,66,150937,77,237543
20952,0.00102,172.217.194.0-255,1484,152421,77,237543
20953,0.001034,172.217.194.0-255,2902,155323,77,237543
20954,0.001038,172.31.40.0-255,66,155389,77,237543
20955,0.001042,172.217.194.0-255,1484,156873,77,237543
20956,0.001063,172.217.194.0-255,4320,161193,77,237543
20957,0.001066,172.31.40.0-255,66,161259,77,237543
20958,0.001089,172.217.194.0-255,9992,171251,77,237543
20959,0.001092,172.31.40.0-255,66,171317,77,237543
20960,0.001105,172.217.194.0-255,2902,174219,77,237543
20961,0.001111,172.217.194.0-255,5738,179957,77,237543
20962,0.001115,172.31.40.0-255,66,180023,77,237543
20963,0.001118,172.31.40.0-255,66,180089,77,237543
20964,0.001145,172.217.194.0-255,5020,185109,77,237543
20965,0.001149,172.31.40.0-255,66,185175,77,237543
20966,0.003165,172.217.194.0-255,5738,190913,77,237543
20967,0.003171,172.31.40.0-255,66,190979,77,237543
20968,0.005201,172.217.194.0-255,2902,193881,77,237543
20969,0.005206,172.31.40.0-255,66,193947,77,237543
20970,0.005222,172.217.194.0-255,2902,196849,77,237543
20971,0.005225,172.31.40.0-255,66,196915,77,237543
20972,0.007254,172.217.194.0-255,5738,202653,77,237543
20973,0.007258,172.31.40.0-255,66,202719,77,237543
20974,0.009272,172.217.194.0-255,5738,208457,77,237543
20975,0.009282,172.31.40.0-255,66,208523,77,237543
20976,0.011325,172.217.194.0-255,5738,214261,77,237543
20977,0.011333,172.31.40.0-255,66,214327,77,237543
20978,0.013386,172.217.194.0-255,5738,220065,77,237543
20979,0.013395,172.31.40.0-255,66,220131,77,237543
20980,0.015429,172.217.194.0-255,5738,225869,77,237543
20981,0.015438,172.31.40.0-255,66,225935,77,237543
20982,0.017489,172.217.194.0-255,5738,231673,77,237543
20983,0.017501,172.31.40.0-255,66,231739,77,237543
20984,0.019523,172.217.194.0-255,5738,237477,77,237543
20985,0.019531,172.31.40.0-255,66,237543,77,237543
20986,0.0,74.125.24.0-255,303,303,77,397895
20987,2.5e-05,172.31.40.0-255,66,369,77,397895
20988,3.2e-05,74.125.24.0-255,1484,1853,77,397895
20989,3.7e-05,172.31.40.0-255,66,1919,77,397895
20990,4.4e-05,74.125.24.0-255,4320,6239,77,397895
20991,4.7e-05,172.31.40.0-255,66,6305,77,397895
20992,7.4e-05,74.125.24.0-255,7610,13915,77,397895
20993,7.7e-05,172.31.40.0-255,66,13981,77,397895
20994,0.000172,74.125.24.0-255,1484,15465,77,397895
20995,0.000176,172.31.40.0-255,66,15531,77,397895
20996,0.00018,74.125.24.0-255,1484,17015,77,397895
20997,0.000181,172.31.40.0-255,66,17081,77,397895
20998,0.000194,74.125.24.0-255,1484,18565,77,397895
20999,0.000196,172.31.40.0-255,66,18631,77,397895
21000,0.000203,74.125.24.0-255,5738,24369,77,397895
21001,0.000205,172.31.40.0-255,66,24435,77,397895
21002,0.00021,74.125.24.0-255,4320,28755,77,397895
21003,0.000213,172.31.40.0-255,66,28821,77,397895
21004,0.000237,74.125.24.0-255,2543,31364,77,397895
21005,0.00024,172.31.40.0-255,66,31430,77,397895
21006,0.000256,74.125.24.0-255,5738,37168,77,397895
21007,0.000258,172.31.40.0-255,66,37234,77,397895
21008,0.000289,74.125.24.0-255,8574,45808,77,397895
21009,0.000291,172.31.40.0-255,66,45874,77,397895
21010,0.000302,74.125.24.0-255,12828,58702,77,397895
21011,0.000304,172.31.40.0-255,66,58768,77,397895
21012,0.000307,74.125.24.0-255,1484,60252,77,397895
21013,0.000309,172.31.40.0-255,66,60318,77,397895
21014,0.000335,74.125.24.0-255,5318,65636,77,397895
21015,0.000338,172.31.40.0-255,66,65702,77,397895
21016,0.000417,74.125.24.0-255,132,65834,77,397895
21017,0.000421,172.31.40.0-255,66,65900,77,397895
21018,0.000424,74.125.24.0-255,345,66245,77,397895
21019,0.000564,74.125.24.0-255,1484,67729,77,397895
21020,0.000568,74.125.24.0-255,1484,69213,77,397895
21021,0.00058,172.31.40.0-255,66,69279,77,397895
21022,0.000584,74.125.24.0-255,1484,70763,77,397895
21023,0.00059,74.125.24.0-255,5738,76501,77,397895
21024,0.000601,172.31.40.0-255,66,76567,77,397895
21025,0.000618,74.125.24.0-255,5738,82305,77,397895
21026,0.000637,74.125.24.0-255,7156,89461,77,397895
21027,0.000645,172.31.40.0-255,66,89527,77,397895
21028,0.000681,74.125.24.0-255,4320,93847,77,397895
21029,0.000686,172.31.40.0-255,66,93913,77,397895
21030,0.000699,74.125.24.0-255,6438,100351,77,397895
21031,0.000703,172.31.40.0-255,66,100417,77,397895
21032,0.000801,74.125.24.0-255,1484,101901,77,397895
21033,0.000806,74.125.24.0-255,1484,103385,77,397895
21034,0.000818,74.125.24.0-255,1484,104869,77,397895
21035,0.000822,172.31.40.0-255,66,104935,77,397895
21036,0.000835,74.125.24.0-255,5738,110673,77,397895
21037,0.000859,74.125.24.0-255,2902,113575,77,397895
21038,0.000864,172.31.40.0-255,66,113641,77,397895
21039,0.000881,74.125.24.0-255,9992,123633,77,397895
21040,0.000887,74.125.24.0-255,4320,127953,77,397895
21041,0.000906,74.125.24.0-255,1484,129437,77,397895
21042,0.000922,74.125.24.0-255,5020,134457,77,397895
21043,0.000935,74.125.24.0-255,1484,135941,77,397895
21044,0.000944,172.31.40.0-255,66,136007,77,397895
21045,0.000951,74.125.24.0-255,4320,140327,77,397895
21046,0.000962,172.31.40.0-255,66,140393,77,397895
21047,0.001,74.125.24.0-255,12828,153221,77,397895
21048,0.001008,74.125.24.0-255,7156,160377,77,397895
21049,0.001021,74.125.24.0-255,1484,161861,77,397895
21050,0.001038,74.125.24.0-255,6438,168299,77,397895
21051,0.001041,172.31.40.0-255,66,168365,77,397895
21052,0.001046,172.31.40.0-255,66,168431,77,397895
21053,0.001234,74.125.24.0-255,1484,169915,77,397895
21054,0.001238,74.125.24.0-255,1484,171399,77,397895
21055,0.001249,172.31.40.0-255,66,171465,77,397895
21056,0.001261,74.125.24.0-255,1484,172949,77,397895
21057,0.001268,74.125.24.0-255,5738,178687,77,397895
21058,0.00129,74.125.24.0-255,8574,187261,77,397895
21059,0.0013,172.31.40.0-255,66,187327,77,397895
21060,0.001316,74.125.24.0-255,4320,191647,77,397895
21061,0.001328,74.125.24.0-255,2902,194549,77,397895
21062,0.001337,172.31.40.0-255,66,194615,77,397895
21063,0.001352,74.125.24.0-255,7856,202471,77,397895
21064,0.001371,172.31.40.0-255,66,202537,77,397895
21065,0.001541,74.125.24.0-255,1484,204021,77,397895
21066,0.001545,74.125.24.0-255,1484,205505,77,397895
21067,0.001561,172.31.40.0-255,66,205571,77,397895
21068,0.001565,74.125.24.0-255,1484,207055,77,397895
21069,0.001571,74.125.24.0-255,5738,212793,77,397895
21070,0.001577,172.31.40.0-255,66,212859,77,397895
21071,0.00159,74.125.24.0-255,7156,220015,77,397895
21072,0.001607,74.125.24.0-255,5738,225753,77,397895
21073,0.001625,74.125.24.0-255,8574,234327,77,397895
21074,0.001628,74.125.24.0-255,1484,235811,77,397895
21075,0.001637,172.31.40.0-255,66,235877,77,397895
21076,0.00164,74.125.24.0-255,766,236643,77,397895
21077,0.001656,74.125.24.0-255,2902,239545,77,397895
21078,0.001673,74.125.24.0-255,5738,245283,77,397895
21079,0.001686,74.125.24.0-255,1484,246767,77,397895
21080,0.001691,74.125.24.0-255,2902,249669,77,397895
21081,0.00173,172.31.40.0-255,66,249735,77,397895
21082,0.001736,172.31.40.0-255,66,249801,77,397895
21083,0.001755,74.125.24.0-255,11410,261211,77,397895
21084,0.001762,74.125.24.0-255,7156,268367,77,397895
21085,0.001775,74.125.24.0-255,2184,270551,77,397895
21086,0.001797,172.31.40.0-255,66,270617,77,397895
21087,0.001871,74.125.24.0-255,1484,272101,77,397895
21088,0.001877,74.125.24.0-255,2902,275003,77,397895
21089,0.00189,74.125.24.0-255,2902,277905,77,397895
21090,0.001895,172.31.40.0-255,66,277971,77,397895
21091,0.001905,74.125.24.0-255,2902,280873,77,397895
21092,0.001909,74.125.24.0-255,2902,283775,77,397895
21093,0.001915,172.31.40.0-255,66,283841,77,397895
21094,0.001932,74.125.24.0-255,9992,293833,77,397895
21095,0.001935,74.125.24.0-255,1484,295317,77,397895
21096,0.001963,74.125.24.0-255,9274,304591,77,397895
21097,0.001968,172.31.40.0-255,66,304657,77,397895
21098,0.002025,74.125.24.0-255,1484,306141,77,397895
21099,0.00203,74.125.24.0-255,2902,309043,77,397895
21100,0.002035,172.31.40.0-255,66,309109,77,397895
21101,0.00206,74.125.24.0-255,5738,314847,77,397895
21102,0.00208,172.31.40.0-255,66,314913,77,397895
21103,0.002102,74.125.24.0-255,12828,327741,77,397895
21104,0.002107,74.125.24.0-255,4320,332061,77,397895
21105,0.002128,172.31.40.0-255,66,332127,77,397895
21106,0.002146,74.125.24.0-255,5738,337865,77,397895
21107,0.00216,74.125.24.0-255,766,338631,77,397895
21108,0.002168,172.31.40.0-255,66,338697,77,397895
21109,0.002185,74.125.24.0-255,4320,343017,77,397895
21110,0.002199,74.125.24.0-255,2902,345919,77,397895
21111,0.002204,74.125.24.0-255,4320,350239,77,397895
21112,0.002212,172.31.40.0-255,66,350305,77,397895
21113,0.00222,74.125.24.0-255,1484,351789,77,397895
21114,0.002234,74.125.24.0-255,7156,358945,77,397895
21115,0.002259,74.125.24.0-255,7156,366101,77,397895
21116,0.002264,74.125.24.0-255,2902,369003,77,397895
21117,0.002275,74.125.24.0-255,4320,373323,77,397895
21118,0.002279,172.31.40.0-255,66,373389,77,397895
21119,0.002284,172.31.40.0-255,66,373455,77,397895
21120,0.002307,74.125.24.0-255,9274,382729,77,397895
21121,0.002328,74.125.24.0-255,6438,389167,77,397895
21122,0.002335,172.31.40.0-255,66,389233,77,397895
21123,0.002352,74.125.24.0-255,2902,392135,77,397895
21124,0.00237,74.125.24.0-255,5352,397487,77,397895
21125,0.002385,172.31.40.0-255,66,397553,77,397895
21126,0.004677,74.125.24.0-255,105,397658,77,397895
21127,0.004742,172.31.40.0-255,66,397724,77,397895
21128,0.004779,172.31.40.0-255,105,397829,77,397895
21129,0.00708,74.125.24.0-255,66,397895,77,397895
21130,0.0,216.58.203.0-255,153,153,77,163467
21131,2e-05,172.31.40.0-255,66,219,77,163467
21132,2.6e-05,216.58.203.0-255,1484,1703,77,163467
21133,3.1e-05,172.31.40.0-255,66,1769,77,163467
21134,3.7e-05,216.58.203.0-255,2902,4671,77,163467
21135,4.1e-05,172.31.40.0-255,66,4737,77,163467
21136,4.6e-05,216.58.203.0-255,2902,7639,77,163467
21137,5e-05,172.31.40.0-255,66,7705,77,163467
21138,7.3e-05,216.58.203.0-255,4320,12025,77,163467
21139,7.6e-05,172.31.40.0-255,66,12091,77,163467
21140,8e-05,216.58.203.0-255,2068,14159,77,163467
21141,8.3e-05,172.31.40.0-255,66,14225,77,163467
21142,0.000107,216.58.203.0-255,2902,17127,77,163467
21143,0.00011,172.31.40.0-255,66,17193,77,163467
21144,0.000114,216.58.203.0-255,2902,20095,77,163467
21145,0.000117,172.31.40.0-255,66,20161,77,163467
21146,0.000121,216.58.203.0-255,4320,24481,77,163467
21147,0.000124,172.31.40.0-255,66,24547,77,163467
21148,0.000171,216.58.203.0-255,4320,28867,77,163467
21149,0.000173,172.31.40.0-255,66,28933,77,163467
21150,0.000193,216.58.203.0-255,2543,31476,77,163467
21151,0.000195,172.31.40.0-255,66,31542,77,163467
21152,0.000215,216.58.203.0-255,4320,35862,77,163467
21153,0.000217,172.31.40.0-255,66,35928,77,163467
21154,0.000221,216.58.203.0-255,2902,38830,77,163467
21155,0.000223,172.31.40.0-255,66,38896,77,163467
21156,0.000239,216.58.203.0-255,2902,41798,77,163467
21157,0.000258,172.31.40.0-255,66,41864,77,163467
21158,0.000264,216.58.203.0-255,4320,46184,77,163467
21159,0.00027,172.31.40.0-255,66,46250,77,163467
21160,0.000294,216.58.203.0-255,2543,48793,77,163467
21161,0.000296,172.31.40.0-255,66,48859,77,163467
21162,0.000374,216.58.203.0-255,1484,50343,77,163467
21163,0.00038,216.58.203.0-255,1484,51827,77,163467
21164,0.000382,172.31.40.0-255,66,51893,77,163467
21165,0.000405,216.58.203.0-255,1484,53377,77,163467
21166,0.000413,216.58.203.0-255,5738,59115,77,163467
21167,0.000415,172.31.40.0-255,66,59181,77,163467
21168,0.000422,216.58.203.0-255,5738,64919,77,163467
21169,0.000425,172.31.40.0-255,66,64985,77,163467
21170,0.000436,216.58.203.0-255,1419,66404,77,163467
21171,0.000995,216.58.203.0-255,135,66539,77,163467
21172,0.001001,172.31.40.0-255,66,66605,77,163467
21173,0.00111,216.58.203.0-255,1484,68089,77,163467
21174,0.001115,216.58.203.0-255,1484,69573,77,163467
21175,0.001119,172.31.40.0-255,66,69639,77,163467
21176,0.001133,216.58.203.0-255,1484,71123,77,163467
21177,0.001139,216.58.203.0-255,4320,75443,77,163467
21178,0.001141,172.31.40.0-255,66,75509,77,163467
21179,0.001161,216.58.203.0-255,7156,82665,77,163467
21180,0.001163,172.31.40.0-255,66,82731,77,163467
21181,0.001177,216.58.203.0-255,2543,85274,77,163467
21182,0.00118,172.31.40.0-255,66,85340,77,163467
21183,0.00119,216.58.203.0-255,9992,95332,77,163467
21184,0.001192,172.31.40.0-255,66,95398,77,163467
21185,0.001215,216.58.203.0-255,2902,98300,77,163467
21186,0.001218,172.31.40.0-255,66,98366,77,163467
21187,0.001222,216.58.203.0-255,2543,100909,77,163467
21188,0.001225,172.31.40.0-255,66,100975,77,163467
21189,0.002868,216.58.203.0-255,5738,106713,77,163467
21190,0.002874,172.31.40.0-255,66,106779,77,163467
21191,0.004496,216.58.203.0-255,5738,112517,77,163467
21192,0.004501,172.31.40.0-255,66,112583,77,163467
21193,0.006136,216.58.203.0-255,5738,118321,77,163467
21194,0.006147,172.31.40.0-255,66,118387,77,163467
21195,0.007786,216.58.203.0-255,5738,124125,77,163467
21196,0.007796,172.31.40.0-255,66,124191,77,163467
21197,0.009427,216.58.203.0-255,5738,129929,77,163467
21198,0.009434,172.31.40.0-255,66,129995,77,163467
21199,0.011048,216.58.203.0-255,4320,134315,77,163467
21200,0.011053,172.31.40.0-255,66,134381,77,163467
21201,0.011069,216.58.203.0-255,1484,135865,77,163467
21202,0.012671,216.58.203.0-255,4320,140185,77,163467
21203,0.012677,172.31.40.0-255,66,140251,77,163467
21204,0.01431,216.58.203.0-255,5738,145989,77,163467
21205,0.01432,172.31.40.0-255,66,146055,77,163467
21206,0.015944,216.58.203.0-255,5738,151793,77,163467
21207,0.015951,172.31.40.0-255,66,151859,77,163467
21208,0.01759,216.58.203.0-255,5738,157597,77,163467
21209,0.017599,172.31.40.0-255,66,157663,77,163467
21210,0.019232,216.58.203.0-255,5738,163401,77,163467
21211,0.019239,172.31.40.0-255,66,163467,77,163467
21212,0.0,172.217.194.0-255,152,152,77,272330
21213,2.4e-05,172.31.40.0-255,66,218,77,272330
21214,3.2e-05,172.217.194.0-255,1484,1702,77,272330
21215,3.7e-05,172.31.40.0-255,66,1768,77,272330
21216,4.2e-05,172.217.194.0-255,2902,4670,77,272330
21217,4.5e-05,172.31.40.0-255,66,4736,77,272330
21218,5.3e-05,172.217.194.0-255,7156,11892,77,272330
21219,5.6e-05,172.31.40.0-255,66,11958,77,272330
21220,6e-05,172.217.194.0-255,2011,13969,77,272330
21221,6.4e-05,172.31.40.0-255,66,14035,77,272330
21222,0.0001,172.217.194.0-255,11410,25445,77,272330
21223,0.000103,172.31.40.0-255,66,25511,77,272330
21224,0.000109,172.217.194.0-255,5379,30890,77,272330
21225,0.000112,172.31.40.0-255,66,30956,77,272330
21226,0.000621,172.217.194.0-255,1484,32440,77,272330
21227,0.000627,172.31.40.0-255,66,32506,77,272330
21228,0.000633,172.217.194.0-255,2902,35408,77,272330
21229,0.000635,172.31.40.0-255,66,35474,77,272330
21230,0.000651,172.217.194.0-255,2902,38376,77,272330
21231,0.000654,172.31.40.0-255,66,38442,77,272330
21232,0.000678,172.217.194.0-255,7156,45598,77,272330
21233,0.000681,172.31.40.0-255,66,45664,77,272330
21234,0.000716,172.217.194.0-255,7156,52820,77,272330
21235,0.000719,172.31.40.0-255,66,52886,77,272330
21236,0.000745,172.217.194.0-255,7156,60042,77,272330
21237,0.000748,172.31.40.0-255,66,60108,77,272330
21238,0.000769,172.217.194.0-255,5020,65128,77,272330
21239,0.000772,172.31.40.0-255,66,65194,77,272330
21240,0.000856,172.217.194.0-255,365,65559,77,272330
21241,0.00086,172.31.40.0-255,66,65625,77,272330
21242,0.00089,172.217.194.0-255,1484,67109,77,272330
21243,0.000893,172.31.40.0-255,66,67175,77,272330
21244,0.000914,172.217.194.0-255,4320,71495,77,272330
21245,0.000916,172.31.40.0-255,66,71561,77,272330
21246,0.000955,172.217.194.0-255,9992,81553,77,272330
21247,0.000958,172.31.40.0-255,66,81619,77,272330
21248,0.000961,172.217.194.0-255,857,82476,77,272330
21249,0.001251,172.31.40.0-255,66,82542,77,272330
21250,0.001452,172.217.194.0-255,1484,84026,77,272330
21251,0.001462,172.217.194.0-255,2902,86928,77,272330
21252,0.001466,172.31.40.0-255,66,86994,77,272330
21253,0.00147,172.217.194.0-255,1484,88478,77,272330
21254,0.001491,172.217.194.0-255,2902,91380,77,272330
21255,0.001493,172.31.40.0-255,66,91446,77,272330
21256,0.001523,172.217.194.0-255,4320,95766,77,272330
21257,0.001526,172.31.40.0-255,66,95832,77,272330
21258,0.001552,172.217.194.0-255,5379,101211,77,272330
21259,0.001555,172.31.40.0-255,66,101277,77,272330
21260,0.001565,172.217.194.0-255,9992,111269,77,272330
21261,0.001567,172.31.40.0-255,66,111335,77,272330
21262,0.001598,172.217.194.0-255,5738,117073,77,272330
21263,0.001601,172.31.40.0-255,66,117139,77,272330
21264,0.001622,172.217.194.0-255,4320,121459,77,272330
21265,0.001624,172.31.40.0-255,66,121525,77,272330
21266,0.001634,172.217.194.0-255,11410,132935,77,272330
21267,0.001637,172.31.40.0-255,66,133001,77,272330
21268,0.001639,172.217.194.0-255,766,133767,77,272330
21269,0.001858,172.217.194.0-255,1484,135251,77,272330
21270,0.001864,172.31.40.0-255,66,135317,77,272330
21271,0.001871,172.217.194.0-255,2902,138219,77,272330
21272,0.001874,172.31.40.0-255,66,138285,77,272330
21273,0.001905,172.217.194.0-255,5738,144023,77,272330
21274,0.001908,172.31.40.0-255,66,144089,77,272330
21275,0.001926,172.217.194.0-255,4320,148409,77,272330
21276,0.001929,172.31.40.0-255,66,148475,77,272330
21277,0.001959,172.217.194.0-255,8574,157049,77,272330
21278,0.001962,172.31.40.0-255,66,157115,77,272330
21279,0.002,172.217.194.0-255,1484,158599,77,272330
21280,0.002021,172.217.194.0-255,9274,167873,77,272330
21281,0.002024,172.31.40.0-255,66,167939,77,272330
21282,0.002204,172.217.194.0-255,1484,169423,77,272330
21283,0.00221,172.217.194.0-255,1484,170907,77,272330
21284,0.002214,172.31.40.0-255,66,170973,77,272330
21285,0.002233,172.217.194.0-255,1484,172457,77,272330
21286,0.002239,172.217.194.0-255,5738,178195,77,272330
21287,0.002242,172.31.40.0-255,66,178261,77,272330
21288,0.002255,172.217.194.0-255,2902,181163,77,272330
21289,0.002258,172.31.40.0-255,66,181229,77,272330
21290,0.002273,172.217.194.0-255,2902,184131,77,272330
21291,0.002276,172.31.40.0-255,66,184197,77,272330
21292,0.002281,172.217.194.0-255,2902,187099,77,272330
21293,0.002283,172.31.40.0-255,66,187165,77,272330
21294,0.002311,172.217.194.0-255,9992,197157,77,272330
21295,0.002314,172.31.40.0-255,66,197223,77,272330
21296,0.002333,172.217.194.0-255,5020,202243,77,272330
21297,0.002335,172.31.40.0-255,66,202309,77,272330
21298,0.002368,172.217.194.0-255,1484,203793,77,272330
21299,0.002371,172.217.194.0-255,1484,205277,77,272330
21300,0.002374,172.31.40.0-255,66,205343,77,272330
21301,0.00239,172.217.194.0-255,1484,206827,77,272330
21302,0.002393,172.217.194.0-255,1484,208311,77,272330
21303,0.002395,172.31.40.0-255,66,208377,77,272330
21304,0.002418,172.217.194.0-255,4320,212697,77,272330
21305,0.00242,172.31.40.0-255,66,212763,77,272330
21306,0.002426,172.217.194.0-255,5738,218501,77,272330
21307,0.002429,172.31.40.0-255,66,218567,77,272330
21308,0.002448,172.217.194.0-255,5738,224305,77,272330
21309,0.002451,172.31.40.0-255,66,224371,77,272330
21310,0.002472,172.217.194.0-255,7156,231527,77,272330
21311,0.002475,172.31.40.0-255,66,231593,77,272330
21312,0.002479,172.217.194.0-255,2902,234495,77,272330
21313,0.002481,172.31.40.0-255,66,234561,77,272330
21314,0.002516,172.217.194.0-255,2184,236745,77,272330
21315,0.002518,172.31.40.0-255,66,236811,77,272330
21316,0.004786,172.31.40.0-255,101,236912,77,272330
21317,0.005093,172.217.194.0-255,2902,239814,77,272330
21318,0.0051,172.31.40.0-255,66,239880,77,272330
21319,0.005142,172.217.194.0-255,2902,242782,77,272330
21320,0.005147,172.31.40.0-255,66,242848,77,272330
21321,0.007371,172.217.194.0-255,66,242914,77,272330
21322,0.007715,172.217.194.0-255,2902,245816,77,272330
21323,0.00772,172.31.40.0-255,66,245882,77,272330
21324,0.007763,172.217.194.0-255,2902,248784,77,272330
21325,0.007766,172.31.40.0-255,66,248850,77,272330
21326,0.010365,172.217.194.0-255,2902,251752,77,272330
21327,0.010373,172.31.40.0-255,66,251818,77,272330
21328,0.010402,172.217.194.0-255,2902,254720,77,272330
21329,0.010405,172.31.40.0-255,66,254786,77,272330
21330,0.013014,172.217.194.0-255,2902,257688,77,272330
21331,0.013033,172.31.40.0-255,66,257754,77,272330
21332,0.013057,172.217.194.0-255,2902,260656,77,272330
21333,0.013059,172.31.40.0-255,66,260722,77,272330
21334,0.015685,172.217.194.0-255,5738,266460,77,272330
21335,0.015699,172.31.40.0-255,66,266526,77,272330
21336,0.018409,172.217.194.0-255,5738,272264,77,272330
21337,0.018424,172.31.40.0-255,66,272330,77,272330
21338,0.0,172.217.194.0-255,153,153,77,251603
21339,1.4e-05,172.31.40.0-255,66,219,77,251603
21340,4.8e-05,172.217.194.0-255,1484,1703,77,251603
21341,5.3e-05,172.31.40.0-255,66,1769,77,251603
21342,5.9e-05,172.217.194.0-255,2902,4671,77,251603
21343,6.2e-05,172.31.40.0-255,66,4737,77,251603
21344,7.5e-05,172.217.194.0-255,7156,11893,77,251603
21345,7.8e-05,172.31.40.0-255,66,11959,77,251603
21346,0.00013,172.31.40.0-255,66,12025,77,251603
21347,0.000136,172.217.194.0-255,3961,15986,77,251603
21348,0.000139,172.31.40.0-255,66,16052,77,251603
21349,0.000468,172.217.194.0-255,1484,17536,77,251603
21350,0.000473,172.31.40.0-255,66,17602,77,251603
21351,0.00048,172.217.194.0-255,2902,20504,77,251603
21352,0.000483,172.31.40.0-255,66,20570,77,251603
21353,0.000495,172.217.194.0-255,5738,26308,77,251603
21354,0.000497,172.31.40.0-255,66,26374,77,251603
21355,0.000503,172.217.194.0-255,5738,32112,77,251603
21356,0.000507,172.31.40.0-255,66,32178,77,251603
21357,0.000531,172.217.194.0-255,2902,35080,77,251603
21358,0.000534,172.31.40.0-255,66,35146,77,251603
21359,0.000577,172.31.40.0-255,66,35212,77,251603
21360,0.000579,172.217.194.0-255,340,35552,77,251603
21361,0.000581,172.31.40.0-255,66,35618,77,251603
21362,0.000585,172.217.194.0-255,118,35736,77,251603
21363,0.000587,172.31.40.0-255,66,35802,77,251603
21364,0.000662,172.217.194.0-255,1484,37286,77,251603
21365,0.000665,172.31.40.0-255,66,37352,77,251603
21366,0.000671,172.217.194.0-255,2902,40254,77,251603
21367,0.000673,172.31.40.0-255,66,40320,77,251603
21368,0.000678,172.217.194.0-255,2902,43222,77,251603
21369,0.000685,172.31.40.0-255,66,43288,77,251603
21370,0.000721,172.217.194.0-255,2902,46190,77,251603
21371,0.000724,172.31.40.0-255,66,46256,77,251603
21372,0.000731,172.217.194.0-255,6797,53053,77,251603
21373,0.000733,172.31.40.0-255,66,53119,77,251603
21374,0.000751,172.31.40.0-255,66,53185,77,251603
21375,0.000756,172.217.194.0-255,2543,55728,77,251603
21376,0.000758,172.31.40.0-255,66,55794,77,251603
21377,0.000789,172.217.194.0-255,381,56175,77,251603
21378,0.001079,172.217.194.0-255,1484,57659,77,251603
21379,0.001083,172.31.40.0-255,66,57725,77,251603
21380,0.001086,172.217.194.0-255,1484,59209,77,251603
21381,0.001108,172.217.194.0-255,1484,60693,77,251603
21382,0.00111,172.31.40.0-255,66,60759,77,251603
21383,0.001116,172.217.194.0-255,5738,66497,77,251603
21384,0.001118,172.31.40.0-255,66,66563,77,251603
21385,0.001126,172.217.194.0-255,4320,70883,77,251603
21386,0.001128,172.31.40.0-255,66,70949,77,251603
21387,0.001164,172.217.194.0-255,11410,82359,77,251603
21388,0.001167,172.31.40.0-255,66,82425,77,251603
21389,0.001174,172.217.194.0-255,7856,90281,77,251603
21390,0.001176,172.31.40.0-255,66,90347,77,251603
21391,0.00123,172.217.194.0-255,1484,91831,77,251603
21392,0.001234,172.217.194.0-255,2902,94733,77,251603
21393,0.001236,172.31.40.0-255,66,94799,77,251603
21394,0.001239,172.217.194.0-255,1484,96283,77,251603
21395,0.001263,172.217.194.0-255,4320,100603,77,251603
21396,0.001266,172.31.40.0-255,66,100669,77,251603
21397,0.001273,172.217.194.0-255,7156,107825,77,251603
21398,0.001275,172.31.40.0-255,66,107891,77,251603
21399,0.001294,172.217.194.0-255,7156,115047,77,251603
21400,0.001297,172.31.40.0-255,66,115113,77,251603
21401,0.00133,172.217.194.0-255,7156,122269,77,251603
21402,0.001333,172.31.40.0-255,66,122335,77,251603
21403,0.001337,172.217.194.0-255,2184,124519,77,251603
21404,0.001338,172.31.40.0-255,66,124585,77,251603
21405,0.001827,172.217.194.0-255,1484,126069,77,251603
21406,0.001835,172.217.194.0-255,2902,128971,77,251603
21407,0.001839,172.31.40.0-255,66,129037,77,251603
21408,0.001846,172.217.194.0-255,5738,134775,77,251603
21409,0.001848,172.31.40.0-255,66,134841,77,251603
21410,0.00188,172.217.194.0-255,11410,146251,77,251603
21411,0.001883,172.31.40.0-255,66,146317,77,251603
21412,0.001909,172.217.194.0-255,1484,147801,77,251603
21413,0.001915,172.217.194.0-255,5738,153539,77,251603
21414,0.001917,172.31.40.0-255,66,153605,77,251603
21415,0.001942,172.217.194.0-255,5020,158625,77,251603
21416,0.001944,172.31.40.0-255,66,158691,77,251603
21417,0.001964,172.217.194.0-255,5738,164429,77,251603
21418,0.001966,172.31.40.0-255,66,164495,77,251603
21419,0.001994,172.217.194.0-255,9992,174487,77,251603
21420,0.001997,172.31.40.0-255,66,174553,77,251603
21421,0.001999,172.217.194.0-255,1484,176037,77,251603
21422,0.002035,172.31.40.0-255,66,176103,77,251603
21423,0.002037,172.217.194.0-255,766,176869,77,251603
21424,0.002163,172.217.194.0-255,1484,178353,77,251603
21425,0.002166,172.31.40.0-255,66,178419,77,251603
21426,0.002171,172.217.194.0-255,2902,181321,77,251603
21427,0.002173,172.31.40.0-255,66,181387,77,251603
21428,0.002205,172.217.194.0-255,5738,187125,77,251603
21429,0.002207,172.31.40.0-255,66,187191,77,251603
21430,0.002218,172.217.194.0-255,7156,194347,77,251603
21431,0.002224,172.31.40.0-255,66,194413,77,251603
21432,0.002257,172.217.194.0-255,5738,200151,77,251603
21433,0.002259,172.31.40.0-255,66,200217,77,251603
21434,0.002268,172.217.194.0-255,10692,210909,77,251603
21435,0.00227,172.31.40.0-255,66,210975,77,251603
21436,0.00454,172.217.194.0-255,5738,216713,77,251603
21437,0.004543,172.31.40.0-255,66,216779,77,251603
21438,0.006882,172.217.194.0-255,5738,222517,77,251603
21439,0.00689,172.31.40.0-255,66,222583,77,251603
21440,0.009152,172.217.194.0-255,5738,228321,77,251603
21441,0.009156,172.31.40.0-255,66,228387,77,251603
21442,0.011435,172.217.194.0-255,5738,234125,77,251603
21443,0.011443,172.31.40.0-255,66,234191,77,251603
21444,0.013709,172.217.194.0-255,5738,239929,77,251603
21445,0.013716,172.31.40.0-255,66,239995,77,251603
21446,0.016007,172.217.194.0-255,5738,245733,77,251603
21447,0.016014,172.31.40.0-255,66,245799,77,251603
21448,0.018315,172.217.194.0-255,5738,251537,77,251603
21449,0.018323,172.31.40.0-255,66,251603,77,251603
21450,0.0,172.217.194.0-255,156,156,77,411492
21451,2.3e-05,172.31.40.0-255,66,222,77,411492
21452,3.1e-05,172.217.194.0-255,1484,1706,77,411492
21453,3.6e-05,172.31.40.0-255,66,1772,77,411492
21454,4.3e-05,172.217.194.0-255,2902,4674,77,411492
21455,5.7e-05,172.31.40.0-255,66,4740,77,411492
21456,6.5e-05,172.217.194.0-255,7156,11896,77,411492
21457,6.8e-05,172.31.40.0-255,66,11962,77,411492
21458,7.8e-05,172.217.194.0-255,9992,21954,77,411492
21459,8.1e-05,172.31.40.0-255,66,22020,77,411492
21460,0.000112,172.217.194.0-255,6388,28408,77,411492
21461,0.000116,172.31.40.0-255,66,28474,77,411492
21462,0.000121,172.217.194.0-255,2543,31017,77,411492
21463,0.000123,172.31.40.0-255,66,31083,77,411492
21464,0.000126,172.217.194.0-255,1484,32567,77,411492
21465,0.000128,172.31.40.0-255,66,32633,77,411492
21466,0.000156,172.217.194.0-255,2902,35535,77,411492
21467,0.000162,172.31.40.0-255,66,35601,77,411492
21468,0.000169,172.217.194.0-255,5738,41339,77,411492
21469,0.000172,172.31.40.0-255,66,41405,77,411492
21470,0.000178,172.217.194.0-255,5738,47143,77,411492
21471,0.00018,172.31.40.0-255,66,47209,77,411492
21472,0.000226,172.217.194.0-255,13887,61096,77,411492
21473,0.000229,172.31.40.0-255,66,61162,77,411492
21474,0.000234,172.217.194.0-255,3961,65123,77,411492
21475,0.000236,172.31.40.0-255,66,65189,77,411492
21476,0.000239,172.217.194.0-255,365,65554,77,411492
21477,0.000245,172.31.40.0-255,66,65620,77,411492
21478,0.000414,172.217.194.0-255,378,65998,77,411492
21479,0.00042,172.31.40.0-255,66,66064,77,411492
21480,0.001263,172.217.194.0-255,1484,67548,77,411492
21481,0.001269,172.31.40.0-255,66,67614,77,411492
21482,0.001278,172.217.194.0-255,2902,70516,77,411492
21483,0.001291,172.217.194.0-255,5738,76254,77,411492
21484,0.001297,172.217.194.0-255,5738,81992,77,411492
21485,0.001321,172.217.194.0-255,9992,91984,77,411492
21486,0.001337,172.217.194.0-255,2902,94886,77,411492
21487,0.001344,172.217.194.0-255,5020,99906,77,411492
21488,0.001483,172.217.194.0-255,1484,101390,77,411492
21489,0.00149,172.217.194.0-255,2902,104292,77,411492
21490,0.001512,172.217.194.0-255,5738,110030,77,411492
21491,0.001545,172.217.194.0-255,12828,122858,77,411492
21492,0.001552,172.217.194.0-255,5738,128596,77,411492
21493,0.001571,172.217.194.0-255,2902,131498,77,411492
21494,0.001592,172.217.194.0-255,2184,133682,77,411492
21495,0.001639,172.217.194.0-255,1484,135166,77,411492
21496,0.001665,172.217.194.0-255,2902,138068,77,411492
21497,0.001684,172.217.194.0-255,5738,143806,77,411492
21498,0.001707,172.217.194.0-255,7156,150962,77,411492
21499,0.001712,172.217.194.0-255,1484,152446,77,411492
21500,0.001727,172.217.194.0-255,7156,159602,77,411492
21501,0.001746,172.217.194.0-255,5738,165340,77,411492
21502,0.00175,172.217.194.0-255,2184,167524,77,411492
21503,0.001801,172.217.194.0-255,2902,170426,77,411492
21504,0.001808,172.217.194.0-255,7156,177582,77,411492
21505,0.001815,172.217.194.0-255,7156,184738,77,411492
21506,0.001841,172.217.194.0-255,8574,193312,77,411492
21507,0.001862,172.217.194.0-255,7156,200468,77,411492
21508,0.001865,172.217.194.0-255,766,201234,77,411492
21509,0.001896,172.217.194.0-255,4320,205554,77,411492
21510,0.001916,172.217.194.0-255,4320,209874,77,411492
21511,0.001926,172.217.194.0-255,1484,211358,77,411492
21512,0.001953,172.217.194.0-255,9992,221350,77,411492
21513,0.001964,172.217.194.0-255,1484,222834,77,411492
21514,0.001972,172.217.194.0-255,7156,229990,77,411492
21515,0.001996,172.217.194.0-255,1484,231474,77,411492
21516,0.002014,172.217.194.0-255,3602,235076,77,411492
21517,0.002041,172.217.194.0-255,4320,239396,77,411492
21518,0.002054,172.217.194.0-255,1484,240880,77,411492
21519,0.002059,172.217.194.0-255,4320,245200,77,411492
21520,0.00208,172.217.194.0-255,4320,249520,77,411492
21521,0.002109,172.217.194.0-255,7156,256676,77,411492
21522,0.002118,172.217.194.0-255,8574,265250,77,411492
21523,0.002136,172.217.194.0-255,3602,268852,77,411492
21524,0.002151,172.217.194.0-255,2902,271754,77,411492
21525,0.002164,172.217.194.0-255,4320,276074,77,411492
21526,0.002178,172.217.194.0-255,2902,278976,77,411492
21527,0.002192,172.217.194.0-255,2902,281878,77,411492
21528,0.002216,172.217.194.0-255,7156,289034,77,411492
21529,0.002238,172.217.194.0-255,1484,290518,77,411492
21530,0.002246,172.217.194.0-255,8574,299092,77,411492
21531,0.002281,172.217.194.0-255,3602,302694,77,411492
21532,0.002292,172.217.194.0-255,12828,315522,77,411492
21533,0.002299,172.217.194.0-255,7156,322678,77,411492
21534,0.002307,172.217.194.0-255,8574,331252,77,411492
21535,0.002314,172.217.194.0-255,5020,336272,77,411492
21536,0.002347,172.217.194.0-255,5738,342010,77,411492
21537,0.002368,172.217.194.0-255,4320,346330,77,411492
21538,0.002385,172.217.194.0-255,1484,347814,77,411492
21539,0.002436,172.217.194.0-255,4320,352134,77,411492
21540,0.002463,172.217.194.0-255,8574,360708,77,411492
21541,0.002474,172.217.194.0-255,9274,369982,77,411492
21542,0.002483,172.217.194.0-255,9992,379974,77,411492
21543,0.00249,172.217.194.0-255,7156,387130,77,411492
21544,0.002514,172.217.194.0-255,7156,394286,77,411492
21545,0.002549,172.217.194.0-255,12110,406396,77,411492
21546,0.002567,172.217.194.0-255,4688,411084,77,411492
21547,0.00299,172.31.40.0-255,66,411150,77,411492
21548,0.005578,172.217.194.0-255,105,411255,77,411492
21549,0.005647,172.31.40.0-255,66,411321,77,411492
21550,0.005684,172.31.40.0-255,105,411426,77,411492
21551,0.008182,172.217.194.0-255,66,411492,77,411492
21552,0.0,74.125.24.0-255,297,297,77,104728
21553,2.1e-05,172.31.40.0-255,66,363,77,104728
21554,2.7e-05,74.125.24.0-255,1484,1847,77,104728
21555,3e-05,172.31.40.0-255,66,1913,77,104728
21556,3.5e-05,74.125.24.0-255,2902,4815,77,104728
21557,3.8e-05,172.31.40.0-255,66,4881,77,104728
21558,8.4e-05,74.125.24.0-255,5738,10619,77,104728
21559,8.7e-05,172.31.40.0-255,66,10685,77,104728
21560,0.000221,74.125.24.0-255,7156,17841,77,104728
21561,0.000225,172.31.40.0-255,66,17907,77,104728
21562,0.000243,74.125.24.0-255,6086,23993,77,104728
21563,0.000245,172.31.40.0-255,66,24059,77,104728
21564,0.000523,74.125.24.0-255,1484,25543,77,104728
21565,0.000527,172.31.40.0-255,66,25609,77,104728
21566,0.000547,74.125.24.0-255,5379,30988,77,104728
21567,0.000552,172.31.40.0-255,66,31054,77,104728
21568,0.000704,74.125.24.0-255,5738,36792,77,104728
21569,0.000708,172.31.40.0-255,66,36858,77,104728
21570,0.000754,172.31.40.0-255,66,36924,77,104728
21571,0.001223,74.125.24.0-255,5738,42662,77,104728
21572,0.001229,172.31.40.0-255,66,42728,77,104728
21573,0.001259,74.125.24.0-255,5689,48417,77,104728
21574,0.001262,172.31.40.0-255,66,48483,77,104728
21575,0.001488,74.125.24.0-255,12828,61311,77,104728
21576,0.001494,172.31.40.0-255,66,61377,77,104728
21577,0.001539,172.31.40.0-255,66,61443,77,104728
21578,0.002151,74.125.24.0-255,7156,68599,77,104728
21579,0.002155,172.31.40.0-255,66,68665,77,104728
21580,0.002209,172.31.40.0-255,66,68731,77,104728
21581,0.002227,74.125.24.0-255,4925,73656,77,104728
21582,0.00306,74.125.24.0-255,5738,79394,77,104728
21583,0.00366,74.125.24.0-255,7856,87250,77,104728
21584,0.010897,172.31.40.0-255,66,87316,77,104728
21585,0.013245,74.125.24.0-255,5738,93054,77,104728
21586,0.01326,172.31.40.0-255,66,93120,77,104728
21587,0.01564,74.125.24.0-255,5738,98858,77,104728
21588,0.015656,172.31.40.0-255,66,98924,77,104728
21589,0.017985,74.125.24.0-255,5738,104662,77,104728
21590,0.017995,172.31.40.0-255,66,104728,77,104728
21591,0.0,74.125.68.0-255,153,153,77,216070
21592,1.6e-05,172.31.40.0-255,66,219,77,216070
21593,2.3e-05,74.125.68.0-255,1484,1703,77,216070
21594,2.7e-05,172.31.40.0-255,66,1769,77,216070
21595,3.3e-05,74.125.68.0-255,2902,4671,77,216070
21596,4.3e-05,172.31.40.0-255,66,4737,77,216070
21597,4.7e-05,74.125.68.0-255,1484,6221,77,216070
21598,4.9e-05,172.31.40.0-255,66,6287,77,216070
21599,9.4e-05,74.125.68.0-255,2902,9189,77,216070
21600,9.7e-05,172.31.40.0-255,66,9255,77,216070
21601,0.000104,74.125.68.0-255,4875,14130,77,216070
21602,0.000107,172.31.40.0-255,66,14196,77,216070
21603,0.000125,74.125.68.0-255,4320,18516,77,216070
21604,0.000127,172.31.40.0-255,66,18582,77,216070
21605,0.000153,74.125.68.0-255,1484,20066,77,216070
21606,0.000156,172.31.40.0-255,66,20132,77,216070
21607,0.00016,74.125.68.0-255,2902,23034,77,216070
21608,0.000163,172.31.40.0-255,66,23100,77,216070
21609,0.000172,74.125.68.0-255,4320,27420,77,216070
21610,0.000174,172.31.40.0-255,66,27486,77,216070
21611,0.000207,74.125.68.0-255,3961,31447,77,216070
21612,0.000209,172.31.40.0-255,66,31513,77,216070
21613,0.000429,74.125.68.0-255,1484,32997,77,216070
21614,0.000434,172.31.40.0-255,66,33063,77,216070
21615,0.000441,74.125.68.0-255,2902,35965,77,216070
21616,0.000443,172.31.40.0-255,66,36031,77,216070
21617,0.000447,74.125.68.0-255,2902,38933,77,216070
21618,0.000453,172.31.40.0-255,66,38999,77,216070
21619,0.000459,74.125.68.0-255,4320,43319,77,216070
21620,0.000461,172.31.40.0-255,66,43385,77,216070
21621,0.000525,74.125.68.0-255,9633,53018,77,216070
21622,0.000527,172.31.40.0-255,66,53084,77,216070
21623,0.000532,74.125.68.0-255,4320,57404,77,216070
21624,0.000535,172.31.40.0-255,66,57470,77,216070
21625,0.000541,74.125.68.0-255,5738,63208,77,216070
21626,0.000543,172.31.40.0-255,66,63274,77,216070
21627,0.000567,74.125.68.0-255,2543,65817,77,216070
21628,0.00057,172.31.40.0-255,66,65883,77,216070
21629,0.001117,74.125.68.0-255,645,66528,77,216070
21630,0.001127,172.31.40.0-255,66,66594,77,216070
21631,0.001326,74.125.68.0-255,1484,68078,77,216070
21632,0.001335,74.125.68.0-255,2902,70980,77,216070
21633,0.00134,172.31.40.0-255,66,71046,77,216070
21634,0.001344,74.125.68.0-255,1484,72530,77,216070
21635,0.001372,74.125.68.0-255,4320,76850,77,216070
21636,0.001374,172.31.40.0-255,66,76916,77,216070
21637,0.001381,74.125.68.0-255,5738,82654,77,216070
21638,0.001383,172.31.40.0-255,66,82720,77,216070
21639,0.00139,74.125.68.0-255,7156,89876,77,216070
21640,0.001392,172.31.40.0-255,66,89942,77,216070
21641,0.001426,74.125.68.0-255,8574,98516,77,216070
21642,0.001429,172.31.40.0-255,66,98582,77,216070
21643,0.001455,74.125.68.0-255,2184,100766,77,216070
21644,0.001458,172.31.40.0-255,66,100832,77,216070
21645,0.001631,74.125.68.0-255,1484,102316,77,216070
21646,0.00165,74.125.68.0-255,2902,105218,77,216070
21647,0.001655,172.31.40.0-255,66,105284,77,216070
21648,0.001661,74.125.68.0-255,4320,109604,77,216070
21649,0.001663,172.31.40.0-255,66,109670,77,216070
21650,0.001685,74.125.68.0-255,1484,111154,77,216070
21651,0.00169,74.125.68.0-255,2902,114056,77,216070
21652,0.001692,172.31.40.0-255,66,114122,77,216070
21653,0.001698,74.125.68.0-255,4320,118442,77,216070
21654,0.0017,172.31.40.0-255,66,118508,77,216070
21655,0.001706,74.125.68.0-255,5738,124246,77,216070
21656,0.001709,172.31.40.0-255,66,124312,77,216070
21657,0.001744,74.125.68.0-255,2902,127214,77,216070
21658,0.001746,172.31.40.0-255,66,127280,77,216070
21659,0.001754,74.125.68.0-255,7156,134436,77,216070
21660,0.001756,172.31.40.0-255,66,134502,77,216070
21661,0.001759,74.125.68.0-255,766,135268,77,216070
21662,0.001848,74.125.68.0-255,1484,136752,77,216070
21663,0.001852,172.31.40.0-255,66,136818,77,216070
21664,0.001884,74.125.68.0-255,2902,139720,77,216070
21665,0.001887,172.31.40.0-255,66,139786,77,216070
21666,0.001892,74.125.68.0-255,4320,144106,77,216070
21667,0.001894,172.31.40.0-255,66,144172,77,216070
21668,0.0019,74.125.68.0-255,5738,149910,77,216070
21669,0.001906,172.31.40.0-255,66,149976,77,216070
21670,0.001909,74.125.68.0-255,1484,151460,77,216070
21671,0.001939,74.125.68.0-255,9992,161452,77,216070
21672,0.001941,172.31.40.0-255,66,161518,77,216070
21673,0.001947,74.125.68.0-255,4320,165838,77,216070
21674,0.001948,172.31.40.0-255,66,165904,77,216070
21675,0.001993,74.125.68.0-255,3602,169506,77,216070
21676,0.001996,172.31.40.0-255,66,169572,77,216070
21677,0.004006,74.125.68.0-255,1484,171056,77,216070
21678,0.004045,74.125.68.0-255,4320,175376,77,216070
21679,0.00405,172.31.40.0-255,66,175442,77,216070
21680,0.006112,74.125.68.0-255,5738,181180,77,216070
21681,0.006117,172.31.40.0-255,66,181246,77,216070
21682,0.008176,74.125.68.0-255,5738,186984,77,216070
21683,0.008182,172.31.40.0-255,66,187050,77,216070
21684,0.010245,74.125.68.0-255,5738,192788,77,216070
21685,0.010252,172.31.40.0-255,66,192854,77,216070
21686,0.012329,74.125.68.0-255,5738,198592,77,216070
21687,0.012336,172.31.40.0-255,66,198658,77,216070
21688,0.014427,74.125.68.0-255,5738,204396,77,216070
21689,0.014438,172.31.40.0-255,66,204462,77,216070
21690,0.016513,74.125.68.0-255,5738,210200,77,216070
21691,0.016523,172.31.40.0-255,66,210266,77,216070
21692,0.018583,74.125.68.0-255,5738,216004,77,216070
21693,0.018592,172.31.40.0-255,66,216070,77,216070
21694,0.0,74.125.200.0-255,150,150,77,414291
21695,2.5e-05,172.31.40.0-255,66,216,77,414291
21696,3.3e-05,74.125.200.0-255,1484,1700,77,414291
21697,3.7e-05,172.31.40.0-255,66,1766,77,414291
21698,5.5e-05,74.125.200.0-255,2902,4668,77,414291
21699,6.1e-05,172.31.40.0-255,66,4734,77,414291
21700,6.9e-05,74.125.200.0-255,7156,11890,77,414291
21701,7.3e-05,172.31.40.0-255,66,11956,77,414291
21702,0.000122,74.125.200.0-255,2141,14097,77,414291
21703,0.000126,172.31.40.0-255,66,14163,77,414291
21704,0.000218,74.125.200.0-255,1484,15647,77,414291
21705,0.000222,172.31.40.0-255,66,15713,77,414291
21706,0.000226,74.125.200.0-255,1484,17197,77,414291
21707,0.000229,172.31.40.0-255,66,17263,77,414291
21708,0.000257,74.125.200.0-255,1484,18747,77,414291
21709,0.00026,172.31.40.0-255,66,18813,77,414291
21710,0.000267,74.125.200.0-255,5738,24551,77,414291
21711,0.000269,172.31.40.0-255,66,24617,77,414291
21712,0.000278,74.125.200.0-255,2902,27519,77,414291
21713,0.00028,172.31.40.0-255,66,27585,77,414291
21714,0.000285,74.125.200.0-255,3961,31546,77,414291
21715,0.000288,172.31.40.0-255,66,31612,77,414291
21716,0.000321,74.125.200.0-255,5738,37350,77,414291
21717,0.000325,172.31.40.0-255,66,37416,77,414291
21718,0.00033,74.125.200.0-255,4320,41736,77,414291
21719,0.000332,172.31.40.0-255,66,41802,77,414291
21720,0.000353,74.125.200.0-255,2902,44704,77,414291
21721,0.00036,172.31.40.0-255,66,44770,77,414291
21722,0.000366,74.125.200.0-255,5738,50508,77,414291
21723,0.000369,172.31.40.0-255,66,50574,77,414291
21724,0.000388,74.125.200.0-255,5738,56312,77,414291
21725,0.000391,172.31.40.0-255,66,56378,77,414291
21726,0.00044,74.125.200.0-255,9567,65945,77,414291
21727,0.000444,172.31.40.0-255,66,66011,77,414291
21728,0.000446,74.125.200.0-255,133,66144,77,414291
21729,0.000491,74.125.200.0-255,1484,67628,77,414291
21730,0.000495,172.31.40.0-255,66,67694,77,414291
21731,0.000499,74.125.200.0-255,2902,70596,77,414291
21732,0.000501,172.31.40.0-255,66,70662,77,414291
21733,0.000533,74.125.200.0-255,2902,73564,77,414291
21734,0.000537,172.31.40.0-255,66,73630,77,414291
21735,0.000542,74.125.200.0-255,4320,77950,77,414291
21736,0.000544,172.31.40.0-255,66,78016,77,414291
21737,0.000551,74.125.200.0-255,7156,85172,77,414291
21738,0.000553,172.31.40.0-255,66,85238,77,414291
21739,0.000575,74.125.200.0-255,1484,86722,77,414291
21740,0.000584,74.125.200.0-255,8574,95296,77,414291
21741,0.000587,172.31.40.0-255,66,95362,77,414291
21742,0.00062,74.125.200.0-255,5020,100382,77,414291
21743,0.000623,172.31.40.0-255,66,100448,77,414291
21744,0.000987,74.125.200.0-255,1484,101932,77,414291
21745,0.000992,74.125.200.0-255,1484,103416,77,414291
21746,0.000995,172.31.40.0-255,66,103482,77,414291
21747,0.001019,74.125.200.0-255,1484,104966,77,414291
21748,0.001025,74.125.200.0-255,5738,110704,77,414291
21749,0.001027,172.31.40.0-255,66,110770,77,414291
21750,0.001033,74.125.200.0-255,5738,116508,77,414291
21751,0.001035,172.31.40.0-255,66,116574,77,414291
21752,0.001041,74.125.200.0-255,5738,122312,77,414291
21753,0.001044,172.31.40.0-255,66,122378,77,414291
21754,0.001056,74.125.200.0-255,1484,123862,77,414291
21755,0.001087,74.125.200.0-255,8574,132436,77,414291
21756,0.00109,172.31.40.0-255,66,132502,77,414291
21757,0.001118,74.125.200.0-255,2184,134686,77,414291
21758,0.001121,172.31.40.0-255,66,134752,77,414291
21759,0.001173,74.125.200.0-255,1484,136236,77,414291
21760,0.001176,74.125.200.0-255,1484,137720,77,414291
21761,0.001179,172.31.40.0-255,66,137786,77,414291
21762,0.001191,74.125.200.0-255,1484,139270,77,414291
21763,0.001201,74.125.200.0-255,5738,145008,77,414291
21764,0.001204,172.31.40.0-255,66,145074,77,414291
21765,0.001241,74.125.200.0-255,12828,157902,77,414291
21766,0.001244,172.31.40.0-255,66,157968,77,414291
21767,0.001286,74.125.200.0-255,4320,162288,77,414291
21768,0.001289,172.31.40.0-255,66,162354,77,414291
21769,0.001319,74.125.200.0-255,6438,168792,77,414291
21770,0.001323,172.31.40.0-255,66,168858,77,414291
21771,0.001367,74.125.200.0-255,1484,170342,77,414291
21772,0.001381,74.125.200.0-255,2902,173244,77,414291
21773,0.001384,172.31.40.0-255,66,173310,77,414291
21774,0.001414,74.125.200.0-255,5738,179048,77,414291
21775,0.001417,172.31.40.0-255,66,179114,77,414291
21776,0.001455,74.125.200.0-255,12828,191942,77,414291
21777,0.001458,172.31.40.0-255,66,192008,77,414291
21778,0.001465,74.125.200.0-255,8574,200582,77,414291
21779,0.001472,172.31.40.0-255,66,200648,77,414291
21780,0.001499,74.125.200.0-255,2184,202832,77,414291
21781,0.001502,172.31.40.0-255,66,202898,77,414291
21782,0.001612,74.125.200.0-255,1484,204382,77,414291
21783,0.001624,74.125.200.0-255,1484,205866,77,414291
21784,0.001627,172.31.40.0-255,66,205932,77,414291
21785,0.001659,74.125.200.0-255,1484,207416,77,414291
21786,0.001665,74.125.200.0-255,4320,211736,77,414291
21787,0.001668,172.31.40.0-255,66,211802,77,414291
21788,0.001675,74.125.200.0-255,5738,217540,77,414291
21789,0.001677,172.31.40.0-255,66,217606,77,414291
21790,0.001682,74.125.200.0-255,4320,221926,77,414291
21791,0.001684,172.31.40.0-255,66,221992,77,414291
21792,0.001715,74.125.200.0-255,7156,229148,77,414291
21793,0.001719,172.31.40.0-255,66,229214,77,414291
21794,0.001724,74.125.200.0-255,4320,233534,77,414291
21795,0.001726,172.31.40.0-255,66,233600,77,414291
21796,0.001749,74.125.200.0-255,3602,237202,77,414291
21797,0.001752,172.31.40.0-255,66,237268,77,414291
21798,0.00179,74.125.200.0-255,1484,238752,77,414291
21799,0.001827,74.125.200.0-255,1484,240236,77,414291
21800,0.00183,172.31.40.0-255,66,240302,77,414291
21801,0.001861,74.125.200.0-255,1484,241786,77,414291
21802,0.001868,74.125.200.0-255,5738,247524,77,414291
21803,0.001871,172.31.40.0-255,66,247590,77,414291
21804,0.001886,74.125.200.0-255,11410,259000,77,414291
21805,0.001889,172.31.40.0-255,66,259066,77,414291
21806,0.0019,74.125.200.0-255,12110,271176,77,414291
21807,0.001903,172.31.40.0-255,66,271242,77,414291
21808,0.001909,74.125.200.0-255,4320,275562,77,414291
21809,0.001912,172.31.40.0-255,66,275628,77,414291
21810,0.001946,74.125.200.0-255,5738,281366,77,414291
21811,0.001948,74.125.200.0-255,1484,282850,77,414291
21812,0.001952,172.31.40.0-255,66,282916,77,414291
21813,0.001986,74.125.200.0-255,5738,288654,77,414291
21814,0.00199,172.31.40.0-255,66,288720,77,414291
21815,0.001995,74.125.200.0-255,8574,297294,77,414291
21816,0.002,74.125.200.0-255,4320,301614,77,414291
21817,0.002005,172.31.40.0-255,66,301680,77,414291
21818,0.002026,74.125.200.0-255,3602,305282,77,414291
21819,0.002034,172.31.40.0-255,66,305348,77,414291
21820,0.002035,74.125.200.0-255,8574,313922,77,414291
21821,0.002043,172.31.40.0-255,66,313988,77,414291
21822,0.002079,74.125.200.0-255,9992,323980,77,414291
21823,0.002091,74.125.200.0-255,11410,335390,77,414291
21824,0.002095,74.125.200.0-255,3602,338992,77,414291
21825,0.0021,172.31.40.0-255,66,339058,77,414291
21826,0.002121,74.125.200.0-255,4320,343378,77,414291
21827,0.002135,172.31.40.0-255,66,343444,77,414291
21828,0.002136,74.125.200.0-255,7156,350600,77,414291
21829,0.00215,172.31.40.0-255,66,350666,77,414291
21830,0.002157,74.125.200.0-255,2902,353568,77,414291
21831,0.002165,74.125.200.0-255,7156,360724,77,414291
21832,0.002168,172.31.40.0-255,66,360790,77,414291
21833,0.002194,74.125.200.0-255,8574,369364,77,414291
21834,0.002204,172.31.40.0-255,66,369430,77,414291
21835,0.002232,74.125.200.0-255,7856,377286,77,414291
21836,0.00224,74.125.200.0-255,8574,385860,77,414291
21837,0.002251,172.31.40.0-255,66,385926,77,414291
21838,0.002266,74.125.200.0-255,11410,397336,77,414291
21839,0.002274,172.31.40.0-255,66,397402,77,414291
21840,0.002293,74.125.200.0-255,2902,400304,77,414291
21841,0.0023,172.31.40.0-255,66,400370,77,414291
21842,0.002301,74.125.200.0-255,8574,408944,77,414291
21843,0.002305,172.31.40.0-255,66,409010,77,414291
21844,0.002372,74.125.200.0-255,3602,412612,77,414291
21845,0.004569,74.125.200.0-255,682,413294,77,414291
21846,0.010494,172.31.40.0-255,66,413360,77,414291
21847,0.011673,74.125.200.0-255,682,414042,77,414291
21848,0.011684,172.31.40.0-255,78,414120,77,414291
21849,0.012067,172.31.40.0-255,105,414225,77,414291
21850,0.014342,74.125.200.0-255,66,414291,77,414291
21851,0.0,74.125.68.0-255,153,153,77,117704
21852,1.3e-05,172.31.40.0-255,66,219,77,117704
21853,3.7e-05,74.125.68.0-255,1484,1703,77,117704
21854,4.1e-05,172.31.40.0-255,66,1769,77,117704
21855,5.9e-05,74.125.68.0-255,2902,4671,77,117704
21856,6.2e-05,172.31.40.0-255,66,4737,77,117704
21857,6.7e-05,74.125.68.0-255,2902,7639,77,117704
21858,7e-05,172.31.40.0-255,66,7705,77,117704
21859,0.000105,74.125.68.0-255,4320,12025,77,117704
21860,0.000108,172.31.40.0-255,66,12091,77,117704
21861,0.000129,74.125.68.0-255,2001,14092,77,117704
21862,0.000131,172.31.40.0-255,66,14158,77,117704
21863,0.000149,74.125.68.0-255,2902,17060,77,117704
21864,0.000151,172.31.40.0-255,66,17126,77,117704
21865,0.000172,74.125.68.0-255,7156,24282,77,117704
21866,0.000175,172.31.40.0-255,66,24348,77,117704
21867,0.000227,74.125.68.0-255,4320,28668,77,117704
21868,0.000231,172.31.40.0-255,66,28734,77,117704
21869,0.000248,74.125.68.0-255,2543,31277,77,117704
21870,0.00025,172.31.40.0-255,66,31343,77,117704
21871,0.0004,74.125.68.0-255,1484,32827,77,117704
21872,0.000405,172.31.40.0-255,66,32893,77,117704
21873,0.000409,74.125.68.0-255,1484,34377,77,117704
21874,0.000411,172.31.40.0-255,66,34443,77,117704
21875,0.000426,74.125.68.0-255,1484,35927,77,117704
21876,0.000429,172.31.40.0-255,66,35993,77,117704
21877,0.000435,74.125.68.0-255,4320,40313,77,117704
21878,0.000437,172.31.40.0-255,66,40379,77,117704
21879,0.000481,74.125.68.0-255,5738,46117,77,117704
21880,0.000484,172.31.40.0-255,66,46183,77,117704
21881,0.000502,74.125.68.0-255,2543,48726,77,117704
21882,0.000505,172.31.40.0-255,66,48792,77,117704
21883,0.000604,74.125.68.0-255,1484,50276,77,117704
21884,0.000623,74.125.68.0-255,2902,53178,77,117704
21885,0.000627,74.125.68.0-255,1484,54662,77,117704
21886,0.000639,172.31.40.0-255,66,54728,77,117704
21887,0.00065,74.125.68.0-255,2902,57630,77,117704
21888,0.000655,74.125.68.0-255,2902,60532,77,117704
21889,0.000677,74.125.68.0-255,2902,63434,77,117704
21890,0.000681,74.125.68.0-255,2543,65977,77,117704
21891,0.00069,172.31.40.0-255,66,66043,77,117704
21892,0.001414,74.125.68.0-255,645,66688,77,117704
21893,0.002202,74.125.68.0-255,1484,68172,77,117704
21894,0.002208,172.31.40.0-255,66,68238,77,117704
21895,0.002228,74.125.68.0-255,2902,71140,77,117704
21896,0.002255,74.125.68.0-255,1484,72624,77,117704
21897,0.002268,74.125.68.0-255,4320,76944,77,117704
21898,0.002271,74.125.68.0-255,1484,78428,77,117704
21899,0.002285,74.125.68.0-255,1484,79912,77,117704
21900,0.002326,74.125.68.0-255,2902,82814,77,117704
21901,0.002342,74.125.68.0-255,4320,87134,77,117704
21902,0.002353,74.125.68.0-255,1484,88618,77,117704
21903,0.005806,172.31.40.0-255,66,88684,77,117704
21904,0.008102,74.125.68.0-255,5738,94422,77,117704
21905,0.008108,172.31.40.0-255,66,94488,77,117704
21906,0.010392,74.125.68.0-255,5738,100226,77,117704
21907,0.010398,172.31.40.0-255,66,100292,77,117704
21908,0.012712,74.125.68.0-255,5738,106030,77,117704
21909,0.01423,172.31.40.0-255,66,106096,77,117704
21910,0.016513,74.125.68.0-255,5738,111834,77,117704
21911,0.01652,172.31.40.0-255,66,111900,77,117704
21912,0.01882,74.125.68.0-255,5738,117638,77,117704
21913,0.018829,172.31.40.0-255,66,117704,77,117704
21914,0.0,172.31.40.0-255,105,105,77,210
21915,0.001943,157.240.13.0-255,105,210,77,210
21916,0.0,74.125.24.0-255,147,147,77,243605
21917,2.5e-05,172.31.40.0-255,66,213,77,243605
21918,3.2e-05,74.125.24.0-255,1484,1697,77,243605
21919,3.6e-05,172.31.40.0-255,66,1763,77,243605
21920,4.2e-05,74.125.24.0-255,2902,4665,77,243605
21921,5.2e-05,172.31.40.0-255,66,4731,77,243605
21922,6e-05,74.125.24.0-255,7156,11887,77,243605
21923,6.3e-05,172.31.40.0-255,66,11953,77,243605
21924,6.7e-05,74.125.24.0-255,2039,13992,77,243605
21925,7.1e-05,172.31.40.0-255,66,14058,77,243605
21926,0.000156,74.125.24.0-255,1484,15542,77,243605
21927,0.000159,172.31.40.0-255,66,15608,77,243605
21928,0.000165,74.125.24.0-255,2902,18510,77,243605
21929,0.000168,172.31.40.0-255,66,18576,77,243605
21930,0.000202,74.125.24.0-255,5738,24314,77,243605
21931,0.000205,172.31.40.0-255,66,24380,77,243605
21932,0.000234,74.125.24.0-255,6797,31177,77,243605
21933,0.000236,172.31.40.0-255,66,31243,77,243605
21934,0.000281,74.125.24.0-255,5738,36981,77,243605
21935,0.000284,172.31.40.0-255,66,37047,77,243605
21936,0.000306,74.125.24.0-255,1484,38531,77,243605
21937,0.000309,172.31.40.0-255,66,38597,77,243605
21938,0.000316,74.125.24.0-255,5738,44335,77,243605
21939,0.000318,172.31.40.0-255,66,44401,77,243605
21940,0.000339,74.125.24.0-255,3961,48362,77,243605
21941,0.000346,172.31.40.0-255,66,48428,77,243605
21942,0.00037,74.125.24.0-255,1484,49912,77,243605
21943,0.000373,172.31.40.0-255,66,49978,77,243605
21944,0.000377,74.125.24.0-255,2902,52880,77,243605
21945,0.00038,172.31.40.0-255,66,52946,77,243605
21946,0.000436,74.125.24.0-255,5738,58684,77,243605
21947,0.00044,172.31.40.0-255,66,58750,77,243605
21948,0.000447,74.125.24.0-255,6797,65547,77,243605
21949,0.000449,172.31.40.0-255,66,65613,77,243605
21950,0.000452,74.125.24.0-255,676,66289,77,243605
21951,0.00064,74.125.24.0-255,1484,67773,77,243605
21952,0.000645,172.31.40.0-255,66,67839,77,243605
21953,0.000651,74.125.24.0-255,2902,70741,77,243605
21954,0.000654,172.31.40.0-255,66,70807,77,243605
21955,0.00066,74.125.24.0-255,4320,75127,77,243605
21956,0.000667,172.31.40.0-255,66,75193,77,243605
21957,0.000696,74.125.24.0-255,1484,76677,77,243605
21958,0.000721,74.125.24.0-255,9992,86669,77,243605
21959,0.000724,172.31.40.0-255,66,86735,77,243605
21960,0.000751,74.125.24.0-255,3961,90696,77,243605
21961,0.000754,172.31.40.0-255,66,90762,77,243605
21962,0.000773,74.125.24.0-255,5738,96500,77,243605
21963,0.000775,172.31.40.0-255,66,96566,77,243605
21964,0.000804,74.125.24.0-255,3961,100527,77,243605
21965,0.000807,172.31.40.0-255,66,100593,77,243605
21966,0.001007,74.125.24.0-255,1484,102077,77,243605
21967,0.001013,74.125.24.0-255,2902,104979,77,243605
21968,0.001017,172.31.40.0-255,66,105045,77,243605
21969,0.001022,74.125.24.0-255,2902,107947,77,243605
21970,0.001024,172.31.40.0-255,66,108013,77,243605
21971,0.001049,74.125.24.0-255,2902,110915,77,243605
21972,0.001051,172.31.40.0-255,66,110981,77,243605
21973,0.001063,74.125.24.0-255,12828,123809,77,243605
21974,0.00107,172.31.40.0-255,66,123875,77,243605
21975,0.00108,74.125.24.0-255,10692,134567,77,243605
21976,0.001083,172.31.40.0-255,66,134633,77,243605
21977,0.001345,74.125.24.0-255,1484,136117,77,243605
21978,0.001351,74.125.24.0-255,2902,139019,77,243605
21979,0.001355,172.31.40.0-255,66,139085,77,243605
21980,0.00139,74.125.24.0-255,5738,144823,77,243605
21981,0.001392,172.31.40.0-255,66,144889,77,243605
21982,0.001398,74.125.24.0-255,4320,149209,77,243605
21983,0.0014,172.31.40.0-255,66,149275,77,243605
21984,0.00143,74.125.24.0-255,8574,157849,77,243605
21985,0.001433,172.31.40.0-255,66,157915,77,243605
21986,0.001442,74.125.24.0-255,8574,166489,77,243605
21987,0.001444,172.31.40.0-255,66,166555,77,243605
21988,0.00147,74.125.24.0-255,2184,168739,77,243605
21989,0.001472,172.31.40.0-255,66,168805,77,243605
21990,0.001777,74.125.24.0-255,1484,170289,77,243605
21991,0.001782,74.125.24.0-255,2902,173191,77,243605
21992,0.001786,172.31.40.0-255,66,173257,77,243605
21993,0.001793,74.125.24.0-255,5738,178995,77,243605
21994,0.001795,172.31.40.0-255,66,179061,77,243605
21995,0.001822,74.125.24.0-255,5738,184799,77,243605
21996,0.001828,172.31.40.0-255,66,184865,77,243605
21997,0.001834,74.125.24.0-255,4320,189185,77,243605
21998,0.001836,172.31.40.0-255,66,189251,77,243605
21999,0.001863,74.125.24.0-255,8574,197825,77,243605
22000,0.001866,172.31.40.0-255,66,197891,77,243605
22001,0.001896,74.125.24.0-255,5020,202911,77,243605
22002,0.001899,172.31.40.0-255,66,202977,77,243605
22003,0.004153,74.125.24.0-255,5738,208715,77,243605
22004,0.00416,172.31.40.0-255,66,208781,77,243605
22005,0.006391,74.125.24.0-255,5738,214519,77,243605
22006,0.006395,172.31.40.0-255,66,214585,77,243605
22007,0.00865,74.125.24.0-255,5738,220323,77,243605
22008,0.008658,172.31.40.0-255,66,220389,77,243605
22009,0.010931,74.125.24.0-255,5738,226127,77,243605
22010,0.010938,172.31.40.0-255,66,226193,77,243605
22011,0.013223,74.125.24.0-255,5738,231931,77,243605
22012,0.013231,172.31.40.0-255,66,231997,77,243605
22013,0.0155,74.125.24.0-255,5738,237735,77,243605
22014,0.015507,172.31.40.0-255,66,237801,77,243605
22015,0.017767,74.125.24.0-255,5738,243539,77,243605
22016,0.017776,172.31.40.0-255,66,243605,77,243605
22017,0.0,172.31.40.0-255,105,105,77,459
22018,0.000246,172.31.40.0-255,90,195,77,459
22019,0.000256,172.31.40.0-255,66,261,77,459
22020,0.002621,74.125.68.0-255,66,327,77,459
22021,0.002655,74.125.68.0-255,66,393,77,459
22022,0.002679,172.31.40.0-255,66,459,77,459
22023,0.0,74.125.200.0-255,153,153,77,139086
22024,2.5e-05,172.31.40.0-255,66,219,77,139086
22025,3.2e-05,74.125.200.0-255,1484,1703,77,139086
22026,3.7e-05,172.31.40.0-255,66,1769,77,139086
22027,4e-05,74.125.200.0-255,1484,3253,77,139086
22028,4.3e-05,172.31.40.0-255,66,3319,77,139086
22029,5.7e-05,74.125.200.0-255,2902,6221,77,139086
22030,6e-05,172.31.40.0-255,66,6287,77,139086
22031,6.4e-05,74.125.200.0-255,1484,7771,77,139086
22032,6.6e-05,172.31.40.0-255,66,7837,77,139086
22033,0.000102,74.125.200.0-255,4320,12157,77,139086
22034,0.000106,172.31.40.0-255,66,12223,77,139086
22035,0.00011,74.125.200.0-255,2138,14361,77,139086
22036,0.000113,172.31.40.0-255,66,14427,77,139086
22037,0.000338,74.125.200.0-255,1484,15911,77,139086
22038,0.000343,172.31.40.0-255,66,15977,77,139086
22039,0.00035,74.125.200.0-255,2902,18879,77,139086
22040,0.000353,172.31.40.0-255,66,18945,77,139086
22041,0.000376,74.125.200.0-255,5738,24683,77,139086
22042,0.000379,172.31.40.0-255,66,24749,77,139086
22043,0.000383,74.125.200.0-255,2902,27651,77,139086
22044,0.000385,172.31.40.0-255,66,27717,77,139086
22045,0.000418,74.125.200.0-255,3961,31678,77,139086
22046,0.000421,172.31.40.0-255,66,31744,77,139086
22047,0.000616,74.125.200.0-255,1484,33228,77,139086
22048,0.00062,172.31.40.0-255,66,33294,77,139086
22049,0.000626,74.125.200.0-255,2902,36196,77,139086
22050,0.000629,172.31.40.0-255,66,36262,77,139086
22051,0.000633,74.125.200.0-255,2902,39164,77,139086
22052,0.00064,172.31.40.0-255,66,39230,77,139086
22053,0.000646,74.125.200.0-255,4320,43550,77,139086
22054,0.000648,172.31.40.0-255,66,43616,77,139086
22055,0.000694,74.125.200.0-255,5379,48995,77,139086
22056,0.000699,172.31.40.0-255,66,49061,77,139086
22057,0.000782,74.125.200.0-255,1484,50545,77,139086
22058,0.000788,74.125.200.0-255,2902,53447,77,139086
22059,0.000791,172.31.40.0-255,66,53513,77,139086
22060,0.000824,74.125.200.0-255,5738,59251,77,139086
22061,0.000827,172.31.40.0-255,66,59317,77,139086
22062,0.000832,74.125.200.0-255,2902,62219,77,139086
22063,0.000834,172.31.40.0-255,66,62285,77,139086
22064,0.000859,74.125.200.0-255,4258,66543,77,139086
22065,0.000861,172.31.40.0-255,66,66609,77,139086
22066,0.001656,74.125.200.0-255,381,66990,77,139086
22067,0.001787,74.125.200.0-255,1484,68474,77,139086
22068,0.001794,172.31.40.0-255,66,68540,77,139086
22069,0.001801,74.125.200.0-255,2902,71442,77,139086
22070,0.001803,172.31.40.0-255,66,71508,77,139086
22071,0.001841,74.125.200.0-255,5738,77246,77,139086
22072,0.001844,172.31.40.0-255,66,77312,77,139086
22073,0.001851,74.125.200.0-255,6797,84109,77,139086
22074,0.001853,172.31.40.0-255,66,84175,77,139086
22075,0.001877,74.125.200.0-255,1484,85659,77,139086
22076,0.001895,74.125.200.0-255,5738,91397,77,139086
22077,0.001897,172.31.40.0-255,66,91463,77,139086
22078,0.001937,74.125.200.0-255,8574,100037,77,139086
22079,0.00194,172.31.40.0-255,66,100103,77,139086
22080,0.001943,74.125.200.0-255,1125,101228,77,139086
22081,0.004503,74.125.200.0-255,4320,105548,77,139086
22082,0.004508,172.31.40.0-255,66,105614,77,139086
22083,0.007066,74.125.200.0-255,5738,111352,77,139086
22084,0.007072,172.31.40.0-255,66,111418,77,139086
22085,0.009628,74.125.200.0-255,5738,117156,77,139086
22086,0.009636,172.31.40.0-255,66,117222,77,139086
22087,0.012192,74.125.200.0-255,5738,122960,77,139086
22088,0.012202,172.31.40.0-255,66,123026,77,139086
22089,0.014786,74.125.200.0-255,5738,128764,77,139086
22090,0.0148,172.31.40.0-255,66,128830,77,139086
22091,0.017366,74.125.200.0-255,4320,133150,77,139086
22092,0.017376,172.31.40.0-255,66,133216,77,139086
22093,0.017408,74.125.200.0-255,1484,134700,77,139086
22094,0.019956,74.125.200.0-255,4320,139020,77,139086
22095,0.01997,172.31.40.0-255,66,139086,77,139086
22096,0.0,172.31.40.0-255,105,105,77,459
22097,0.000229,172.31.40.0-255,90,195,77,459
22098,0.00024,172.31.40.0-255,66,261,77,459
22099,0.002512,74.125.68.0-255,66,327,77,459
22100,0.002534,74.125.68.0-255,66,393,77,459
22101,0.002549,172.31.40.0-255,66,459,77,459
22102,0.0,172.253.118.0-255,152,152,77,167558
22103,1.9e-05,172.31.40.0-255,66,218,77,167558
22104,2.5e-05,172.253.118.0-255,1484,1702,77,167558
22105,2.9e-05,172.31.40.0-255,66,1768,77,167558
22106,3.5e-05,172.253.118.0-255,2902,4670,77,167558
22107,3.8e-05,172.31.40.0-255,66,4736,77,167558
22108,5e-05,172.253.118.0-255,7156,11892,77,167558
22109,5.3e-05,172.31.40.0-255,66,11958,77,167558
22110,5.7e-05,172.253.118.0-255,2902,14860,77,167558
22111,6e-05,172.31.40.0-255,66,14926,77,167558
22112,8.3e-05,172.253.118.0-255,9110,24036,77,167558
22113,8.6e-05,172.31.40.0-255,66,24102,77,167558
22114,9.7e-05,172.253.118.0-255,6797,30899,77,167558
22115,9.9e-05,172.31.40.0-255,66,30965,77,167558
22116,0.000143,172.253.118.0-255,1484,32449,77,167558
22117,0.000145,172.31.40.0-255,66,32515,77,167558
22118,0.00015,172.253.118.0-255,2902,35417,77,167558
22119,0.000152,172.31.40.0-255,66,35483,77,167558
22120,0.000172,172.253.118.0-255,2902,38385,77,167558
22121,0.000174,172.31.40.0-255,66,38451,77,167558
22122,0.000196,172.253.118.0-255,2902,41353,77,167558
22123,0.000199,172.31.40.0-255,66,41419,77,167558
22124,0.000203,172.253.118.0-255,4320,45739,77,167558
22125,0.000205,172.31.40.0-255,66,45805,77,167558
22126,0.000227,172.253.118.0-255,2543,48348,77,167558
22127,0.000229,172.31.40.0-255,66,48414,77,167558
22128,0.000816,172.253.118.0-255,1484,49898,77,167558
22129,0.000822,172.31.40.0-255,66,49964,77,167558
22130,0.000828,172.253.118.0-255,2902,52866,77,167558
22131,0.000831,172.31.40.0-255,66,52932,77,167558
22132,0.000834,172.253.118.0-255,1484,54416,77,167558
22133,0.000836,172.31.40.0-255,66,54482,77,167558
22134,0.000866,172.253.118.0-255,4320,58802,77,167558
22135,0.000868,172.31.40.0-255,66,58868,77,167558
22136,0.000874,172.253.118.0-255,4320,63188,77,167558
22137,0.000876,172.31.40.0-255,66,63254,77,167558
22138,0.000905,172.253.118.0-255,4320,67574,77,167558
22139,0.000908,172.31.40.0-255,66,67640,77,167558
22140,0.000952,172.253.118.0-255,6797,74437,77,167558
22141,0.000955,172.31.40.0-255,66,74503,77,167558
22142,0.000966,172.253.118.0-255,11410,85913,77,167558
22143,0.000968,172.31.40.0-255,66,85979,77,167558
22144,0.000981,172.253.118.0-255,13528,99507,77,167558
22145,0.000983,172.31.40.0-255,66,99573,77,167558
22146,0.001885,172.253.118.0-255,645,100218,77,167558
22147,0.001907,172.253.118.0-255,1484,101702,77,167558
22148,0.001911,172.31.40.0-255,66,101768,77,167558
22149,0.001917,172.253.118.0-255,2902,104670,77,167558
22150,0.001918,172.31.40.0-255,66,104736,77,167558
22151,0.001954,172.253.118.0-255,1484,106220,77,167558
22152,0.001964,172.253.118.0-255,9992,116212,77,167558
22153,0.001966,172.31.40.0-255,66,116278,77,167558
22154,0.001969,172.253.118.0-255,462,116740,77,167558
22155,0.003927,172.253.118.0-255,4320,121060,77,167558
22156,0.003932,172.31.40.0-255,66,121126,77,167558
22157,0.005898,172.253.118.0-255,5738,126864,77,167558
22158,0.005905,172.31.40.0-255,66,126930,77,167558
22159,0.007888,172.253.118.0-255,5738,132668,77,167558
22160,0.007895,172.31.40.0-255,66,132734,77,167558
22161,0.009874,172.253.118.0-255,5738,138472,77,167558
22162,0.009881,172.31.40.0-255,66,138538,77,167558
22163,0.011844,172.253.118.0-255,5738,144276,77,167558
22164,0.011851,172.31.40.0-255,66,144342,77,167558
22165,0.01383,172.253.118.0-255,5738,150080,77,167558
22166,0.013838,172.31.40.0-255,66,150146,77,167558
22167,0.015802,172.253.118.0-255,5738,155884,77,167558
22168,0.015811,172.31.40.0-255,66,155950,77,167558
22169,0.017799,172.253.118.0-255,5738,161688,77,167558
22170,0.017807,172.31.40.0-255,66,161754,77,167558
22171,0.019794,172.253.118.0-255,5738,167492,77,167558
22172,0.0198,172.31.40.0-255,66,167558,77,167558
22173,0.0,172.217.194.0-255,150,150,77,207081
22174,2.1e-05,172.31.40.0-255,66,216,77,207081
22175,2.9e-05,172.217.194.0-255,1484,1700,77,207081
22176,3.4e-05,172.31.40.0-255,66,1766,77,207081
22177,3.9e-05,172.217.194.0-255,2902,4668,77,207081
22178,4.9e-05,172.31.40.0-255,66,4734,77,207081
22179,5.8e-05,172.217.194.0-255,7156,11890,77,207081
22180,6e-05,172.31.40.0-255,66,11956,77,207081
22181,7e-05,172.217.194.0-255,9109,21065,77,207081
22182,7.2e-05,172.31.40.0-255,66,21131,77,207081
22183,7.6e-05,172.217.194.0-255,1484,22615,77,207081
22184,7.8e-05,172.31.40.0-255,66,22681,77,207081
22185,0.00012,172.217.194.0-255,8215,30896,77,207081
22186,0.000123,172.31.40.0-255,66,30962,77,207081
22187,0.000157,172.217.194.0-255,1484,32446,77,207081
22188,0.000159,172.31.40.0-255,66,32512,77,207081
22189,0.000163,172.217.194.0-255,1484,33996,77,207081
22190,0.000165,172.31.40.0-255,66,34062,77,207081
22191,0.000201,172.217.194.0-255,1484,35546,77,207081
22192,0.000203,172.31.40.0-255,66,35612,77,207081
22193,0.000211,172.217.194.0-255,5738,41350,77,207081
22194,0.000213,172.31.40.0-255,66,41416,77,207081
22195,0.00022,172.217.194.0-255,6797,48213,77,207081
22196,0.000222,172.31.40.0-255,66,48279,77,207081
22197,0.000947,172.217.194.0-255,1484,49763,77,207081
22198,0.000953,172.31.40.0-255,66,49829,77,207081
22199,0.000962,172.217.194.0-255,2902,52731,77,207081
22200,0.000965,172.31.40.0-255,66,52797,77,207081
22201,0.000977,172.217.194.0-255,5738,58535,77,207081
22202,0.000979,172.31.40.0-255,66,58601,77,207081
22203,0.000982,172.217.194.0-255,1484,60085,77,207081
22204,0.000984,172.31.40.0-255,66,60151,77,207081
22205,0.001023,172.217.194.0-255,5379,65530,77,207081
22206,0.001026,172.31.40.0-255,66,65596,77,207081
22207,0.001356,172.217.194.0-255,1484,67080,77,207081
22208,0.001366,172.217.194.0-255,2902,69982,77,207081
22209,0.00137,172.31.40.0-255,66,70048,77,207081
22210,0.001377,172.217.194.0-255,4320,74368,77,207081
22211,0.001379,172.31.40.0-255,66,74434,77,207081
22212,0.001407,172.217.194.0-255,1484,75918,77,207081
22213,0.00142,172.217.194.0-255,12828,88746,77,207081
22214,0.001422,172.31.40.0-255,66,88812,77,207081
22215,0.00143,172.217.194.0-255,5738,94550,77,207081
22216,0.001432,172.31.40.0-255,66,94616,77,207081
22217,0.001457,172.217.194.0-255,4320,98936,77,207081
22218,0.001459,172.31.40.0-255,66,99002,77,207081
22219,0.001462,172.217.194.0-255,766,99768,77,207081
22220,0.001512,172.217.194.0-255,1484,101252,77,207081
22221,0.001515,172.31.40.0-255,66,101318,77,207081
22222,0.001518,172.217.194.0-255,1484,102802,77,207081
22223,0.001541,172.217.194.0-255,4320,107122,77,207081
22224,0.001544,172.31.40.0-255,66,107188,77,207081
22225,0.001571,172.217.194.0-255,5738,112926,77,207081
22226,0.001574,172.31.40.0-255,66,112992,77,207081
22227,0.001609,172.217.194.0-255,5365,118357,77,207081
22228,0.001613,172.31.40.0-255,66,118423,77,207081
22229,0.00162,172.217.194.0-255,7156,125579,77,207081
22230,0.001623,172.31.40.0-255,66,125645,77,207081
22231,0.001667,172.31.40.0-255,66,125711,77,207081
22232,0.001696,172.217.194.0-255,2902,128613,77,207081
22233,0.001698,172.31.40.0-255,66,128679,77,207081
22234,0.001704,172.217.194.0-255,5020,133699,77,207081
22235,0.001707,172.31.40.0-255,66,133765,77,207081
22236,0.001854,172.217.194.0-255,1484,135249,77,207081
22237,0.001872,172.217.194.0-255,2902,138151,77,207081
22238,0.001878,172.31.40.0-255,66,138217,77,207081
22239,0.001887,172.217.194.0-255,5738,143955,77,207081
22240,0.001895,172.31.40.0-255,66,144021,77,207081
22241,0.001903,172.217.194.0-255,8574,152595,77,207081
22242,0.001906,172.31.40.0-255,66,152661,77,207081
22243,0.001956,172.217.194.0-255,5738,158399,77,207081
22244,0.00196,172.31.40.0-255,66,158465,77,207081
22245,0.001994,172.217.194.0-255,9274,167739,77,207081
22246,0.001997,172.31.40.0-255,66,167805,77,207081
22247,0.004356,172.217.194.0-255,5738,173543,77,207081
22248,0.004362,172.31.40.0-255,66,173609,77,207081
22249,0.006712,172.217.194.0-255,4320,177929,77,207081
22250,0.006718,172.31.40.0-255,66,177995,77,207081
22251,0.006746,172.217.194.0-255,1484,179479,77,207081
22252,0.009049,172.217.194.0-255,4320,183799,77,207081
22253,0.009056,172.31.40.0-255,66,183865,77,207081
22254,0.011426,172.217.194.0-255,5738,189603,77,207081
22255,0.011433,172.31.40.0-255,66,189669,77,207081
22256,0.014137,172.217.194.0-255,5738,195407,77,207081
22257,0.014148,172.31.40.0-255,66,195473,77,207081
22258,0.016522,172.217.194.0-255,5738,201211,77,207081
22259,0.016529,172.31.40.0-255,66,201277,77,207081
22260,0.018884,172.217.194.0-255,5738,207015,77,207081
22261,0.018892,172.31.40.0-255,66,207081,77,207081
22262,0.0,172.217.194.0-255,150,150,77,324498
22263,1.4e-05,172.31.40.0-255,66,216,77,324498
22264,2.1e-05,172.217.194.0-255,1484,1700,77,324498
22265,2.5e-05,172.31.40.0-255,66,1766,77,324498
22266,3.1e-05,172.217.194.0-255,2902,4668,77,324498
22267,3.4e-05,172.31.40.0-255,66,4734,77,324498
22268,4.1e-05,172.217.194.0-255,7156,11890,77,324498
22269,4.4e-05,172.31.40.0-255,66,11956,77,324498
22270,6e-05,172.217.194.0-255,1484,13440,77,324498
22271,6.3e-05,172.31.40.0-255,66,13506,77,324498
22272,0.00012,172.31.40.0-255,66,13572,77,324498
22273,0.000125,172.217.194.0-255,2543,16115,77,324498
22274,0.000127,172.31.40.0-255,66,16181,77,324498
22275,0.000142,172.217.194.0-255,1484,17665,77,324498
22276,0.000144,172.31.40.0-255,66,17731,77,324498
22277,0.000149,172.217.194.0-255,2902,20633,77,324498
22278,0.000151,172.31.40.0-255,66,20699,77,324498
22279,0.00018,172.217.194.0-255,5738,26437,77,324498
22280,0.000183,172.31.40.0-255,66,26503,77,324498
22281,0.00019,172.217.194.0-255,8215,34718,77,324498
22282,0.000193,172.31.40.0-255,66,34784,77,324498
22283,0.000256,172.31.40.0-255,66,34850,77,324498
22284,0.000259,172.217.194.0-255,367,35217,77,324498
22285,0.000261,172.31.40.0-255,66,35283,77,324498
22286,0.000367,172.217.194.0-255,1484,36767,77,324498
22287,0.000371,172.31.40.0-255,66,36833,77,324498
22288,0.000377,172.217.194.0-255,2902,39735,77,324498
22289,0.000379,172.31.40.0-255,66,39801,77,324498
22290,0.000386,172.217.194.0-255,5738,45539,77,324498
22291,0.000388,172.31.40.0-255,66,45605,77,324498
22292,0.000414,172.217.194.0-255,9992,55597,77,324498
22293,0.000417,172.31.40.0-255,66,55663,77,324498
22294,0.000436,172.217.194.0-255,2902,58565,77,324498
22295,0.000438,172.31.40.0-255,66,58631,77,324498
22296,0.000447,172.217.194.0-255,8574,67205,77,324498
22297,0.000449,172.31.40.0-255,66,67271,77,324498
22298,0.00047,172.217.194.0-255,1634,68905,77,324498
22299,0.000472,172.31.40.0-255,66,68971,77,324498
22300,0.00048,172.217.194.0-255,5738,74709,77,324498
22301,0.000482,172.31.40.0-255,66,74775,77,324498
22302,0.000509,172.217.194.0-255,5738,80513,77,324498
22303,0.000512,172.31.40.0-255,66,80579,77,324498
22304,0.000518,172.217.194.0-255,5365,85944,77,324498
22305,0.00052,172.31.40.0-255,66,86010,77,324498
22306,0.000768,172.217.194.0-255,1484,87494,77,324498
22307,0.000778,172.217.194.0-255,2902,90396,77,324498
22308,0.000783,172.31.40.0-255,66,90462,77,324498
22309,0.000795,172.217.194.0-255,1484,91946,77,324498
22310,0.00081,172.217.194.0-255,2902,94848,77,324498
22311,0.000812,172.31.40.0-255,66,94914,77,324498
22312,0.000819,172.217.194.0-255,5738,100652,77,324498
22313,0.000821,172.31.40.0-255,66,100718,77,324498
22314,0.000837,172.217.194.0-255,5738,106456,77,324498
22315,0.00084,172.31.40.0-255,66,106522,77,324498
22316,0.000863,172.217.194.0-255,5738,112260,77,324498
22317,0.000866,172.31.40.0-255,66,112326,77,324498
22318,0.000873,172.217.194.0-255,7856,120182,77,324498
22319,0.000875,172.31.40.0-255,66,120248,77,324498
22320,0.001221,172.217.194.0-255,1484,121732,77,324498
22321,0.001229,172.217.194.0-255,2902,124634,77,324498
22322,0.001235,172.31.40.0-255,66,124700,77,324498
22323,0.001242,172.217.194.0-255,5738,130438,77,324498
22324,0.001244,172.31.40.0-255,66,130504,77,324498
22325,0.001266,172.217.194.0-255,8574,139078,77,324498
22326,0.001269,172.31.40.0-255,66,139144,77,324498
22327,0.001287,172.217.194.0-255,4320,143464,77,324498
22328,0.00129,172.31.40.0-255,66,143530,77,324498
22329,0.00131,172.217.194.0-255,12496,156026,77,324498
22330,0.001312,172.31.40.0-255,66,156092,77,324498
22331,0.001315,172.217.194.0-255,1484,157576,77,324498
22332,0.001338,172.217.194.0-255,9992,167568,77,324498
22333,0.001341,172.31.40.0-255,66,167634,77,324498
22334,0.001365,172.217.194.0-255,2902,170536,77,324498
22335,0.001367,172.31.40.0-255,66,170602,77,324498
22336,0.001397,172.217.194.0-255,11410,182012,77,324498
22337,0.0014,172.31.40.0-255,66,182078,77,324498
22338,0.001422,172.217.194.0-255,5020,187098,77,324498
22339,0.001425,172.31.40.0-255,66,187164,77,324498
22340,0.001432,172.217.194.0-255,5738,192902,77,324498
22341,0.001435,172.31.40.0-255,66,192968,77,324498
22342,0.001442,172.217.194.0-255,7156,200124,77,324498
22343,0.001445,172.31.40.0-255,66,200190,77,324498
22344,0.001487,172.31.40.0-255,66,200256,77,324498
22345,0.001494,172.217.194.0-255,6438,206694,77,324498
22346,0.001497,172.31.40.0-255,66,206760,77,324498
22347,0.001572,172.31.40.0-255,66,206826,77,324498
22348,0.001581,172.217.194.0-255,10692,217518,77,324498
22349,0.001583,172.31.40.0-255,66,217584,77,324498
22350,0.001598,172.217.194.0-255,1484,219068,77,324498
22351,0.001616,172.217.194.0-255,2902,221970,77,324498
22352,0.001618,172.31.40.0-255,66,222036,77,324498
22353,0.001625,172.217.194.0-255,5738,227774,77,324498
22354,0.001627,172.31.40.0-255,66,227840,77,324498
22355,0.001637,172.217.194.0-255,1484,229324,77,324498
22356,0.001655,172.217.194.0-255,8574,237898,77,324498
22357,0.001658,172.31.40.0-255,66,237964,77,324498
22358,0.00168,172.217.194.0-255,2902,240866,77,324498
22359,0.001683,172.31.40.0-255,66,240932,77,324498
22360,0.001692,172.217.194.0-255,10692,251624,77,324498
22361,0.001694,172.31.40.0-255,66,251690,77,324498
22362,0.001965,172.217.194.0-255,1484,253174,77,324498
22363,0.001971,172.217.194.0-255,2902,256076,77,324498
22364,0.001975,172.31.40.0-255,66,256142,77,324498
22365,0.001978,172.217.194.0-255,1484,257626,77,324498
22366,0.001998,172.217.194.0-255,4320,261946,77,324498
22367,0.002,172.31.40.0-255,66,262012,77,324498
22368,0.002005,172.217.194.0-255,4320,266332,77,324498
22369,0.002007,172.31.40.0-255,66,266398,77,324498
22370,0.002033,172.217.194.0-255,8574,274972,77,324498
22371,0.002035,172.31.40.0-255,66,275038,77,324498
22372,0.002041,172.217.194.0-255,5738,280776,77,324498
22373,0.002042,172.31.40.0-255,66,280842,77,324498
22374,0.002068,172.217.194.0-255,5020,285862,77,324498
22375,0.00207,172.31.40.0-255,66,285928,77,324498
22376,0.002073,172.217.194.0-255,1484,287412,77,324498
22377,0.002098,172.217.194.0-255,11410,298822,77,324498
22378,0.0021,172.31.40.0-255,66,298888,77,324498
22379,0.002121,172.217.194.0-255,12828,311716,77,324498
22380,0.002123,172.31.40.0-255,66,311782,77,324498
22381,0.00213,172.217.194.0-255,7856,319638,77,324498
22382,0.002132,172.31.40.0-255,66,319704,77,324498
22383,0.002137,172.217.194.0-255,4320,324024,77,324498
22384,0.00214,172.31.40.0-255,66,324090,77,324498
22385,0.002178,172.31.40.0-255,66,324156,77,324498
22386,0.002181,172.217.194.0-255,105,324261,77,324498
22387,0.006923,172.31.40.0-255,66,324327,77,324498
22388,0.006957,172.31.40.0-255,105,324432,77,324498
22389,0.009218,172.217.194.0-255,66,324498,77,324498
22390,0.0,172.217.194.0-255,150,150,77,347426
22391,1.6e-05,172.31.40.0-255,66,216,77,347426
22392,3.6e-05,172.217.194.0-255,1484,1700,77,347426
22393,4.2e-05,172.31.40.0-255,66,1766,77,347426
22394,4.8e-05,172.217.194.0-255,2902,4668,77,347426
22395,5.2e-05,172.31.40.0-255,66,4734,77,347426
22396,6.1e-05,172.217.194.0-255,7156,11890,77,347426
22397,6.4e-05,172.31.40.0-255,66,11956,77,347426
22398,0.000107,172.217.194.0-255,2030,13986,77,347426
22399,0.00011,172.31.40.0-255,66,14052,77,347426
22400,0.000148,172.217.194.0-255,2902,16954,77,347426
22401,0.000151,172.31.40.0-255,66,17020,77,347426
22402,0.000158,172.217.194.0-255,7156,24176,77,347426
22403,0.00016,172.31.40.0-255,66,24242,77,347426
22404,0.000174,172.217.194.0-255,1484,25726,77,347426
22405,0.000177,172.31.40.0-255,66,25792,77,347426
22406,0.000204,172.217.194.0-255,2902,28694,77,347426
22407,0.000207,172.31.40.0-255,66,28760,77,347426
22408,0.000248,172.217.194.0-255,2543,31303,77,347426
22409,0.000251,172.31.40.0-255,66,31369,77,347426
22410,0.000312,172.217.194.0-255,1484,32853,77,347426
22411,0.000315,172.31.40.0-255,66,32919,77,347426
22412,0.000321,172.217.194.0-255,2902,35821,77,347426
22413,0.000323,172.31.40.0-255,66,35887,77,347426
22414,0.000358,172.217.194.0-255,5738,41625,77,347426
22415,0.000361,172.31.40.0-255,66,41691,77,347426
22416,0.000367,172.217.194.0-255,4320,46011,77,347426
22417,0.000369,172.31.40.0-255,66,46077,77,347426
22418,0.000429,172.217.194.0-255,2543,48620,77,347426
22419,0.000432,172.31.40.0-255,66,48686,77,347426
22420,0.001099,172.217.194.0-255,1484,50170,77,347426
22421,0.001106,172.31.40.0-255,66,50236,77,347426
22422,0.001114,172.217.194.0-255,2902,53138,77,347426
22423,0.001116,172.31.40.0-255,66,53204,77,347426
22424,0.001122,172.217.194.0-255,2902,56106,77,347426
22425,0.001124,172.31.40.0-255,66,56172,77,347426
22426,0.001149,172.217.194.0-255,2902,59074,77,347426
22427,0.001152,172.31.40.0-255,66,59140,77,347426
22428,0.001156,172.217.194.0-255,1484,60624,77,347426
22429,0.00118,172.217.194.0-255,8215,68839,77,347426
22430,0.001182,172.31.40.0-255,66,68905,77,347426
22431,0.001186,172.217.194.0-255,1484,70389,77,347426
22432,0.001212,172.217.194.0-255,8574,78963,77,347426
22433,0.001215,172.31.40.0-255,66,79029,77,347426
22434,0.001221,172.217.194.0-255,3961,82990,77,347426
22435,0.001223,172.31.40.0-255,66,83056,77,347426
22436,0.001362,172.217.194.0-255,1484,84540,77,347426
22437,0.00137,172.217.194.0-255,2902,87442,77,347426
22438,0.001374,172.31.40.0-255,66,87508,77,347426
22439,0.001381,172.217.194.0-255,5738,93246,77,347426
22440,0.001383,172.31.40.0-255,66,93312,77,347426
22441,0.001407,172.217.194.0-255,1484,94796,77,347426
22442,0.001432,172.217.194.0-255,11410,106206,77,347426
22443,0.001436,172.31.40.0-255,66,106272,77,347426
22444,0.001442,172.217.194.0-255,5738,112010,77,347426
22445,0.001444,172.31.40.0-255,66,112076,77,347426
22446,0.001468,172.217.194.0-255,1484,113560,77,347426
22447,0.001483,172.217.194.0-255,2902,116462,77,347426
22448,0.001485,172.31.40.0-255,66,116528,77,347426
22449,0.001495,172.217.194.0-255,752,117280,77,347426
22450,0.001613,172.217.194.0-255,1484,118764,77,347426
22451,0.001617,172.31.40.0-255,66,118830,77,347426
22452,0.001623,172.217.194.0-255,2902,121732,77,347426
22453,0.001626,172.31.40.0-255,66,121798,77,347426
22454,0.001658,172.217.194.0-255,5738,127536,77,347426
22455,0.001661,172.31.40.0-255,66,127602,77,347426
22456,0.001665,172.217.194.0-255,1484,129086,77,347426
22457,0.00169,172.217.194.0-255,11410,140496,77,347426
22458,0.001693,172.31.40.0-255,66,140562,77,347426
22459,0.001762,172.217.194.0-255,7156,147718,77,347426
22460,0.001765,172.31.40.0-255,66,147784,77,347426
22461,0.001787,172.217.194.0-255,3602,151386,77,347426
22462,0.00179,172.31.40.0-255,66,151452,77,347426
22463,0.001824,172.217.194.0-255,1484,152936,77,347426
22464,0.001842,172.217.194.0-255,2902,155838,77,347426
22465,0.001845,172.31.40.0-255,66,155904,77,347426
22466,0.001849,172.217.194.0-255,1484,157388,77,347426
22467,0.001866,172.217.194.0-255,4320,161708,77,347426
22468,0.001869,172.31.40.0-255,66,161774,77,347426
22469,0.001876,172.217.194.0-255,4320,166094,77,347426
22470,0.001879,172.31.40.0-255,66,166160,77,347426
22471,0.001899,172.217.194.0-255,1484,167644,77,347426
22472,0.001928,172.217.194.0-255,9992,177636,77,347426
22473,0.001931,172.31.40.0-255,66,177702,77,347426
22474,0.001938,172.217.194.0-255,5738,183440,77,347426
22475,0.00194,172.31.40.0-255,66,183506,77,347426
22476,0.001953,172.217.194.0-255,2184,185690,77,347426
22477,0.001955,172.31.40.0-255,66,185756,77,347426
22478,0.002018,172.217.194.0-255,1484,187240,77,347426
22479,0.00211,172.217.194.0-255,2902,190142,77,347426
22480,0.002112,172.31.40.0-255,66,190208,77,347426
22481,0.002117,172.217.194.0-255,2902,193110,77,347426
22482,0.002119,172.31.40.0-255,66,193176,77,347426
22483,0.002135,172.217.194.0-255,2902,196078,77,347426
22484,0.002137,172.31.40.0-255,66,196144,77,347426
22485,0.002145,172.217.194.0-255,7156,203300,77,347426
22486,0.002147,172.31.40.0-255,66,203366,77,347426
22487,0.002155,172.217.194.0-255,8574,211940,77,347426
22488,0.002157,172.31.40.0-255,66,212006,77,347426
22489,0.002174,172.217.194.0-255,5738,217744,77,347426
22490,0.002177,172.31.40.0-255,66,217810,77,347426
22491,0.002188,172.217.194.0-255,1484,219294,77,347426
22492,0.002191,172.217.194.0-255,766,220060,77,347426
22493,0.002193,172.31.40.0-255,66,220126,77,347426
22494,0.002421,172.217.194.0-255,1484,221610,77,347426
22495,0.002434,172.217.194.0-255,2902,224512,77,347426
22496,0.002437,172.31.40.0-255,66,224578,77,347426
22497,0.002458,172.217.194.0-255,5738,230316,77,347426
22498,0.002461,172.31.40.0-255,66,230382,77,347426
22499,0.002483,172.217.194.0-255,2902,233284,77,347426
22500,0.002485,172.31.40.0-255,66,233350,77,347426
22501,0.002511,172.217.194.0-255,9992,243342,77,347426
22502,0.002514,172.31.40.0-255,66,243408,77,347426
22503,0.002534,172.217.194.0-255,4320,247728,77,347426
22504,0.002536,172.31.40.0-255,66,247794,77,347426
22505,0.002563,172.217.194.0-255,9274,257068,77,347426
22506,0.002566,172.31.40.0-255,66,257134,77,347426
22507,0.002572,172.217.194.0-255,5738,262872,77,347426
22508,0.002575,172.31.40.0-255,66,262938,77,347426
22509,0.002609,172.217.194.0-255,8574,271512,77,347426
22510,0.002611,172.31.40.0-255,66,271578,77,347426
22511,0.00262,172.217.194.0-255,9992,281570,77,347426
22512,0.002622,172.31.40.0-255,66,281636,77,347426
22513,0.002646,172.217.194.0-255,1484,283120,77,347426
22514,0.002668,172.217.194.0-255,12828,295948,77,347426
22515,0.00267,172.31.40.0-255,66,296014,77,347426
22516,0.002695,172.217.194.0-255,2184,298198,77,347426
22517,0.002697,172.31.40.0-255,66,298264,77,347426
22518,0.002714,172.31.40.0-255,66,298330,77,347426
22519,0.00272,172.217.194.0-255,6438,304768,77,347426
22520,0.002723,172.31.40.0-255,66,304834,77,347426
22521,0.002743,172.217.194.0-255,4320,309154,77,347426
22522,0.002745,172.31.40.0-255,66,309220,77,347426
22523,0.002806,172.31.40.0-255,66,309286,77,347426
22524,0.002824,172.217.194.0-255,5738,315024,77,347426
22525,0.002827,172.31.40.0-255,66,315090,77,347426
22526,0.002835,172.217.194.0-255,7856,322946,77,347426
22527,0.002837,172.31.40.0-255,66,323012,77,347426
22528,0.002866,172.31.40.0-255,66,323078,77,347426
22529,0.002876,172.217.194.0-255,11410,334488,77,347426
22530,0.002878,172.31.40.0-255,66,334554,77,347426
22531,0.002911,172.217.194.0-255,12464,347018,77,347426
22532,0.002914,172.31.40.0-255,66,347084,77,347426
22533,0.002918,172.217.194.0-255,105,347189,77,347426
22534,0.012313,172.31.40.0-255,66,347255,77,347426
22535,0.012361,172.31.40.0-255,105,347360,77,347426
22536,0.014344,172.217.194.0-255,66,347426,77,347426
22537,0.0,172.217.194.0-255,150,150,77,162781
22538,1.7e-05,172.31.40.0-255,66,216,77,162781
22539,3.3e-05,172.217.194.0-255,1484,1700,77,162781
22540,3.8e-05,172.31.40.0-255,66,1766,77,162781
22541,4.3e-05,172.217.194.0-255,2902,4668,77,162781
22542,4.6e-05,172.31.40.0-255,66,4734,77,162781
22543,7e-05,172.217.194.0-255,7156,11890,77,162781
22544,7.3e-05,172.31.40.0-255,66,11956,77,162781
22545,7.7e-05,172.217.194.0-255,2024,13980,77,162781
22546,7.9e-05,172.31.40.0-255,66,14046,77,162781
22547,0.000301,172.217.194.0-255,1484,15530,77,162781
22548,0.000305,172.31.40.0-255,66,15596,77,162781
22549,0.000311,172.217.194.0-255,2902,18498,77,162781
22550,0.000313,172.31.40.0-255,66,18564,77,162781
22551,0.000317,172.217.194.0-255,2902,21466,77,162781
22552,0.00032,172.31.40.0-255,66,21532,77,162781
22553,0.000351,172.217.194.0-255,2902,24434,77,162781
22554,0.000353,172.31.40.0-255,66,24500,77,162781
22555,0.000359,172.217.194.0-255,5738,30238,77,162781
22556,0.000361,172.31.40.0-255,66,30304,77,162781
22557,0.000376,172.217.194.0-255,1125,31429,77,162781
22558,0.000378,172.31.40.0-255,66,31495,77,162781
22559,0.000494,172.217.194.0-255,1484,32979,77,162781
22560,0.000498,172.31.40.0-255,66,33045,77,162781
22561,0.000501,172.217.194.0-255,2902,35947,77,162781
22562,0.000503,172.31.40.0-255,66,36013,77,162781
22563,0.000529,172.217.194.0-255,1484,37497,77,162781
22564,0.000531,172.31.40.0-255,66,37563,77,162781
22565,0.000548,172.217.194.0-255,4320,41883,77,162781
22566,0.00055,172.31.40.0-255,66,41949,77,162781
22567,0.000553,172.217.194.0-255,1484,43433,77,162781
22568,0.000554,172.31.40.0-255,66,43499,77,162781
22569,0.000601,172.217.194.0-255,5379,48878,77,162781
22570,0.000604,172.31.40.0-255,66,48944,77,162781
22571,0.002205,172.217.194.0-255,1484,50428,77,162781
22572,0.002213,172.217.194.0-255,2902,53330,77,162781
22573,0.002217,172.31.40.0-255,66,53396,77,162781
22574,0.002223,172.217.194.0-255,4320,57716,77,162781
22575,0.002225,172.31.40.0-255,66,57782,77,162781
22576,0.002247,172.217.194.0-255,4320,62102,77,162781
22577,0.00225,172.31.40.0-255,66,62168,77,162781
22578,0.002273,172.217.194.0-255,5379,67547,77,162781
22579,0.002275,172.31.40.0-255,66,67613,77,162781
22580,0.002282,172.217.194.0-255,7156,74769,77,162781
22581,0.002284,172.31.40.0-255,66,74835,77,162781
22582,0.00232,172.31.40.0-255,66,74901,77,162781
22583,0.002343,172.217.194.0-255,4320,79221,77,162781
22584,0.002345,172.31.40.0-255,66,79287,77,162781
22585,0.002353,172.217.194.0-255,6438,85725,77,162781
22586,0.002355,172.31.40.0-255,66,85791,77,162781
22587,0.002358,172.217.194.0-255,645,86436,77,162781
22588,0.002438,172.217.194.0-255,1484,87920,77,162781
22589,0.00244,172.31.40.0-255,66,87986,77,162781
22590,0.002445,172.217.194.0-255,2902,90888,77,162781
22591,0.002448,172.31.40.0-255,66,90954,77,162781
22592,0.002451,172.217.194.0-255,1484,92438,77,162781
22593,0.002468,172.217.194.0-255,4320,96758,77,162781
22594,0.00247,172.31.40.0-255,66,96824,77,162781
22595,0.002476,172.217.194.0-255,5738,102562,77,162781
22596,0.002479,172.31.40.0-255,66,102628,77,162781
22597,0.002509,172.217.194.0-255,563,103191,77,162781
22598,0.002547,172.217.194.0-255,1484,104675,77,162781
22599,0.00255,172.31.40.0-255,66,104741,77,162781
22600,0.002556,172.217.194.0-255,4320,109061,77,162781
22601,0.002558,172.31.40.0-255,66,109127,77,162781
22602,0.002566,172.217.194.0-255,7156,116283,77,162781
22603,0.002569,172.31.40.0-255,66,116349,77,162781
22604,0.002599,172.217.194.0-255,2902,119251,77,162781
22605,0.002601,172.31.40.0-255,66,119317,77,162781
22606,0.00261,172.217.194.0-255,8574,127891,77,162781
22607,0.002612,172.31.40.0-255,66,127957,77,162781
22608,0.005177,172.217.194.0-255,5738,133695,77,162781
22609,0.005183,172.31.40.0-255,66,133761,77,162781
22610,0.007731,172.217.194.0-255,5738,139499,77,162781
22611,0.007736,172.31.40.0-255,66,139565,77,162781
22612,0.0103,172.217.194.0-255,5738,145303,77,162781
22613,0.010307,172.31.40.0-255,66,145369,77,162781
22614,0.012894,172.217.194.0-255,5738,151107,77,162781
22615,0.012905,172.31.40.0-255,66,151173,77,162781
22616,0.015496,172.217.194.0-255,5738,156911,77,162781
22617,0.015505,172.31.40.0-255,66,156977,77,162781
22618,0.018076,172.217.194.0-255,5738,162715,77,162781
22619,0.018083,172.31.40.0-255,66,162781,77,162781
22620,0.0,74.125.130.0-255,152,152,77,216522
22621,2.3e-05,172.31.40.0-255,66,218,77,216522
22622,3e-05,74.125.130.0-255,1484,1702,77,216522
22623,3.5e-05,172.31.40.0-255,66,1768,77,216522
22624,3.8e-05,74.125.130.0-255,1484,3252,77,216522
22625,4.2e-05,172.31.40.0-255,66,3318,77,216522
22626,4.8e-05,74.125.130.0-255,2902,6220,77,216522
22627,5.1e-05,172.31.40.0-255,66,6286,77,216522
22628,6.9e-05,74.125.130.0-255,1484,7770,77,216522
22629,7.2e-05,172.31.40.0-255,66,7836,77,216522
22630,0.000101,74.125.130.0-255,4320,12156,77,216522
22631,0.000104,172.31.40.0-255,66,12222,77,216522
22632,0.000107,74.125.130.0-255,1484,13706,77,216522
22633,0.000109,172.31.40.0-255,66,13772,77,216522
22634,0.000123,74.125.130.0-255,581,14353,77,216522
22635,0.000126,172.31.40.0-255,66,14419,77,216522
22636,0.00029,74.125.130.0-255,1484,15903,77,216522
22637,0.000295,172.31.40.0-255,66,15969,77,216522
22638,0.000301,74.125.130.0-255,2902,18871,77,216522
22639,0.000304,172.31.40.0-255,66,18937,77,216522
22640,0.000325,74.125.130.0-255,5738,24675,77,216522
22641,0.000328,172.31.40.0-255,66,24741,77,216522
22642,0.000348,74.125.130.0-255,4320,29061,77,216522
22643,0.000351,172.31.40.0-255,66,29127,77,216522
22644,0.000375,74.125.130.0-255,5379,34506,77,216522
22645,0.000378,172.31.40.0-255,66,34572,77,216522
22646,0.000398,74.125.130.0-255,2902,37474,77,216522
22647,0.0004,172.31.40.0-255,66,37540,77,216522
22648,0.000428,74.125.130.0-255,4320,41860,77,216522
22649,0.000431,172.31.40.0-255,66,41926,77,216522
22650,0.000439,74.125.130.0-255,8574,50500,77,216522
22651,0.000442,172.31.40.0-255,66,50566,77,216522
22652,0.000448,74.125.130.0-255,5738,56304,77,216522
22653,0.00045,172.31.40.0-255,66,56370,77,216522
22654,0.000471,74.125.130.0-255,4320,60690,77,216522
22655,0.000474,172.31.40.0-255,66,60756,77,216522
22656,0.0005,74.125.130.0-255,5630,66386,77,216522
22657,0.000508,172.31.40.0-255,66,66452,77,216522
22658,0.000581,74.125.130.0-255,1484,67936,77,216522
22659,0.000602,74.125.130.0-255,2902,70838,77,216522
22660,0.000605,172.31.40.0-255,66,70904,77,216522
22661,0.000653,74.125.130.0-255,5738,76642,77,216522
22662,0.000656,172.31.40.0-255,66,76708,77,216522
22663,0.000662,74.125.130.0-255,5738,82446,77,216522
22664,0.000664,172.31.40.0-255,66,82512,77,216522
22665,0.00067,74.125.130.0-255,7156,89668,77,216522
22666,0.000672,172.31.40.0-255,66,89734,77,216522
22667,0.000701,74.125.130.0-255,2902,92636,77,216522
22668,0.000704,172.31.40.0-255,66,92702,77,216522
22669,0.000731,74.125.130.0-255,7856,100558,77,216522
22670,0.000734,172.31.40.0-255,66,100624,77,216522
22671,0.000807,74.125.130.0-255,1484,102108,77,216522
22672,0.000827,74.125.130.0-255,2902,105010,77,216522
22673,0.00083,172.31.40.0-255,66,105076,77,216522
22674,0.000841,74.125.130.0-255,1484,106560,77,216522
22675,0.000854,74.125.130.0-255,2902,109462,77,216522
22676,0.000863,172.31.40.0-255,66,109528,77,216522
22677,0.000882,74.125.130.0-255,1484,111012,77,216522
22678,0.000904,74.125.130.0-255,4320,115332,77,216522
22679,0.000906,172.31.40.0-255,66,115398,77,216522
22680,0.000911,74.125.130.0-255,2902,118300,77,216522
22681,0.000912,172.31.40.0-255,66,118366,77,216522
22682,0.000931,74.125.130.0-255,4320,122686,77,216522
22683,0.000933,172.31.40.0-255,66,122752,77,216522
22684,0.00096,74.125.130.0-255,4320,127072,77,216522
22685,0.000962,172.31.40.0-255,66,127138,77,216522
22686,0.000966,74.125.130.0-255,2902,130040,77,216522
22687,0.000968,172.31.40.0-255,66,130106,77,216522
22688,0.000983,74.125.130.0-255,2902,133008,77,216522
22689,0.000986,172.31.40.0-255,66,133074,77,216522
22690,0.000993,74.125.130.0-255,2184,135258,77,216522
22691,0.000995,172.31.40.0-255,66,135324,77,216522
22692,0.00151,74.125.130.0-255,1484,136808,77,216522
22693,0.00153,74.125.130.0-255,2902,139710,77,216522
22694,0.001534,172.31.40.0-255,66,139776,77,216522
22695,0.001539,74.125.130.0-255,2902,142678,77,216522
22696,0.001541,172.31.40.0-255,66,142744,77,216522
22697,0.001557,74.125.130.0-255,2902,145646,77,216522
22698,0.001559,172.31.40.0-255,66,145712,77,216522
22699,0.001561,74.125.130.0-255,1484,147196,77,216522
22700,0.001564,74.125.130.0-255,1484,148680,77,216522
22701,0.001566,172.31.40.0-255,66,148746,77,216522
22702,0.001584,74.125.130.0-255,1484,150230,77,216522
22703,0.001617,74.125.130.0-255,4320,154550,77,216522
22704,0.00162,172.31.40.0-255,66,154616,77,216522
22705,0.001635,74.125.130.0-255,4320,158936,77,216522
22706,0.001637,172.31.40.0-255,66,159002,77,216522
22707,0.001647,74.125.130.0-255,1484,160486,77,216522
22708,0.001662,74.125.130.0-255,4320,164806,77,216522
22709,0.001663,172.31.40.0-255,66,164872,77,216522
22710,0.001697,74.125.130.0-255,5020,169892,77,216522
22711,0.0017,172.31.40.0-255,66,169958,77,216522
22712,0.003726,74.125.130.0-255,5738,175696,77,216522
22713,0.003734,172.31.40.0-255,66,175762,77,216522
22714,0.005752,74.125.130.0-255,5738,181500,77,216522
22715,0.005756,172.31.40.0-255,66,181566,77,216522
22716,0.007789,74.125.130.0-255,5738,187304,77,216522
22717,0.007794,172.31.40.0-255,66,187370,77,216522
22718,0.009814,74.125.130.0-255,5738,193108,77,216522
22719,0.009821,172.31.40.0-255,66,193174,77,216522
22720,0.011859,74.125.130.0-255,5738,198912,77,216522
22721,0.01187,172.31.40.0-255,66,198978,77,216522
22722,0.013906,74.125.130.0-255,2902,201880,77,216522
22723,0.013914,172.31.40.0-255,66,201946,77,216522
22724,0.013937,74.125.130.0-255,2902,204848,77,216522
22725,0.01394,172.31.40.0-255,66,204914,77,216522
22726,0.015953,74.125.130.0-255,5738,210652,77,216522
22727,0.015962,172.31.40.0-255,66,210718,77,216522
22728,0.017987,74.125.130.0-255,5738,216456,77,216522
22729,0.017996,172.31.40.0-255,66,216522,77,216522
22730,0.0,172.217.194.0-255,297,297,77,181271
22731,2.2e-05,172.31.40.0-255,66,363,77,181271
22732,2.9e-05,172.217.194.0-255,1484,1847,77,181271
22733,3.3e-05,172.31.40.0-255,66,1913,77,181271
22734,3.9e-05,172.217.194.0-255,4320,6233,77,181271
22735,4.3e-05,172.31.40.0-255,66,6299,77,181271
22736,5.2e-05,172.217.194.0-255,7502,13801,77,181271
22737,5.6e-05,172.31.40.0-255,66,13867,77,181271
22738,0.000115,172.217.194.0-255,1484,15351,77,181271
22739,0.000118,172.31.40.0-255,66,15417,77,181271
22740,0.000124,172.217.194.0-255,2902,18319,77,181271
22741,0.000126,172.31.40.0-255,66,18385,77,181271
22742,0.000145,172.217.194.0-255,5738,24123,77,181271
22743,0.000147,172.31.40.0-255,66,24189,77,181271
22744,0.000155,172.217.194.0-255,6797,30986,77,181271
22745,0.000158,172.31.40.0-255,66,31052,77,181271
22746,0.000228,172.217.194.0-255,1484,32536,77,181271
22747,0.000231,172.31.40.0-255,66,32602,77,181271
22748,0.000236,172.217.194.0-255,2902,35504,77,181271
22749,0.000238,172.31.40.0-255,66,35570,77,181271
22750,0.000243,172.217.194.0-255,2902,38472,77,181271
22751,0.000245,172.31.40.0-255,66,38538,77,181271
22752,0.000272,172.217.194.0-255,2902,41440,77,181271
22753,0.000275,172.31.40.0-255,66,41506,77,181271
22754,0.000282,172.217.194.0-255,6797,48303,77,181271
22755,0.000284,172.31.40.0-255,66,48369,77,181271
22756,0.000308,172.217.194.0-255,5738,54107,77,181271
22757,0.000311,172.31.40.0-255,66,54173,77,181271
22758,0.00033,172.217.194.0-255,1484,55657,77,181271
22759,0.000332,172.31.40.0-255,66,55723,77,181271
22760,0.000341,172.217.194.0-255,8574,64297,77,181271
22761,0.000343,172.31.40.0-255,66,64363,77,181271
22762,0.000367,172.217.194.0-255,1767,66130,77,181271
22763,0.000369,172.31.40.0-255,66,66196,77,181271
22764,0.000529,172.217.194.0-255,1484,67680,77,181271
22765,0.000546,172.217.194.0-255,2902,70582,77,181271
22766,0.00055,172.31.40.0-255,66,70648,77,181271
22767,0.000555,172.217.194.0-255,2902,73550,77,181271
22768,0.000557,172.31.40.0-255,66,73616,77,181271
22769,0.000579,172.217.194.0-255,2902,76518,77,181271
22770,0.000584,172.217.194.0-255,4320,80838,77,181271
22771,0.000589,172.217.194.0-255,4320,85158,77,181271
22772,0.000594,172.31.40.0-255,66,85224,77,181271
22773,0.000597,172.31.40.0-255,66,85290,77,181271
22774,0.000599,172.31.40.0-255,66,85356,77,181271
22775,0.000626,172.217.194.0-255,7156,92512,77,181271
22776,0.000629,172.31.40.0-255,66,92578,77,181271
22777,0.000637,172.217.194.0-255,7856,100434,77,181271
22778,0.00064,172.31.40.0-255,66,100500,77,181271
22779,0.001384,172.217.194.0-255,1484,101984,77,181271
22780,0.001391,172.217.194.0-255,2902,104886,77,181271
22781,0.001395,172.31.40.0-255,66,104952,77,181271
22782,0.00141,172.217.194.0-255,2902,107854,77,181271
22783,0.001414,172.31.40.0-255,66,107920,77,181271
22784,0.001441,172.217.194.0-255,2902,110822,77,181271
22785,0.001445,172.31.40.0-255,66,110888,77,181271
22786,0.001456,172.217.194.0-255,12828,123716,77,181271
22787,0.001458,172.31.40.0-255,66,123782,77,181271
22788,0.001464,172.217.194.0-255,4320,128102,77,181271
22789,0.001465,172.31.40.0-255,66,128168,77,181271
22790,0.001491,172.217.194.0-255,6438,134606,77,181271
22791,0.001493,172.31.40.0-255,66,134672,77,181271
22792,0.00173,172.31.40.0-255,101,134773,77,181271
22793,0.003789,172.217.194.0-255,5738,140511,77,181271
22794,0.003797,172.31.40.0-255,66,140577,77,181271
22795,0.003956,172.217.194.0-255,66,140643,77,181271
22796,0.006068,172.217.194.0-255,5738,146381,77,181271
22797,0.006075,172.31.40.0-255,66,146447,77,181271
22798,0.00836,172.217.194.0-255,5738,152185,77,181271
22799,0.008367,172.31.40.0-255,66,152251,77,181271
22800,0.010634,172.217.194.0-255,5738,157989,77,181271
22801,0.01064,172.31.40.0-255,66,158055,77,181271
22802,0.012895,172.217.194.0-255,5738,163793,77,181271
22803,0.012903,172.31.40.0-255,66,163859,77,181271
22804,0.015213,172.217.194.0-255,5738,169597,77,181271
22805,0.015222,172.31.40.0-255,66,169663,77,181271
22806,0.017521,172.217.194.0-255,5738,175401,77,181271
22807,0.017532,172.31.40.0-255,66,175467,77,181271
22808,0.019792,172.217.194.0-255,5738,181205,77,181271
22809,0.019801,172.31.40.0-255,66,181271,77,181271
22810,0.0,74.125.24.0-255,154,154,77,209282
22811,2.3e-05,172.31.40.0-255,66,220,77,209282
22812,3e-05,74.125.24.0-255,1484,1704,77,209282
22813,3.5e-05,172.31.40.0-255,66,1770,77,209282
22814,4.1e-05,74.125.24.0-255,2902,4672,77,209282
22815,4.4e-05,172.31.40.0-255,66,4738,77,209282
22816,5.9e-05,74.125.24.0-255,7156,11894,77,209282
22817,6.2e-05,172.31.40.0-255,66,11960,77,209282
22818,6.6e-05,74.125.24.0-255,1982,13942,77,209282
22819,6.9e-05,172.31.40.0-255,66,14008,77,209282
22820,7.5e-05,74.125.24.0-255,4320,18328,77,209282
22821,7.9e-05,172.31.40.0-255,66,18394,77,209282
22822,0.0001,74.125.24.0-255,7156,25550,77,209282
22823,0.000103,172.31.40.0-255,66,25616,77,209282
22824,0.000114,74.125.24.0-255,5379,30995,77,209282
22825,0.000116,172.31.40.0-255,66,31061,77,209282
22826,0.000251,74.125.24.0-255,1484,32545,77,209282
22827,0.000256,172.31.40.0-255,66,32611,77,209282
22828,0.000293,74.125.24.0-255,2902,35513,77,209282
22829,0.000296,172.31.40.0-255,66,35579,77,209282
22830,0.000303,74.125.24.0-255,5738,41317,77,209282
22831,0.000306,172.31.40.0-255,66,41383,77,209282
22832,0.000318,74.125.24.0-255,7156,48539,77,209282
22833,0.00032,172.31.40.0-255,66,48605,77,209282
22834,0.000345,74.125.24.0-255,4320,52925,77,209282
22835,0.000347,172.31.40.0-255,66,52991,77,209282
22836,0.000362,74.125.24.0-255,9992,62983,77,209282
22837,0.000364,172.31.40.0-255,66,63049,77,209282
22838,0.000376,74.125.24.0-255,2184,65233,77,209282
22839,0.000378,172.31.40.0-255,66,65299,77,209282
22840,0.000473,74.125.24.0-255,401,65700,77,209282
22841,0.000477,172.31.40.0-255,66,65766,77,209282
22842,0.000523,74.125.24.0-255,108,65874,77,209282
22843,0.000606,74.125.24.0-255,1484,67358,77,209282
22844,0.000611,172.31.40.0-255,66,67424,77,209282
22845,0.000617,74.125.24.0-255,2902,70326,77,209282
22846,0.000619,172.31.40.0-255,66,70392,77,209282
22847,0.00063,74.125.24.0-255,4320,74712,77,209282
22848,0.000633,172.31.40.0-255,66,74778,77,209282
22849,0.000643,74.125.24.0-255,11410,86188,77,209282
22850,0.000646,172.31.40.0-255,66,86254,77,209282
22851,0.000685,74.125.24.0-255,13792,100046,77,209282
22852,0.000688,172.31.40.0-255,66,100112,77,209282
22853,0.001657,74.125.24.0-255,1484,101596,77,209282
22854,0.001667,74.125.24.0-255,2902,104498,77,209282
22855,0.001671,172.31.40.0-255,66,104564,77,209282
22856,0.001676,74.125.24.0-255,1484,106048,77,209282
22857,0.001706,74.125.24.0-255,4320,110368,77,209282
22858,0.001709,172.31.40.0-255,66,110434,77,209282
22859,0.001715,74.125.24.0-255,4320,114754,77,209282
22860,0.001717,172.31.40.0-255,66,114820,77,209282
22861,0.001752,74.125.24.0-255,8574,123394,77,209282
22862,0.001755,172.31.40.0-255,66,123460,77,209282
22863,0.001762,74.125.24.0-255,5738,129198,77,209282
22864,0.001764,172.31.40.0-255,66,129264,77,209282
22865,0.001792,74.125.24.0-255,5020,134284,77,209282
22866,0.001794,172.31.40.0-255,66,134350,77,209282
22867,0.002071,74.125.24.0-255,1484,135834,77,209282
22868,0.002079,74.125.24.0-255,2902,138736,77,209282
22869,0.002083,172.31.40.0-255,66,138802,77,209282
22870,0.002115,74.125.24.0-255,5738,144540,77,209282
22871,0.002118,172.31.40.0-255,66,144606,77,209282
22872,0.002122,74.125.24.0-255,1484,146090,77,209282
22873,0.002127,74.125.24.0-255,4320,150410,77,209282
22874,0.00213,172.31.40.0-255,66,150476,77,209282
22875,0.002159,74.125.24.0-255,4320,154796,77,209282
22876,0.002162,172.31.40.0-255,66,154862,77,209282
22877,0.002172,74.125.24.0-255,9992,164854,77,209282
22878,0.002178,172.31.40.0-255,66,164920,77,209282
22879,0.002205,74.125.24.0-255,3602,168522,77,209282
22880,0.002207,172.31.40.0-255,66,168588,77,209282
22881,0.004449,74.125.24.0-255,1484,170072,77,209282
22882,0.004471,74.125.24.0-255,4320,174392,77,209282
22883,0.004475,172.31.40.0-255,66,174458,77,209282
22884,0.006743,74.125.24.0-255,5738,180196,77,209282
22885,0.006749,172.31.40.0-255,66,180262,77,209282
22886,0.009022,74.125.24.0-255,5738,186000,77,209282
22887,0.009029,172.31.40.0-255,66,186066,77,209282
22888,0.011334,74.125.24.0-255,5738,191804,77,209282
22889,0.011342,172.31.40.0-255,66,191870,77,209282
22890,0.013598,74.125.24.0-255,5738,197608,77,209282
22891,0.013605,172.31.40.0-255,66,197674,77,209282
22892,0.015883,74.125.24.0-255,5738,203412,77,209282
22893,0.015889,172.31.40.0-255,66,203478,77,209282
22894,0.018133,74.125.24.0-255,5738,209216,77,209282
22895,0.01814,172.31.40.0-255,66,209282,77,209282
22896,0.0,74.125.130.0-255,153,153,77,211015
22897,1.8e-05,172.31.40.0-255,66,219,77,211015
22898,2.6e-05,74.125.130.0-255,1484,1703,77,211015
22899,3.2e-05,172.31.40.0-255,66,1769,77,211015
22900,4.6e-05,74.125.130.0-255,2902,4671,77,211015
22901,5e-05,172.31.40.0-255,66,4737,77,211015
22902,5.3e-05,74.125.130.0-255,1484,6221,77,211015
22903,5.6e-05,172.31.40.0-255,66,6287,77,211015
22904,6.2e-05,74.125.130.0-255,2902,9189,77,211015
22905,6.5e-05,172.31.40.0-255,66,9255,77,211015
22906,0.000101,74.125.130.0-255,4974,14229,77,211015
22907,0.000105,172.31.40.0-255,66,14295,77,211015
22908,0.000128,74.125.130.0-255,1484,15779,77,211015
22909,0.00013,172.31.40.0-255,66,15845,77,211015
22910,0.000158,74.125.130.0-255,4320,20165,77,211015
22911,0.000161,172.31.40.0-255,66,20231,77,211015
22912,0.000164,74.125.130.0-255,1484,21715,77,211015
22913,0.000166,172.31.40.0-255,66,21781,77,211015
22914,0.000182,74.125.130.0-255,4320,26101,77,211015
22915,0.000189,172.31.40.0-255,66,26167,77,211015
22916,0.000214,74.125.130.0-255,4320,30487,77,211015
22917,0.000221,172.31.40.0-255,66,30553,77,211015
22918,0.000224,74.125.130.0-255,1125,31678,77,211015
22919,0.000227,172.31.40.0-255,66,31744,77,211015
22920,0.000313,74.125.130.0-255,1484,33228,77,211015
22921,0.000316,172.31.40.0-255,66,33294,77,211015
22922,0.000344,74.125.130.0-255,2902,36196,77,211015
22923,0.000346,172.31.40.0-255,66,36262,77,211015
22924,0.000349,74.125.130.0-255,1484,37746,77,211015
22925,0.000351,172.31.40.0-255,66,37812,77,211015
22926,0.00037,74.125.130.0-255,2902,40714,77,211015
22927,0.000373,172.31.40.0-255,66,40780,77,211015
22928,0.000383,74.125.130.0-255,5738,46518,77,211015
22929,0.000386,172.31.40.0-255,66,46584,77,211015
22930,0.00039,74.125.130.0-255,2543,49127,77,211015
22931,0.000395,172.31.40.0-255,66,49193,77,211015
22932,0.000424,74.125.130.0-255,2902,52095,77,211015
22933,0.000427,172.31.40.0-255,66,52161,77,211015
22934,0.000455,74.125.130.0-255,7156,59317,77,211015
22935,0.000458,172.31.40.0-255,66,59383,77,211015
22936,0.000491,74.125.130.0-255,1484,60867,77,211015
22937,0.000514,74.125.130.0-255,5633,66500,77,211015
22938,0.000518,172.31.40.0-255,66,66566,77,211015
22939,0.000521,74.125.130.0-255,115,66681,77,211015
22940,0.000648,74.125.130.0-255,1484,68165,77,211015
22941,0.000653,172.31.40.0-255,66,68231,77,211015
22942,0.000659,74.125.130.0-255,2902,71133,77,211015
22943,0.000662,172.31.40.0-255,66,71199,77,211015
22944,0.000691,74.125.130.0-255,5738,76937,77,211015
22945,0.000694,172.31.40.0-255,66,77003,77,211015
22946,0.0007,74.125.130.0-255,5738,82741,77,211015
22947,0.000702,172.31.40.0-255,66,82807,77,211015
22948,0.000745,74.125.130.0-255,2543,85350,77,211015
22949,0.000748,172.31.40.0-255,66,85416,77,211015
22950,0.000753,74.125.130.0-255,2902,88318,77,211015
22951,0.000755,172.31.40.0-255,66,88384,77,211015
22952,0.000787,74.125.130.0-255,7156,95540,77,211015
22953,0.00079,172.31.40.0-255,66,95606,77,211015
22954,0.000816,74.125.130.0-255,5676,101282,77,211015
22955,0.000818,172.31.40.0-255,66,101348,77,211015
22956,0.000986,74.125.130.0-255,1484,102832,77,211015
22957,0.001002,74.125.130.0-255,2902,105734,77,211015
22958,0.001007,172.31.40.0-255,66,105800,77,211015
22959,0.001049,74.125.130.0-255,1484,107284,77,211015
22960,0.001063,74.125.130.0-255,2902,110186,77,211015
22961,0.001067,172.31.40.0-255,66,110252,77,211015
22962,0.001096,74.125.130.0-255,5738,115990,77,211015
22963,0.0011,172.31.40.0-255,66,116056,77,211015
22964,0.001106,74.125.130.0-255,5738,121794,77,211015
22965,0.001109,172.31.40.0-255,66,121860,77,211015
22966,0.001119,74.125.130.0-255,4320,126180,77,211015
22967,0.001121,172.31.40.0-255,66,126246,77,211015
22968,0.001133,74.125.130.0-255,2902,129148,77,211015
22969,0.001136,172.31.40.0-255,66,129214,77,211015
22970,0.001161,74.125.130.0-255,1484,130698,77,211015
22971,0.001207,74.125.130.0-255,2902,133600,77,211015
22972,0.00121,172.31.40.0-255,66,133666,77,211015
22973,0.001258,74.125.130.0-255,2184,135850,77,211015
22974,0.001261,172.31.40.0-255,66,135916,77,211015
22975,0.00143,172.31.40.0-255,101,136017,77,211015
22976,0.001937,74.125.130.0-255,1484,137501,77,211015
22977,0.001959,74.125.130.0-255,2902,140403,77,211015
22978,0.001963,172.31.40.0-255,66,140469,77,211015
22979,0.001998,74.125.130.0-255,4320,144789,77,211015
22980,0.002,172.31.40.0-255,66,144855,77,211015
22981,0.002024,74.125.130.0-255,7156,152011,77,211015
22982,0.002027,172.31.40.0-255,66,152077,77,211015
22983,0.002058,74.125.130.0-255,8574,160651,77,211015
22984,0.002061,172.31.40.0-255,66,160717,77,211015
22985,0.002065,74.125.130.0-255,2902,163619,77,211015
22986,0.002067,172.31.40.0-255,66,163685,77,211015
22987,0.002112,74.125.130.0-255,2902,166587,77,211015
22988,0.002116,172.31.40.0-255,66,166653,77,211015
22989,0.002145,74.125.130.0-255,3602,170255,77,211015
22990,0.002148,172.31.40.0-255,66,170321,77,211015
22991,0.003681,74.125.130.0-255,66,170387,77,211015
22992,0.004428,74.125.130.0-255,5738,176125,77,211015
22993,0.004436,172.31.40.0-255,66,176191,77,211015
22994,0.006747,74.125.130.0-255,5738,181929,77,211015
22995,0.006767,172.31.40.0-255,66,181995,77,211015
22996,0.009064,74.125.130.0-255,5738,187733,77,211015
22997,0.009076,172.31.40.0-255,66,187799,77,211015
22998,0.01137,74.125.130.0-255,5738,193537,77,211015
22999,0.011376,172.31.40.0-255,66,193603,77,211015
23000,0.013676,74.125.130.0-255,5738,199341,77,211015
23001,0.013691,172.31.40.0-255,66,199407,77,211015
23002,0.016,74.125.130.0-255,5738,205145,77,211015
23003,0.016016,172.31.40.0-255,66,205211,77,211015
23004,0.018328,74.125.130.0-255,5738,210949,77,211015
23005,0.018346,172.31.40.0-255,66,211015,77,211015
23006,0.0,172.217.194.0-255,143,143,77,237793
23007,2.3e-05,172.31.40.0-255,66,209,77,237793
23008,3e-05,172.217.194.0-255,1484,1693,77,237793
23009,3.5e-05,172.31.40.0-255,66,1759,77,237793
23010,4.1e-05,172.217.194.0-255,2902,4661,77,237793
23011,4.4e-05,172.31.40.0-255,66,4727,77,237793
23012,4.8e-05,172.217.194.0-255,1484,6211,77,237793
23013,5.1e-05,172.31.40.0-255,66,6277,77,237793
23014,8.1e-05,172.217.194.0-255,5738,12015,77,237793
23015,8.4e-05,172.31.40.0-255,66,12081,77,237793
23016,0.000106,172.217.194.0-255,2000,14081,77,237793
23017,0.000109,172.31.40.0-255,66,14147,77,237793
23018,0.000227,172.217.194.0-255,1484,15631,77,237793
23019,0.000231,172.31.40.0-255,66,15697,77,237793
23020,0.000237,172.217.194.0-255,2902,18599,77,237793
23021,0.000239,172.31.40.0-255,66,18665,77,237793
23022,0.000242,172.217.194.0-255,1484,20149,77,237793
23023,0.000244,172.31.40.0-255,66,20215,77,237793
23024,0.000265,172.217.194.0-255,4320,24535,77,237793
23025,0.000267,172.31.40.0-255,66,24601,77,237793
23026,0.00027,172.217.194.0-255,1484,26085,77,237793
23027,0.000272,172.31.40.0-255,66,26151,77,237793
23028,0.000291,172.217.194.0-255,5379,31530,77,237793
23029,0.000294,172.31.40.0-255,66,31596,77,237793
23030,0.000371,172.217.194.0-255,1484,33080,77,237793
23031,0.000375,172.31.40.0-255,66,33146,77,237793
23032,0.00038,172.217.194.0-255,2902,36048,77,237793
23033,0.000382,172.31.40.0-255,66,36114,77,237793
23034,0.000387,172.217.194.0-255,2902,39016,77,237793
23035,0.000389,172.31.40.0-255,66,39082,77,237793
23036,0.000403,172.217.194.0-255,2902,41984,77,237793
23037,0.000406,172.31.40.0-255,66,42050,77,237793
23038,0.000429,172.217.194.0-255,6797,48847,77,237793
23039,0.000431,172.31.40.0-255,66,48913,77,237793
23040,0.000447,172.217.194.0-255,1484,50397,77,237793
23041,0.000471,172.217.194.0-255,5738,56135,77,237793
23042,0.000474,172.31.40.0-255,66,56201,77,237793
23043,0.000498,172.217.194.0-255,2902,59103,77,237793
23044,0.0005,172.31.40.0-255,66,59169,77,237793
23045,0.000516,172.217.194.0-255,6797,65966,77,237793
23046,0.000518,172.31.40.0-255,66,66032,77,237793
23047,0.000701,172.217.194.0-255,645,66677,77,237793
23048,0.001029,172.217.194.0-255,1484,68161,77,237793
23049,0.001033,172.31.40.0-255,66,68227,77,237793
23050,0.001038,172.217.194.0-255,2902,71129,77,237793
23051,0.00104,172.31.40.0-255,66,71195,77,237793
23052,0.001043,172.217.194.0-255,1484,72679,77,237793
23053,0.001071,172.217.194.0-255,4320,76999,77,237793
23054,0.001073,172.31.40.0-255,66,77065,77,237793
23055,0.0011,172.217.194.0-255,5738,82803,77,237793
23056,0.001102,172.31.40.0-255,66,82869,77,237793
23057,0.001126,172.217.194.0-255,7156,90025,77,237793
23058,0.001128,172.31.40.0-255,66,90091,77,237793
23059,0.001165,172.217.194.0-255,10692,100783,77,237793
23060,0.001167,172.31.40.0-255,66,100849,77,237793
23061,0.00179,172.217.194.0-255,1484,102333,77,237793
23062,0.001805,172.217.194.0-255,2902,105235,77,237793
23063,0.001808,172.31.40.0-255,66,105301,77,237793
23064,0.001815,172.217.194.0-255,5738,111039,77,237793
23065,0.001817,172.31.40.0-255,66,111105,77,237793
23066,0.00183,172.217.194.0-255,4320,115425,77,237793
23067,0.001831,172.31.40.0-255,66,115491,77,237793
23068,0.001853,172.217.194.0-255,8574,124065,77,237793
23069,0.001856,172.31.40.0-255,66,124131,77,237793
23070,0.001865,172.217.194.0-255,10692,134823,77,237793
23071,0.001867,172.31.40.0-255,66,134889,77,237793
23072,0.001897,172.217.194.0-255,2902,137791,77,237793
23073,0.001899,172.31.40.0-255,66,137857,77,237793
23074,0.00192,172.217.194.0-255,7156,145013,77,237793
23075,0.001922,172.31.40.0-255,66,145079,77,237793
23076,0.001924,172.217.194.0-255,1484,146563,77,237793
23077,0.00196,172.217.194.0-255,9992,156555,77,237793
23078,0.001962,172.31.40.0-255,66,156621,77,237793
23079,0.001967,172.217.194.0-255,5738,162359,77,237793
23080,0.001969,172.31.40.0-255,66,162425,77,237793
23081,0.001994,172.217.194.0-255,6438,168863,77,237793
23082,0.001996,172.31.40.0-255,66,168929,77,237793
23083,0.002397,172.217.194.0-255,1484,170413,77,237793
23084,0.002401,172.217.194.0-255,2902,173315,77,237793
23085,0.002404,172.31.40.0-255,66,173381,77,237793
23086,0.00241,172.217.194.0-255,5738,179119,77,237793
23087,0.002411,172.31.40.0-255,66,179185,77,237793
23088,0.002433,172.217.194.0-255,5738,184923,77,237793
23089,0.002435,172.31.40.0-255,66,184989,77,237793
23090,0.002449,172.217.194.0-255,7156,192145,77,237793
23091,0.002451,172.31.40.0-255,66,192211,77,237793
23092,0.002476,172.217.194.0-255,10692,202903,77,237793
23093,0.002478,172.31.40.0-255,66,202969,77,237793
23094,0.005075,172.217.194.0-255,5738,208707,77,237793
23095,0.00508,172.31.40.0-255,66,208773,77,237793
23096,0.007675,172.217.194.0-255,5738,214511,77,237793
23097,0.007686,172.31.40.0-255,66,214577,77,237793
23098,0.010266,172.217.194.0-255,5738,220315,77,237793
23099,0.010273,172.31.40.0-255,66,220381,77,237793
23100,0.012871,172.217.194.0-255,5738,226119,77,237793
23101,0.012879,172.31.40.0-255,66,226185,77,237793
23102,0.015493,172.217.194.0-255,5738,231923,77,237793
23103,0.015501,172.31.40.0-255,66,231989,77,237793
23104,0.018066,172.217.194.0-255,5738,237727,77,237793
23105,0.018074,172.31.40.0-255,66,237793,77,237793
23106,0.0,172.31.40.0-255,105,105,77,459
23107,0.000211,172.31.40.0-255,90,195,77,459
23108,0.000222,172.31.40.0-255,66,261,77,459
23109,0.002715,74.125.130.0-255,66,327,77,459
23110,0.002745,74.125.130.0-255,66,393,77,459
23111,0.002768,172.31.40.0-255,66,459,77,459
23112,0.0,172.217.160.0-255,153,153,77,135318
23113,2.2e-05,172.31.40.0-255,66,219,77,135318
23114,3e-05,172.217.160.0-255,1484,1703,77,135318
23115,3.4e-05,172.31.40.0-255,66,1769,77,135318
23116,4.1e-05,172.217.160.0-255,2902,4671,77,135318
23117,5.2e-05,172.31.40.0-255,66,4737,77,135318
23118,6.1e-05,172.217.160.0-255,7156,11893,77,135318
23119,6.4e-05,172.31.40.0-255,66,11959,77,135318
23120,0.000173,172.217.160.0-255,2100,14059,77,135318
23121,0.000177,172.31.40.0-255,66,14125,77,135318
23122,0.000213,172.217.160.0-255,2902,17027,77,135318
23123,0.000216,172.31.40.0-255,66,17093,77,135318
23124,0.000261,172.217.160.0-255,5738,22831,77,135318
23125,0.000264,172.31.40.0-255,66,22897,77,135318
23126,0.000289,172.217.160.0-255,1484,24381,77,135318
23127,0.000291,172.31.40.0-255,66,24447,77,135318
23128,0.00038,172.217.160.0-255,6797,31244,77,135318
23129,0.000383,172.31.40.0-255,66,31310,77,135318
23130,0.000492,172.217.160.0-255,2902,34212,77,135318
23131,0.000498,172.31.40.0-255,66,34278,77,135318
23132,0.000517,172.217.160.0-255,4320,38598,77,135318
23133,0.000521,172.31.40.0-255,66,38664,77,135318
23134,0.000618,172.217.160.0-255,9992,48656,77,135318
23135,0.000622,172.31.40.0-255,66,48722,77,135318
23136,0.000647,172.217.160.0-255,8215,56937,77,135318
23137,0.00065,172.31.40.0-255,66,57003,77,135318
23138,0.000916,172.217.160.0-255,8521,65524,77,135318
23139,0.000921,172.31.40.0-255,66,65590,77,135318
23140,0.001019,172.217.160.0-255,104,65694,77,135318
23141,0.001023,172.31.40.0-255,66,65760,77,135318
23142,0.00109,172.217.160.0-255,1484,67244,77,135318
23143,0.001094,172.31.40.0-255,66,67310,77,135318
23144,0.001099,172.217.160.0-255,2902,70212,77,135318
23145,0.001128,172.31.40.0-255,66,70278,77,135318
23146,0.001157,172.217.160.0-255,5738,76016,77,135318
23147,0.001172,172.31.40.0-255,66,76082,77,135318
23148,0.001246,172.217.160.0-255,2902,78984,77,135318
23149,0.00125,172.31.40.0-255,66,79050,77,135318
23150,0.001271,172.217.160.0-255,1484,80534,77,135318
23151,0.001312,172.217.160.0-255,4320,84854,77,135318
23152,0.001331,172.217.160.0-255,7156,92010,77,135318
23153,0.001338,172.31.40.0-255,66,92076,77,135318
23154,0.001346,172.217.160.0-255,1125,93201,77,135318
23155,0.001455,172.31.40.0-255,66,93267,77,135318
23156,0.001532,172.217.160.0-255,6797,100064,77,135318
23157,0.001607,172.217.160.0-255,364,100428,77,135318
23158,0.00705,172.31.40.0-255,66,100494,77,135318
23159,0.009019,172.217.160.0-255,5738,106232,77,135318
23160,0.009027,172.31.40.0-255,66,106298,77,135318
23161,0.010971,172.217.160.0-255,5738,112036,77,135318
23162,0.011815,172.31.40.0-255,66,112102,77,135318
23163,0.013759,172.217.160.0-255,5738,117840,77,135318
23164,0.013768,172.31.40.0-255,66,117906,77,135318
23165,0.015706,172.217.160.0-255,5738,123644,77,135318
23166,0.015714,172.31.40.0-255,66,123710,77,135318
23167,0.017651,172.217.160.0-255,5738,129448,77,135318
23168,0.017658,172.31.40.0-255,66,129514,77,135318
23169,0.019608,172.217.160.0-255,5738,135252,77,135318
23170,0.01962,172.31.40.0-255,66,135318,77,135318
23171,0.0,172.217.160.0-255,150,150,77,231080
23172,2.3e-05,172.31.40.0-255,66,216,77,231080
23173,3e-05,172.217.160.0-255,1484,1700,77,231080
23174,3.5e-05,172.31.40.0-255,66,1766,77,231080
23175,4e-05,172.217.160.0-255,2902,4668,77,231080
23176,5.1e-05,172.31.40.0-255,66,4734,77,231080
23177,6e-05,172.217.160.0-255,7156,11890,77,231080
23178,6.2e-05,172.31.40.0-255,66,11956,77,231080
23179,0.000103,172.217.160.0-255,2014,13970,77,231080
23180,0.000106,172.31.40.0-255,66,14036,77,231080
23181,0.000132,172.217.160.0-255,2902,16938,77,231080
23182,0.000135,172.31.40.0-255,66,17004,77,231080
23183,0.000143,172.217.160.0-255,7156,24160,77,231080
23184,0.000146,172.31.40.0-255,66,24226,77,231080
23185,0.000184,172.217.160.0-255,4320,28546,77,231080
23186,0.000186,172.31.40.0-255,66,28612,77,231080
23187,0.00021,172.217.160.0-255,2543,31155,77,231080
23188,0.000213,172.31.40.0-255,66,31221,77,231080
23189,0.000301,172.217.160.0-255,1484,32705,77,231080
23190,0.000305,172.31.40.0-255,66,32771,77,231080
23191,0.000329,172.217.160.0-255,2902,35673,77,231080
23192,0.000332,172.31.40.0-255,66,35739,77,231080
23193,0.000374,172.217.160.0-255,2902,38641,77,231080
23194,0.000377,172.31.40.0-255,66,38707,77,231080
23195,0.000383,172.217.160.0-255,4320,43027,77,231080
23196,0.000385,172.31.40.0-255,66,43093,77,231080
23197,0.000412,172.217.160.0-255,5379,48472,77,231080
23198,0.000415,172.31.40.0-255,66,48538,77,231080
23199,0.000444,172.217.160.0-255,5738,54276,77,231080
23200,0.000447,172.31.40.0-255,66,54342,77,231080
23201,0.000484,172.217.160.0-255,5738,60080,77,231080
23202,0.000487,172.31.40.0-255,66,60146,77,231080
23203,0.000507,172.217.160.0-255,5379,65525,77,231080
23204,0.00051,172.31.40.0-255,66,65591,77,231080
23205,0.00067,172.217.160.0-255,373,65964,77,231080
23206,0.000695,172.217.160.0-255,372,66336,77,231080
23207,0.000947,172.217.160.0-255,1484,67820,77,231080
23208,0.000951,172.31.40.0-255,66,67886,77,231080
23209,0.000979,172.217.160.0-255,1484,69370,77,231080
23210,0.000985,172.217.160.0-255,2902,72272,77,231080
23211,0.000987,172.31.40.0-255,66,72338,77,231080
23212,0.000994,172.217.160.0-255,5738,78076,77,231080
23213,0.000996,172.31.40.0-255,66,78142,77,231080
23214,0.001028,172.217.160.0-255,2902,81044,77,231080
23215,0.001031,172.31.40.0-255,66,81110,77,231080
23216,0.001055,172.217.160.0-255,2543,83653,77,231080
23217,0.001058,172.31.40.0-255,66,83719,77,231080
23218,0.001064,172.217.160.0-255,5738,89457,77,231080
23219,0.001066,172.31.40.0-255,66,89523,77,231080
23220,0.001106,172.217.160.0-255,11051,100574,77,231080
23221,0.001109,172.31.40.0-255,66,100640,77,231080
23222,0.00141,172.217.160.0-255,1484,102124,77,231080
23223,0.001416,172.217.160.0-255,2902,105026,77,231080
23224,0.00142,172.31.40.0-255,66,105092,77,231080
23225,0.001427,172.217.160.0-255,5738,110830,77,231080
23226,0.001429,172.31.40.0-255,66,110896,77,231080
23227,0.001477,172.217.160.0-255,7156,118052,77,231080
23228,0.00148,172.31.40.0-255,66,118118,77,231080
23229,0.001511,172.217.160.0-255,5738,123856,77,231080
23230,0.001514,172.31.40.0-255,66,123922,77,231080
23231,0.001559,172.217.160.0-255,8574,132496,77,231080
23232,0.001562,172.31.40.0-255,66,132562,77,231080
23233,0.001588,172.217.160.0-255,2184,134746,77,231080
23234,0.001591,172.31.40.0-255,66,134812,77,231080
23235,0.001634,172.217.160.0-255,9992,144804,77,231080
23236,0.001637,172.31.40.0-255,66,144870,77,231080
23237,0.001647,172.217.160.0-255,1484,146354,77,231080
23238,0.001707,172.217.160.0-255,8574,154928,77,231080
23239,0.001711,172.31.40.0-255,66,154994,77,231080
23240,0.001749,172.217.160.0-255,13528,168522,77,231080
23241,0.001752,172.31.40.0-255,66,168588,77,231080
23242,0.003394,172.217.160.0-255,5738,174326,77,231080
23243,0.003401,172.31.40.0-255,66,174392,77,231080
23244,0.005038,172.217.160.0-255,5738,180130,77,231080
23245,0.005042,172.31.40.0-255,66,180196,77,231080
23246,0.006678,172.217.160.0-255,4320,184516,77,231080
23247,0.006682,172.31.40.0-255,66,184582,77,231080
23248,0.006705,172.217.160.0-255,1484,186066,77,231080
23249,0.008324,172.217.160.0-255,4320,190386,77,231080
23250,0.00833,172.31.40.0-255,66,190452,77,231080
23251,0.009973,172.217.160.0-255,5738,196190,77,231080
23252,0.00998,172.31.40.0-255,66,196256,77,231080
23253,0.011624,172.217.160.0-255,5738,201994,77,231080
23254,0.011632,172.31.40.0-255,66,202060,77,231080
23255,0.013286,172.217.160.0-255,5738,207798,77,231080
23256,0.013293,172.31.40.0-255,66,207864,77,231080
23257,0.014935,172.217.160.0-255,5738,213602,77,231080
23258,0.014943,172.31.40.0-255,66,213668,77,231080
23259,0.016595,172.217.160.0-255,5738,219406,77,231080
23260,0.016603,172.31.40.0-255,66,219472,77,231080
23261,0.018256,172.217.160.0-255,5738,225210,77,231080
23262,0.018263,172.31.40.0-255,66,225276,77,231080
23263,0.019917,172.217.160.0-255,5738,231014,77,231080
23264,0.019924,172.31.40.0-255,66,231080,77,231080
23265,0.0,74.125.200.0-255,152,152,77,416143
23266,2.4e-05,172.31.40.0-255,66,218,77,416143
23267,3.1e-05,74.125.200.0-255,1484,1702,77,416143
23268,3.6e-05,172.31.40.0-255,66,1768,77,416143
23269,4.1e-05,74.125.200.0-255,2902,4670,77,416143
23270,4.5e-05,172.31.40.0-255,66,4736,77,416143
23271,5.2e-05,74.125.200.0-255,5738,10474,77,416143
23272,5.5e-05,172.31.40.0-255,66,10540,77,416143
23273,8.6e-05,74.125.200.0-255,3462,14002,77,416143
23274,8.9e-05,172.31.40.0-255,66,14068,77,416143
23275,9.2e-05,74.125.200.0-255,1484,15552,77,416143
23276,9.4e-05,172.31.40.0-255,66,15618,77,416143
23277,0.000109,74.125.200.0-255,2902,18520,77,416143
23278,0.000111,172.31.40.0-255,66,18586,77,416143
23279,0.000122,74.125.200.0-255,9992,28578,77,416143
23280,0.000124,172.31.40.0-255,66,28644,77,416143
23281,0.00013,74.125.200.0-255,4320,32964,77,416143
23282,0.000132,172.31.40.0-255,66,33030,77,416143
23283,0.000175,74.125.200.0-255,5738,38768,77,416143
23284,0.000178,172.31.40.0-255,66,38834,77,416143
23285,0.000199,74.125.200.0-255,9274,48108,77,416143
23286,0.000201,172.31.40.0-255,66,48174,77,416143
23287,0.000213,74.125.200.0-255,1484,49658,77,416143
23288,0.000215,172.31.40.0-255,66,49724,77,416143
23289,0.000232,74.125.200.0-255,2902,52626,77,416143
23290,0.000235,172.31.40.0-255,66,52692,77,416143
23291,0.000262,74.125.200.0-255,5738,58430,77,416143
23292,0.000265,172.31.40.0-255,66,58496,77,416143
23293,0.000271,74.125.200.0-255,5738,64234,77,416143
23294,0.000273,172.31.40.0-255,66,64300,77,416143
23295,0.000311,74.125.200.0-255,1461,65761,77,416143
23296,0.000314,172.31.40.0-255,66,65827,77,416143
23297,0.000423,74.125.200.0-255,1484,67311,77,416143
23298,0.000428,74.125.200.0-255,1484,68795,77,416143
23299,0.00043,172.31.40.0-255,66,68861,77,416143
23300,0.000444,74.125.200.0-255,1484,70345,77,416143
23301,0.00045,74.125.200.0-255,4320,74665,77,416143
23302,0.000453,172.31.40.0-255,66,74731,77,416143
23303,0.000481,74.125.200.0-255,1484,76215,77,416143
23304,0.000486,74.125.200.0-255,4320,80535,77,416143
23305,0.000489,172.31.40.0-255,66,80601,77,416143
23306,0.000495,74.125.200.0-255,5738,86339,77,416143
23307,0.000498,172.31.40.0-255,66,86405,77,416143
23308,0.000551,74.125.200.0-255,11410,97815,77,416143
23309,0.000554,172.31.40.0-255,66,97881,77,416143
23310,0.000559,74.125.200.0-255,2184,100065,77,416143
23311,0.000561,172.31.40.0-255,66,100131,77,416143
23312,0.000565,74.125.200.0-255,2902,103033,77,416143
23313,0.000567,172.31.40.0-255,66,103099,77,416143
23314,0.00061,74.125.200.0-255,12828,115927,77,416143
23315,0.000613,172.31.40.0-255,66,115993,77,416143
23316,0.00062,74.125.200.0-255,5738,121731,77,416143
23317,0.000622,172.31.40.0-255,66,121797,77,416143
23318,0.000653,74.125.200.0-255,11805,133602,77,416143
23319,0.000656,172.31.40.0-255,66,133668,77,416143
23320,0.001172,74.125.200.0-255,1484,135152,77,416143
23321,0.001178,74.125.200.0-255,2902,138054,77,416143
23322,0.001182,172.31.40.0-255,66,138120,77,416143
23323,0.001186,74.125.200.0-255,1484,139604,77,416143
23324,0.001204,74.125.200.0-255,1484,141088,77,416143
23325,0.001206,172.31.40.0-255,66,141154,77,416143
23326,0.001211,74.125.200.0-255,4320,145474,77,416143
23327,0.001214,172.31.40.0-255,66,145540,77,416143
23328,0.001218,74.125.200.0-255,2902,148442,77,416143
23329,0.00122,172.31.40.0-255,66,148508,77,416143
23330,0.001249,74.125.200.0-255,5738,154246,77,416143
23331,0.001252,172.31.40.0-255,66,154312,77,416143
23332,0.00126,74.125.200.0-255,8574,162886,77,416143
23333,0.001262,172.31.40.0-255,66,162952,77,416143
23334,0.001298,74.125.200.0-255,5020,167972,77,416143
23335,0.001301,172.31.40.0-255,66,168038,77,416143
23336,0.001348,74.125.200.0-255,1484,169522,77,416143
23337,0.001351,74.125.200.0-255,1484,171006,77,416143
23338,0.001354,172.31.40.0-255,66,171072,77,416143
23339,0.00137,74.125.200.0-255,1484,172556,77,416143
23340,0.001385,74.125.200.0-255,4320,176876,77,416143
23341,0.001388,172.31.40.0-255,66,176942,77,416143
23342,0.001401,74.125.200.0-255,1484,178426,77,416143
23343,0.001406,74.125.200.0-255,4320,182746,77,416143
23344,0.001409,172.31.40.0-255,66,182812,77,416143
23345,0.001429,74.125.200.0-255,2902,185714,77,416143
23346,0.001433,172.31.40.0-255,66,185780,77,416143
23347,0.001442,74.125.200.0-255,2902,188682,77,416143
23348,0.001444,172.31.40.0-255,66,188748,77,416143
23349,0.00148,74.125.200.0-255,11410,200158,77,416143
23350,0.001484,172.31.40.0-255,66,200224,77,416143
23351,0.001488,74.125.200.0-255,2184,202408,77,416143
23352,0.00149,172.31.40.0-255,66,202474,77,416143
23353,0.00157,74.125.200.0-255,1484,203958,77,416143
23354,0.001583,74.125.200.0-255,2902,206860,77,416143
23355,0.001586,172.31.40.0-255,66,206926,77,416143
23356,0.00161,74.125.200.0-255,4320,211246,77,416143
23357,0.001613,172.31.40.0-255,66,211312,77,416143
23358,0.001632,74.125.200.0-255,1484,212796,77,416143
23359,0.001639,74.125.200.0-255,7156,219952,77,416143
23360,0.001642,172.31.40.0-255,66,220018,77,416143
23361,0.001662,74.125.200.0-255,5738,225756,77,416143
23362,0.001665,172.31.40.0-255,66,225822,77,416143
23363,0.001691,74.125.200.0-255,5738,231560,77,416143
23364,0.001695,172.31.40.0-255,66,231626,77,416143
23365,0.001698,74.125.200.0-255,1484,233110,77,416143
23366,0.001716,74.125.200.0-255,3602,236712,77,416143
23367,0.001719,172.31.40.0-255,66,236778,77,416143
23368,0.001792,74.125.200.0-255,1484,238262,77,416143
23369,0.001808,74.125.200.0-255,2902,241164,77,416143
23370,0.001811,172.31.40.0-255,66,241230,77,416143
23371,0.001818,74.125.200.0-255,5738,246968,77,416143
23372,0.001819,172.31.40.0-255,66,247034,77,416143
23373,0.001866,74.125.200.0-255,5738,252772,77,416143
23374,0.001869,172.31.40.0-255,66,252838,77,416143
23375,0.001877,74.125.200.0-255,7156,259994,77,416143
23376,0.001879,172.31.40.0-255,66,260060,77,416143
23377,0.001904,74.125.200.0-255,4320,264380,77,416143
23378,0.001907,172.31.40.0-255,66,264446,77,416143
23379,0.001922,74.125.200.0-255,6438,270884,77,416143
23380,0.001925,172.31.40.0-255,66,270950,77,416143
23381,0.001973,74.125.200.0-255,11410,282360,77,416143
23382,0.001976,172.31.40.0-255,66,282426,77,416143
23383,0.001985,74.125.200.0-255,8574,291000,77,416143
23384,0.001987,172.31.40.0-255,66,291066,77,416143
23385,0.001996,74.125.200.0-255,9992,301058,77,416143
23386,0.001998,172.31.40.0-255,66,301124,77,416143
23387,0.002003,74.125.200.0-255,3602,304726,77,416143
23388,0.002006,172.31.40.0-255,66,304792,77,416143
23389,0.00201,74.125.200.0-255,2902,307694,77,416143
23390,0.002012,172.31.40.0-255,66,307760,77,416143
23391,0.002034,74.125.200.0-255,1484,309244,77,416143
23392,0.002039,74.125.200.0-255,2902,312146,77,416143
23393,0.002042,172.31.40.0-255,66,312212,77,416143
23394,0.002061,74.125.200.0-255,7156,319368,77,416143
23395,0.002064,172.31.40.0-255,66,319434,77,416143
23396,0.00207,74.125.200.0-255,7156,326590,77,416143
23397,0.002073,172.31.40.0-255,66,326656,77,416143
23398,0.002095,74.125.200.0-255,1484,328140,77,416143
23399,0.002129,74.125.200.0-255,7156,335296,77,416143
23400,0.002132,172.31.40.0-255,66,335362,77,416143
23401,0.002138,74.125.200.0-255,5020,340382,77,416143
23402,0.00214,172.31.40.0-255,66,340448,77,416143
23403,0.002147,74.125.200.0-255,5738,346186,77,416143
23404,0.002148,172.31.40.0-255,66,346252,77,416143
23405,0.002154,74.125.200.0-255,5738,351990,77,416143
23406,0.002156,172.31.40.0-255,66,352056,77,416143
23407,0.002183,74.125.200.0-255,7156,359212,77,416143
23408,0.002191,74.125.200.0-255,8574,367786,77,416143
23409,0.002194,172.31.40.0-255,66,367852,77,416143
23410,0.002197,172.31.40.0-255,66,367918,77,416143
23411,0.00223,74.125.200.0-255,5020,372938,77,416143
23412,0.002234,172.31.40.0-255,66,373004,77,416143
23413,0.002239,74.125.200.0-255,4320,377324,77,416143
23414,0.002241,172.31.40.0-255,66,377390,77,416143
23415,0.002247,74.125.200.0-255,5738,383128,77,416143
23416,0.002249,172.31.40.0-255,66,383194,77,416143
23417,0.002259,74.125.200.0-255,11410,394604,77,416143
23418,0.002262,172.31.40.0-255,66,394670,77,416143
23419,0.002267,74.125.200.0-255,4320,398990,77,416143
23420,0.00227,172.31.40.0-255,66,399056,77,416143
23421,0.002323,74.125.200.0-255,4320,403376,77,416143
23422,0.002327,172.31.40.0-255,66,403442,77,416143
23423,0.002358,74.125.200.0-255,12196,415638,77,416143
23424,0.00236,172.31.40.0-255,66,415704,77,416143
23425,0.002364,74.125.200.0-255,97,415801,77,416143
23426,0.004523,172.31.40.0-255,66,415867,77,416143
23427,0.004671,74.125.200.0-255,105,415972,77,416143
23428,0.019149,172.31.40.0-255,66,416038,77,416143
23429,0.019233,172.31.40.0-255,105,416143,77,416143
23430,0.0,172.253.118.0-255,150,150,77,204071
23431,2.7e-05,172.31.40.0-255,66,216,77,204071
23432,3.5e-05,172.253.118.0-255,1484,1700,77,204071
23433,4e-05,172.31.40.0-255,66,1766,77,204071
23434,4.6e-05,172.253.118.0-255,2902,4668,77,204071
23435,4.9e-05,172.31.40.0-255,66,4734,77,204071
23436,5.7e-05,172.253.118.0-255,7156,11890,77,204071
23437,6e-05,172.31.40.0-255,66,11956,77,204071
23438,0.000116,172.253.118.0-255,1484,13440,77,204071
23439,0.000119,172.31.40.0-255,66,13506,77,204071
23440,0.000137,172.253.118.0-255,693,14199,77,204071
23441,0.00014,172.31.40.0-255,66,14265,77,204071
23442,0.000188,172.253.118.0-255,1484,15749,77,204071
23443,0.00019,172.31.40.0-255,66,15815,77,204071
23444,0.000212,172.253.118.0-255,2902,18717,77,204071
23445,0.000215,172.31.40.0-255,66,18783,77,204071
23446,0.00022,172.253.118.0-255,4320,23103,77,204071
23447,0.000222,172.31.40.0-255,66,23169,77,204071
23448,0.000234,172.253.118.0-255,1484,24653,77,204071
23449,0.000236,172.31.40.0-255,66,24719,77,204071
23450,0.00029,172.253.118.0-255,6797,31516,77,204071
23451,0.000293,172.31.40.0-255,66,31582,77,204071
23452,0.00049,172.253.118.0-255,1484,33066,77,204071
23453,0.000495,172.31.40.0-255,66,33132,77,204071
23454,0.0005,172.253.118.0-255,2902,36034,77,204071
23455,0.000503,172.31.40.0-255,66,36100,77,204071
23456,0.00052,172.253.118.0-255,5738,41838,77,204071
23457,0.000523,172.31.40.0-255,66,41904,77,204071
23458,0.000582,172.253.118.0-255,4320,46224,77,204071
23459,0.000586,172.31.40.0-255,66,46290,77,204071
23460,0.000603,172.253.118.0-255,2543,48833,77,204071
23461,0.000606,172.31.40.0-255,66,48899,77,204071
23462,0.001285,172.253.118.0-255,1484,50383,77,204071
23463,0.001296,172.253.118.0-255,2902,53285,77,204071
23464,0.001301,172.31.40.0-255,66,53351,77,204071
23465,0.001322,172.253.118.0-255,5738,59089,77,204071
23466,0.001325,172.31.40.0-255,66,59155,77,204071
23467,0.00138,172.253.118.0-255,4320,63475,77,204071
23468,0.001383,172.31.40.0-255,66,63541,77,204071
23469,0.001401,172.253.118.0-255,2543,66084,77,204071
23470,0.001404,172.31.40.0-255,66,66150,77,204071
23471,0.001495,172.253.118.0-255,1484,67634,77,204071
23472,0.0015,172.253.118.0-255,1484,69118,77,204071
23473,0.001503,172.31.40.0-255,66,69184,77,204071
23474,0.001519,172.253.118.0-255,1484,70668,77,204071
23475,0.001521,172.253.118.0-255,1484,72152,77,204071
23476,0.001523,172.31.40.0-255,66,72218,77,204071
23477,0.001547,172.253.118.0-255,4320,76538,77,204071
23478,0.00155,172.31.40.0-255,66,76604,77,204071
23479,0.0016,172.253.118.0-255,7156,83760,77,204071
23480,0.001603,172.31.40.0-255,66,83826,77,204071
23481,0.001624,172.253.118.0-255,5738,89564,77,204071
23482,0.001626,172.31.40.0-255,66,89630,77,204071
23483,0.001747,172.253.118.0-255,4320,93950,77,204071
23484,0.001752,172.31.40.0-255,66,94016,77,204071
23485,0.001777,172.253.118.0-255,6438,100454,77,204071
23486,0.00178,172.31.40.0-255,66,100520,77,204071
23487,0.001869,172.253.118.0-255,1484,102004,77,204071
23488,0.001889,172.253.118.0-255,2902,104906,77,204071
23489,0.001891,172.31.40.0-255,66,104972,77,204071
23490,0.00192,172.253.118.0-255,5738,110710,77,204071
23491,0.001923,172.31.40.0-255,66,110776,77,204071
23492,0.001982,172.253.118.0-255,5738,116514,77,204071
23493,0.001985,172.31.40.0-255,66,116580,77,204071
23494,0.002006,172.253.118.0-255,7156,123736,77,204071
23495,0.002008,172.31.40.0-255,66,123802,77,204071
23496,0.00213,172.253.118.0-255,4320,128122,77,204071
23497,0.002133,172.31.40.0-255,66,128188,77,204071
23498,0.002157,172.253.118.0-255,7019,135207,77,204071
23499,0.00216,172.31.40.0-255,66,135273,77,204071
23500,0.002253,172.253.118.0-255,8574,143847,77,204071
23501,0.002255,172.31.40.0-255,66,143913,77,204071
23502,0.002274,172.253.118.0-255,2902,146815,77,204071
23503,0.002276,172.31.40.0-255,66,146881,77,204071
23504,0.002387,172.253.118.0-255,4320,151201,77,204071
23505,0.002389,172.31.40.0-255,66,151267,77,204071
23506,0.002421,172.253.118.0-255,12828,164095,77,204071
23507,0.002423,172.31.40.0-255,66,164161,77,204071
23508,0.002442,172.253.118.0-255,5020,169181,77,204071
23509,0.002444,172.31.40.0-255,66,169247,77,204071
23510,0.005043,172.253.118.0-255,5738,174985,77,204071
23511,0.005048,172.31.40.0-255,66,175051,77,204071
23512,0.007651,172.253.118.0-255,5738,180789,77,204071
23513,0.007658,172.31.40.0-255,66,180855,77,204071
23514,0.010276,172.253.118.0-255,5738,186593,77,204071
23515,0.010293,172.31.40.0-255,66,186659,77,204071
23516,0.012926,172.253.118.0-255,5738,192397,77,204071
23517,0.012936,172.31.40.0-255,66,192463,77,204071
23518,0.015533,172.253.118.0-255,5738,198201,77,204071
23519,0.015542,172.31.40.0-255,66,198267,77,204071
23520,0.018126,172.253.118.0-255,5738,204005,77,204071
23521,0.018135,172.31.40.0-255,66,204071,77,204071
23522,0.0,172.217.194.0-255,153,153,77,194415
23523,2.2e-05,172.31.40.0-255,66,219,77,194415
23524,3e-05,172.217.194.0-255,1484,1703,77,194415
23525,3.4e-05,172.31.40.0-255,66,1769,77,194415
23526,3.9e-05,172.217.194.0-255,2902,4671,77,194415
23527,5.1e-05,172.31.40.0-255,66,4737,77,194415
23528,5.8e-05,172.217.194.0-255,7156,11893,77,194415
23529,6.2e-05,172.31.40.0-255,66,11959,77,194415
23530,6.6e-05,172.217.194.0-255,2037,13996,77,194415
23531,6.9e-05,172.31.40.0-255,66,14062,77,194415
23532,0.0001,172.217.194.0-255,1484,15546,77,194415
23533,0.000103,172.31.40.0-255,66,15612,77,194415
23534,0.000106,172.217.194.0-255,1484,17096,77,194415
23535,0.000109,172.31.40.0-255,66,17162,77,194415
23536,0.000129,172.217.194.0-255,1484,18646,77,194415
23537,0.000131,172.31.40.0-255,66,18712,77,194415
23538,0.000138,172.217.194.0-255,5738,24450,77,194415
23539,0.00014,172.31.40.0-255,66,24516,77,194415
23540,0.000176,172.217.194.0-255,9633,34149,77,194415
23541,0.000179,172.31.40.0-255,66,34215,77,194415
23542,0.000187,172.217.194.0-255,8574,42789,77,194415
23543,0.00019,172.31.40.0-255,66,42855,77,194415
23544,0.000218,172.217.194.0-255,1484,44339,77,194415
23545,0.00022,172.31.40.0-255,66,44405,77,194415
23546,0.000226,172.217.194.0-255,3961,48366,77,194415
23547,0.000228,172.31.40.0-255,66,48432,77,194415
23548,0.000233,172.217.194.0-255,4320,52752,77,194415
23549,0.000235,172.31.40.0-255,66,52818,77,194415
23550,0.000242,172.217.194.0-255,7156,59974,77,194415
23551,0.000245,172.31.40.0-255,66,60040,77,194415
23552,0.000277,172.217.194.0-255,2902,62942,77,194415
23553,0.000279,172.31.40.0-255,66,63008,77,194415
23554,0.000284,172.217.194.0-255,2543,65551,77,194415
23555,0.000286,172.31.40.0-255,66,65617,77,194415
23556,0.000356,172.31.40.0-255,66,65683,77,194415
23557,0.000359,172.217.194.0-255,1484,67167,77,194415
23558,0.000393,172.217.194.0-255,11051,78218,77,194415
23559,0.000396,172.31.40.0-255,66,78284,77,194415
23560,0.000427,172.217.194.0-255,7093,85377,77,194415
23561,0.00043,172.31.40.0-255,66,85443,77,194415
23562,0.001228,172.217.194.0-255,1484,86927,77,194415
23563,0.00124,172.217.194.0-255,2902,89829,77,194415
23564,0.001244,172.31.40.0-255,66,89895,77,194415
23565,0.001252,172.217.194.0-255,5738,95633,77,194415
23566,0.001253,172.31.40.0-255,66,95699,77,194415
23567,0.001262,172.217.194.0-255,1484,97183,77,194415
23568,0.001291,172.217.194.0-255,11410,108593,77,194415
23569,0.001294,172.31.40.0-255,66,108659,77,194415
23570,0.001303,172.217.194.0-255,8574,117233,77,194415
23571,0.001305,172.31.40.0-255,66,117299,77,194415
23572,0.001336,172.217.194.0-255,2184,119483,77,194415
23573,0.001338,172.31.40.0-255,66,119549,77,194415
23574,0.002077,172.217.194.0-255,1484,121033,77,194415
23575,0.002086,172.217.194.0-255,2902,123935,77,194415
23576,0.00209,172.31.40.0-255,66,124001,77,194415
23577,0.002129,172.217.194.0-255,5738,129739,77,194415
23578,0.002132,172.31.40.0-255,66,129805,77,194415
23579,0.002141,172.217.194.0-255,7156,136961,77,194415
23580,0.002143,172.31.40.0-255,66,137027,77,194415
23581,0.002174,172.217.194.0-255,5738,142765,77,194415
23582,0.002176,172.31.40.0-255,66,142831,77,194415
23583,0.002181,172.217.194.0-255,5738,148569,77,194415
23584,0.002183,172.31.40.0-255,66,148635,77,194415
23585,0.002205,172.217.194.0-255,1484,150119,77,194415
23586,0.002219,172.217.194.0-255,3602,153721,77,194415
23587,0.002221,172.31.40.0-255,66,153787,77,194415
23588,0.004496,172.217.194.0-255,5738,159525,77,194415
23589,0.0045,172.31.40.0-255,66,159591,77,194415
23590,0.006803,172.217.194.0-255,5738,165329,77,194415
23591,0.00681,172.31.40.0-255,66,165395,77,194415
23592,0.009078,172.217.194.0-255,5738,171133,77,194415
23593,0.009081,172.31.40.0-255,66,171199,77,194415
23594,0.011384,172.217.194.0-255,5738,176937,77,194415
23595,0.011391,172.31.40.0-255,66,177003,77,194415
23596,0.013687,172.217.194.0-255,5738,182741,77,194415
23597,0.013694,172.31.40.0-255,66,182807,77,194415
23598,0.015978,172.217.194.0-255,5738,188545,77,194415
23599,0.015986,172.31.40.0-255,66,188611,77,194415
23600,0.018297,172.217.194.0-255,5738,194349,77,194415
23601,0.018304,172.31.40.0-255,66,194415,77,194415
23602,0.0,172.217.194.0-255,146,146,77,366860
23603,3e-05,172.31.40.0-255,66,212,77,366860
23604,3.9e-05,172.217.194.0-255,1484,1696,77,366860
23605,4.4e-05,172.31.40.0-255,66,1762,77,366860
23606,5.1e-05,172.217.194.0-255,2902,4664,77,366860
23607,6.2e-05,172.31.40.0-255,66,4730,77,366860
23608,7.1e-05,172.217.194.0-255,7156,11886,77,366860
23609,7.4e-05,172.31.40.0-255,66,11952,77,366860
23610,7.9e-05,172.217.194.0-255,2030,13982,77,366860
23611,8.2e-05,172.31.40.0-255,66,14048,77,366860
23612,0.000186,172.217.194.0-255,1484,15532,77,366860
23613,0.000189,172.31.40.0-255,66,15598,77,366860
23614,0.000195,172.217.194.0-255,2902,18500,77,366860
23615,0.000197,172.31.40.0-255,66,18566,77,366860
23616,0.000221,172.217.194.0-255,5738,24304,77,366860
23617,0.000224,172.31.40.0-255,66,24370,77,366860
23618,0.000288,172.217.194.0-255,13887,38257,77,366860
23619,0.000291,172.31.40.0-255,66,38323,77,366860
23620,0.000303,172.217.194.0-255,12828,51151,77,366860
23621,0.000306,172.31.40.0-255,66,51217,77,366860
23622,0.000344,172.217.194.0-255,1484,52701,77,366860
23623,0.000347,172.31.40.0-255,66,52767,77,366860
23624,0.000359,172.217.194.0-255,11410,64177,77,366860
23625,0.000361,172.31.40.0-255,66,64243,77,366860
23626,0.000364,172.217.194.0-255,1377,65620,77,366860
23627,0.000366,172.31.40.0-255,66,65686,77,366860
23628,0.00045,172.217.194.0-255,1484,67170,77,366860
23629,0.000453,172.31.40.0-255,66,67236,77,366860
23630,0.000464,172.217.194.0-255,1484,68720,77,366860
23631,0.000466,172.31.40.0-255,66,68786,77,366860
23632,0.000487,172.217.194.0-255,1484,70270,77,366860
23633,0.00049,172.31.40.0-255,66,70336,77,366860
23634,0.000501,172.217.194.0-255,5738,76074,77,366860
23635,0.000506,172.217.194.0-255,1484,77558,77,366860
23636,0.000529,172.217.194.0-255,5379,82937,77,366860
23637,0.000537,172.217.194.0-255,5738,88675,77,366860
23638,0.000547,172.217.194.0-255,1484,90159,77,366860
23639,0.000563,172.217.194.0-255,5738,95897,77,366860
23640,0.000585,172.217.194.0-255,3961,99858,77,366860
23641,0.000689,172.31.40.0-255,66,99924,77,366860
23642,0.001023,172.217.194.0-255,1484,101408,77,366860
23643,0.001041,172.217.194.0-255,2902,104310,77,366860
23644,0.001047,172.217.194.0-255,5738,110048,77,366860
23645,0.001069,172.217.194.0-255,9992,120040,77,366860
23646,0.001083,172.217.194.0-255,2902,122942,77,366860
23647,0.001088,172.217.194.0-255,2902,125844,77,366860
23648,0.001094,172.31.40.0-255,66,125910,77,366860
23649,0.001127,172.217.194.0-255,7156,133066,77,366860
23650,0.00113,172.217.194.0-255,766,133832,77,366860
23651,0.001144,172.31.40.0-255,66,133898,77,366860
23652,0.001397,172.217.194.0-255,1484,135382,77,366860
23653,0.001403,172.217.194.0-255,2902,138284,77,366860
23654,0.001407,172.31.40.0-255,66,138350,77,366860
23655,0.00143,172.217.194.0-255,5738,144088,77,366860
23656,0.001443,172.217.194.0-255,2902,146990,77,366860
23657,0.001447,172.31.40.0-255,66,147056,77,366860
23658,0.001488,172.217.194.0-255,9992,157048,77,366860
23659,0.001494,172.217.194.0-255,4320,161368,77,366860
23660,0.001516,172.217.194.0-255,6438,167806,77,366860
23661,0.001522,172.31.40.0-255,66,167872,77,366860
23662,0.00173,172.217.194.0-255,1484,169356,77,366860
23663,0.001737,172.217.194.0-255,2902,172258,77,366860
23664,0.001739,172.31.40.0-255,66,172324,77,366860
23665,0.001775,172.217.194.0-255,5738,178062,77,366860
23666,0.001813,172.217.194.0-255,2902,180964,77,366860
23667,0.001823,172.31.40.0-255,66,181030,77,366860
23668,0.001838,172.217.194.0-255,9992,191022,77,366860
23669,0.001853,172.217.194.0-255,12110,203132,77,366860
23670,0.001864,172.217.194.0-255,12828,215960,77,366860
23671,0.001873,172.217.194.0-255,9992,225952,77,366860
23672,0.001904,172.217.194.0-255,9274,235226,77,366860
23673,0.001909,172.217.194.0-255,4320,239546,77,366860
23674,0.001911,172.31.40.0-255,66,239612,77,366860
23675,0.00192,172.31.40.0-255,66,239678,77,366860
23676,0.001976,172.217.194.0-255,2902,242580,77,366860
23677,0.00198,172.31.40.0-255,66,242646,77,366860
23678,0.001997,172.217.194.0-255,13528,256174,77,366860
23679,0.002012,172.217.194.0-255,9992,266166,77,366860
23680,0.002017,172.31.40.0-255,66,266232,77,366860
23681,0.002053,172.217.194.0-255,7156,273388,77,366860
23682,0.002065,172.217.194.0-255,13528,286916,77,366860
23683,0.002079,172.31.40.0-255,66,286982,77,366860
23684,0.002095,172.217.194.0-255,11410,298392,77,366860
23685,0.002115,172.217.194.0-255,9992,308384,77,366860
23686,0.002119,172.31.40.0-255,66,308450,77,366860
23687,0.002147,172.217.194.0-255,11410,319860,77,366860
23688,0.002162,172.217.194.0-255,12110,331970,77,366860
23689,0.002187,172.217.194.0-255,5738,337708,77,366860
23690,0.002225,172.31.40.0-255,66,337774,77,366860
23691,0.002242,172.31.40.0-255,66,337840,77,366860
23692,0.004392,172.217.194.0-255,5738,343578,77,366860
23693,0.007165,172.31.40.0-255,66,343644,77,366860
23694,0.009311,172.217.194.0-255,5738,349382,77,366860
23695,0.009322,172.31.40.0-255,66,349448,77,366860
23696,0.011465,172.217.194.0-255,5738,355186,77,366860
23697,0.011633,172.31.40.0-255,66,355252,77,366860
23698,0.013791,172.217.194.0-255,5738,360990,77,366860
23699,0.01381,172.31.40.0-255,66,361056,77,366860
23700,0.015966,172.217.194.0-255,5738,366794,77,366860
23701,0.018626,172.31.40.0-255,66,366860,77,366860
23702,0.0,74.125.24.0-255,297,297,77,147949
23703,2.2e-05,172.31.40.0-255,66,363,77,147949
23704,2.8e-05,74.125.24.0-255,1484,1847,77,147949
23705,3.2e-05,172.31.40.0-255,66,1913,77,147949
23706,4e-05,74.125.24.0-255,4320,6233,77,147949
23707,4.4e-05,172.31.40.0-255,66,6299,77,147949
23708,6.6e-05,74.125.24.0-255,5738,12037,77,147949
23709,6.9e-05,172.31.40.0-255,66,12103,77,147949
23710,8.6e-05,74.125.24.0-255,1920,14023,77,147949
23711,8.8e-05,172.31.40.0-255,66,14089,77,147949
23712,0.000169,74.125.24.0-255,1484,15573,77,147949
23713,0.000172,172.31.40.0-255,66,15639,77,147949
23714,0.000177,74.125.24.0-255,2902,18541,77,147949
23715,0.000179,172.31.40.0-255,66,18607,77,147949
23716,0.000207,74.125.24.0-255,5738,24345,77,147949
23717,0.00021,172.31.40.0-255,66,24411,77,147949
23718,0.000245,74.125.24.0-255,6797,31208,77,147949
23719,0.00025,172.31.40.0-255,66,31274,77,147949
23720,0.000255,74.125.24.0-255,4320,35594,77,147949
23721,0.000258,172.31.40.0-255,66,35660,77,147949
23722,0.000273,74.125.24.0-255,2902,38562,77,147949
23723,0.000276,172.31.40.0-255,66,38628,77,147949
23724,0.00028,74.125.24.0-255,2902,41530,77,147949
23725,0.000283,172.31.40.0-255,66,41596,77,147949
23726,0.000327,74.125.24.0-255,4320,45916,77,147949
23727,0.000329,172.31.40.0-255,66,45982,77,147949
23728,0.000347,74.125.24.0-255,2543,48525,77,147949
23729,0.000349,172.31.40.0-255,66,48591,77,147949
23730,0.000969,74.125.24.0-255,1484,50075,77,147949
23731,0.000975,172.31.40.0-255,66,50141,77,147949
23732,0.000983,74.125.24.0-255,2902,53043,77,147949
23733,0.000986,172.31.40.0-255,66,53109,77,147949
23734,0.000992,74.125.24.0-255,5738,58847,77,147949
23735,0.000994,172.31.40.0-255,66,58913,77,147949
23736,0.001025,74.125.24.0-255,2902,61815,77,147949
23737,0.001028,172.31.40.0-255,66,61881,77,147949
23738,0.001051,74.125.24.0-255,4540,66421,77,147949
23739,0.001053,172.31.40.0-255,66,66487,77,147949
23740,0.00106,74.125.24.0-255,7156,73643,77,147949
23741,0.001062,172.31.40.0-255,66,73709,77,147949
23742,0.001079,74.125.24.0-255,1484,75193,77,147949
23743,0.001083,74.125.24.0-255,1484,76677,77,147949
23744,0.001085,172.31.40.0-255,66,76743,77,147949
23745,0.001107,74.125.24.0-255,6797,83540,77,147949
23746,0.001109,172.31.40.0-255,66,83606,77,147949
23747,0.001118,74.125.24.0-255,8574,92180,77,147949
23748,0.00112,172.31.40.0-255,66,92246,77,147949
23749,0.001126,74.125.24.0-255,5738,97984,77,147949
23750,0.001129,172.31.40.0-255,66,98050,77,147949
23751,0.001152,74.125.24.0-255,2543,100593,77,147949
23752,0.001155,172.31.40.0-255,66,100659,77,147949
23753,0.003399,74.125.24.0-255,2902,103561,77,147949
23754,0.003407,172.31.40.0-255,66,103627,77,147949
23755,0.003432,74.125.24.0-255,2902,106529,77,147949
23756,0.003435,172.31.40.0-255,66,106595,77,147949
23757,0.005666,74.125.24.0-255,2902,109497,77,147949
23758,0.005673,172.31.40.0-255,66,109563,77,147949
23759,0.005706,74.125.24.0-255,1484,111047,77,147949
23760,0.005724,74.125.24.0-255,1484,112531,77,147949
23761,0.005727,172.31.40.0-255,66,112597,77,147949
23762,0.00796,74.125.24.0-255,2902,115499,77,147949
23763,0.007964,172.31.40.0-255,66,115565,77,147949
23764,0.008006,74.125.24.0-255,2902,118467,77,147949
23765,0.008009,172.31.40.0-255,66,118533,77,147949
23766,0.010275,74.125.24.0-255,2902,121435,77,147949
23767,0.010283,172.31.40.0-255,66,121501,77,147949
23768,0.010315,74.125.24.0-255,2902,124403,77,147949
23769,0.010318,172.31.40.0-255,66,124469,77,147949
23770,0.012585,74.125.24.0-255,2902,127371,77,147949
23771,0.012593,172.31.40.0-255,66,127437,77,147949
23772,0.012616,74.125.24.0-255,2902,130339,77,147949
23773,0.012619,172.31.40.0-255,66,130405,77,147949
23774,0.01488,74.125.24.0-255,2902,133307,77,147949
23775,0.014888,172.31.40.0-255,66,133373,77,147949
23776,0.014905,74.125.24.0-255,2902,136275,77,147949
23777,0.014908,172.31.40.0-255,66,136341,77,147949
23778,0.017188,74.125.24.0-255,5738,142079,77,147949
23779,0.017198,172.31.40.0-255,66,142145,77,147949
23780,0.019509,74.125.24.0-255,5738,147883,77,147949
23781,0.019516,172.31.40.0-255,66,147949,77,147949
23782,0.0,74.125.68.0-255,156,156,77,185785
23783,2.6e-05,172.31.40.0-255,66,222,77,185785
23784,3.3e-05,74.125.68.0-255,1484,1706,77,185785
23785,3.8e-05,172.31.40.0-255,66,1772,77,185785
23786,4.3e-05,74.125.68.0-255,2902,4674,77,185785
23787,5.5e-05,172.31.40.0-255,66,4740,77,185785
23788,6.1e-05,74.125.68.0-255,4320,9060,77,185785
23789,6.3e-05,172.31.40.0-255,66,9126,77,185785
23790,6.7e-05,74.125.68.0-255,1484,10610,77,185785
23791,6.9e-05,172.31.40.0-255,66,10676,77,185785
23792,0.000114,74.125.68.0-255,3517,14193,77,185785
23793,0.000117,172.31.40.0-255,66,14259,77,185785
23794,0.000206,74.125.68.0-255,1484,15743,77,185785
23795,0.000209,172.31.40.0-255,66,15809,77,185785
23796,0.000233,74.125.68.0-255,2902,18711,77,185785
23797,0.000239,172.31.40.0-255,66,18777,77,185785
23798,0.000247,74.125.68.0-255,5738,24515,77,185785
23799,0.000249,172.31.40.0-255,66,24581,77,185785
23800,0.000291,74.125.68.0-255,4320,28901,77,185785
23801,0.000293,172.31.40.0-255,66,28967,77,185785
23802,0.000318,74.125.68.0-255,2543,31510,77,185785
23803,0.00032,172.31.40.0-255,66,31576,77,185785
23804,0.000465,74.125.68.0-255,1484,33060,77,185785
23805,0.00047,172.31.40.0-255,66,33126,77,185785
23806,0.000476,74.125.68.0-255,2902,36028,77,185785
23807,0.000478,172.31.40.0-255,66,36094,77,185785
23808,0.000481,74.125.68.0-255,1484,37578,77,185785
23809,0.000482,172.31.40.0-255,66,37644,77,185785
23810,0.000509,74.125.68.0-255,2902,40546,77,185785
23811,0.000516,172.31.40.0-255,66,40612,77,185785
23812,0.000532,74.125.68.0-255,5738,46350,77,185785
23813,0.000534,172.31.40.0-255,66,46416,77,185785
23814,0.000587,74.125.68.0-255,1484,47900,77,185785
23815,0.000597,74.125.68.0-255,8215,56115,77,185785
23816,0.0006,74.125.68.0-255,1484,57599,77,185785
23817,0.000605,74.125.68.0-255,2902,60501,77,185785
23818,0.00064,74.125.68.0-255,2902,63403,77,185785
23819,0.000665,74.125.68.0-255,2543,65946,77,185785
23820,0.000667,74.125.68.0-255,411,66357,77,185785
23821,0.000691,172.31.40.0-255,66,66423,77,185785
23822,0.000719,74.125.68.0-255,332,66755,77,185785
23823,0.000968,74.125.68.0-255,1484,68239,77,185785
23824,0.000973,74.125.68.0-255,1484,69723,77,185785
23825,0.000983,172.31.40.0-255,66,69789,77,185785
23826,0.000995,74.125.68.0-255,1484,71273,77,185785
23827,0.001005,74.125.68.0-255,2902,74175,77,185785
23828,0.00101,74.125.68.0-255,4320,78495,77,185785
23829,0.001013,74.125.68.0-255,1484,79979,77,185785
23830,0.001041,74.125.68.0-255,7156,87135,77,185785
23831,0.001045,74.125.68.0-255,4320,91455,77,185785
23832,0.001049,172.31.40.0-255,66,91521,77,185785
23833,0.001059,74.125.68.0-255,2902,94423,77,185785
23834,0.001064,172.31.40.0-255,66,94489,77,185785
23835,0.001085,74.125.68.0-255,2902,97391,77,185785
23836,0.001087,74.125.68.0-255,1484,98875,77,185785
23837,0.001109,74.125.68.0-255,2184,101059,77,185785
23838,0.001123,172.31.40.0-255,66,101125,77,185785
23839,0.001781,74.125.68.0-255,1484,102609,77,185785
23840,0.001828,74.125.68.0-255,1484,104093,77,185785
23841,0.001833,172.31.40.0-255,66,104159,77,185785
23842,0.001864,74.125.68.0-255,2902,107061,77,185785
23843,0.001871,74.125.68.0-255,4320,111381,77,185785
23844,0.001899,74.125.68.0-255,8574,119955,77,185785
23845,0.001903,74.125.68.0-255,1484,121439,77,185785
23846,0.001917,74.125.68.0-255,4320,125759,77,185785
23847,0.001923,74.125.68.0-255,4320,130079,77,185785
23848,0.001939,74.125.68.0-255,2902,132981,77,185785
23849,0.001956,74.125.68.0-255,2184,135165,77,185785
23850,0.002389,74.125.68.0-255,1484,136649,77,185785
23851,0.002422,74.125.68.0-255,2902,139551,77,185785
23852,0.002444,74.125.68.0-255,4320,143871,77,185785
23853,0.002496,74.125.68.0-255,8574,152445,77,185785
23854,0.002501,74.125.68.0-255,4320,156765,77,185785
23855,0.002508,74.125.68.0-255,5738,162503,77,185785
23856,0.007661,172.31.40.0-255,66,162569,77,185785
23857,0.010172,74.125.68.0-255,5738,168307,77,185785
23858,0.010185,172.31.40.0-255,66,168373,77,185785
23859,0.012687,74.125.68.0-255,5738,174111,77,185785
23860,0.012702,172.31.40.0-255,66,174177,77,185785
23861,0.015197,74.125.68.0-255,5738,179915,77,185785
23862,0.015216,172.31.40.0-255,66,179981,77,185785
23863,0.017725,74.125.68.0-255,5738,185719,77,185785
23864,0.017743,172.31.40.0-255,66,185785,77,185785
23865,0.0,172.217.194.0-255,153,153,77,175396
23866,2.3e-05,172.31.40.0-255,66,219,77,175396
23867,3e-05,172.217.194.0-255,1484,1703,77,175396
23868,3.5e-05,172.31.40.0-255,66,1769,77,175396
23869,4.1e-05,172.217.194.0-255,2902,4671,77,175396
23870,4.5e-05,172.31.40.0-255,66,4737,77,175396
23871,5.2e-05,172.217.194.0-255,7156,11893,77,175396
23872,5.5e-05,172.31.40.0-255,66,11959,77,175396
23873,5.9e-05,172.217.194.0-255,2000,13959,77,175396
23874,6.2e-05,172.31.40.0-255,66,14025,77,175396
23875,0.000423,172.217.194.0-255,1484,15509,77,175396
23876,0.000428,172.217.194.0-255,2902,18411,77,175396
23877,0.000434,172.217.194.0-255,5738,24149,77,175396
23878,0.000439,172.31.40.0-255,66,24215,77,175396
23879,0.00045,172.31.40.0-255,66,24281,77,175396
23880,0.000453,172.31.40.0-255,66,24347,77,175396
23881,0.000458,172.217.194.0-255,4320,28667,77,175396
23882,0.00046,172.31.40.0-255,66,28733,77,175396
23883,0.000479,172.217.194.0-255,2543,31276,77,175396
23884,0.000481,172.31.40.0-255,66,31342,77,175396
23885,0.000611,172.217.194.0-255,1484,32826,77,175396
23886,0.000615,172.31.40.0-255,66,32892,77,175396
23887,0.00062,172.217.194.0-255,2902,35794,77,175396
23888,0.000623,172.31.40.0-255,66,35860,77,175396
23889,0.000653,172.217.194.0-255,5738,41598,77,175396
23890,0.000657,172.31.40.0-255,66,41664,77,175396
23891,0.000663,172.217.194.0-255,4320,45984,77,175396
23892,0.000665,172.31.40.0-255,66,46050,77,175396
23893,0.000687,172.217.194.0-255,5379,51429,77,175396
23894,0.000689,172.31.40.0-255,66,51495,77,175396
23895,0.000699,172.217.194.0-255,9992,61487,77,175396
23896,0.000701,172.31.40.0-255,66,61553,77,175396
23897,0.000729,172.217.194.0-255,3961,65514,77,175396
23898,0.000733,172.31.40.0-255,66,65580,77,175396
23899,0.000852,172.217.194.0-255,646,66226,77,175396
23900,0.000966,172.217.194.0-255,1484,67710,77,175396
23901,0.00097,172.31.40.0-255,66,67776,77,175396
23902,0.000976,172.217.194.0-255,2902,70678,77,175396
23903,0.000978,172.31.40.0-255,66,70744,77,175396
23904,0.000998,172.217.194.0-255,5738,76482,77,175396
23905,0.001001,172.31.40.0-255,66,76548,77,175396
23906,0.001007,172.217.194.0-255,4320,80868,77,175396
23907,0.001009,172.31.40.0-255,66,80934,77,175396
23908,0.001035,172.217.194.0-255,8574,89508,77,175396
23909,0.001038,172.31.40.0-255,66,89574,77,175396
23910,0.001047,172.217.194.0-255,9992,99566,77,175396
23911,0.00105,172.31.40.0-255,66,99632,77,175396
23912,0.001071,172.217.194.0-255,766,100398,77,175396
23913,0.001417,172.31.40.0-255,66,100464,77,175396
23914,0.001712,172.217.194.0-255,1484,101948,77,175396
23915,0.001723,172.217.194.0-255,2902,104850,77,175396
23916,0.001727,172.31.40.0-255,66,104916,77,175396
23917,0.001734,172.217.194.0-255,5738,110654,77,175396
23918,0.001736,172.31.40.0-255,66,110720,77,175396
23919,0.001742,172.217.194.0-255,4320,115040,77,175396
23920,0.001744,172.31.40.0-255,66,115106,77,175396
23921,0.001763,172.217.194.0-255,1484,116590,77,175396
23922,0.001774,172.217.194.0-255,12828,129418,77,175396
23923,0.001777,172.31.40.0-255,66,129484,77,175396
23924,0.001803,172.217.194.0-255,1484,130968,77,175396
23925,0.001819,172.217.194.0-255,3602,134570,77,175396
23926,0.001821,172.31.40.0-255,66,134636,77,175396
23927,0.004145,172.217.194.0-255,2902,137538,77,175396
23928,0.004151,172.31.40.0-255,66,137604,77,175396
23929,0.004171,172.217.194.0-255,2902,140506,77,175396
23930,0.004173,172.31.40.0-255,66,140572,77,175396
23931,0.006512,172.217.194.0-255,5738,146310,77,175396
23932,0.006518,172.31.40.0-255,66,146376,77,175396
23933,0.008857,172.217.194.0-255,5738,152114,77,175396
23934,0.008865,172.31.40.0-255,66,152180,77,175396
23935,0.011248,172.217.194.0-255,5738,157918,77,175396
23936,0.011256,172.31.40.0-255,66,157984,77,175396
23937,0.013628,172.217.194.0-255,5738,163722,77,175396
23938,0.013636,172.31.40.0-255,66,163788,77,175396
23939,0.015966,172.217.194.0-255,5738,169526,77,175396
23940,0.015973,172.31.40.0-255,66,169592,77,175396
23941,0.018299,172.217.194.0-255,5738,175330,77,175396
23942,0.018307,172.31.40.0-255,66,175396,77,175396
23943,0.0,172.217.194.0-255,153,153,77,189509
23944,2.3e-05,172.31.40.0-255,66,219,77,189509
23945,3e-05,172.217.194.0-255,1484,1703,77,189509
23946,3.4e-05,172.31.40.0-255,66,1769,77,189509
23947,4e-05,172.217.194.0-255,2902,4671,77,189509
23948,4.4e-05,172.31.40.0-255,66,4737,77,189509
23949,5.3e-05,172.217.194.0-255,7156,11893,77,189509
23950,5.6e-05,172.31.40.0-255,66,11959,77,189509
23951,0.000106,172.217.194.0-255,4766,16725,77,189509
23952,0.00011,172.31.40.0-255,66,16791,77,189509
23953,0.000163,172.217.194.0-255,8574,25365,77,189509
23954,0.000166,172.31.40.0-255,66,25431,77,189509
23955,0.000183,172.217.194.0-255,5379,30810,77,189509
23956,0.000186,172.31.40.0-255,66,30876,77,189509
23957,0.000287,172.217.194.0-255,5738,36614,77,189509
23958,0.000292,172.31.40.0-255,66,36680,77,189509
23959,0.000352,172.217.194.0-255,9992,46672,77,189509
23960,0.000356,172.31.40.0-255,66,46738,77,189509
23961,0.000382,172.217.194.0-255,11410,58148,77,189509
23962,0.000386,172.31.40.0-255,66,58214,77,189509
23963,0.000546,172.217.194.0-255,6438,64652,77,189509
23964,0.000552,172.31.40.0-255,66,64718,77,189509
23965,0.000589,172.217.194.0-255,680,65398,77,189509
23966,0.000594,172.31.40.0-255,66,65464,77,189509
23967,0.000615,172.217.194.0-255,9992,75456,77,189509
23968,0.000619,172.31.40.0-255,66,75522,77,189509
23969,0.000663,172.31.40.0-255,66,75588,77,189509
23970,0.0009,172.217.194.0-255,2184,77772,77,189509
23971,0.000905,172.31.40.0-255,66,77838,77,189509
23972,0.000929,172.217.194.0-255,2902,80740,77,189509
23973,0.000933,172.31.40.0-255,66,80806,77,189509
23974,0.000966,172.217.194.0-255,7156,87962,77,189509
23975,0.000968,172.31.40.0-255,66,88028,77,189509
23976,0.001021,172.217.194.0-255,2902,90930,77,189509
23977,0.001025,172.31.40.0-255,66,90996,77,189509
23978,0.001058,172.217.194.0-255,12828,103824,77,189509
23979,0.001062,172.31.40.0-255,66,103890,77,189509
23980,0.001164,172.217.194.0-255,2902,106792,77,189509
23981,0.001168,172.31.40.0-255,66,106858,77,189509
23982,0.001197,172.217.194.0-255,5020,111878,77,189509
23983,0.0012,172.31.40.0-255,66,111944,77,189509
23984,0.00124,172.217.194.0-255,4320,116264,77,189509
23985,0.001243,172.31.40.0-255,66,116330,77,189509
23986,0.001327,172.31.40.0-255,66,116396,77,189509
23987,0.001492,172.217.194.0-255,8574,124970,77,189509
23988,0.001512,172.31.40.0-255,66,125036,77,189509
23989,0.001832,172.217.194.0-255,5020,130056,77,189509
23990,0.001888,172.217.194.0-255,5738,135794,77,189509
23991,0.002218,172.217.194.0-255,2902,138696,77,189509
23992,0.00229,172.217.194.0-255,3602,142298,77,189509
23993,0.002629,172.217.194.0-255,8574,150872,77,189509
23994,0.002661,172.217.194.0-255,12110,162982,77,189509
23995,0.002819,172.217.194.0-255,4320,167302,77,189509
23996,0.003445,172.217.194.0-255,9992,177294,77,189509
23997,0.010464,172.31.40.0-255,66,177360,77,189509
23998,0.010912,172.217.194.0-255,1484,178844,77,189509
23999,0.012746,172.217.194.0-255,4320,183164,77,189509
24000,0.012752,172.31.40.0-255,66,183230,77,189509
24001,0.015037,172.217.194.0-255,5738,188968,77,189509
24002,0.015052,172.31.40.0-255,66,189034,77,189509
24003,0.017326,172.217.194.0-255,475,189509,77,189509
24004,0.0,74.125.24.0-255,153,153,77,215383
24005,1.7e-05,172.31.40.0-255,66,219,77,215383
24006,4.5e-05,74.125.24.0-255,1484,1703,77,215383
24007,5e-05,172.31.40.0-255,66,1769,77,215383
24008,5.5e-05,74.125.24.0-255,2902,4671,77,215383
24009,5.8e-05,172.31.40.0-255,66,4737,77,215383
24010,6.1e-05,74.125.24.0-255,1484,6221,77,215383
24011,6.8e-05,172.31.40.0-255,66,6287,77,215383
24012,8.3e-05,74.125.24.0-255,4320,10607,77,215383
24013,8.6e-05,172.31.40.0-255,66,10673,77,215383
24014,8.9e-05,74.125.24.0-255,1484,12157,77,215383
24015,9.2e-05,172.31.40.0-255,66,12223,77,215383
24016,0.000122,74.125.24.0-255,2037,14260,77,215383
24017,0.000126,172.31.40.0-255,66,14326,77,215383
24018,0.000159,74.125.24.0-255,1484,15810,77,215383
24019,0.000161,172.31.40.0-255,66,15876,77,215383
24020,0.000191,74.125.24.0-255,2902,18778,77,215383
24021,0.000193,172.31.40.0-255,66,18844,77,215383
24022,0.0002,74.125.24.0-255,5738,24582,77,215383
24023,0.000203,172.31.40.0-255,66,24648,77,215383
24024,0.000205,74.125.24.0-255,1484,26132,77,215383
24025,0.000207,172.31.40.0-255,66,26198,77,215383
24026,0.000237,74.125.24.0-255,5379,31577,77,215383
24027,0.000239,172.31.40.0-255,66,31643,77,215383
24028,0.00025,74.125.24.0-255,5738,37381,77,215383
24029,0.000252,172.31.40.0-255,66,37447,77,215383
24030,0.000285,74.125.24.0-255,8574,46021,77,215383
24031,0.000288,172.31.40.0-255,66,46087,77,215383
24032,0.000292,74.125.24.0-255,2543,48630,77,215383
24033,0.000294,172.31.40.0-255,66,48696,77,215383
24034,0.000298,74.125.24.0-255,2902,51598,77,215383
24035,0.000305,172.31.40.0-255,66,51664,77,215383
24036,0.000311,74.125.24.0-255,4320,55984,77,215383
24037,0.000314,172.31.40.0-255,66,56050,77,215383
24038,0.000343,74.125.24.0-255,2902,58952,77,215383
24039,0.000345,172.31.40.0-255,66,59018,77,215383
24040,0.000353,74.125.24.0-255,7075,66093,77,215383
24041,0.000356,172.31.40.0-255,66,66159,77,215383
24042,0.000389,74.125.24.0-255,132,66291,77,215383
24043,0.000394,74.125.24.0-255,342,66633,77,215383
24044,0.000604,74.125.24.0-255,1484,68117,77,215383
24045,0.00061,74.125.24.0-255,2902,71019,77,215383
24046,0.000615,172.31.40.0-255,66,71085,77,215383
24047,0.00062,172.31.40.0-255,66,71151,77,215383
24048,0.000645,74.125.24.0-255,5738,76889,77,215383
24049,0.000648,172.31.40.0-255,66,76955,77,215383
24050,0.000666,74.125.24.0-255,12828,89783,77,215383
24051,0.000669,172.31.40.0-255,66,89849,77,215383
24052,0.000676,74.125.24.0-255,5738,95587,77,215383
24053,0.000678,172.31.40.0-255,66,95653,77,215383
24054,0.000709,74.125.24.0-255,5020,100673,77,215383
24055,0.000717,172.31.40.0-255,66,100739,77,215383
24056,0.001103,74.125.24.0-255,1484,102223,77,215383
24057,0.001109,74.125.24.0-255,2902,105125,77,215383
24058,0.001112,172.31.40.0-255,66,105191,77,215383
24059,0.001117,74.125.24.0-255,2902,108093,77,215383
24060,0.001119,172.31.40.0-255,66,108159,77,215383
24061,0.001152,74.125.24.0-255,2902,111061,77,215383
24062,0.001159,172.31.40.0-255,66,111127,77,215383
24063,0.00117,74.125.24.0-255,12828,123955,77,215383
24064,0.001172,172.31.40.0-255,66,124021,77,215383
24065,0.001179,74.125.24.0-255,7156,131177,77,215383
24066,0.001181,172.31.40.0-255,66,131243,77,215383
24067,0.00124,74.125.24.0-255,3602,134845,77,215383
24068,0.001243,172.31.40.0-255,66,134911,77,215383
24069,0.001382,74.125.24.0-255,1484,136395,77,215383
24070,0.001388,74.125.24.0-255,2902,139297,77,215383
24071,0.001391,172.31.40.0-255,66,139363,77,215383
24072,0.001397,74.125.24.0-255,5738,145101,77,215383
24073,0.0014,172.31.40.0-255,66,145167,77,215383
24074,0.001411,74.125.24.0-255,5738,150905,77,215383
24075,0.001414,172.31.40.0-255,66,150971,77,215383
24076,0.00144,74.125.24.0-255,5738,156709,77,215383
24077,0.001447,172.31.40.0-255,66,156775,77,215383
24078,0.001459,74.125.24.0-255,12110,168885,77,215383
24079,0.001461,172.31.40.0-255,66,168951,77,215383
24080,0.003539,74.125.24.0-255,5738,174689,77,215383
24081,0.003546,172.31.40.0-255,66,174755,77,215383
24082,0.005667,74.125.24.0-255,5738,180493,77,215383
24083,0.005674,172.31.40.0-255,66,180559,77,215383
24084,0.0078,74.125.24.0-255,5738,186297,77,215383
24085,0.007806,172.31.40.0-255,66,186363,77,215383
24086,0.009925,74.125.24.0-255,5738,192101,77,215383
24087,0.009931,172.31.40.0-255,66,192167,77,215383
24088,0.012019,74.125.24.0-255,5738,197905,77,215383
24089,0.012026,172.31.40.0-255,66,197971,77,215383
24090,0.01414,74.125.24.0-255,5738,203709,77,215383
24091,0.014148,172.31.40.0-255,66,203775,77,215383
24092,0.016209,74.125.24.0-255,5738,209513,77,215383
24093,0.016216,172.31.40.0-255,66,209579,77,215383
24094,0.018267,74.125.24.0-255,5738,215317,77,215383
24095,0.018277,172.31.40.0-255,66,215383,77,215383
24096,0.0,74.125.200.0-255,153,153,77,169858
24097,2.3e-05,172.31.40.0-255,66,219,77,169858
24098,3.1e-05,74.125.200.0-255,1484,1703,77,169858
24099,3.5e-05,172.31.40.0-255,66,1769,77,169858
24100,4e-05,74.125.200.0-255,2902,4671,77,169858
24101,4.5e-05,172.31.40.0-255,66,4737,77,169858
24102,4.8e-05,74.125.200.0-255,1484,6221,77,169858
24103,5.1e-05,172.31.40.0-255,66,6287,77,169858
24104,5.7e-05,74.125.200.0-255,2902,9189,77,169858
24105,6e-05,172.31.40.0-255,66,9255,77,169858
24106,8.3e-05,74.125.200.0-255,1484,10739,77,169858
24107,8.6e-05,172.31.40.0-255,66,10805,77,169858
24108,0.00011,74.125.200.0-255,3421,14226,77,169858
24109,0.000112,172.31.40.0-255,66,14292,77,169858
24110,0.000126,74.125.200.0-255,1484,15776,77,169858
24111,0.000128,172.31.40.0-255,66,15842,77,169858
24112,0.000149,74.125.200.0-255,4320,20162,77,169858
24113,0.000152,172.31.40.0-255,66,20228,77,169858
24114,0.000156,74.125.200.0-255,2902,23130,77,169858
24115,0.000158,172.31.40.0-255,66,23196,77,169858
24116,0.000164,74.125.200.0-255,4320,27516,77,169858
24117,0.000166,172.31.40.0-255,66,27582,77,169858
24118,0.000199,74.125.200.0-255,1484,29066,77,169858
24119,0.000201,172.31.40.0-255,66,29132,77,169858
24120,0.000221,74.125.200.0-255,2543,31675,77,169858
24121,0.000223,172.31.40.0-255,66,31741,77,169858
24122,0.00059,74.125.200.0-255,1484,33225,77,169858
24123,0.000595,172.31.40.0-255,66,33291,77,169858
24124,0.000599,74.125.200.0-255,1484,34775,77,169858
24125,0.000601,172.31.40.0-255,66,34841,77,169858
24126,0.000607,74.125.200.0-255,2902,37743,77,169858
24127,0.00061,172.31.40.0-255,66,37809,77,169858
24128,0.000632,74.125.200.0-255,4320,42129,77,169858
24129,0.000638,172.31.40.0-255,66,42195,77,169858
24130,0.000663,74.125.200.0-255,1484,43679,77,169858
24131,0.00067,74.125.200.0-255,5379,49058,77,169858
24132,0.000673,172.31.40.0-255,66,49124,77,169858
24133,0.000691,74.125.200.0-255,1484,50608,77,169858
24134,0.000713,74.125.200.0-255,2902,53510,77,169858
24135,0.000716,172.31.40.0-255,66,53576,77,169858
24136,0.000741,74.125.200.0-255,5738,59314,77,169858
24137,0.000744,172.31.40.0-255,66,59380,77,169858
24138,0.000749,74.125.200.0-255,4320,63700,77,169858
24139,0.000751,172.31.40.0-255,66,63766,77,169858
24140,0.000768,74.125.200.0-255,2543,66309,77,169858
24141,0.000771,172.31.40.0-255,66,66375,77,169858
24142,0.000785,74.125.200.0-255,443,66818,77,169858
24143,0.000829,74.125.200.0-255,331,67149,77,169858
24144,0.001034,74.125.200.0-255,1484,68633,77,169858
24145,0.001039,74.125.200.0-255,2902,71535,77,169858
24146,0.001046,172.31.40.0-255,66,71601,77,169858
24147,0.001068,74.125.200.0-255,4320,75921,77,169858
24148,0.001073,74.125.200.0-255,5738,81659,77,169858
24149,0.001099,74.125.200.0-255,7156,88815,77,169858
24150,0.001124,74.125.200.0-255,4320,93135,77,169858
24151,0.001145,74.125.200.0-255,5738,98873,77,169858
24152,0.001174,74.125.200.0-255,2184,101057,77,169858
24153,0.00141,74.125.200.0-255,1484,102541,77,169858
24154,0.001429,74.125.200.0-255,1484,104025,77,169858
24155,0.001442,74.125.200.0-255,1484,105509,77,169858
24156,0.001457,74.125.200.0-255,5738,111247,77,169858
24157,0.001467,74.125.200.0-255,1484,112731,77,169858
24158,0.001496,74.125.200.0-255,2902,115633,77,169858
24159,0.001508,74.125.200.0-255,2902,118535,77,169858
24160,0.001518,74.125.200.0-255,2902,121437,77,169858
24161,0.001555,74.125.200.0-255,2902,124339,77,169858
24162,0.001569,74.125.200.0-255,4320,128659,77,169858
24163,0.001592,74.125.200.0-255,6438,135097,77,169858
24164,0.00489,172.31.40.0-255,66,135163,77,169858
24165,0.004896,172.31.40.0-255,66,135229,77,169858
24166,0.004899,172.31.40.0-255,66,135295,77,169858
24167,0.004901,172.31.40.0-255,66,135361,77,169858
24168,0.004905,172.31.40.0-255,66,135427,77,169858
24169,0.004916,172.31.40.0-255,66,135493,77,169858
24170,0.004919,172.31.40.0-255,66,135559,77,169858
24171,0.004924,172.31.40.0-255,66,135625,77,169858
24172,0.004927,172.31.40.0-255,66,135691,77,169858
24173,0.00493,172.31.40.0-255,66,135757,77,169858
24174,0.004933,172.31.40.0-255,66,135823,77,169858
24175,0.004936,172.31.40.0-255,66,135889,77,169858
24176,0.004938,172.31.40.0-255,66,135955,77,169858
24177,0.004942,172.31.40.0-255,66,136021,77,169858
24178,0.004945,172.31.40.0-255,66,136087,77,169858
24179,0.007237,74.125.200.0-255,2902,138989,77,169858
24180,0.007243,172.31.40.0-255,66,139055,77,169858
24181,0.00726,74.125.200.0-255,2902,141957,77,169858
24182,0.007263,172.31.40.0-255,66,142023,77,169858
24183,0.007321,172.31.40.0-255,101,142124,77,169858
24184,0.009521,74.125.200.0-255,5738,147862,77,169858
24185,0.009529,172.31.40.0-255,66,147928,77,169858
24186,0.009552,74.125.200.0-255,66,147994,77,169858
24187,0.011809,74.125.200.0-255,4320,152314,77,169858
24188,0.011816,172.31.40.0-255,66,152380,77,169858
24189,0.011835,74.125.200.0-255,1484,153864,77,169858
24190,0.014092,74.125.200.0-255,4320,158184,77,169858
24191,0.014102,172.31.40.0-255,66,158250,77,169858
24192,0.016378,74.125.200.0-255,5738,163988,77,169858
24193,0.016387,172.31.40.0-255,66,164054,77,169858
24194,0.018656,74.125.200.0-255,5738,169792,77,169858
24195,0.018663,172.31.40.0-255,66,169858,77,169858
24196,0.0,74.125.68.0-255,153,153,77,239815
24197,1.5e-05,172.31.40.0-255,66,219,77,239815
24198,2.2e-05,74.125.68.0-255,1484,1703,77,239815
24199,2.7e-05,172.31.40.0-255,66,1769,77,239815
24200,6.5e-05,74.125.68.0-255,2902,4671,77,239815
24201,6.8e-05,172.31.40.0-255,66,4737,77,239815
24202,7.4e-05,74.125.68.0-255,4320,9057,77,239815
24203,7.6e-05,172.31.40.0-255,66,9123,77,239815
24204,9.7e-05,74.125.68.0-255,4866,13989,77,239815
24205,0.0001,172.31.40.0-255,66,14055,77,239815
24206,0.000139,74.125.68.0-255,1484,15539,77,239815
24207,0.000142,172.31.40.0-255,66,15605,77,239815
24208,0.000158,74.125.68.0-255,2902,18507,77,239815
24209,0.00016,172.31.40.0-255,66,18573,77,239815
24210,0.000193,74.125.68.0-255,5738,24311,77,239815
24211,0.000195,172.31.40.0-255,66,24377,77,239815
24212,0.000203,74.125.68.0-255,5738,30115,77,239815
24213,0.000206,172.31.40.0-255,66,30181,77,239815
24214,0.000231,74.125.68.0-255,4320,34501,77,239815
24215,0.000234,172.31.40.0-255,66,34567,77,239815
24216,0.000257,74.125.68.0-255,2543,37110,77,239815
24217,0.00026,172.31.40.0-255,66,37176,77,239815
24218,0.000265,74.125.68.0-255,2902,40078,77,239815
24219,0.000267,172.31.40.0-255,66,40144,77,239815
24220,0.000311,74.125.68.0-255,8215,48359,77,239815
24221,0.000314,172.31.40.0-255,66,48425,77,239815
24222,0.000687,74.125.68.0-255,1484,49909,77,239815
24223,0.000694,172.31.40.0-255,66,49975,77,239815
24224,0.0007,74.125.68.0-255,2902,52877,77,239815
24225,0.000703,172.31.40.0-255,66,52943,77,239815
24226,0.000706,74.125.68.0-255,1484,54427,77,239815
24227,0.000709,172.31.40.0-255,66,54493,77,239815
24228,0.000729,74.125.68.0-255,2902,57395,77,239815
24229,0.000732,172.31.40.0-255,66,57461,77,239815
24230,0.000759,74.125.68.0-255,7156,64617,77,239815
24231,0.000762,172.31.40.0-255,66,64683,77,239815
24232,0.000782,74.125.68.0-255,1125,65808,77,239815
24233,0.000785,74.125.68.0-255,647,66455,77,239815
24234,0.000788,172.31.40.0-255,66,66521,77,239815
24235,0.000984,74.125.68.0-255,1484,68005,77,239815
24236,0.000991,74.125.68.0-255,2902,70907,77,239815
24237,0.000996,172.31.40.0-255,66,70973,77,239815
24238,0.001,74.125.68.0-255,1484,72457,77,239815
24239,0.001013,74.125.68.0-255,2902,75359,77,239815
24240,0.001016,172.31.40.0-255,66,75425,77,239815
24241,0.001047,74.125.68.0-255,5738,81163,77,239815
24242,0.001053,172.31.40.0-255,66,81229,77,239815
24243,0.001061,74.125.68.0-255,1484,82713,77,239815
24244,0.001074,74.125.68.0-255,2902,85615,77,239815
24245,0.001076,172.31.40.0-255,66,85681,77,239815
24246,0.001123,74.125.68.0-255,4320,90001,77,239815
24247,0.001125,172.31.40.0-255,66,90067,77,239815
24248,0.001139,74.125.68.0-255,1484,91551,77,239815
24249,0.001144,74.125.68.0-255,2902,94453,77,239815
24250,0.001146,172.31.40.0-255,66,94519,77,239815
24251,0.001152,74.125.68.0-255,4320,98839,77,239815
24252,0.001154,172.31.40.0-255,66,98905,77,239815
24253,0.001158,74.125.68.0-255,2184,101089,77,239815
24254,0.001161,172.31.40.0-255,66,101155,77,239815
24255,0.001236,74.125.68.0-255,1484,102639,77,239815
24256,0.001242,74.125.68.0-255,2902,105541,77,239815
24257,0.001245,172.31.40.0-255,66,105607,77,239815
24258,0.001248,74.125.68.0-255,1484,107091,77,239815
24259,0.001267,74.125.68.0-255,2902,109993,77,239815
24260,0.001269,172.31.40.0-255,66,110059,77,239815
24261,0.001284,74.125.68.0-255,4320,114379,77,239815
24262,0.001287,172.31.40.0-255,66,114445,77,239815
24263,0.001308,74.125.68.0-255,1484,115929,77,239815
24264,0.001312,74.125.68.0-255,1484,117413,77,239815
24265,0.001315,172.31.40.0-255,66,117479,77,239815
24266,0.001354,74.125.68.0-255,1484,118963,77,239815
24267,0.001368,74.125.68.0-255,2902,121865,77,239815
24268,0.001372,172.31.40.0-255,66,121931,77,239815
24269,0.001384,74.125.68.0-255,1484,123415,77,239815
24270,0.001403,74.125.68.0-255,4320,127735,77,239815
24271,0.001406,172.31.40.0-255,66,127801,77,239815
24272,0.001411,74.125.68.0-255,4320,132121,77,239815
24273,0.001414,172.31.40.0-255,66,132187,77,239815
24274,0.001437,74.125.68.0-255,1484,133671,77,239815
24275,0.001459,74.125.68.0-255,2184,135855,77,239815
24276,0.001462,172.31.40.0-255,66,135921,77,239815
24277,0.001514,74.125.68.0-255,1484,137405,77,239815
24278,0.001529,74.125.68.0-255,1484,138889,77,239815
24279,0.001532,172.31.40.0-255,66,138955,77,239815
24280,0.00155,74.125.68.0-255,1484,140439,77,239815
24281,0.001558,74.125.68.0-255,5738,146177,77,239815
24282,0.00156,172.31.40.0-255,66,146243,77,239815
24283,0.001565,74.125.68.0-255,2902,149145,77,239815
24284,0.001567,172.31.40.0-255,66,149211,77,239815
24285,0.001571,74.125.68.0-255,1484,150695,77,239815
24286,0.001592,74.125.68.0-255,2902,153597,77,239815
24287,0.001595,172.31.40.0-255,66,153663,77,239815
24288,0.001601,74.125.68.0-255,4320,157983,77,239815
24289,0.001603,172.31.40.0-255,66,158049,77,239815
24290,0.001624,74.125.68.0-255,4320,162369,77,239815
24291,0.001627,172.31.40.0-255,66,162435,77,239815
24292,0.001634,74.125.68.0-255,5738,168173,77,239815
24293,0.001635,172.31.40.0-255,66,168239,77,239815
24294,0.001671,74.125.68.0-255,2184,170423,77,239815
24295,0.001674,172.31.40.0-255,66,170489,77,239815
24296,0.001707,74.125.68.0-255,2902,173391,77,239815
24297,0.00171,172.31.40.0-255,66,173457,77,239815
24298,0.001724,74.125.68.0-255,1484,174941,77,239815
24299,0.001745,74.125.68.0-255,2902,177843,77,239815
24300,0.001748,172.31.40.0-255,66,177909,77,239815
24301,0.001768,74.125.68.0-255,2902,180811,77,239815
24302,0.001771,172.31.40.0-255,66,180877,77,239815
24303,0.001787,74.125.68.0-255,2902,183779,77,239815
24304,0.00179,74.125.68.0-255,1484,185263,77,239815
24305,0.001799,74.125.68.0-255,8574,193837,77,239815
24306,0.001803,172.31.40.0-255,66,193903,77,239815
24307,0.001811,172.31.40.0-255,66,193969,77,239815
24308,0.001825,74.125.68.0-255,4320,198289,77,239815
24309,0.001827,172.31.40.0-255,66,198355,77,239815
24310,0.001847,74.125.68.0-255,2902,201257,77,239815
24311,0.00185,172.31.40.0-255,66,201323,77,239815
24312,0.001871,74.125.68.0-255,3602,204925,77,239815
24313,0.001873,172.31.40.0-255,66,204991,77,239815
24314,0.004457,74.125.68.0-255,5738,210729,77,239815
24315,0.004464,172.31.40.0-255,66,210795,77,239815
24316,0.007045,74.125.68.0-255,5738,216533,77,239815
24317,0.007049,172.31.40.0-255,66,216599,77,239815
24318,0.009657,74.125.68.0-255,5738,222337,77,239815
24319,0.009664,172.31.40.0-255,66,222403,77,239815
24320,0.012259,74.125.68.0-255,5738,228141,77,239815
24321,0.012268,172.31.40.0-255,66,228207,77,239815
24322,0.014867,74.125.68.0-255,5738,233945,77,239815
24323,0.014874,172.31.40.0-255,66,234011,77,239815
24324,0.017446,74.125.68.0-255,5738,239749,77,239815
24325,0.017452,172.31.40.0-255,66,239815,77,239815
24326,0.0,74.125.24.0-255,153,153,77,223971
24327,3.3e-05,172.31.40.0-255,66,219,77,223971
24328,4.1e-05,74.125.24.0-255,1484,1703,77,223971
24329,4.8e-05,172.31.40.0-255,66,1769,77,223971
24330,6.1e-05,74.125.24.0-255,2902,4671,77,223971
24331,6.4e-05,172.31.40.0-255,66,4737,77,223971
24332,7.1e-05,74.125.24.0-255,4320,9057,77,223971
24333,7.3e-05,172.31.40.0-255,66,9123,77,223971
24334,8e-05,74.125.24.0-255,4904,14027,77,223971
24335,8.4e-05,172.31.40.0-255,66,14093,77,223971
24336,0.000123,74.125.24.0-255,1484,15577,77,223971
24337,0.000126,172.31.40.0-255,66,15643,77,223971
24338,0.000131,74.125.24.0-255,2902,18545,77,223971
24339,0.000133,172.31.40.0-255,66,18611,77,223971
24340,0.000174,74.125.24.0-255,5738,24349,77,223971
24341,0.000177,172.31.40.0-255,66,24415,77,223971
24342,0.00018,74.125.24.0-255,1484,25899,77,223971
24343,0.000182,172.31.40.0-255,66,25965,77,223971
24344,0.000214,74.125.24.0-255,5379,31344,77,223971
24345,0.000217,172.31.40.0-255,66,31410,77,223971
24346,0.000249,74.125.24.0-255,7156,38566,77,223971
24347,0.000252,172.31.40.0-255,66,38632,77,223971
24348,0.000315,74.125.24.0-255,2902,41534,77,223971
24349,0.000319,172.31.40.0-255,66,41600,77,223971
24350,0.000354,74.125.24.0-255,6797,48397,77,223971
24351,0.000357,172.31.40.0-255,66,48463,77,223971
24352,0.000381,74.125.24.0-255,5738,54201,77,223971
24353,0.000384,172.31.40.0-255,66,54267,77,223971
24354,0.000413,74.125.24.0-255,5738,60005,77,223971
24355,0.000416,172.31.40.0-255,66,60071,77,223971
24356,0.000447,74.125.24.0-255,5654,65725,77,223971
24357,0.000449,172.31.40.0-255,66,65791,77,223971
24358,0.000495,74.125.24.0-255,412,66203,77,223971
24359,0.000566,74.125.24.0-255,1484,67687,77,223971
24360,0.000569,172.31.40.0-255,66,67753,77,223971
24361,0.000575,74.125.24.0-255,2902,70655,77,223971
24362,0.000577,172.31.40.0-255,66,70721,77,223971
24363,0.000628,74.125.24.0-255,5738,76459,77,223971
24364,0.000631,172.31.40.0-255,66,76525,77,223971
24365,0.000636,74.125.24.0-255,2902,79427,77,223971
24366,0.000639,172.31.40.0-255,66,79493,77,223971
24367,0.000675,74.125.24.0-255,9992,89485,77,223971
24368,0.000678,172.31.40.0-255,66,89551,77,223971
24369,0.000737,74.125.24.0-255,5738,95289,77,223971
24370,0.000741,172.31.40.0-255,66,95355,77,223971
24371,0.000767,74.125.24.0-255,1484,96839,77,223971
24372,0.000782,74.125.24.0-255,3602,100441,77,223971
24373,0.000785,172.31.40.0-255,66,100507,77,223971
24374,0.001169,74.125.24.0-255,1484,101991,77,223971
24375,0.001177,74.125.24.0-255,2902,104893,77,223971
24376,0.00118,172.31.40.0-255,66,104959,77,223971
24377,0.001187,74.125.24.0-255,4320,109279,77,223971
24378,0.001189,172.31.40.0-255,66,109345,77,223971
24379,0.00123,74.125.24.0-255,8574,117919,77,223971
24380,0.001233,172.31.40.0-255,66,117985,77,223971
24381,0.001293,74.125.24.0-255,8574,126559,77,223971
24382,0.001298,172.31.40.0-255,66,126625,77,223971
24383,0.00133,74.125.24.0-255,7856,134481,77,223971
24384,0.001334,172.31.40.0-255,66,134547,77,223971
24385,0.001412,74.125.24.0-255,2902,137449,77,223971
24386,0.001417,172.31.40.0-255,66,137515,77,223971
24387,0.001436,74.125.24.0-255,1484,138999,77,223971
24388,0.001467,74.125.24.0-255,8574,147573,77,223971
24389,0.00147,172.31.40.0-255,66,147639,77,223971
24390,0.001505,74.125.24.0-255,11410,159049,77,223971
24391,0.001508,172.31.40.0-255,66,159115,77,223971
24392,0.001604,74.125.24.0-255,2902,162017,77,223971
24393,0.001609,172.31.40.0-255,66,162083,77,223971
24394,0.001644,74.125.24.0-255,6438,168521,77,223971
24395,0.001647,172.31.40.0-255,66,168587,77,223971
24396,0.001688,172.31.40.0-255,66,168653,77,223971
24397,0.001721,172.31.40.0-255,66,168719,77,223971
24398,0.001913,74.125.24.0-255,6438,175157,77,223971
24399,0.001919,172.31.40.0-255,66,175223,77,223971
24400,0.001955,74.125.24.0-255,1484,176707,77,223971
24401,0.002,172.31.40.0-255,66,176773,77,223971
24402,0.002181,74.125.24.0-255,5738,182511,77,223971
24403,0.002186,172.31.40.0-255,66,182577,77,223971
24404,0.002229,172.31.40.0-255,66,182643,77,223971
24405,0.002267,74.125.24.0-255,12110,194753,77,223971
24406,0.002271,172.31.40.0-255,66,194819,77,223971
24407,0.002447,172.31.40.0-255,66,194885,77,223971
24408,0.008538,172.31.40.0-255,66,194951,77,223971
24409,0.010665,74.125.24.0-255,5738,200689,77,223971
24410,0.010682,172.31.40.0-255,66,200755,77,223971
24411,0.012793,74.125.24.0-255,5738,206493,77,223971
24412,0.012812,172.31.40.0-255,66,206559,77,223971
24413,0.014943,74.125.24.0-255,5738,212297,77,223971
24414,0.014961,172.31.40.0-255,66,212363,77,223971
24415,0.017078,74.125.24.0-255,5738,218101,77,223971
24416,0.017096,172.31.40.0-255,66,218167,77,223971
24417,0.01921,74.125.24.0-255,5738,223905,77,223971
24418,0.019232,172.31.40.0-255,66,223971,77,223971
24419,0.0,74.125.24.0-255,147,147,77,328130
24420,2.4e-05,172.31.40.0-255,66,213,77,328130
24421,3.2e-05,74.125.24.0-255,1484,1697,77,328130
24422,3.7e-05,172.31.40.0-255,66,1763,77,328130
24423,4.3e-05,74.125.24.0-255,2902,4665,77,328130
24424,6e-05,172.31.40.0-255,66,4731,77,328130
24425,6.7e-05,74.125.24.0-255,7156,11887,77,328130
24426,7.1e-05,172.31.40.0-255,66,11953,77,328130
24427,7.4e-05,74.125.24.0-255,1484,13437,77,328130
24428,7.8e-05,172.31.40.0-255,66,13503,77,328130
24429,0.00012,74.125.24.0-255,7156,20659,77,328130
24430,0.000123,172.31.40.0-255,66,20725,77,328130
24431,0.00015,74.125.24.0-255,3453,24178,77,328130
24432,0.000152,172.31.40.0-255,66,24244,77,328130
24433,0.000159,74.125.24.0-255,7156,31400,77,328130
24434,0.000162,172.31.40.0-255,66,31466,77,328130
24435,0.000177,172.31.40.0-255,66,31532,77,328130
24436,0.000193,172.31.40.0-255,66,31598,77,328130
24437,0.000196,74.125.24.0-255,360,31958,77,328130
24438,0.000198,172.31.40.0-255,66,32024,77,328130
24439,0.000545,74.125.24.0-255,1484,33508,77,328130
24440,0.000551,172.31.40.0-255,66,33574,77,328130
24441,0.000557,74.125.24.0-255,2902,36476,77,328130
24442,0.000559,172.31.40.0-255,66,36542,77,328130
24443,0.000562,74.125.24.0-255,1484,38026,77,328130
24444,0.000564,172.31.40.0-255,66,38092,77,328130
24445,0.000587,74.125.24.0-255,4320,42412,77,328130
24446,0.00059,172.31.40.0-255,66,42478,77,328130
24447,0.000597,74.125.24.0-255,6797,49275,77,328130
24448,0.000599,172.31.40.0-255,66,49341,77,328130
24449,0.000625,74.125.24.0-255,5738,55079,77,328130
24450,0.000633,172.31.40.0-255,66,55145,77,328130
24451,0.000642,74.125.24.0-255,1484,56629,77,328130
24452,0.000649,74.125.24.0-255,5738,62367,77,328130
24453,0.000666,74.125.24.0-255,3698,66065,77,328130
24454,0.000677,172.31.40.0-255,66,66131,77,328130
24455,0.000852,74.125.24.0-255,1484,67615,77,328130
24456,0.000856,74.125.24.0-255,1484,69099,77,328130
24457,0.000865,74.125.24.0-255,1484,70583,77,328130
24458,0.000868,74.125.24.0-255,1484,72067,77,328130
24459,0.000872,172.31.40.0-255,66,72133,77,328130
24460,0.000892,74.125.24.0-255,4320,76453,77,328130
24461,0.0009,74.125.24.0-255,6683,83136,77,328130
24462,0.000911,172.31.40.0-255,66,83202,77,328130
24463,0.001156,74.125.24.0-255,1484,84686,77,328130
24464,0.001161,74.125.24.0-255,2902,87588,77,328130
24465,0.001163,172.31.40.0-255,66,87654,77,328130
24466,0.001167,74.125.24.0-255,2902,90556,77,328130
24467,0.001173,172.31.40.0-255,66,90622,77,328130
24468,0.001184,74.125.24.0-255,2902,93524,77,328130
24469,0.001196,74.125.24.0-255,1484,95008,77,328130
24470,0.001209,172.31.40.0-255,66,95074,77,328130
24471,0.001215,74.125.24.0-255,5502,100576,77,328130
24472,0.001219,172.31.40.0-255,66,100642,77,328130
24473,0.001257,74.125.24.0-255,1484,102126,77,328130
24474,0.001276,74.125.24.0-255,2902,105028,77,328130
24475,0.001279,172.31.40.0-255,66,105094,77,328130
24476,0.001304,74.125.24.0-255,5738,110832,77,328130
24477,0.00131,172.31.40.0-255,66,110898,77,328130
24478,0.001338,74.125.24.0-255,12828,123726,77,328130
24479,0.001343,172.31.40.0-255,66,123792,77,328130
24480,0.001365,74.125.24.0-255,5738,129530,77,328130
24481,0.001378,74.125.24.0-255,5020,134550,77,328130
24482,0.001382,172.31.40.0-255,66,134616,77,328130
24483,0.001809,74.125.24.0-255,1484,136100,77,328130
24484,0.001823,74.125.24.0-255,2902,139002,77,328130
24485,0.001827,172.31.40.0-255,66,139068,77,328130
24486,0.001848,74.125.24.0-255,5738,144806,77,328130
24487,0.001854,172.31.40.0-255,66,144872,77,328130
24488,0.00187,74.125.24.0-255,4320,149192,77,328130
24489,0.001876,172.31.40.0-255,66,149258,77,328130
24490,0.001891,74.125.24.0-255,8574,157832,77,328130
24491,0.001904,172.31.40.0-255,66,157898,77,328130
24492,0.001915,74.125.24.0-255,4320,162218,77,328130
24493,0.001919,172.31.40.0-255,66,162284,77,328130
24494,0.001938,74.125.24.0-255,6438,168722,77,328130
24495,0.001967,172.31.40.0-255,66,168788,77,328130
24496,0.001988,74.125.24.0-255,11410,180198,77,328130
24497,0.001993,74.125.24.0-255,5738,185936,77,328130
24498,0.001997,172.31.40.0-255,66,186002,77,328130
24499,0.002026,74.125.24.0-255,4320,190322,77,328130
24500,0.002048,74.125.24.0-255,12110,202432,77,328130
24501,0.002074,172.31.40.0-255,66,202498,77,328130
24502,0.002088,74.125.24.0-255,12828,215326,77,328130
24503,0.002102,74.125.24.0-255,1484,216810,77,328130
24504,0.002117,74.125.24.0-255,4320,221130,77,328130
24505,0.002139,74.125.24.0-255,6438,227568,77,328130
24506,0.002147,74.125.24.0-255,11410,238978,77,328130
24507,0.00218,74.125.24.0-255,13528,252506,77,328130
24508,0.002235,74.125.24.0-255,11410,263916,77,328130
24509,0.002265,74.125.24.0-255,4320,268236,77,328130
24510,0.002301,74.125.24.0-255,7856,276092,77,328130
24511,0.002311,74.125.24.0-255,12828,288920,77,328130
24512,0.002315,74.125.24.0-255,4320,293240,77,328130
24513,0.005244,172.31.40.0-255,66,293306,77,328130
24514,0.007489,74.125.24.0-255,5738,299044,77,328130
24515,0.007496,172.31.40.0-255,66,299110,77,328130
24516,0.009718,74.125.24.0-255,5738,304848,77,328130
24517,0.009723,172.31.40.0-255,66,304914,77,328130
24518,0.011983,74.125.24.0-255,5738,310652,77,328130
24519,0.012002,172.31.40.0-255,66,310718,77,328130
24520,0.014256,74.125.24.0-255,5738,316456,77,328130
24521,0.014265,172.31.40.0-255,66,316522,77,328130
24522,0.01656,74.125.24.0-255,5738,322260,77,328130
24523,0.017555,172.31.40.0-255,66,322326,77,328130
24524,0.019812,74.125.24.0-255,5738,328064,77,328130
24525,0.019823,172.31.40.0-255,66,328130,77,328130
24526,0.0,74.125.130.0-255,153,153,77,243568
24527,4.4e-05,172.31.40.0-255,66,219,77,243568
24528,5.2e-05,74.125.130.0-255,1484,1703,77,243568
24529,5.7e-05,172.31.40.0-255,66,1769,77,243568
24530,6.2e-05,74.125.130.0-255,2902,4671,77,243568
24531,6.6e-05,172.31.40.0-255,66,4737,77,243568
24532,7.2e-05,74.125.130.0-255,4320,9057,77,243568
24533,7.5e-05,172.31.40.0-255,66,9123,77,243568
24534,8.5e-05,74.125.130.0-255,9154,18277,77,243568
24535,8.7e-05,172.31.40.0-255,66,18343,77,243568
24536,0.000121,74.125.130.0-255,9992,28335,77,243568
24537,0.000124,172.31.40.0-255,66,28401,77,243568
24538,0.00013,74.125.130.0-255,4320,32721,77,243568
24539,0.000132,172.31.40.0-255,66,32787,77,243568
24540,0.000139,74.125.130.0-255,5738,38525,77,243568
24541,0.000141,172.31.40.0-255,66,38591,77,243568
24542,0.000189,74.125.130.0-255,9274,47865,77,243568
24543,0.000191,172.31.40.0-255,66,47931,77,243568
24544,0.000222,74.125.130.0-255,9992,57923,77,243568
24545,0.000224,172.31.40.0-255,66,57989,77,243568
24546,0.000229,74.125.130.0-255,2902,60891,77,243568
24547,0.000231,172.31.40.0-255,66,60957,77,243568
24548,0.000253,74.125.130.0-255,2902,63859,77,243568
24549,0.000255,172.31.40.0-255,66,63925,77,243568
24550,0.000268,74.125.130.0-255,1434,65359,77,243568
24551,0.000271,172.31.40.0-255,66,65425,77,243568
24552,0.000499,74.125.130.0-255,1484,66909,77,243568
24553,0.000504,172.31.40.0-255,66,66975,77,243568
24554,0.000522,74.125.130.0-255,2902,69877,77,243568
24555,0.000526,172.31.40.0-255,66,69943,77,243568
24556,0.000549,74.125.130.0-255,4320,74263,77,243568
24557,0.000552,172.31.40.0-255,66,74329,77,243568
24558,0.000574,74.125.130.0-255,7156,81485,77,243568
24559,0.000577,172.31.40.0-255,66,81551,77,243568
24560,0.000604,74.125.130.0-255,1484,83035,77,243568
24561,0.000611,74.125.130.0-255,4320,87355,77,243568
24562,0.000613,172.31.40.0-255,66,87421,77,243568
24563,0.000619,74.125.130.0-255,5738,93159,77,243568
24564,0.000621,172.31.40.0-255,66,93225,77,243568
24565,0.000624,74.125.130.0-255,1484,94709,77,243568
24566,0.000652,74.125.130.0-255,2902,97611,77,243568
24567,0.000654,172.31.40.0-255,66,97677,77,243568
24568,0.000685,74.125.130.0-255,2184,99861,77,243568
24569,0.000688,172.31.40.0-255,66,99927,77,243568
24570,0.000858,74.125.130.0-255,1484,101411,77,243568
24571,0.000909,74.125.130.0-255,2902,104313,77,243568
24572,0.000912,172.31.40.0-255,66,104379,77,243568
24573,0.000918,74.125.130.0-255,2902,107281,77,243568
24574,0.00092,172.31.40.0-255,66,107347,77,243568
24575,0.000925,74.125.130.0-255,4320,111667,77,243568
24576,0.000927,172.31.40.0-255,66,111733,77,243568
24577,0.000936,74.125.130.0-255,8574,120307,77,243568
24578,0.000939,172.31.40.0-255,66,120373,77,243568
24579,0.000966,74.125.130.0-255,7156,127529,77,243568
24580,0.00097,172.31.40.0-255,66,127595,77,243568
24581,0.000993,74.125.130.0-255,6438,134033,77,243568
24582,0.000996,172.31.40.0-255,66,134099,77,243568
24583,0.001041,74.125.130.0-255,7156,141255,77,243568
24584,0.001044,172.31.40.0-255,66,141321,77,243568
24585,0.001073,74.125.130.0-255,8574,149895,77,243568
24586,0.001076,172.31.40.0-255,66,149961,77,243568
24587,0.001079,74.125.130.0-255,1484,151445,77,243568
24588,0.001097,74.125.130.0-255,4320,155765,77,243568
24589,0.001099,172.31.40.0-255,66,155831,77,243568
24590,0.00112,74.125.130.0-255,5738,161569,77,243568
24591,0.001122,172.31.40.0-255,66,161635,77,243568
24592,0.001136,74.125.130.0-255,1484,163119,77,243568
24593,0.001152,74.125.130.0-255,5020,168139,77,243568
24594,0.001155,172.31.40.0-255,66,168205,77,243568
24595,0.001941,74.125.130.0-255,1484,169689,77,243568
24596,0.001949,74.125.130.0-255,2902,172591,77,243568
24597,0.001955,172.31.40.0-255,66,172657,77,243568
24598,0.001961,74.125.130.0-255,4320,176977,77,243568
24599,0.001964,172.31.40.0-255,66,177043,77,243568
24600,0.001979,74.125.130.0-255,4320,181363,77,243568
24601,0.001982,172.31.40.0-255,66,181429,77,243568
24602,0.002002,74.125.130.0-255,4320,185749,77,243568
24603,0.002004,172.31.40.0-255,66,185815,77,243568
24604,0.002011,74.125.130.0-255,5738,191553,77,243568
24605,0.002013,172.31.40.0-255,66,191619,77,243568
24606,0.002019,74.125.130.0-255,4320,195939,77,243568
24607,0.002021,172.31.40.0-255,66,196005,77,243568
24608,0.002039,74.125.130.0-255,2902,198907,77,243568
24609,0.002041,172.31.40.0-255,66,198973,77,243568
24610,0.002044,74.125.130.0-255,1484,200457,77,243568
24611,0.002062,74.125.130.0-255,2184,202641,77,243568
24612,0.002065,172.31.40.0-255,66,202707,77,243568
24613,0.004549,74.125.130.0-255,1484,204191,77,243568
24614,0.004574,74.125.130.0-255,4320,208511,77,243568
24615,0.004579,172.31.40.0-255,66,208577,77,243568
24616,0.007101,74.125.130.0-255,5738,214315,77,243568
24617,0.007109,172.31.40.0-255,66,214381,77,243568
24618,0.00963,74.125.130.0-255,5738,220119,77,243568
24619,0.009637,172.31.40.0-255,66,220185,77,243568
24620,0.01006,172.31.40.0-255,101,220286,77,243568
24621,0.012162,74.125.130.0-255,5738,226024,77,243568
24622,0.012169,172.31.40.0-255,66,226090,77,243568
24623,0.012549,74.125.130.0-255,66,226156,77,243568
24624,0.014705,74.125.130.0-255,5738,231894,77,243568
24625,0.014713,172.31.40.0-255,66,231960,77,243568
24626,0.01724,74.125.130.0-255,5738,237698,77,243568
24627,0.017247,172.31.40.0-255,66,237764,77,243568
24628,0.019791,74.125.130.0-255,5738,243502,77,243568
24629,0.019798,172.31.40.0-255,66,243568,77,243568
24630,0.0,74.125.24.0-255,146,146,77,313347
24631,2.4e-05,172.31.40.0-255,66,212,77,313347
24632,3e-05,74.125.24.0-255,1484,1696,77,313347
24633,3.5e-05,172.31.40.0-255,66,1762,77,313347
24634,4.1e-05,74.125.24.0-255,2902,4664,77,313347
24635,5.4e-05,172.31.40.0-255,66,4730,77,313347
24636,6e-05,74.125.24.0-255,5738,10468,77,313347
24637,6.3e-05,172.31.40.0-255,66,10534,77,313347
24638,6.8e-05,74.125.24.0-255,3407,13941,77,313347
24639,7e-05,172.31.40.0-255,66,14007,77,313347
24640,0.000128,74.125.24.0-255,1484,15491,77,313347
24641,0.000132,172.31.40.0-255,66,15557,77,313347
24642,0.000137,74.125.24.0-255,2902,18459,77,313347
24643,0.000139,172.31.40.0-255,66,18525,77,313347
24644,0.000142,74.125.24.0-255,1484,20009,77,313347
24645,0.000144,172.31.40.0-255,66,20075,77,313347
24646,0.000177,74.125.24.0-255,4320,24395,77,313347
24647,0.00018,172.31.40.0-255,66,24461,77,313347
24648,0.000188,74.125.24.0-255,6797,31258,77,313347
24649,0.00019,172.31.40.0-255,66,31324,77,313347
24650,0.000482,74.125.24.0-255,1484,32808,77,313347
24651,0.000488,172.31.40.0-255,66,32874,77,313347
24652,0.000495,74.125.24.0-255,2902,35776,77,313347
24653,0.000497,172.31.40.0-255,66,35842,77,313347
24654,0.000504,74.125.24.0-255,5738,41580,77,313347
24655,0.000512,172.31.40.0-255,66,41646,77,313347
24656,0.000518,74.125.24.0-255,4320,45966,77,313347
24657,0.000521,172.31.40.0-255,66,46032,77,313347
24658,0.000546,74.125.24.0-255,2543,48575,77,313347
24659,0.000549,172.31.40.0-255,66,48641,77,313347
24660,0.000564,172.31.40.0-255,66,48707,77,313347
24661,0.000573,74.125.24.0-255,2815,51522,77,313347
24662,0.000576,172.31.40.0-255,66,51588,77,313347
24663,0.000602,74.125.24.0-255,385,51973,77,313347
24664,0.000851,74.125.24.0-255,1484,53457,77,313347
24665,0.000855,172.31.40.0-255,66,53523,77,313347
24666,0.000861,74.125.24.0-255,2902,56425,77,313347
24667,0.000863,172.31.40.0-255,66,56491,77,313347
24668,0.000868,74.125.24.0-255,2902,59393,77,313347
24669,0.000875,172.31.40.0-255,66,59459,77,313347
24670,0.000914,74.125.24.0-255,2902,62361,77,313347
24671,0.000917,172.31.40.0-255,66,62427,77,313347
24672,0.000928,74.125.24.0-255,12828,75255,77,313347
24673,0.00093,172.31.40.0-255,66,75321,77,313347
24674,0.000945,74.125.24.0-255,10692,86013,77,313347
24675,0.000948,172.31.40.0-255,66,86079,77,313347
24676,0.000983,74.125.24.0-255,9992,96071,77,313347
24677,0.000987,172.31.40.0-255,66,96137,77,313347
24678,0.000994,74.125.24.0-255,7156,103293,77,313347
24679,0.000996,172.31.40.0-255,66,103359,77,313347
24680,0.001016,74.125.24.0-255,4320,107679,77,313347
24681,0.001019,172.31.40.0-255,66,107745,77,313347
24682,0.001034,74.125.24.0-255,12110,119855,77,313347
24683,0.001037,172.31.40.0-255,66,119921,77,313347
24684,0.001078,74.125.24.0-255,12828,132749,77,313347
24685,0.001081,172.31.40.0-255,66,132815,77,313347
24686,0.00109,74.125.24.0-255,9992,142807,77,313347
24687,0.001092,172.31.40.0-255,66,142873,77,313347
24688,0.001107,74.125.24.0-255,10692,153565,77,313347
24689,0.00111,172.31.40.0-255,66,153631,77,313347
24690,0.001175,74.125.24.0-255,1484,155115,77,313347
24691,0.00118,74.125.24.0-255,2902,158017,77,313347
24692,0.001183,172.31.40.0-255,66,158083,77,313347
24693,0.00119,74.125.24.0-255,5738,163821,77,313347
24694,0.001192,172.31.40.0-255,66,163887,77,313347
24695,0.001225,74.125.24.0-255,4320,168207,77,313347
24696,0.001227,172.31.40.0-255,66,168273,77,313347
24697,0.00126,74.125.24.0-255,8574,176847,77,313347
24698,0.001263,172.31.40.0-255,66,176913,77,313347
24699,0.001298,74.125.24.0-255,10692,187605,77,313347
24700,0.001306,172.31.40.0-255,66,187671,77,313347
24701,0.001335,74.125.24.0-255,8574,196245,77,313347
24702,0.001346,74.125.24.0-255,9992,206237,77,313347
24703,0.001393,172.31.40.0-255,66,206303,77,313347
24704,0.001467,74.125.24.0-255,6438,212741,77,313347
24705,0.001469,74.125.24.0-255,1484,214225,77,313347
24706,0.001472,74.125.24.0-255,1484,215709,77,313347
24707,0.001485,172.31.40.0-255,66,215775,77,313347
24708,0.001489,74.125.24.0-255,1484,217259,77,313347
24709,0.001495,74.125.24.0-255,5738,222997,77,313347
24710,0.001515,74.125.24.0-255,2902,225899,77,313347
24711,0.001537,74.125.24.0-255,9992,235891,77,313347
24712,0.001546,74.125.24.0-255,9992,245883,77,313347
24713,0.001559,172.31.40.0-255,66,245949,77,313347
24714,0.001587,74.125.24.0-255,5738,251687,77,313347
24715,0.0016,172.31.40.0-255,66,251753,77,313347
24716,0.001633,74.125.24.0-255,4320,256073,77,313347
24717,0.00165,172.31.40.0-255,66,256139,77,313347
24718,0.001688,74.125.24.0-255,11410,267549,77,313347
24719,0.001694,74.125.24.0-255,4469,272018,77,313347
24720,0.001702,172.31.40.0-255,66,272084,77,313347
24721,0.00185,74.125.24.0-255,1484,273568,77,313347
24722,0.001855,74.125.24.0-255,1484,275052,77,313347
24723,0.001863,172.31.40.0-255,66,275118,77,313347
24724,0.001877,74.125.24.0-255,1484,276602,77,313347
24725,0.001883,74.125.24.0-255,5738,282340,77,313347
24726,0.001888,172.31.40.0-255,66,282406,77,313347
24727,0.00191,74.125.24.0-255,4320,286726,77,313347
24728,0.001913,74.125.24.0-255,1484,288210,77,313347
24729,0.001943,74.125.24.0-255,9992,298202,77,313347
24730,0.001953,74.125.24.0-255,7856,306058,77,313347
24731,0.001997,172.31.40.0-255,66,306124,77,313347
24732,0.002007,74.125.24.0-255,4320,310444,77,313347
24733,0.002018,172.31.40.0-255,66,310510,77,313347
24734,0.002042,74.125.24.0-255,2666,313176,77,313347
24735,0.002049,172.31.40.0-255,66,313242,77,313347
24736,0.002074,74.125.24.0-255,105,313347,77,313347
24737,0.0,172.217.27.0-255,153,153,77,199084
24738,2.1e-05,172.31.40.0-255,66,219,77,199084
24739,2.8e-05,172.217.27.0-255,1484,1703,77,199084
24740,3.2e-05,172.31.40.0-255,66,1769,77,199084
24741,3.8e-05,172.217.27.0-255,2902,4671,77,199084
24742,4e-05,172.31.40.0-255,66,4737,77,199084
24743,5.7e-05,172.217.27.0-255,7156,11893,77,199084
24744,6e-05,172.31.40.0-255,66,11959,77,199084
24745,6.4e-05,172.217.27.0-255,2001,13960,77,199084
24746,6.7e-05,172.31.40.0-255,66,14026,77,199084
24747,7.2e-05,172.217.27.0-255,2902,16928,77,199084
24748,7.5e-05,172.31.40.0-255,66,16994,77,199084
24749,0.00011,172.217.27.0-255,4320,21314,77,199084
24750,0.000113,172.31.40.0-255,66,21380,77,199084
24751,0.000133,172.217.27.0-255,1484,22864,77,199084
24752,0.000136,172.31.40.0-255,66,22930,77,199084
24753,0.000162,172.217.27.0-255,4320,27250,77,199084
24754,0.000165,172.31.40.0-255,66,27316,77,199084
24755,0.000168,172.217.27.0-255,1484,28800,77,199084
24756,0.000169,172.31.40.0-255,66,28866,77,199084
24757,0.000174,172.217.27.0-255,2543,31409,77,199084
24758,0.000175,172.31.40.0-255,66,31475,77,199084
24759,0.000288,172.217.27.0-255,1484,32959,77,199084
24760,0.000293,172.31.40.0-255,66,33025,77,199084
24761,0.000298,172.217.27.0-255,2902,35927,77,199084
24762,0.0003,172.31.40.0-255,66,35993,77,199084
24763,0.00031,172.217.27.0-255,2902,38895,77,199084
24764,0.000312,172.31.40.0-255,66,38961,77,199084
24765,0.000339,172.217.27.0-255,2902,41863,77,199084
24766,0.000341,172.31.40.0-255,66,41929,77,199084
24767,0.000347,172.217.27.0-255,4320,46249,77,199084
24768,0.000349,172.31.40.0-255,66,46315,77,199084
24769,0.00038,172.217.27.0-255,9633,55948,77,199084
24770,0.000382,172.31.40.0-255,66,56014,77,199084
24771,0.000392,172.217.27.0-255,9940,65954,77,199084
24772,0.000394,172.31.40.0-255,66,66020,77,199084
24773,0.000694,172.217.27.0-255,115,66135,77,199084
24774,0.000836,172.217.27.0-255,1484,67619,77,199084
24775,0.000841,172.31.40.0-255,66,67685,77,199084
24776,0.000847,172.217.27.0-255,2902,70587,77,199084
24777,0.000849,172.31.40.0-255,66,70653,77,199084
24778,0.000855,172.217.27.0-255,4320,74973,77,199084
24779,0.000863,172.31.40.0-255,66,75039,77,199084
24780,0.000891,172.217.27.0-255,1484,76523,77,199084
24781,0.000899,172.217.27.0-255,6797,83320,77,199084
24782,0.000902,172.31.40.0-255,66,83386,77,199084
24783,0.000913,172.217.27.0-255,12828,96214,77,199084
24784,0.000916,172.31.40.0-255,66,96280,77,199084
24785,0.000941,172.217.27.0-255,1484,97764,77,199084
24786,0.000946,172.217.27.0-255,2543,100307,77,199084
24787,0.000949,172.31.40.0-255,66,100373,77,199084
24788,0.000952,172.217.27.0-255,330,100703,77,199084
24789,0.001276,172.217.27.0-255,1484,102187,77,199084
24790,0.001281,172.31.40.0-255,66,102253,77,199084
24791,0.001287,172.217.27.0-255,2902,105155,77,199084
24792,0.001289,172.31.40.0-255,66,105221,77,199084
24793,0.001292,172.217.27.0-255,1484,106705,77,199084
24794,0.00132,172.217.27.0-255,4320,111025,77,199084
24795,0.001323,172.31.40.0-255,66,111091,77,199084
24796,0.001329,172.217.27.0-255,5738,116829,77,199084
24797,0.001331,172.31.40.0-255,66,116895,77,199084
24798,0.001338,172.217.27.0-255,5738,122633,77,199084
24799,0.00134,172.31.40.0-255,66,122699,77,199084
24800,0.001362,172.217.27.0-255,1484,124183,77,199084
24801,0.001366,172.217.27.0-255,1484,125667,77,199084
24802,0.001368,172.31.40.0-255,66,125733,77,199084
24803,0.001406,172.217.27.0-255,9274,135007,77,199084
24804,0.00141,172.31.40.0-255,66,135073,77,199084
24805,0.002018,172.31.40.0-255,101,135174,77,199084
24806,0.003073,172.217.27.0-255,5738,140912,77,199084
24807,0.003081,172.31.40.0-255,66,140978,77,199084
24808,0.003629,172.217.27.0-255,66,141044,77,199084
24809,0.004715,172.217.27.0-255,5738,146782,77,199084
24810,0.004719,172.31.40.0-255,66,146848,77,199084
24811,0.006355,172.217.27.0-255,5738,152586,77,199084
24812,0.006358,172.31.40.0-255,66,152652,77,199084
24813,0.008,172.217.27.0-255,5738,158390,77,199084
24814,0.008008,172.31.40.0-255,66,158456,77,199084
24815,0.009662,172.217.27.0-255,5738,164194,77,199084
24816,0.009673,172.31.40.0-255,66,164260,77,199084
24817,0.011315,172.217.27.0-255,5738,169998,77,199084
24818,0.011327,172.31.40.0-255,66,170064,77,199084
24819,0.01297,172.217.27.0-255,5738,175802,77,199084
24820,0.012979,172.31.40.0-255,66,175868,77,199084
24821,0.014628,172.217.27.0-255,5738,181606,77,199084
24822,0.014635,172.31.40.0-255,66,181672,77,199084
24823,0.016292,172.217.27.0-255,5738,187410,77,199084
24824,0.0163,172.31.40.0-255,66,187476,77,199084
24825,0.017948,172.217.27.0-255,5738,193214,77,199084
24826,0.017958,172.31.40.0-255,66,193280,77,199084
24827,0.019614,172.217.27.0-255,5738,199018,77,199084
24828,0.019624,172.31.40.0-255,66,199084,77,199084
24829,0.0,74.125.24.0-255,152,152,77,202246
24830,1.9e-05,172.31.40.0-255,66,218,77,202246
24831,2.5e-05,74.125.24.0-255,1484,1702,77,202246
24832,3e-05,172.31.40.0-255,66,1768,77,202246
24833,3.5e-05,74.125.24.0-255,2902,4670,77,202246
24834,3.8e-05,172.31.40.0-255,66,4736,77,202246
24835,4.5e-05,74.125.24.0-255,5738,10474,77,202246
24836,4.8e-05,172.31.40.0-255,66,10540,77,202246
24837,7.4e-05,74.125.24.0-255,1484,12024,77,202246
24838,7.7e-05,172.31.40.0-255,66,12090,77,202246
24839,8.2e-05,74.125.24.0-255,2037,14127,77,202246
24840,8.3e-05,172.31.40.0-255,66,14193,77,202246
24841,0.000166,74.125.24.0-255,1484,15677,77,202246
24842,0.000169,172.31.40.0-255,66,15743,77,202246
24843,0.000174,74.125.24.0-255,2902,18645,77,202246
24844,0.000177,172.31.40.0-255,66,18711,77,202246
24845,0.000204,74.125.24.0-255,5738,24449,77,202246
24846,0.000207,172.31.40.0-255,66,24515,77,202246
24847,0.000234,74.125.24.0-255,8215,32730,77,202246
24848,0.000237,172.31.40.0-255,66,32796,77,202246
24849,0.000245,74.125.24.0-255,8574,41370,77,202246
24850,0.000247,172.31.40.0-255,66,41436,77,202246
24851,0.000272,74.125.24.0-255,9992,51428,77,202246
24852,0.000274,172.31.40.0-255,66,51494,77,202246
24853,0.000305,74.125.24.0-255,8574,60068,77,202246
24854,0.000308,172.31.40.0-255,66,60134,77,202246
24855,0.000315,74.125.24.0-255,5020,65154,77,202246
24856,0.000317,172.31.40.0-255,66,65220,77,202246
24857,0.00032,74.125.24.0-255,399,65619,77,202246
24858,0.000322,172.31.40.0-255,66,65685,77,202246
24859,0.000342,74.125.24.0-255,111,65796,77,202246
24860,0.000345,172.31.40.0-255,66,65862,77,202246
24861,0.000379,74.125.24.0-255,330,66192,77,202246
24862,0.000748,74.125.24.0-255,1484,67676,77,202246
24863,0.000752,172.31.40.0-255,66,67742,77,202246
24864,0.000757,74.125.24.0-255,2902,70644,77,202246
24865,0.000759,172.31.40.0-255,66,70710,77,202246
24866,0.000765,74.125.24.0-255,5738,76448,77,202246
24867,0.000766,172.31.40.0-255,66,76514,77,202246
24868,0.000783,74.125.24.0-255,2902,79416,77,202246
24869,0.000785,172.31.40.0-255,66,79482,77,202246
24870,0.000801,74.125.24.0-255,8574,88056,77,202246
24871,0.000803,172.31.40.0-255,66,88122,77,202246
24872,0.000817,74.125.24.0-255,1484,89606,77,202246
24873,0.000829,74.125.24.0-255,10692,100298,77,202246
24874,0.000832,172.31.40.0-255,66,100364,77,202246
24875,0.001104,74.125.24.0-255,1484,101848,77,202246
24876,0.001109,74.125.24.0-255,2902,104750,77,202246
24877,0.001115,172.31.40.0-255,66,104816,77,202246
24878,0.001139,74.125.24.0-255,5738,110554,77,202246
24879,0.001141,172.31.40.0-255,66,110620,77,202246
24880,0.001146,74.125.24.0-255,2902,113522,77,202246
24881,0.001148,172.31.40.0-255,66,113588,77,202246
24882,0.001178,74.125.24.0-255,9992,123580,77,202246
24883,0.001181,172.31.40.0-255,66,123646,77,202246
24884,0.001189,74.125.24.0-255,8574,132220,77,202246
24885,0.001191,172.31.40.0-255,66,132286,77,202246
24886,0.001194,74.125.24.0-255,1484,133770,77,202246
24887,0.001213,74.125.24.0-255,766,134536,77,202246
24888,0.001215,172.31.40.0-255,66,134602,77,202246
24889,0.002535,74.125.24.0-255,1484,136086,77,202246
24890,0.002546,74.125.24.0-255,2902,138988,77,202246
24891,0.00255,172.31.40.0-255,66,139054,77,202246
24892,0.002559,74.125.24.0-255,5738,144792,77,202246
24893,0.002561,172.31.40.0-255,66,144858,77,202246
24894,0.002589,74.125.24.0-255,12828,157686,77,202246
24895,0.002591,172.31.40.0-255,66,157752,77,202246
24896,0.0026,74.125.24.0-255,8574,166326,77,202246
24897,0.002601,172.31.40.0-255,66,166392,77,202246
24898,0.002606,74.125.24.0-255,2184,168576,77,202246
24899,0.002609,172.31.40.0-255,66,168642,77,202246
24900,0.005125,74.125.24.0-255,2902,171544,77,202246
24901,0.005128,172.31.40.0-255,66,171610,77,202246
24902,0.005146,74.125.24.0-255,2902,174512,77,202246
24903,0.005148,172.31.40.0-255,66,174578,77,202246
24904,0.007678,74.125.24.0-255,4320,178898,77,202246
24905,0.007685,172.31.40.0-255,66,178964,77,202246
24906,0.007699,74.125.24.0-255,1484,180448,77,202246
24907,0.010255,74.125.24.0-255,4320,184768,77,202246
24908,0.010263,172.31.40.0-255,66,184834,77,202246
24909,0.012796,74.125.24.0-255,5738,190572,77,202246
24910,0.012803,172.31.40.0-255,66,190638,77,202246
24911,0.01535,74.125.24.0-255,5738,196376,77,202246
24912,0.015357,172.31.40.0-255,66,196442,77,202246
24913,0.017904,74.125.24.0-255,5738,202180,77,202246
24914,0.017915,172.31.40.0-255,66,202246,77,202246
24915,0.0,172.31.40.0-255,105,105,77,459
24916,0.00031,172.31.40.0-255,90,195,77,459
24917,0.000334,172.31.40.0-255,66,261,77,459
24918,0.002998,74.125.24.0-255,66,327,77,459
24919,0.003021,74.125.24.0-255,66,393,77,459
24920,0.003037,172.31.40.0-255,66,459,77,459
24921,0.0,172.217.194.0-255,152,152,77,321030
24922,2.1e-05,172.31.40.0-255,66,218,77,321030
24923,2.8e-05,172.217.194.0-255,1484,1702,77,321030
24924,3.2e-05,172.31.40.0-255,66,1768,77,321030
24925,3.7e-05,172.217.194.0-255,2902,4670,77,321030
24926,4.6e-05,172.31.40.0-255,66,4736,77,321030
24927,5.3e-05,172.217.194.0-255,5738,10474,77,321030
24928,5.6e-05,172.31.40.0-255,66,10540,77,321030
24929,8.6e-05,172.217.194.0-255,3448,13988,77,321030
24930,8.8e-05,172.31.40.0-255,66,14054,77,321030
24931,0.000234,172.217.194.0-255,1484,15538,77,321030
24932,0.000239,172.31.40.0-255,66,15604,77,321030
24933,0.000257,172.217.194.0-255,2902,18506,77,321030
24934,0.00026,172.31.40.0-255,66,18572,77,321030
24935,0.000289,172.217.194.0-255,5738,24310,77,321030
24936,0.000291,172.31.40.0-255,66,24376,77,321030
24937,0.000297,172.217.194.0-255,5738,30114,77,321030
24938,0.000299,172.31.40.0-255,66,30180,77,321030
24939,0.00032,172.217.194.0-255,1125,31305,77,321030
24940,0.000322,172.31.40.0-255,66,31371,77,321030
24941,0.000359,172.217.194.0-255,12828,44199,77,321030
24942,0.000362,172.31.40.0-255,66,44265,77,321030
24943,0.000388,172.217.194.0-255,1484,45749,77,321030
24944,0.00039,172.31.40.0-255,66,45815,77,321030
24945,0.000395,172.217.194.0-255,2543,48358,77,321030
24946,0.000397,172.31.40.0-255,66,48424,77,321030
24947,0.00058,172.217.194.0-255,1484,49908,77,321030
24948,0.000584,172.31.40.0-255,66,49974,77,321030
24949,0.000598,172.217.194.0-255,2902,52876,77,321030
24950,0.000607,172.31.40.0-255,66,52942,77,321030
24951,0.000619,172.217.194.0-255,5738,58680,77,321030
24952,0.000622,172.31.40.0-255,66,58746,77,321030
24953,0.000679,172.217.194.0-255,11051,69797,77,321030
24954,0.000683,172.31.40.0-255,66,69863,77,321030
24955,0.00069,172.217.194.0-255,5738,75601,77,321030
24956,0.000692,172.31.40.0-255,66,75667,77,321030
24957,0.000723,172.217.194.0-255,5738,81405,77,321030
24958,0.000726,172.31.40.0-255,66,81471,77,321030
24959,0.000731,172.217.194.0-255,1704,83175,77,321030
24960,0.000733,172.31.40.0-255,66,83241,77,321030
24961,0.000737,172.217.194.0-255,2902,86143,77,321030
24962,0.000739,172.31.40.0-255,66,86209,77,321030
24963,0.000747,172.217.194.0-255,7156,93365,77,321030
24964,0.000749,172.31.40.0-255,66,93431,77,321030
24965,0.000756,172.217.194.0-255,5738,99169,77,321030
24966,0.000758,172.31.40.0-255,66,99235,77,321030
24967,0.000783,172.217.194.0-255,1125,100360,77,321030
24968,0.000908,172.217.194.0-255,1484,101844,77,321030
24969,0.000912,172.31.40.0-255,66,101910,77,321030
24970,0.000918,172.217.194.0-255,2902,104812,77,321030
24971,0.00092,172.31.40.0-255,66,104878,77,321030
24972,0.000947,172.217.194.0-255,5738,110616,77,321030
24973,0.000949,172.31.40.0-255,66,110682,77,321030
24974,0.000965,172.217.194.0-255,11410,122092,77,321030
24975,0.000967,172.31.40.0-255,66,122158,77,321030
24976,0.000996,172.217.194.0-255,1484,123642,77,321030
24977,0.001007,172.217.194.0-255,9992,133634,77,321030
24978,0.001009,172.31.40.0-255,66,133700,77,321030
24979,0.001017,172.217.194.0-255,6438,140138,77,321030
24980,0.001019,172.31.40.0-255,66,140204,77,321030
24981,0.001023,172.217.194.0-255,2902,143106,77,321030
24982,0.001025,172.31.40.0-255,66,143172,77,321030
24983,0.001058,172.217.194.0-255,4320,147492,77,321030
24984,0.001061,172.31.40.0-255,66,147558,77,321030
24985,0.001082,172.31.40.0-255,66,147624,77,321030
24986,0.001088,172.217.194.0-255,5020,152644,77,321030
24987,0.00109,172.31.40.0-255,66,152710,77,321030
24988,0.00132,172.217.194.0-255,1484,154194,77,321030
24989,0.001325,172.217.194.0-255,2902,157096,77,321030
24990,0.001328,172.31.40.0-255,66,157162,77,321030
24991,0.001332,172.217.194.0-255,2902,160064,77,321030
24992,0.001334,172.31.40.0-255,66,160130,77,321030
24993,0.00136,172.217.194.0-255,2902,163032,77,321030
24994,0.001362,172.31.40.0-255,66,163098,77,321030
24995,0.001373,172.217.194.0-255,12828,175926,77,321030
24996,0.001374,172.31.40.0-255,66,175992,77,321030
24997,0.001377,172.217.194.0-255,1484,177476,77,321030
24998,0.00141,172.217.194.0-255,8574,186050,77,321030
24999,0.001417,172.31.40.0-255,66,186116,77,321030
25000,0.001419,172.217.194.0-255,766,186882,77,321030
25001,0.001703,172.217.194.0-255,1484,188366,77,321030
25002,0.001707,172.31.40.0-255,66,188432,77,321030
25003,0.001714,172.217.194.0-255,2902,191334,77,321030
25004,0.001716,172.31.40.0-255,66,191400,77,321030
25005,0.001721,172.217.194.0-255,4320,195720,77,321030
25006,0.001723,172.31.40.0-255,66,195786,77,321030
25007,0.001749,172.217.194.0-255,1484,197270,77,321030
25008,0.001756,172.217.194.0-255,7156,204426,77,321030
25009,0.001759,172.31.40.0-255,66,204492,77,321030
25010,0.001766,172.217.194.0-255,5738,210230,77,321030
25011,0.001768,172.31.40.0-255,66,210296,77,321030
25012,0.001809,172.217.194.0-255,8574,218870,77,321030
25013,0.001812,172.31.40.0-255,66,218936,77,321030
25014,0.001816,172.217.194.0-255,2184,221120,77,321030
25015,0.001818,172.31.40.0-255,66,221186,77,321030
25016,0.001979,172.31.40.0-255,101,221287,77,321030
25017,0.002168,172.217.194.0-255,1484,222771,77,321030
25018,0.002173,172.217.194.0-255,1484,224255,77,321030
25019,0.002177,172.31.40.0-255,66,224321,77,321030
25020,0.002208,172.217.194.0-255,1484,225805,77,321030
25021,0.002215,172.217.194.0-255,5738,231543,77,321030
25022,0.002218,172.31.40.0-255,66,231609,77,321030
25023,0.002241,172.217.194.0-255,12828,244437,77,321030
25024,0.002244,172.31.40.0-255,66,244503,77,321030
25025,0.002253,172.217.194.0-255,8574,253077,77,321030
25026,0.002255,172.31.40.0-255,66,253143,77,321030
25027,0.002286,172.217.194.0-255,2184,255327,77,321030
25028,0.002289,172.31.40.0-255,66,255393,77,321030
25029,0.002394,172.217.194.0-255,1484,256877,77,321030
25030,0.002398,172.217.194.0-255,2902,259779,77,321030
25031,0.002401,172.31.40.0-255,66,259845,77,321030
25032,0.002408,172.217.194.0-255,5738,265583,77,321030
25033,0.00241,172.31.40.0-255,66,265649,77,321030
25034,0.002446,172.217.194.0-255,12828,278477,77,321030
25035,0.002451,172.31.40.0-255,66,278543,77,321030
25036,0.002489,172.217.194.0-255,7156,285699,77,321030
25037,0.002491,172.31.40.0-255,66,285765,77,321030
25038,0.002523,172.217.194.0-255,2902,288667,77,321030
25039,0.002526,172.31.40.0-255,66,288733,77,321030
25040,0.00255,172.31.40.0-255,66,288799,77,321030
25041,0.00259,172.217.194.0-255,3602,292401,77,321030
25042,0.002594,172.31.40.0-255,66,292467,77,321030
25043,0.002603,172.217.194.0-255,9274,301741,77,321030
25044,0.002606,172.31.40.0-255,66,301807,77,321030
25045,0.002629,172.31.40.0-255,66,301873,77,321030
25046,0.002649,172.31.40.0-255,66,301939,77,321030
25047,0.002663,172.31.40.0-255,66,302005,77,321030
25048,0.002669,172.217.194.0-255,7156,309161,77,321030
25049,0.002671,172.31.40.0-255,66,309227,77,321030
25050,0.002675,172.217.194.0-255,1484,310711,77,321030
25051,0.002709,172.217.194.0-255,9911,320622,77,321030
25052,0.002717,172.31.40.0-255,66,320688,77,321030
25053,0.002734,172.217.194.0-255,105,320793,77,321030
25054,0.004526,172.217.194.0-255,66,320859,77,321030
25055,0.008785,172.31.40.0-255,105,320964,77,321030
25056,0.011352,172.217.194.0-255,66,321030,77,321030
25057,0.0,74.125.24.0-255,150,150,77,378503
25058,2.5e-05,172.31.40.0-255,66,216,77,378503
25059,3.2e-05,74.125.24.0-255,1484,1700,77,378503
25060,3.7e-05,172.31.40.0-255,66,1766,77,378503
25061,4.3e-05,74.125.24.0-255,2902,4668,77,378503
25062,4.7e-05,172.31.40.0-255,66,4734,77,378503
25063,5.4e-05,74.125.24.0-255,7156,11890,77,378503
25064,5.8e-05,172.31.40.0-255,66,11956,77,378503
25065,7.4e-05,74.125.24.0-255,1930,13886,77,378503
25066,7.7e-05,172.31.40.0-255,66,13952,77,378503
25067,8.2e-05,74.125.24.0-255,2902,16854,77,378503
25068,8.4e-05,172.31.40.0-255,66,16920,77,378503
25069,0.000101,74.125.24.0-255,5738,22658,77,378503
25070,0.000104,172.31.40.0-255,66,22724,77,378503
25071,0.000125,74.125.24.0-255,1484,24208,77,378503
25072,0.000127,172.31.40.0-255,66,24274,77,378503
25073,0.000135,74.125.24.0-255,6797,31071,77,378503
25074,0.000138,172.31.40.0-255,66,31137,77,378503
25075,0.000206,74.125.24.0-255,1484,32621,77,378503
25076,0.000209,172.31.40.0-255,66,32687,77,378503
25077,0.000213,74.125.24.0-255,2902,35589,77,378503
25078,0.000216,172.31.40.0-255,66,35655,77,378503
25079,0.000233,74.125.24.0-255,4320,39975,77,378503
25080,0.000236,172.31.40.0-255,66,40041,77,378503
25081,0.000279,74.125.24.0-255,8215,48256,77,378503
25082,0.000283,172.31.40.0-255,66,48322,77,378503
25083,0.00029,74.125.24.0-255,7156,55478,77,378503
25084,0.000293,172.31.40.0-255,66,55544,77,378503
25085,0.000314,74.125.24.0-255,1484,57028,77,378503
25086,0.000316,172.31.40.0-255,66,57094,77,378503
25087,0.000335,74.125.24.0-255,7156,64250,77,378503
25088,0.000338,172.31.40.0-255,66,64316,77,378503
25089,0.000359,74.125.24.0-255,1456,65772,77,378503
25090,0.000363,74.125.24.0-255,113,65885,77,378503
25091,0.000367,74.125.24.0-255,332,66217,77,378503
25092,0.000517,74.125.24.0-255,1484,67701,77,378503
25093,0.000525,74.125.24.0-255,2902,70603,77,378503
25094,0.000527,74.125.24.0-255,1484,72087,77,378503
25095,0.000541,74.125.24.0-255,4320,76407,77,378503
25096,0.000597,74.125.24.0-255,8574,84981,77,378503
25097,0.000618,74.125.24.0-255,5379,90360,77,378503
25098,0.000621,74.125.24.0-255,1484,91844,77,378503
25099,0.000638,74.125.24.0-255,5738,97582,77,378503
25100,0.000651,74.125.24.0-255,2543,100125,77,378503
25101,0.000777,74.125.24.0-255,1484,101609,77,378503
25102,0.000783,74.125.24.0-255,2902,104511,77,378503
25103,0.000801,74.125.24.0-255,2902,107413,77,378503
25104,0.000817,74.125.24.0-255,2902,110315,77,378503
25105,0.000822,74.125.24.0-255,2902,113217,77,378503
25106,0.00085,74.125.24.0-255,9992,123209,77,378503
25107,0.000859,74.125.24.0-255,8574,131783,77,378503
25108,0.000882,74.125.24.0-255,2184,133967,77,378503
25109,0.000902,172.31.40.0-255,66,134033,77,378503
25110,0.000958,74.125.24.0-255,1484,135517,77,378503
25111,0.000962,74.125.24.0-255,1484,137001,77,378503
25112,0.000974,74.125.24.0-255,1484,138485,77,378503
25113,0.000982,74.125.24.0-255,5738,144223,77,378503
25114,0.000986,74.125.24.0-255,2902,147125,77,378503
25115,0.001009,74.125.24.0-255,4320,151445,77,378503
25116,0.001032,74.125.24.0-255,5738,157183,77,378503
25117,0.001076,74.125.24.0-255,1484,158667,77,378503
25118,0.001098,74.125.24.0-255,9274,167941,77,378503
25119,0.00111,74.125.24.0-255,11410,179351,77,378503
25120,0.001119,74.125.24.0-255,8574,187925,77,378503
25121,0.001137,74.125.24.0-255,1484,189409,77,378503
25122,0.001161,74.125.24.0-255,11559,200968,77,378503
25123,0.001182,74.125.24.0-255,1484,202452,77,378503
25124,0.001197,74.125.24.0-255,1484,203936,77,378503
25125,0.001206,74.125.24.0-255,1484,205420,77,378503
25126,0.00121,74.125.24.0-255,1484,206904,77,378503
25127,0.001231,74.125.24.0-255,4320,211224,77,378503
25128,0.001244,74.125.24.0-255,2902,214126,77,378503
25129,0.001265,74.125.24.0-255,9633,223759,77,378503
25130,0.001286,74.125.24.0-255,2902,226661,77,378503
25131,0.001308,74.125.24.0-255,8215,234876,77,378503
25132,0.001422,172.31.40.0-255,66,234942,77,378503
25133,0.001569,74.125.24.0-255,1484,236426,77,378503
25134,0.001576,74.125.24.0-255,2902,239328,77,378503
25135,0.0016,74.125.24.0-255,5738,245066,77,378503
25136,0.001608,74.125.24.0-255,7156,252222,77,378503
25137,0.001619,172.31.40.0-255,66,252288,77,378503
25138,0.001634,74.125.24.0-255,2902,255190,77,378503
25139,0.001655,74.125.24.0-255,11410,266600,77,378503
25140,0.001659,74.125.24.0-255,2184,268784,77,378503
25141,0.001679,172.31.40.0-255,66,268850,77,378503
25142,0.001701,74.125.24.0-255,7156,276006,77,378503
25143,0.001721,74.125.24.0-255,4320,280326,77,378503
25144,0.001728,74.125.24.0-255,5738,286064,77,378503
25145,0.001731,172.31.40.0-255,66,286130,77,378503
25146,0.001742,74.125.24.0-255,7156,293286,77,378503
25147,0.001754,172.31.40.0-255,66,293352,77,378503
25148,0.001766,74.125.24.0-255,2902,296254,77,378503
25149,0.001798,172.31.40.0-255,66,296320,77,378503
25150,0.001841,74.125.24.0-255,6438,302758,77,378503
25151,0.001845,172.31.40.0-255,66,302824,77,378503
25152,0.001876,74.125.24.0-255,1484,304308,77,378503
25153,0.001894,74.125.24.0-255,2902,307210,77,378503
25154,0.001948,74.125.24.0-255,5738,312948,77,378503
25155,0.001959,74.125.24.0-255,12828,325776,77,378503
25156,0.001969,74.125.24.0-255,10692,336468,77,378503
25157,0.001984,172.31.40.0-255,66,336534,77,378503
25158,0.001999,74.125.24.0-255,2902,339436,77,378503
25159,0.002018,74.125.24.0-255,9992,349428,77,378503
25160,0.002028,74.125.24.0-255,9992,359420,77,378503
25161,0.002041,172.31.40.0-255,66,359486,77,378503
25162,0.002046,74.125.24.0-255,4320,363806,77,378503
25163,0.002053,74.125.24.0-255,5738,369544,77,378503
25164,0.002058,172.31.40.0-255,66,369610,77,378503
25165,0.002085,74.125.24.0-255,8593,378203,77,378503
25166,0.002089,74.125.24.0-255,105,378308,77,378503
25167,0.002099,172.31.40.0-255,66,378374,77,378503
25168,0.002109,74.125.24.0-255,129,378503,77,378503
25169,0.0,172.217.194.0-255,150,150,77,170117
25170,2.4e-05,172.31.40.0-255,66,216,77,170117
25171,3.2e-05,172.217.194.0-255,1484,1700,77,170117
25172,3.6e-05,172.31.40.0-255,66,1766,77,170117
25173,4.4e-05,172.217.194.0-255,2902,4668,77,170117
25174,4.8e-05,172.31.40.0-255,66,4734,77,170117
25175,5.6e-05,172.217.194.0-255,7156,11890,77,170117
25176,5.9e-05,172.31.40.0-255,66,11956,77,170117
25177,6.3e-05,172.217.194.0-255,2067,14023,77,170117
25178,6.6e-05,172.31.40.0-255,66,14089,77,170117
25179,0.000263,172.217.194.0-255,1484,15573,77,170117
25180,0.000268,172.31.40.0-255,66,15639,77,170117
25181,0.000273,172.217.194.0-255,2902,18541,77,170117
25182,0.000275,172.31.40.0-255,66,18607,77,170117
25183,0.000278,172.217.194.0-255,1484,20091,77,170117
25184,0.000279,172.31.40.0-255,66,20157,77,170117
25185,0.000293,172.217.194.0-255,4320,24477,77,170117
25186,0.000296,172.31.40.0-255,66,24543,77,170117
25187,0.000309,172.217.194.0-255,4320,28863,77,170117
25188,0.000311,172.31.40.0-255,66,28929,77,170117
25189,0.000331,172.217.194.0-255,2543,31472,77,170117
25190,0.000333,172.31.40.0-255,66,31538,77,170117
25191,0.000361,172.217.194.0-255,1484,33022,77,170117
25192,0.000363,172.31.40.0-255,66,33088,77,170117
25193,0.000366,172.217.194.0-255,1484,34572,77,170117
25194,0.000367,172.31.40.0-255,66,34638,77,170117
25195,0.000378,172.217.194.0-255,1484,36122,77,170117
25196,0.00038,172.31.40.0-255,66,36188,77,170117
25197,0.00039,172.217.194.0-255,1484,37672,77,170117
25198,0.000392,172.31.40.0-255,66,37738,77,170117
25199,0.000415,172.217.194.0-255,4320,42058,77,170117
25200,0.000421,172.217.194.0-255,6797,48855,77,170117
25201,0.000424,172.31.40.0-255,66,48921,77,170117
25202,0.000431,172.31.40.0-255,66,48987,77,170117
25203,0.001725,172.217.194.0-255,1484,50471,77,170117
25204,0.001736,172.217.194.0-255,2902,53373,77,170117
25205,0.00174,172.31.40.0-255,66,53439,77,170117
25206,0.001749,172.217.194.0-255,5738,59177,77,170117
25207,0.001751,172.31.40.0-255,66,59243,77,170117
25208,0.001777,172.217.194.0-255,1484,60727,77,170117
25209,0.001798,172.217.194.0-255,5958,66685,77,170117
25210,0.001801,172.31.40.0-255,66,66751,77,170117
25211,0.001838,172.217.194.0-255,1484,68235,77,170117
25212,0.001842,172.217.194.0-255,2902,71137,77,170117
25213,0.001844,172.31.40.0-255,66,71203,77,170117
25214,0.00185,172.217.194.0-255,4320,75523,77,170117
25215,0.001852,172.31.40.0-255,66,75589,77,170117
25216,0.001864,172.217.194.0-255,1484,77073,77,170117
25217,0.001883,172.217.194.0-255,7156,84229,77,170117
25218,0.001885,172.31.40.0-255,66,84295,77,170117
25219,0.001903,172.217.194.0-255,5738,90033,77,170117
25220,0.001905,172.31.40.0-255,66,90099,77,170117
25221,0.001914,172.217.194.0-255,8574,98673,77,170117
25222,0.001916,172.31.40.0-255,66,98739,77,170117
25223,0.001939,172.217.194.0-255,2184,100923,77,170117
25224,0.001941,172.31.40.0-255,66,100989,77,170117
25225,0.002398,172.217.194.0-255,1484,102473,77,170117
25226,0.002402,172.217.194.0-255,1484,103957,77,170117
25227,0.002404,172.31.40.0-255,66,104023,77,170117
25228,0.002417,172.217.194.0-255,1484,105507,77,170117
25229,0.002423,172.217.194.0-255,5738,111245,77,170117
25230,0.002425,172.31.40.0-255,66,111311,77,170117
25231,0.002442,172.217.194.0-255,2902,114213,77,170117
25232,0.002444,172.31.40.0-255,66,114279,77,170117
25233,0.002472,172.217.194.0-255,9992,124271,77,170117
25234,0.002474,172.31.40.0-255,66,124337,77,170117
25235,0.002503,172.217.194.0-255,7156,131493,77,170117
25236,0.002506,172.31.40.0-255,66,131559,77,170117
25237,0.002524,172.217.194.0-255,3602,135161,77,170117
25238,0.003887,172.31.40.0-255,66,135227,77,170117
25239,0.005011,172.217.194.0-255,1484,136711,77,170117
25240,0.006426,172.217.194.0-255,4320,141031,77,170117
25241,0.006431,172.31.40.0-255,66,141097,77,170117
25242,0.008996,172.217.194.0-255,5738,146835,77,170117
25243,0.009003,172.31.40.0-255,66,146901,77,170117
25244,0.011536,172.217.194.0-255,5738,152639,77,170117
25245,0.011545,172.31.40.0-255,66,152705,77,170117
25246,0.01408,172.217.194.0-255,5738,158443,77,170117
25247,0.01409,172.31.40.0-255,66,158509,77,170117
25248,0.016656,172.217.194.0-255,5738,164247,77,170117
25249,0.016666,172.31.40.0-255,66,164313,77,170117
25250,0.019235,172.217.194.0-255,5738,170051,77,170117
25251,0.019246,172.31.40.0-255,66,170117,77,170117
25252,0.0,74.125.200.0-255,150,150,77,244245
25253,2.3e-05,172.31.40.0-255,66,216,77,244245
25254,3e-05,74.125.200.0-255,1484,1700,77,244245
25255,3.5e-05,172.31.40.0-255,66,1766,77,244245
25256,3.8e-05,74.125.200.0-255,1484,3250,77,244245
25257,5e-05,172.31.40.0-255,66,3316,77,244245
25258,8.7e-05,74.125.200.0-255,2902,6218,77,244245
25259,9.1e-05,172.31.40.0-255,66,6284,77,244245
25260,9.7e-05,74.125.200.0-255,4320,10604,77,244245
25261,0.0001,172.31.40.0-255,66,10670,77,244245
25262,0.000131,74.125.200.0-255,2902,13572,77,244245
25263,0.000133,172.31.40.0-255,66,13638,77,244245
25264,0.000162,74.125.200.0-255,3556,17194,77,244245
25265,0.000165,172.31.40.0-255,66,17260,77,244245
25266,0.000191,74.125.200.0-255,4320,21580,77,244245
25267,0.000193,172.31.40.0-255,66,21646,77,244245
25268,0.000236,74.125.200.0-255,8574,30220,77,244245
25269,0.000239,172.31.40.0-255,66,30286,77,244245
25270,0.000267,74.125.200.0-255,1125,31411,77,244245
25271,0.000269,172.31.40.0-255,66,31477,77,244245
25272,0.000342,74.125.200.0-255,1484,32961,77,244245
25273,0.000345,172.31.40.0-255,66,33027,77,244245
25274,0.00035,74.125.200.0-255,2902,35929,77,244245
25275,0.000353,172.31.40.0-255,66,35995,77,244245
25276,0.000383,74.125.200.0-255,4320,40315,77,244245
25277,0.000386,172.31.40.0-255,66,40381,77,244245
25278,0.000428,74.125.200.0-255,5738,46119,77,244245
25279,0.000432,172.31.40.0-255,66,46185,77,244245
25280,0.00044,74.125.200.0-255,7156,53341,77,244245
25281,0.000442,172.31.40.0-255,66,53407,77,244245
25282,0.000472,74.125.200.0-255,5379,58786,77,244245
25283,0.000475,172.31.40.0-255,66,58852,77,244245
25284,0.000481,74.125.200.0-255,4320,63172,77,244245
25285,0.000483,172.31.40.0-255,66,63238,77,244245
25286,0.000487,74.125.200.0-255,2880,66118,77,244245
25287,0.000493,172.31.40.0-255,66,66184,77,244245
25288,0.000557,74.125.200.0-255,349,66533,77,244245
25289,0.001126,74.125.200.0-255,1484,68017,77,244245
25290,0.001131,172.31.40.0-255,66,68083,77,244245
25291,0.001137,74.125.200.0-255,2902,70985,77,244245
25292,0.00114,172.31.40.0-255,66,71051,77,244245
25293,0.001166,74.125.200.0-255,5738,76789,77,244245
25294,0.001169,172.31.40.0-255,66,76855,77,244245
25295,0.0012,74.125.200.0-255,9992,86847,77,244245
25296,0.001203,172.31.40.0-255,66,86913,77,244245
25297,0.001228,74.125.200.0-255,5738,92651,77,244245
25298,0.001231,172.31.40.0-255,66,92717,77,244245
25299,0.001259,74.125.200.0-255,5738,98455,77,244245
25300,0.001262,172.31.40.0-255,66,98521,77,244245
25301,0.001265,74.125.200.0-255,1484,100005,77,244245
25302,0.001268,74.125.200.0-255,766,100771,77,244245
25303,0.00127,172.31.40.0-255,66,100837,77,244245
25304,0.001368,74.125.200.0-255,1484,102321,77,244245
25305,0.001414,74.125.200.0-255,1484,103805,77,244245
25306,0.001418,172.31.40.0-255,66,103871,77,244245
25307,0.001444,74.125.200.0-255,1484,105355,77,244245
25308,0.001467,74.125.200.0-255,2902,108257,77,244245
25309,0.00147,172.31.40.0-255,66,108323,77,244245
25310,0.001495,74.125.200.0-255,4320,112643,77,244245
25311,0.001498,172.31.40.0-255,66,112709,77,244245
25312,0.001528,74.125.200.0-255,5738,118447,77,244245
25313,0.00153,172.31.40.0-255,66,118513,77,244245
25314,0.001566,74.125.200.0-255,7156,125669,77,244245
25315,0.001568,172.31.40.0-255,66,125735,77,244245
25316,0.001572,74.125.200.0-255,1484,127219,77,244245
25317,0.001598,74.125.200.0-255,7156,134375,77,244245
25318,0.001601,172.31.40.0-255,66,134441,77,244245
25319,0.001604,74.125.200.0-255,766,135207,77,244245
25320,0.001747,74.125.200.0-255,1484,136691,77,244245
25321,0.001752,172.31.40.0-255,66,136757,77,244245
25322,0.001757,74.125.200.0-255,2902,139659,77,244245
25323,0.00176,172.31.40.0-255,66,139725,77,244245
25324,0.001763,74.125.200.0-255,1484,141209,77,244245
25325,0.001807,74.125.200.0-255,4320,145529,77,244245
25326,0.00181,172.31.40.0-255,66,145595,77,244245
25327,0.001818,74.125.200.0-255,7156,152751,77,244245
25328,0.00182,172.31.40.0-255,66,152817,77,244245
25329,0.001829,74.125.200.0-255,8574,161391,77,244245
25330,0.001831,172.31.40.0-255,66,161457,77,244245
25331,0.001861,74.125.200.0-255,7856,169313,77,244245
25332,0.001864,172.31.40.0-255,66,169379,77,244245
25333,0.001995,74.125.200.0-255,1484,170863,77,244245
25334,0.001999,74.125.200.0-255,1484,172347,77,244245
25335,0.002002,172.31.40.0-255,66,172413,77,244245
25336,0.002036,74.125.200.0-255,1484,173897,77,244245
25337,0.002042,74.125.200.0-255,5738,179635,77,244245
25338,0.002045,172.31.40.0-255,66,179701,77,244245
25339,0.002053,74.125.200.0-255,8574,188275,77,244245
25340,0.002055,172.31.40.0-255,66,188341,77,244245
25341,0.002066,74.125.200.0-255,5738,194079,77,244245
25342,0.002068,172.31.40.0-255,66,194145,77,244245
25343,0.002097,74.125.200.0-255,4320,198465,77,244245
25344,0.002103,74.125.200.0-255,5020,203485,77,244245
25345,0.002108,172.31.40.0-255,66,203551,77,244245
25346,0.002115,172.31.40.0-255,66,203617,77,244245
25347,0.004414,74.125.200.0-255,5738,209355,77,244245
25348,0.004426,172.31.40.0-255,66,209421,77,244245
25349,0.00669,74.125.200.0-255,5738,215159,77,244245
25350,0.006703,172.31.40.0-255,66,215225,77,244245
25351,0.009019,74.125.200.0-255,5738,220963,77,244245
25352,0.009029,172.31.40.0-255,66,221029,77,244245
25353,0.011298,74.125.200.0-255,5738,226767,77,244245
25354,0.011316,172.31.40.0-255,66,226833,77,244245
25355,0.0136,74.125.200.0-255,5738,232571,77,244245
25356,0.013615,172.31.40.0-255,66,232637,77,244245
25357,0.01588,74.125.200.0-255,5738,238375,77,244245
25358,0.015888,172.31.40.0-255,66,238441,77,244245
25359,0.018147,74.125.200.0-255,5738,244179,77,244245
25360,0.018165,172.31.40.0-255,66,244245,77,244245
25361,0.0,74.125.24.0-255,150,150,77,318526
25362,1.4e-05,172.31.40.0-255,66,216,77,318526
25363,2e-05,74.125.24.0-255,1484,1700,77,318526
25364,2.5e-05,172.31.40.0-255,66,1766,77,318526
25365,3.1e-05,74.125.24.0-255,2902,4668,77,318526
25366,3.5e-05,172.31.40.0-255,66,4734,77,318526
25367,4.2e-05,74.125.24.0-255,7156,11890,77,318526
25368,4.6e-05,172.31.40.0-255,66,11956,77,318526
25369,6.7e-05,74.125.24.0-255,4320,16276,77,318526
25370,6.9e-05,172.31.40.0-255,66,16342,77,318526
25371,9.4e-05,74.125.24.0-255,2021,18363,77,318526
25372,9.6e-05,172.31.40.0-255,66,18429,77,318526
25373,0.000103,74.125.24.0-255,7156,25585,77,318526
25374,0.000106,172.31.40.0-255,66,25651,77,318526
25375,0.000111,74.125.24.0-255,5379,31030,77,318526
25376,0.000115,172.31.40.0-255,66,31096,77,318526
25377,0.000175,74.125.24.0-255,1484,32580,77,318526
25378,0.000178,172.31.40.0-255,66,32646,77,318526
25379,0.000183,74.125.24.0-255,2902,35548,77,318526
25380,0.000185,172.31.40.0-255,66,35614,77,318526
25381,0.000196,74.125.24.0-255,1484,37098,77,318526
25382,0.000198,172.31.40.0-255,66,37164,77,318526
25383,0.000214,74.125.24.0-255,4320,41484,77,318526
25384,0.000216,172.31.40.0-255,66,41550,77,318526
25385,0.000221,74.125.24.0-255,4320,45870,77,318526
25386,0.000223,172.31.40.0-255,66,45936,77,318526
25387,0.000226,74.125.24.0-255,1484,47420,77,318526
25388,0.000228,172.31.40.0-255,66,47486,77,318526
25389,0.000257,74.125.24.0-255,11051,58537,77,318526
25390,0.000259,172.31.40.0-255,66,58603,77,318526
25391,0.000284,74.125.24.0-255,7072,65675,77,318526
25392,0.000286,172.31.40.0-255,66,65741,77,318526
25393,0.000362,74.125.24.0-255,131,65872,77,318526
25394,0.000465,74.125.24.0-255,1484,67356,77,318526
25395,0.000469,172.31.40.0-255,66,67422,77,318526
25396,0.000476,74.125.24.0-255,2902,70324,77,318526
25397,0.000478,172.31.40.0-255,66,70390,77,318526
25398,0.000506,74.125.24.0-255,5738,76128,77,318526
25399,0.000509,172.31.40.0-255,66,76194,77,318526
25400,0.000512,74.125.24.0-255,1484,77678,77,318526
25401,0.000538,74.125.24.0-255,11051,88729,77,318526
25402,0.000541,172.31.40.0-255,66,88795,77,318526
25403,0.000574,74.125.24.0-255,7156,95951,77,318526
25404,0.000578,172.31.40.0-255,66,96017,77,318526
25405,0.000598,74.125.24.0-255,4241,100258,77,318526
25406,0.000601,172.31.40.0-255,66,100324,77,318526
25407,0.000735,74.125.24.0-255,1484,101808,77,318526
25408,0.000741,74.125.24.0-255,2902,104710,77,318526
25409,0.000744,172.31.40.0-255,66,104776,77,318526
25410,0.000767,74.125.24.0-255,5738,110514,77,318526
25411,0.00077,172.31.40.0-255,66,110580,77,318526
25412,0.000778,74.125.24.0-255,8574,119154,77,318526
25413,0.000781,172.31.40.0-255,66,119220,77,318526
25414,0.000834,74.125.24.0-255,9992,129212,77,318526
25415,0.000837,172.31.40.0-255,66,129278,77,318526
25416,0.000854,74.125.24.0-255,5020,134298,77,318526
25417,0.000857,172.31.40.0-255,66,134364,77,318526
25418,0.000862,74.125.24.0-255,4320,138684,77,318526
25419,0.000865,172.31.40.0-255,66,138750,77,318526
25420,0.0009,74.125.24.0-255,11410,150160,77,318526
25421,0.000904,172.31.40.0-255,66,150226,77,318526
25422,0.000913,74.125.24.0-255,11410,161636,77,318526
25423,0.000916,172.31.40.0-255,66,161702,77,318526
25424,0.000918,74.125.24.0-255,1484,163186,77,318526
25425,0.000949,74.125.24.0-255,5020,168206,77,318526
25426,0.000954,172.31.40.0-255,66,168272,77,318526
25427,0.001004,74.125.24.0-255,1484,169756,77,318526
25428,0.001022,74.125.24.0-255,2902,172658,77,318526
25429,0.001025,172.31.40.0-255,66,172724,77,318526
25430,0.001032,74.125.24.0-255,5738,178462,77,318526
25431,0.001034,172.31.40.0-255,66,178528,77,318526
25432,0.001058,74.125.24.0-255,11410,189938,77,318526
25433,0.001062,172.31.40.0-255,66,190004,77,318526
25434,0.001079,74.125.24.0-255,1484,191488,77,318526
25435,0.001087,74.125.24.0-255,8574,200062,77,318526
25436,0.00109,172.31.40.0-255,66,200128,77,318526
25437,0.001107,74.125.24.0-255,2184,202312,77,318526
25438,0.001109,172.31.40.0-255,66,202378,77,318526
25439,0.001234,74.125.24.0-255,1484,203862,77,318526
25440,0.00124,74.125.24.0-255,2902,206764,77,318526
25441,0.001243,172.31.40.0-255,66,206830,77,318526
25442,0.001248,74.125.24.0-255,2902,209732,77,318526
25443,0.00125,172.31.40.0-255,66,209798,77,318526
25444,0.001267,74.125.24.0-255,2902,212700,77,318526
25445,0.001269,172.31.40.0-255,66,212766,77,318526
25446,0.001279,74.125.24.0-255,9992,222758,77,318526
25447,0.001281,172.31.40.0-255,66,222824,77,318526
25448,0.001315,74.125.24.0-255,2902,225726,77,318526
25449,0.001318,172.31.40.0-255,66,225792,77,318526
25450,0.001327,74.125.24.0-255,10692,236484,77,318526
25451,0.00133,172.31.40.0-255,66,236550,77,318526
25452,0.001411,74.125.24.0-255,1484,238034,77,318526
25453,0.00143,74.125.24.0-255,2902,240936,77,318526
25454,0.001434,172.31.40.0-255,66,241002,77,318526
25455,0.001441,74.125.24.0-255,5738,246740,77,318526
25456,0.001443,172.31.40.0-255,66,246806,77,318526
25457,0.001448,74.125.24.0-255,4320,251126,77,318526
25458,0.001451,172.31.40.0-255,66,251192,77,318526
25459,0.001498,74.125.24.0-255,5738,256930,77,318526
25460,0.001502,172.31.40.0-255,66,256996,77,318526
25461,0.001514,74.125.24.0-255,13528,270524,77,318526
25462,0.001516,172.31.40.0-255,66,270590,77,318526
25463,0.001623,74.125.24.0-255,1484,272074,77,318526
25464,0.001629,74.125.24.0-255,2902,274976,77,318526
25465,0.001632,172.31.40.0-255,66,275042,77,318526
25466,0.001637,74.125.24.0-255,2902,277944,77,318526
25467,0.001639,172.31.40.0-255,66,278010,77,318526
25468,0.001652,74.125.24.0-255,2902,280912,77,318526
25469,0.001654,172.31.40.0-255,66,280978,77,318526
25470,0.001657,74.125.24.0-255,1484,282462,77,318526
25471,0.00171,74.125.24.0-255,9992,292454,77,318526
25472,0.001713,172.31.40.0-255,66,292520,77,318526
25473,0.001725,74.125.24.0-255,1484,294004,77,318526
25474,0.001743,172.31.40.0-255,66,294070,77,318526
25475,0.001762,172.31.40.0-255,66,294136,77,318526
25476,0.001767,74.125.24.0-255,4320,298456,77,318526
25477,0.00177,172.31.40.0-255,66,298522,77,318526
25478,0.001795,74.125.24.0-255,7856,306378,77,318526
25479,0.001798,172.31.40.0-255,66,306444,77,318526
25480,0.001816,74.125.24.0-255,4320,310764,77,318526
25481,0.001819,172.31.40.0-255,66,310830,77,318526
25482,0.001867,172.31.40.0-255,66,310896,77,318526
25483,0.001874,74.125.24.0-255,7156,318052,77,318526
25484,0.001877,172.31.40.0-255,66,318118,77,318526
25485,0.00193,172.31.40.0-255,66,318184,77,318526
25486,0.001933,74.125.24.0-255,105,318289,77,318526
25487,0.00435,172.31.40.0-255,66,318355,77,318526
25488,0.004382,172.31.40.0-255,105,318460,77,318526
25489,0.006376,74.125.24.0-255,66,318526,77,318526
25490,0.0,172.31.40.0-255,105,105,77,459
25491,0.000214,172.31.40.0-255,90,195,77,459
25492,0.000222,172.31.40.0-255,66,261,77,459
25493,0.003115,74.125.24.0-255,66,327,77,459
25494,0.004961,74.125.24.0-255,66,393,77,459
25495,0.004982,172.31.40.0-255,66,459,77,459
25496,0.0,74.125.24.0-255,152,152,77,175975
25497,2.3e-05,172.31.40.0-255,66,218,77,175975
25498,3e-05,74.125.24.0-255,1484,1702,77,175975
25499,3.5e-05,172.31.40.0-255,66,1768,77,175975
25500,4.1e-05,74.125.24.0-255,2902,4670,77,175975
25501,5.2e-05,172.31.40.0-255,66,4736,77,175975
25502,6e-05,74.125.24.0-255,7156,11892,77,175975
25503,6.4e-05,172.31.40.0-255,66,11958,77,175975
25504,6.8e-05,74.125.24.0-255,1985,13943,77,175975
25505,7.1e-05,172.31.40.0-255,66,14009,77,175975
25506,0.000131,74.125.24.0-255,1484,15493,77,175975
25507,0.000133,172.31.40.0-255,66,15559,77,175975
25508,0.000138,74.125.24.0-255,2902,18461,77,175975
25509,0.000141,172.31.40.0-255,66,18527,77,175975
25510,0.000172,74.125.24.0-255,5738,24265,77,175975
25511,0.000175,172.31.40.0-255,66,24331,77,175975
25512,0.000205,74.125.24.0-255,5738,30069,77,175975
25513,0.000208,172.31.40.0-255,66,30135,77,175975
25514,0.000225,74.125.24.0-255,1125,31260,77,175975
25515,0.000228,172.31.40.0-255,66,31326,77,175975
25516,0.000343,74.125.24.0-255,1484,32810,77,175975
25517,0.000348,172.31.40.0-255,66,32876,77,175975
25518,0.000353,74.125.24.0-255,2902,35778,77,175975
25519,0.000356,172.31.40.0-255,66,35844,77,175975
25520,0.000385,74.125.24.0-255,5738,41582,77,175975
25521,0.000388,172.31.40.0-255,66,41648,77,175975
25522,0.000392,74.125.24.0-255,2902,44550,77,175975
25523,0.000394,172.31.40.0-255,66,44616,77,175975
25524,0.000431,74.125.24.0-255,11051,55667,77,175975
25525,0.000434,172.31.40.0-255,66,55733,77,175975
25526,0.000439,74.125.24.0-255,2902,58635,77,175975
25527,0.000441,172.31.40.0-255,66,58701,77,175975
25528,0.000467,74.125.24.0-255,5738,64439,77,175975
25529,0.00047,172.31.40.0-255,66,64505,77,175975
25530,0.000499,74.125.24.0-255,1125,65630,77,175975
25531,0.001067,74.125.24.0-255,414,66044,77,175975
25532,0.001096,74.125.24.0-255,330,66374,77,175975
25533,0.0011,172.31.40.0-255,66,66440,77,175975
25534,0.002016,74.125.24.0-255,1484,67924,77,175975
25535,0.002028,74.125.24.0-255,2902,70826,77,175975
25536,0.002033,172.31.40.0-255,66,70892,77,175975
25537,0.002064,74.125.24.0-255,5738,76630,77,175975
25538,0.002067,172.31.40.0-255,66,76696,77,175975
25539,0.002099,74.125.24.0-255,9992,86688,77,175975
25540,0.002102,172.31.40.0-255,66,86754,77,175975
25541,0.002109,74.125.24.0-255,5738,92492,77,175975
25542,0.002111,172.31.40.0-255,66,92558,77,175975
25543,0.002142,74.125.24.0-255,5738,98296,77,175975
25544,0.002144,172.31.40.0-255,66,98362,77,175975
25545,0.002148,74.125.24.0-255,2184,100546,77,175975
25546,0.002151,172.31.40.0-255,66,100612,77,175975
25547,0.002208,74.125.24.0-255,1484,102096,77,175975
25548,0.002214,74.125.24.0-255,2902,104998,77,175975
25549,0.002216,172.31.40.0-255,66,105064,77,175975
25550,0.002275,74.125.24.0-255,5738,110802,77,175975
25551,0.002277,172.31.40.0-255,66,110868,77,175975
25552,0.002288,74.125.24.0-255,12828,123696,77,175975
25553,0.002295,172.31.40.0-255,66,123762,77,175975
25554,0.002305,74.125.24.0-255,10692,134454,77,175975
25555,0.002308,172.31.40.0-255,66,134520,77,175975
25556,0.004711,74.125.24.0-255,5738,140258,77,175975
25557,0.004715,172.31.40.0-255,66,140324,77,175975
25558,0.006169,172.31.40.0-255,101,140425,77,175975
25559,0.007128,74.125.24.0-255,5738,146163,77,175975
25560,0.007134,172.31.40.0-255,66,146229,77,175975
25561,0.008568,74.125.24.0-255,66,146295,77,175975
25562,0.009577,74.125.24.0-255,2902,149197,77,175975
25563,0.009584,172.31.40.0-255,66,149263,77,175975
25564,0.009611,74.125.24.0-255,2902,152165,77,175975
25565,0.009614,172.31.40.0-255,66,152231,77,175975
25566,0.011974,74.125.24.0-255,2902,155133,77,175975
25567,0.011984,172.31.40.0-255,66,155199,77,175975
25568,0.012044,74.125.24.0-255,2902,158101,77,175975
25569,0.012048,172.31.40.0-255,66,158167,77,175975
25570,0.01441,74.125.24.0-255,2902,161069,77,175975
25571,0.014418,172.31.40.0-255,66,161135,77,175975
25572,0.014465,74.125.24.0-255,2902,164037,77,175975
25573,0.014468,172.31.40.0-255,66,164103,77,175975
25574,0.01682,74.125.24.0-255,2902,167005,77,175975
25575,0.016829,172.31.40.0-255,66,167071,77,175975
25576,0.016865,74.125.24.0-255,2902,169973,77,175975
25577,0.016868,172.31.40.0-255,66,170039,77,175975
25578,0.019198,74.125.24.0-255,2902,172941,77,175975
25579,0.019205,172.31.40.0-255,66,173007,77,175975
25580,0.019255,74.125.24.0-255,2902,175909,77,175975
25581,0.019258,172.31.40.0-255,66,175975,77,175975
25582,0.0,172.31.40.0-255,105,105,77,459
25583,0.000246,172.31.40.0-255,90,195,77,459
25584,0.000257,172.31.40.0-255,66,261,77,459
25585,0.002245,74.125.24.0-255,66,327,77,459
25586,0.002279,74.125.24.0-255,66,393,77,459
25587,0.002303,172.31.40.0-255,66,459,77,459
25588,0.0,172.31.40.0-255,105,105,77,459
25589,0.000237,172.31.40.0-255,90,195,77,459
25590,0.000249,172.31.40.0-255,66,261,77,459
25591,0.002545,74.125.130.0-255,66,327,77,459
25592,0.002577,74.125.130.0-255,66,393,77,459
25593,0.002601,172.31.40.0-255,66,459,77,459
25594,0.0,172.217.194.0-255,151,151,77,299588
25595,1.7e-05,172.31.40.0-255,66,217,77,299588
25596,2.4e-05,172.217.194.0-255,1484,1701,77,299588
25597,2.9e-05,172.31.40.0-255,66,1767,77,299588
25598,3.5e-05,172.217.194.0-255,2902,4669,77,299588
25599,3.8e-05,172.31.40.0-255,66,4735,77,299588
25600,4.6e-05,172.217.194.0-255,7156,11891,77,299588
25601,4.9e-05,172.31.40.0-255,66,11957,77,299588
25602,9e-05,172.217.194.0-255,2038,13995,77,299588
25603,9.3e-05,172.31.40.0-255,66,14061,77,299588
25604,0.000202,172.217.194.0-255,1484,15545,77,299588
25605,0.000206,172.31.40.0-255,66,15611,77,299588
25606,0.000212,172.217.194.0-255,2902,18513,77,299588
25607,0.000214,172.31.40.0-255,66,18579,77,299588
25608,0.00022,172.217.194.0-255,5738,24317,77,299588
25609,0.000222,172.31.40.0-255,66,24383,77,299588
25610,0.000245,172.217.194.0-255,2902,27285,77,299588
25611,0.000247,172.31.40.0-255,66,27351,77,299588
25612,0.000266,172.217.194.0-255,3961,31312,77,299588
25613,0.000269,172.31.40.0-255,66,31378,77,299588
25614,0.000305,172.217.194.0-255,1484,32862,77,299588
25615,0.000307,172.31.40.0-255,66,32928,77,299588
25616,0.000312,172.217.194.0-255,2902,35830,77,299588
25617,0.000314,172.31.40.0-255,66,35896,77,299588
25618,0.000317,172.217.194.0-255,1484,37380,77,299588
25619,0.000319,172.31.40.0-255,66,37446,77,299588
25620,0.000349,172.217.194.0-255,4320,41766,77,299588
25621,0.000351,172.31.40.0-255,66,41832,77,299588
25622,0.000357,172.217.194.0-255,6797,48629,77,299588
25623,0.000359,172.31.40.0-255,66,48695,77,299588
25624,0.00085,172.217.194.0-255,1484,50179,77,299588
25625,0.000855,172.31.40.0-255,66,50245,77,299588
25626,0.00086,172.217.194.0-255,2902,53147,77,299588
25627,0.000867,172.217.194.0-255,5738,58885,77,299588
25628,0.000911,172.217.194.0-255,2902,61787,77,299588
25629,0.000926,172.217.194.0-255,3961,65748,77,299588
25630,0.000946,172.31.40.0-255,66,65814,77,299588
25631,0.000966,172.217.194.0-255,1484,67298,77,299588
25632,0.00097,172.217.194.0-255,2902,70200,77,299588
25633,0.000988,172.217.194.0-255,5738,75938,77,299588
25634,0.000994,172.31.40.0-255,66,76004,77,299588
25635,0.001005,172.217.194.0-255,2902,78906,77,299588
25636,0.001023,172.217.194.0-255,3961,82867,77,299588
25637,0.001031,172.31.40.0-255,66,82933,77,299588
25638,0.001058,172.217.194.0-255,7156,90089,77,299588
25639,0.001067,172.31.40.0-255,66,90155,77,299588
25640,0.001091,172.217.194.0-255,7156,97311,77,299588
25641,0.001097,172.217.194.0-255,3123,100434,77,299588
25642,0.001102,172.31.40.0-255,66,100500,77,299588
25643,0.001445,172.217.194.0-255,1484,101984,77,299588
25644,0.001452,172.217.194.0-255,2902,104886,77,299588
25645,0.001455,172.31.40.0-255,66,104952,77,299588
25646,0.001461,172.217.194.0-255,2902,107854,77,299588
25647,0.001469,172.31.40.0-255,66,107920,77,299588
25648,0.001481,172.217.194.0-255,2902,110822,77,299588
25649,0.001488,172.217.194.0-255,5738,116560,77,299588
25650,0.001519,172.217.194.0-255,12828,129388,77,299588
25651,0.001522,172.31.40.0-255,66,129454,77,299588
25652,0.001528,172.31.40.0-255,66,129520,77,299588
25653,0.001541,172.217.194.0-255,5020,134540,77,299588
25654,0.001561,172.31.40.0-255,66,134606,77,299588
25655,0.001599,172.217.194.0-255,1484,136090,77,299588
25656,0.001604,172.217.194.0-255,2902,138992,77,299588
25657,0.001615,172.217.194.0-255,1484,140476,77,299588
25658,0.001631,172.217.194.0-255,4320,144796,77,299588
25659,0.001636,172.217.194.0-255,5738,150534,77,299588
25660,0.00164,172.31.40.0-255,66,150600,77,299588
25661,0.001651,172.217.194.0-255,2902,153502,77,299588
25662,0.001655,172.31.40.0-255,66,153568,77,299588
25663,0.001675,172.217.194.0-255,9992,163560,77,299588
25664,0.00168,172.217.194.0-255,4320,167880,77,299588
25665,0.001694,172.217.194.0-255,766,168646,77,299588
25666,0.0017,172.31.40.0-255,66,168712,77,299588
25667,0.001723,172.217.194.0-255,2902,171614,77,299588
25668,0.001744,172.217.194.0-255,2902,174516,77,299588
25669,0.001749,172.217.194.0-255,4320,178836,77,299588
25670,0.001751,172.31.40.0-255,66,178902,77,299588
25671,0.001768,172.31.40.0-255,66,178968,77,299588
25672,0.001797,172.217.194.0-255,11410,190378,77,299588
25673,0.001803,172.217.194.0-255,5738,196116,77,299588
25674,0.001825,172.31.40.0-255,66,196182,77,299588
25675,0.001856,172.217.194.0-255,5738,201920,77,299588
25676,0.00187,172.217.194.0-255,766,202686,77,299588
25677,0.001876,172.31.40.0-255,66,202752,77,299588
25678,0.002002,172.217.194.0-255,1484,204236,77,299588
25679,0.002006,172.217.194.0-255,1484,205720,77,299588
25680,0.002024,172.217.194.0-255,1484,207204,77,299588
25681,0.00203,172.217.194.0-255,5738,212942,77,299588
25682,0.002035,172.31.40.0-255,66,213008,77,299588
25683,0.002046,172.217.194.0-255,2902,215910,77,299588
25684,0.00205,172.31.40.0-255,66,215976,77,299588
25685,0.002071,172.217.194.0-255,9992,225968,77,299588
25686,0.002086,172.31.40.0-255,66,226034,77,299588
25687,0.002127,172.217.194.0-255,7156,233190,77,299588
25688,0.002142,172.217.194.0-255,3602,236792,77,299588
25689,0.002152,172.217.194.0-255,11410,248202,77,299588
25690,0.002168,172.217.194.0-255,12828,261030,77,299588
25691,0.002206,172.217.194.0-255,4320,265350,77,299588
25692,0.002222,172.217.194.0-255,5020,270370,77,299588
25693,0.002291,172.217.194.0-255,1484,271854,77,299588
25694,0.002295,172.217.194.0-255,1484,273338,77,299588
25695,0.002307,172.217.194.0-255,1484,274822,77,299588
25696,0.00231,172.217.194.0-255,1484,276306,77,299588
25697,0.008029,172.31.40.0-255,66,276372,77,299588
25698,0.010386,172.217.194.0-255,5738,282110,77,299588
25699,0.010395,172.31.40.0-255,66,282176,77,299588
25700,0.01271,172.217.194.0-255,5738,287914,77,299588
25701,0.01272,172.31.40.0-255,66,287980,77,299588
25702,0.015036,172.217.194.0-255,5738,293718,77,299588
25703,0.01591,172.31.40.0-255,66,293784,77,299588
25704,0.018209,172.217.194.0-255,5738,299522,77,299588
25705,0.01822,172.31.40.0-255,66,299588,77,299588
25706,0.0,74.125.24.0-255,152,152,77,252648
25707,2.3e-05,172.31.40.0-255,66,218,77,252648
25708,3e-05,74.125.24.0-255,1484,1702,77,252648
25709,3.5e-05,172.31.40.0-255,66,1768,77,252648
25710,4.9e-05,74.125.24.0-255,2902,4670,77,252648
25711,5.2e-05,172.31.40.0-255,66,4736,77,252648
25712,6e-05,74.125.24.0-255,7156,11892,77,252648
25713,6.2e-05,172.31.40.0-255,66,11958,77,252648
25714,6.6e-05,74.125.24.0-255,2039,13997,77,252648
25715,6.8e-05,172.31.40.0-255,66,14063,77,252648
25716,0.000278,74.125.24.0-255,1484,15547,77,252648
25717,0.000283,172.31.40.0-255,66,15613,77,252648
25718,0.000289,74.125.24.0-255,2902,18515,77,252648
25719,0.000292,172.31.40.0-255,66,18581,77,252648
25720,0.000295,74.125.24.0-255,1484,20065,77,252648
25721,0.000297,172.31.40.0-255,66,20131,77,252648
25722,0.000317,74.125.24.0-255,4320,24451,77,252648
25723,0.000319,172.31.40.0-255,66,24517,77,252648
25724,0.000379,74.125.24.0-255,4320,28837,77,252648
25725,0.000383,172.31.40.0-255,66,28903,77,252648
25726,0.000407,74.125.24.0-255,2543,31446,77,252648
25727,0.000409,172.31.40.0-255,66,31512,77,252648
25728,0.000718,74.125.24.0-255,1484,32996,77,252648
25729,0.000723,172.31.40.0-255,66,33062,77,252648
25730,0.000729,74.125.24.0-255,2902,35964,77,252648
25731,0.000731,172.31.40.0-255,66,36030,77,252648
25732,0.000737,74.125.24.0-255,4320,40350,77,252648
25733,0.000743,172.31.40.0-255,66,40416,77,252648
25734,0.000774,74.125.24.0-255,1484,41900,77,252648
25735,0.000777,172.31.40.0-255,66,41966,77,252648
25736,0.000785,74.125.24.0-255,6797,48763,77,252648
25737,0.000787,172.31.40.0-255,66,48829,77,252648
25738,0.00079,74.125.24.0-255,1484,50313,77,252648
25739,0.000831,74.125.24.0-255,12828,63141,77,252648
25740,0.000835,172.31.40.0-255,66,63207,77,252648
25741,0.00084,74.125.24.0-255,2543,65750,77,252648
25742,0.000842,172.31.40.0-255,66,65816,77,252648
25743,0.000845,74.125.24.0-255,392,66208,77,252648
25744,0.000886,74.125.24.0-255,352,66560,77,252648
25745,0.001179,172.31.40.0-255,66,66626,77,252648
25746,0.001264,74.125.24.0-255,1484,68110,77,252648
25747,0.001273,74.125.24.0-255,2902,71012,77,252648
25748,0.001276,172.31.40.0-255,66,71078,77,252648
25749,0.00128,74.125.24.0-255,1484,72562,77,252648
25750,0.001307,74.125.24.0-255,4320,76882,77,252648
25751,0.001309,172.31.40.0-255,66,76948,77,252648
25752,0.001318,74.125.24.0-255,8574,85522,77,252648
25753,0.00132,172.31.40.0-255,66,85588,77,252648
25754,0.001347,74.125.24.0-255,2902,88490,77,252648
25755,0.00135,172.31.40.0-255,66,88556,77,252648
25756,0.001365,74.125.24.0-255,2902,91458,77,252648
25757,0.001371,172.31.40.0-255,66,91524,77,252648
25758,0.001405,74.125.24.0-255,9274,100798,77,252648
25759,0.001408,172.31.40.0-255,66,100864,77,252648
25760,0.001595,74.125.24.0-255,1484,102348,77,252648
25761,0.001603,74.125.24.0-255,2902,105250,77,252648
25762,0.001606,172.31.40.0-255,66,105316,77,252648
25763,0.001638,74.125.24.0-255,5738,111054,77,252648
25764,0.001641,172.31.40.0-255,66,111120,77,252648
25765,0.001648,74.125.24.0-255,5738,116858,77,252648
25766,0.001651,172.31.40.0-255,66,116924,77,252648
25767,0.001685,74.125.24.0-255,7156,124080,77,252648
25768,0.001688,172.31.40.0-255,66,124146,77,252648
25769,0.001694,74.125.24.0-255,4320,128466,77,252648
25770,0.001696,172.31.40.0-255,66,128532,77,252648
25771,0.00172,74.125.24.0-255,6438,134970,77,252648
25772,0.001724,172.31.40.0-255,66,135036,77,252648
25773,0.001742,74.125.24.0-255,7156,142192,77,252648
25774,0.001744,172.31.40.0-255,66,142258,77,252648
25775,0.001765,74.125.24.0-255,4320,146578,77,252648
25776,0.001767,172.31.40.0-255,66,146644,77,252648
25777,0.001779,74.125.24.0-255,12828,159472,77,252648
25778,0.001781,172.31.40.0-255,66,159538,77,252648
25779,0.001806,74.125.24.0-255,8574,168112,77,252648
25780,0.001808,172.31.40.0-255,66,168178,77,252648
25781,0.001832,74.125.24.0-255,766,168944,77,252648
25782,0.00185,74.125.24.0-255,2902,171846,77,252648
25783,0.001853,172.31.40.0-255,66,171912,77,252648
25784,0.001876,74.125.24.0-255,7156,179068,77,252648
25785,0.001879,172.31.40.0-255,66,179134,77,252648
25786,0.001885,74.125.24.0-255,4320,183454,77,252648
25787,0.001887,172.31.40.0-255,66,183520,77,252648
25788,0.001911,74.125.24.0-255,1484,185004,77,252648
25789,0.001918,74.125.24.0-255,5738,190742,77,252648
25790,0.001921,172.31.40.0-255,66,190808,77,252648
25791,0.001961,74.125.24.0-255,11410,202218,77,252648
25792,0.001964,172.31.40.0-255,66,202284,77,252648
25793,0.001967,74.125.24.0-255,766,203050,77,252648
25794,0.001996,74.125.24.0-255,1484,204534,77,252648
25795,0.001998,172.31.40.0-255,66,204600,77,252648
25796,0.002003,74.125.24.0-255,2902,207502,77,252648
25797,0.002005,172.31.40.0-255,66,207568,77,252648
25798,0.004046,74.125.24.0-255,5738,213306,77,252648
25799,0.004054,172.31.40.0-255,66,213372,77,252648
25800,0.006074,74.125.24.0-255,5738,219110,77,252648
25801,0.006079,172.31.40.0-255,66,219176,77,252648
25802,0.008087,74.125.24.0-255,5738,224914,77,252648
25803,0.008093,172.31.40.0-255,66,224980,77,252648
25804,0.010088,74.125.24.0-255,5738,230718,77,252648
25805,0.010095,172.31.40.0-255,66,230784,77,252648
25806,0.012101,74.125.24.0-255,5738,236522,77,252648
25807,0.01211,172.31.40.0-255,66,236588,77,252648
25808,0.01413,74.125.24.0-255,5738,242326,77,252648
25809,0.014138,172.31.40.0-255,66,242392,77,252648
25810,0.01615,74.125.24.0-255,4320,246712,77,252648
25811,0.016159,172.31.40.0-255,66,246778,77,252648
25812,0.016188,74.125.24.0-255,1484,248262,77,252648
25813,0.018156,74.125.24.0-255,4320,252582,77,252648
25814,0.018168,172.31.40.0-255,66,252648,77,252648
25815,0.0,172.31.40.0-255,105,105,77,459
25816,0.000223,172.31.40.0-255,90,195,77,459
25817,0.000233,172.31.40.0-255,66,261,77,459
25818,0.002451,74.125.24.0-255,66,327,77,459
25819,0.002478,74.125.24.0-255,66,393,77,459
25820,0.002497,172.31.40.0-255,66,459,77,459
25821,0.0,74.125.24.0-255,153,153,77,323982
25822,2.2e-05,172.31.40.0-255,66,219,77,323982
25823,2.9e-05,74.125.24.0-255,1484,1703,77,323982
25824,3.4e-05,172.31.40.0-255,66,1769,77,323982
25825,4e-05,74.125.24.0-255,2902,4671,77,323982
25826,4.4e-05,172.31.40.0-255,66,4737,77,323982
25827,5.2e-05,74.125.24.0-255,7156,11893,77,323982
25828,5.5e-05,172.31.40.0-255,66,11959,77,323982
25829,5.9e-05,74.125.24.0-255,2078,14037,77,323982
25830,6.1e-05,172.31.40.0-255,66,14103,77,323982
25831,9.6e-05,74.125.24.0-255,11410,25513,77,323982
25832,9.9e-05,172.31.40.0-255,66,25579,77,323982
25833,0.000109,74.125.24.0-255,11410,36989,77,323982
25834,0.000112,172.31.40.0-255,66,37055,77,323982
25835,0.000155,74.125.24.0-255,8574,45629,77,323982
25836,0.000158,172.31.40.0-255,66,45695,77,323982
25837,0.000175,74.125.24.0-255,2184,47879,77,323982
25838,0.000178,172.31.40.0-255,66,47945,77,323982
25839,0.00051,74.125.24.0-255,1484,49429,77,323982
25840,0.000515,172.31.40.0-255,66,49495,77,323982
25841,0.000521,74.125.24.0-255,2902,52397,77,323982
25842,0.000523,172.31.40.0-255,66,52463,77,323982
25843,0.000526,74.125.24.0-255,1484,53947,77,323982
25844,0.000528,172.31.40.0-255,66,54013,77,323982
25845,0.000544,74.125.24.0-255,4320,58333,77,323982
25846,0.000547,172.31.40.0-255,66,58399,77,323982
25847,0.000584,74.125.24.0-255,7068,65467,77,323982
25848,0.000588,172.31.40.0-255,66,65533,77,323982
25849,0.000615,74.125.24.0-255,132,65665,77,323982
25850,0.000617,172.31.40.0-255,66,65731,77,323982
25851,0.000651,74.125.24.0-255,1484,67215,77,323982
25852,0.000655,172.31.40.0-255,66,67281,77,323982
25853,0.00066,74.125.24.0-255,2902,70183,77,323982
25854,0.000662,172.31.40.0-255,66,70249,77,323982
25855,0.000668,74.125.24.0-255,5738,75987,77,323982
25856,0.00067,172.31.40.0-255,66,76053,77,323982
25857,0.000691,74.125.24.0-255,1484,77537,77,323982
25858,0.000701,74.125.24.0-255,8574,86111,77,323982
25859,0.000704,172.31.40.0-255,66,86177,77,323982
25860,0.000736,74.125.24.0-255,7156,93333,77,323982
25861,0.000739,172.31.40.0-255,66,93399,77,323982
25862,0.000747,74.125.24.0-255,6438,99837,77,323982
25863,0.000749,172.31.40.0-255,66,99903,77,323982
25864,0.000752,74.125.24.0-255,349,100252,77,323982
25865,0.001131,74.125.24.0-255,1484,101736,77,323982
25866,0.001136,74.125.24.0-255,2902,104638,77,323982
25867,0.00114,172.31.40.0-255,66,104704,77,323982
25868,0.001143,172.31.40.0-255,66,104770,77,323982
25869,0.001167,74.125.24.0-255,5738,110508,77,323982
25870,0.00117,172.31.40.0-255,66,110574,77,323982
25871,0.001175,74.125.24.0-255,4320,114894,77,323982
25872,0.001177,172.31.40.0-255,66,114960,77,323982
25873,0.001198,74.125.24.0-255,5738,120698,77,323982
25874,0.001201,172.31.40.0-255,66,120764,77,323982
25875,0.001228,74.125.24.0-255,11410,132174,77,323982
25876,0.00123,172.31.40.0-255,66,132240,77,323982
25877,0.001251,74.125.24.0-255,2184,134424,77,323982
25878,0.001253,172.31.40.0-255,66,134490,77,323982
25879,0.001674,74.125.24.0-255,1484,135974,77,323982
25880,0.001678,74.125.24.0-255,1484,137458,77,323982
25881,0.001682,172.31.40.0-255,66,137524,77,323982
25882,0.001707,74.125.24.0-255,1484,139008,77,323982
25883,0.001714,74.125.24.0-255,5738,144746,77,323982
25884,0.001716,172.31.40.0-255,66,144812,77,323982
25885,0.001722,74.125.24.0-255,5738,150550,77,323982
25886,0.001724,172.31.40.0-255,66,150616,77,323982
25887,0.001728,74.125.24.0-255,2902,153518,77,323982
25888,0.00173,172.31.40.0-255,66,153584,77,323982
25889,0.001759,74.125.24.0-255,9992,163576,77,323982
25890,0.001762,172.31.40.0-255,66,163642,77,323982
25891,0.001768,74.125.24.0-255,5020,168662,77,323982
25892,0.00177,172.31.40.0-255,66,168728,77,323982
25893,0.001865,74.125.24.0-255,1484,170212,77,323982
25894,0.00187,74.125.24.0-255,2902,173114,77,323982
25895,0.001873,172.31.40.0-255,66,173180,77,323982
25896,0.001899,74.125.24.0-255,5738,178918,77,323982
25897,0.001901,172.31.40.0-255,66,178984,77,323982
25898,0.001904,74.125.24.0-255,1484,180468,77,323982
25899,0.001937,74.125.24.0-255,11410,191878,77,323982
25900,0.00194,172.31.40.0-255,66,191944,77,323982
25901,0.001943,74.125.24.0-255,1484,193428,77,323982
25902,0.001978,74.125.24.0-255,9274,202702,77,323982
25903,0.001981,172.31.40.0-255,66,202768,77,323982
25904,0.00202,74.125.24.0-255,1484,204252,77,323982
25905,0.002024,74.125.24.0-255,1484,205736,77,323982
25906,0.002027,172.31.40.0-255,66,205802,77,323982
25907,0.002042,74.125.24.0-255,1484,207286,77,323982
25908,0.002058,74.125.24.0-255,5738,213024,77,323982
25909,0.002061,172.31.40.0-255,66,213090,77,323982
25910,0.00209,74.125.24.0-255,9992,223082,77,323982
25911,0.002093,172.31.40.0-255,66,223148,77,323982
25912,0.002126,74.125.24.0-255,2902,226050,77,323982
25913,0.002129,172.31.40.0-255,66,226116,77,323982
25914,0.002156,74.125.24.0-255,10692,236808,77,323982
25915,0.002159,172.31.40.0-255,66,236874,77,323982
25916,0.002172,172.31.40.0-255,66,236940,77,323982
25917,0.00218,74.125.24.0-255,4320,241260,77,323982
25918,0.002182,172.31.40.0-255,66,241326,77,323982
25919,0.00221,74.125.24.0-255,9992,251318,77,323982
25920,0.002213,172.31.40.0-255,66,251384,77,323982
25921,0.002218,74.125.24.0-255,5020,256404,77,323982
25922,0.00222,172.31.40.0-255,66,256470,77,323982
25923,0.002236,74.125.24.0-255,1484,257954,77,323982
25924,0.002255,74.125.24.0-255,4320,262274,77,323982
25925,0.002258,172.31.40.0-255,66,262340,77,323982
25926,0.002262,74.125.24.0-255,4320,266660,77,323982
25927,0.002264,172.31.40.0-255,66,266726,77,323982
25928,0.002294,74.125.24.0-255,8574,275300,77,323982
25929,0.002296,172.31.40.0-255,66,275366,77,323982
25930,0.002305,74.125.24.0-255,9992,285358,77,323982
25931,0.002307,172.31.40.0-255,66,285424,77,323982
25932,0.002352,74.125.24.0-255,5020,290444,77,323982
25933,0.002354,172.31.40.0-255,66,290510,77,323982
25934,0.004886,74.125.24.0-255,4320,294830,77,323982
25935,0.004894,172.31.40.0-255,66,294896,77,323982
25936,0.004914,74.125.24.0-255,1484,296380,77,323982
25937,0.007454,74.125.24.0-255,4320,300700,77,323982
25938,0.00746,172.31.40.0-255,66,300766,77,323982
25939,0.010006,74.125.24.0-255,5738,306504,77,323982
25940,0.010013,172.31.40.0-255,66,306570,77,323982
25941,0.012532,74.125.24.0-255,5738,312308,77,323982
25942,0.012539,172.31.40.0-255,66,312374,77,323982
25943,0.015072,74.125.24.0-255,5738,318112,77,323982
25944,0.015079,172.31.40.0-255,66,318178,77,323982
25945,0.017616,74.125.24.0-255,5738,323916,77,323982
25946,0.017626,172.31.40.0-255,66,323982,77,323982
25947,0.0,74.125.24.0-255,153,153,77,287962
25948,1.6e-05,172.31.40.0-255,66,219,77,287962
25949,2.2e-05,74.125.24.0-255,1484,1703,77,287962
25950,2.8e-05,172.31.40.0-255,66,1769,77,287962
25951,3.4e-05,74.125.24.0-255,2902,4671,77,287962
25952,4.5e-05,172.31.40.0-255,66,4737,77,287962
25953,5.4e-05,74.125.24.0-255,7156,11893,77,287962
25954,5.7e-05,172.31.40.0-255,66,11959,77,287962
25955,6.4e-05,74.125.24.0-255,4320,16279,77,287962
25956,6.6e-05,172.31.40.0-255,66,16345,77,287962
25957,0.000102,74.125.24.0-255,1983,18328,77,287962
25958,0.000106,172.31.40.0-255,66,18394,77,287962
25959,0.000114,74.125.24.0-255,7156,25550,77,287962
25960,0.000116,172.31.40.0-255,66,25616,77,287962
25961,0.000121,74.125.24.0-255,2902,28518,77,287962
25962,0.000123,172.31.40.0-255,66,28584,77,287962
25963,0.000162,74.125.24.0-255,2543,31127,77,287962
25964,0.000166,172.31.40.0-255,66,31193,77,287962
25965,0.000169,74.125.24.0-255,1484,32677,77,287962
25966,0.000171,172.31.40.0-255,66,32743,77,287962
25967,0.000205,74.125.24.0-255,2902,35645,77,287962
25968,0.000208,172.31.40.0-255,66,35711,77,287962
25969,0.000214,74.125.24.0-255,5738,41449,77,287962
25970,0.000216,172.31.40.0-255,66,41515,77,287962
25971,0.000223,74.125.24.0-255,5738,47253,77,287962
25972,0.000264,172.31.40.0-255,66,47319,77,287962
25973,0.000292,74.125.24.0-255,13887,61206,77,287962
25974,0.000295,172.31.40.0-255,66,61272,77,287962
25975,0.0003,74.125.24.0-255,4269,65541,77,287962
25976,0.000303,172.31.40.0-255,66,65607,77,287962
25977,0.000397,74.125.24.0-255,114,65721,77,287962
25978,0.0004,172.31.40.0-255,66,65787,77,287962
25979,0.000534,74.125.24.0-255,1484,67271,77,287962
25980,0.000539,74.125.24.0-255,1484,68755,77,287962
25981,0.000543,172.31.40.0-255,66,68821,77,287962
25982,0.000569,74.125.24.0-255,1484,70305,77,287962
25983,0.000575,74.125.24.0-255,5738,76043,77,287962
25984,0.00058,172.31.40.0-255,66,76109,77,287962
25985,0.000598,74.125.24.0-255,4320,80429,77,287962
25986,0.000601,172.31.40.0-255,66,80495,77,287962
25987,0.000631,74.125.24.0-255,5379,85874,77,287962
25988,0.000635,172.31.40.0-255,66,85940,77,287962
25989,0.000644,74.125.24.0-255,9992,95932,77,287962
25990,0.000646,172.31.40.0-255,66,95998,77,287962
25991,0.000651,74.125.24.0-255,3961,99959,77,287962
25992,0.000653,172.31.40.0-255,66,100025,77,287962
25993,0.000683,74.125.24.0-255,330,100355,77,287962
25994,0.001301,74.125.24.0-255,1484,101839,77,287962
25995,0.001306,172.31.40.0-255,66,101905,77,287962
25996,0.001312,74.125.24.0-255,2902,104807,77,287962
25997,0.001314,172.31.40.0-255,66,104873,77,287962
25998,0.00132,74.125.24.0-255,4320,109193,77,287962
25999,0.001327,172.31.40.0-255,66,109259,77,287962
26000,0.001352,74.125.24.0-255,1484,110743,77,287962
26001,0.00136,74.125.24.0-255,7156,117899,77,287962
26002,0.001362,172.31.40.0-255,66,117965,77,287962
26003,0.001387,74.125.24.0-255,5738,123703,77,287962
26004,0.00139,172.31.40.0-255,66,123769,77,287962
26005,0.001395,74.125.24.0-255,4320,128089,77,287962
26006,0.001397,172.31.40.0-255,66,128155,77,287962
26007,0.001403,74.125.24.0-255,4320,132475,77,287962
26008,0.001405,172.31.40.0-255,66,132541,77,287962
26009,0.001426,74.125.24.0-255,2184,134725,77,287962
26010,0.001428,172.31.40.0-255,66,134791,77,287962
26011,0.00146,74.125.24.0-255,7156,141947,77,287962
26012,0.001463,172.31.40.0-255,66,142013,77,287962
26013,0.001471,74.125.24.0-255,8574,150587,77,287962
26014,0.001473,172.31.40.0-255,66,150653,77,287962
26015,0.001504,74.125.24.0-255,4320,154973,77,287962
26016,0.001506,74.125.24.0-255,1484,156457,77,287962
26017,0.001511,172.31.40.0-255,66,156523,77,287962
26018,0.001548,74.125.24.0-255,12110,168633,77,287962
26019,0.001551,172.31.40.0-255,66,168699,77,287962
26020,0.001697,74.125.24.0-255,1484,170183,77,287962
26021,0.001703,74.125.24.0-255,2902,173085,77,287962
26022,0.001707,172.31.40.0-255,66,173151,77,287962
26023,0.001712,74.125.24.0-255,2902,176053,77,287962
26024,0.001714,172.31.40.0-255,66,176119,77,287962
26025,0.001735,74.125.24.0-255,2902,179021,77,287962
26026,0.001738,172.31.40.0-255,66,179087,77,287962
26027,0.001748,74.125.24.0-255,9992,189079,77,287962
26028,0.00175,172.31.40.0-255,66,189145,77,287962
26029,0.00178,74.125.24.0-255,2902,192047,77,287962
26030,0.00179,74.125.24.0-255,10692,202739,77,287962
26031,0.001802,172.31.40.0-255,101,202840,77,287962
26032,0.001811,172.31.40.0-255,66,202906,77,287962
26033,0.001819,172.31.40.0-255,66,202972,77,287962
26034,0.002005,74.125.24.0-255,1484,204456,77,287962
26035,0.00201,74.125.24.0-255,1484,205940,77,287962
26036,0.002013,172.31.40.0-255,66,206006,77,287962
26037,0.002027,74.125.24.0-255,1484,207490,77,287962
26038,0.002038,74.125.24.0-255,5738,213228,77,287962
26039,0.00204,172.31.40.0-255,66,213294,77,287962
26040,0.002065,74.125.24.0-255,4320,217614,77,287962
26041,0.002068,172.31.40.0-255,66,217680,77,287962
26042,0.002091,74.125.24.0-255,8574,226254,77,287962
26043,0.002093,172.31.40.0-255,66,226320,77,287962
26044,0.002102,74.125.24.0-255,9992,236312,77,287962
26045,0.002105,172.31.40.0-255,66,236378,77,287962
26046,0.002199,172.31.40.0-255,66,236444,77,287962
26047,0.00221,74.125.24.0-255,12110,248554,77,287962
26048,0.002213,172.31.40.0-255,66,248620,77,287962
26049,0.004175,74.125.24.0-255,66,248686,77,287962
26050,0.004579,74.125.24.0-255,4320,253006,77,287962
26051,0.004583,172.31.40.0-255,66,253072,77,287962
26052,0.004615,74.125.24.0-255,1484,254556,77,287962
26053,0.006929,74.125.24.0-255,4320,258876,77,287962
26054,0.006936,172.31.40.0-255,66,258942,77,287962
26055,0.00933,74.125.24.0-255,5738,264680,77,287962
26056,0.009337,172.31.40.0-255,66,264746,77,287962
26057,0.011696,74.125.24.0-255,5738,270484,77,287962
26058,0.011704,172.31.40.0-255,66,270550,77,287962
26059,0.014084,74.125.24.0-255,5738,276288,77,287962
26060,0.014093,172.31.40.0-255,66,276354,77,287962
26061,0.016507,74.125.24.0-255,5738,282092,77,287962
26062,0.01652,172.31.40.0-255,66,282158,77,287962
26063,0.01891,74.125.24.0-255,5738,287896,77,287962
26064,0.018919,172.31.40.0-255,66,287962,77,287962
26065,0.0,172.217.194.0-255,152,152,77,219405
26066,2.3e-05,172.31.40.0-255,66,218,77,219405
26067,3e-05,172.217.194.0-255,1484,1702,77,219405
26068,3.5e-05,172.31.40.0-255,66,1768,77,219405
26069,4.1e-05,172.217.194.0-255,2902,4670,77,219405
26070,4.3e-05,172.31.40.0-255,66,4736,77,219405
26071,6.4e-05,172.217.194.0-255,7156,11892,77,219405
26072,6.7e-05,172.31.40.0-255,66,11958,77,219405
26073,7.2e-05,172.217.194.0-255,2127,14085,77,219405
26074,7.4e-05,172.31.40.0-255,66,14151,77,219405
26075,0.000452,172.217.194.0-255,1484,15635,77,219405
26076,0.000458,172.31.40.0-255,66,15701,77,219405
26077,0.000464,172.217.194.0-255,2902,18603,77,219405
26078,0.000466,172.31.40.0-255,66,18669,77,219405
26079,0.000485,172.217.194.0-255,5738,24407,77,219405
26080,0.000488,172.31.40.0-255,66,24473,77,219405
26081,0.000514,172.217.194.0-255,4320,28793,77,219405
26082,0.000518,172.31.40.0-255,66,28859,77,219405
26083,0.000531,172.217.194.0-255,7156,36015,77,219405
26084,0.000533,172.31.40.0-255,66,36081,77,219405
26085,0.000565,172.217.194.0-255,2543,38624,77,219405
26086,0.000567,172.31.40.0-255,66,38690,77,219405
26087,0.000577,172.217.194.0-255,9633,48323,77,219405
26088,0.000579,172.31.40.0-255,66,48389,77,219405
26089,0.000807,172.217.194.0-255,1484,49873,77,219405
26090,0.000811,172.31.40.0-255,66,49939,77,219405
26091,0.000815,172.217.194.0-255,1484,51423,77,219405
26092,0.000817,172.31.40.0-255,66,51489,77,219405
26093,0.000837,172.217.194.0-255,1484,52973,77,219405
26094,0.000839,172.31.40.0-255,66,53039,77,219405
26095,0.000846,172.217.194.0-255,5738,58777,77,219405
26096,0.000848,172.31.40.0-255,66,58843,77,219405
26097,0.000856,172.217.194.0-255,6797,65640,77,219405
26098,0.000858,172.31.40.0-255,66,65706,77,219405
26099,0.001261,172.217.194.0-255,1484,67190,77,219405
26100,0.001285,172.217.194.0-255,2902,70092,77,219405
26101,0.001289,172.31.40.0-255,66,70158,77,219405
26102,0.001297,172.217.194.0-255,5738,75896,77,219405
26103,0.0013,172.31.40.0-255,66,75962,77,219405
26104,0.001308,172.217.194.0-255,8574,84536,77,219405
26105,0.00131,172.31.40.0-255,66,84602,77,219405
26106,0.001361,172.217.194.0-255,8574,93176,77,219405
26107,0.001365,172.31.40.0-255,66,93242,77,219405
26108,0.001392,172.217.194.0-255,6438,99680,77,219405
26109,0.001394,172.31.40.0-255,66,99746,77,219405
26110,0.001415,172.217.194.0-255,1484,101230,77,219405
26111,0.001421,172.217.194.0-255,2902,104132,77,219405
26112,0.001424,172.31.40.0-255,66,104198,77,219405
26113,0.001428,172.217.194.0-255,2902,107100,77,219405
26114,0.00143,172.31.40.0-255,66,107166,77,219405
26115,0.001447,172.217.194.0-255,2902,110068,77,219405
26116,0.001449,172.31.40.0-255,66,110134,77,219405
26117,0.001455,172.217.194.0-255,4320,114454,77,219405
26118,0.001457,172.31.40.0-255,66,114520,77,219405
26119,0.001478,172.217.194.0-255,2902,117422,77,219405
26120,0.001481,172.31.40.0-255,66,117488,77,219405
26121,0.00149,172.217.194.0-255,8574,126062,77,219405
26122,0.001493,172.31.40.0-255,66,126128,77,219405
26123,0.001518,172.217.194.0-255,5738,131866,77,219405
26124,0.001521,172.31.40.0-255,66,131932,77,219405
26125,0.001526,172.217.194.0-255,2184,134116,77,219405
26126,0.001528,172.31.40.0-255,66,134182,77,219405
26127,0.001578,172.217.194.0-255,1484,135666,77,219405
26128,0.001593,172.217.194.0-255,2902,138568,77,219405
26129,0.001596,172.31.40.0-255,66,138634,77,219405
26130,0.001603,172.217.194.0-255,4320,142954,77,219405
26131,0.001606,172.31.40.0-255,66,143020,77,219405
26132,0.001625,172.217.194.0-255,1484,144504,77,219405
26133,0.001634,172.217.194.0-255,5738,150242,77,219405
26134,0.001637,172.31.40.0-255,66,150308,77,219405
26135,0.001669,172.217.194.0-255,7156,157464,77,219405
26136,0.001672,172.31.40.0-255,66,157530,77,219405
26137,0.001682,172.217.194.0-255,10692,168222,77,219405
26138,0.001685,172.31.40.0-255,66,168288,77,219405
26139,0.00368,172.217.194.0-255,5738,174026,77,219405
26140,0.003688,172.31.40.0-255,66,174092,77,219405
26141,0.005195,172.31.40.0-255,101,174193,77,219405
26142,0.005712,172.217.194.0-255,5738,179931,77,219405
26143,0.005719,172.31.40.0-255,66,179997,77,219405
26144,0.007124,172.217.194.0-255,66,180063,77,219405
26145,0.007683,172.217.194.0-255,5738,185801,77,219405
26146,0.007686,172.31.40.0-255,66,185867,77,219405
26147,0.009666,172.217.194.0-255,5738,191605,77,219405
26148,0.009673,172.31.40.0-255,66,191671,77,219405
26149,0.011699,172.217.194.0-255,5738,197409,77,219405
26150,0.011707,172.31.40.0-255,66,197475,77,219405
26151,0.013686,172.217.194.0-255,5738,203213,77,219405
26152,0.013694,172.31.40.0-255,66,203279,77,219405
26153,0.015708,172.217.194.0-255,4320,207599,77,219405
26154,0.015718,172.31.40.0-255,66,207665,77,219405
26155,0.015739,172.217.194.0-255,1484,209149,77,219405
26156,0.017721,172.217.194.0-255,4320,213469,77,219405
26157,0.017731,172.31.40.0-255,66,213535,77,219405
26158,0.019749,172.217.194.0-255,4320,217855,77,219405
26159,0.019758,172.31.40.0-255,66,217921,77,219405
26160,0.019778,172.217.194.0-255,1484,219405,77,219405
26161,0.0,172.253.118.0-255,153,153,77,359096
26162,2.3e-05,172.31.40.0-255,66,219,77,359096
26163,3e-05,172.253.118.0-255,1484,1703,77,359096
26164,3.5e-05,172.31.40.0-255,66,1769,77,359096
26165,4.8e-05,172.253.118.0-255,2902,4671,77,359096
26166,5.1e-05,172.31.40.0-255,66,4737,77,359096
26167,5.9e-05,172.253.118.0-255,7156,11893,77,359096
26168,6.3e-05,172.31.40.0-255,66,11959,77,359096
26169,9.6e-05,172.253.118.0-255,2072,14031,77,359096
26170,0.0001,172.31.40.0-255,66,14097,77,359096
26171,0.000119,172.253.118.0-255,2902,16999,77,359096
26172,0.000122,172.31.40.0-255,66,17065,77,359096
26173,0.000127,172.253.118.0-255,4320,21385,77,359096
26174,0.00013,172.31.40.0-255,66,21451,77,359096
26175,0.000169,172.253.118.0-255,8574,30025,77,359096
26176,0.000172,172.31.40.0-255,66,30091,77,359096
26177,0.000175,172.253.118.0-255,1125,31216,77,359096
26178,0.000177,172.31.40.0-255,66,31282,77,359096
26179,0.000229,172.253.118.0-255,1484,32766,77,359096
26180,0.000231,172.31.40.0-255,66,32832,77,359096
26181,0.000237,172.253.118.0-255,2902,35734,77,359096
26182,0.000238,172.31.40.0-255,66,35800,77,359096
26183,0.000241,172.253.118.0-255,1484,37284,77,359096
26184,0.000244,172.31.40.0-255,66,37350,77,359096
26185,0.00028,172.253.118.0-255,4320,41670,77,359096
26186,0.000286,172.253.118.0-255,6797,48467,77,359096
26187,0.000291,172.31.40.0-255,66,48533,77,359096
26188,0.000294,172.31.40.0-255,66,48599,77,359096
26189,0.000385,172.253.118.0-255,1484,50083,77,359096
26190,0.000389,172.31.40.0-255,66,50149,77,359096
26191,0.000394,172.253.118.0-255,2902,53051,77,359096
26192,0.000397,172.31.40.0-255,66,53117,77,359096
26193,0.000402,172.253.118.0-255,4320,57437,77,359096
26194,0.00041,172.31.40.0-255,66,57503,77,359096
26195,0.000466,172.253.118.0-255,1484,58987,77,359096
26196,0.000475,172.253.118.0-255,5738,64725,77,359096
26197,0.000478,172.31.40.0-255,66,64791,77,359096
26198,0.000481,172.253.118.0-255,1472,66263,77,359096
26199,0.000501,172.253.118.0-255,330,66593,77,359096
26200,0.000503,172.31.40.0-255,66,66659,77,359096
26201,0.000727,172.253.118.0-255,1484,68143,77,359096
26202,0.000735,172.253.118.0-255,2902,71045,77,359096
26203,0.000739,172.31.40.0-255,66,71111,77,359096
26204,0.000766,172.253.118.0-255,5738,76849,77,359096
26205,0.000769,172.31.40.0-255,66,76915,77,359096
26206,0.000785,172.253.118.0-255,1484,78399,77,359096
26207,0.000816,172.253.118.0-255,11410,89809,77,359096
26208,0.000821,172.31.40.0-255,66,89875,77,359096
26209,0.000853,172.253.118.0-255,10692,100567,77,359096
26210,0.000856,172.31.40.0-255,66,100633,77,359096
26211,0.000959,172.253.118.0-255,1484,102117,77,359096
26212,0.000971,172.253.118.0-255,2902,105019,77,359096
26213,0.000974,172.31.40.0-255,66,105085,77,359096
26214,0.00098,172.253.118.0-255,2902,107987,77,359096
26215,0.000982,172.31.40.0-255,66,108053,77,359096
26216,0.00101,172.253.118.0-255,2902,110955,77,359096
26217,0.001013,172.31.40.0-255,66,111021,77,359096
26218,0.001021,172.253.118.0-255,8574,119595,77,359096
26219,0.001023,172.31.40.0-255,66,119661,77,359096
26220,0.001055,172.253.118.0-255,4320,123981,77,359096
26221,0.001058,172.31.40.0-255,66,124047,77,359096
26222,0.001064,172.253.118.0-255,4320,128367,77,359096
26223,0.001066,172.31.40.0-255,66,128433,77,359096
26224,0.001116,172.253.118.0-255,6438,134871,77,359096
26225,0.001119,172.31.40.0-255,66,134937,77,359096
26226,0.001122,172.253.118.0-255,1484,136421,77,359096
26227,0.001127,172.253.118.0-255,2902,139323,77,359096
26228,0.001129,172.31.40.0-255,66,139389,77,359096
26229,0.001165,172.253.118.0-255,5738,145127,77,359096
26230,0.001169,172.31.40.0-255,66,145193,77,359096
26231,0.00118,172.253.118.0-255,12828,158021,77,359096
26232,0.001183,172.31.40.0-255,66,158087,77,359096
26233,0.00119,172.253.118.0-255,7156,165243,77,359096
26234,0.001192,172.31.40.0-255,66,165309,77,359096
26235,0.001231,172.253.118.0-255,3602,168911,77,359096
26236,0.001234,172.31.40.0-255,66,168977,77,359096
26237,0.001277,172.253.118.0-255,2902,171879,77,359096
26238,0.001281,172.31.40.0-255,66,171945,77,359096
26239,0.001286,172.253.118.0-255,4320,176265,77,359096
26240,0.001288,172.31.40.0-255,66,176331,77,359096
26241,0.00132,172.253.118.0-255,8574,184905,77,359096
26242,0.001323,172.31.40.0-255,66,184971,77,359096
26243,0.001326,172.253.118.0-255,1484,186455,77,359096
26244,0.001369,172.31.40.0-255,66,186521,77,359096
26245,0.001373,172.253.118.0-255,2184,188705,77,359096
26246,0.001375,172.31.40.0-255,66,188771,77,359096
26247,0.001598,172.253.118.0-255,1484,190255,77,359096
26248,0.001618,172.253.118.0-255,2902,193157,77,359096
26249,0.001622,172.31.40.0-255,66,193223,77,359096
26250,0.001628,172.253.118.0-255,4320,197543,77,359096
26251,0.00163,172.31.40.0-255,66,197609,77,359096
26252,0.00165,172.253.118.0-255,1484,199093,77,359096
26253,0.001655,172.253.118.0-255,4320,203413,77,359096
26254,0.001659,172.253.118.0-255,2902,206315,77,359096
26255,0.001664,172.31.40.0-255,66,206381,77,359096
26256,0.001667,172.31.40.0-255,66,206447,77,359096
26257,0.00169,172.253.118.0-255,8574,215021,77,359096
26258,0.001693,172.31.40.0-255,66,215087,77,359096
26259,0.001701,172.253.118.0-255,7856,222943,77,359096
26260,0.001704,172.31.40.0-255,66,223009,77,359096
26261,0.001765,172.253.118.0-255,1484,224493,77,359096
26262,0.001776,172.253.118.0-255,1484,225977,77,359096
26263,0.00178,172.31.40.0-255,66,226043,77,359096
26264,0.001789,172.253.118.0-255,1484,227527,77,359096
26265,0.001799,172.253.118.0-255,5738,233265,77,359096
26266,0.001802,172.31.40.0-255,66,233331,77,359096
26267,0.001805,172.253.118.0-255,1484,234815,77,359096
26268,0.001846,172.253.118.0-255,11410,246225,77,359096
26269,0.001849,172.31.40.0-255,66,246291,77,359096
26270,0.001856,172.253.118.0-255,5738,252029,77,359096
26271,0.001858,172.31.40.0-255,66,252095,77,359096
26272,0.001894,172.253.118.0-255,5020,257115,77,359096
26273,0.001898,172.31.40.0-255,66,257181,77,359096
26274,0.002036,172.253.118.0-255,1484,258665,77,359096
26275,0.002051,172.253.118.0-255,1484,260149,77,359096
26276,0.002054,172.31.40.0-255,66,260215,77,359096
26277,0.002073,172.253.118.0-255,1484,261699,77,359096
26278,0.00208,172.253.118.0-255,5738,267437,77,359096
26279,0.002083,172.31.40.0-255,66,267503,77,359096
26280,0.00209,172.253.118.0-255,7156,274659,77,359096
26281,0.002093,172.31.40.0-255,66,274725,77,359096
26282,0.002135,172.31.40.0-255,66,274791,77,359096
26283,0.002139,172.253.118.0-255,2184,276975,77,359096
26284,0.002141,172.31.40.0-255,66,277041,77,359096
26285,0.002238,172.253.118.0-255,1484,278525,77,359096
26286,0.002244,172.253.118.0-255,2902,281427,77,359096
26287,0.002247,172.31.40.0-255,66,281493,77,359096
26288,0.002254,172.253.118.0-255,5738,287231,77,359096
26289,0.002256,172.31.40.0-255,66,287297,77,359096
26290,0.002331,172.253.118.0-255,12828,300125,77,359096
26291,0.002333,172.31.40.0-255,66,300191,77,359096
26292,0.002346,172.253.118.0-255,13528,313719,77,359096
26293,0.002349,172.31.40.0-255,66,313785,77,359096
26294,0.002358,172.253.118.0-255,9992,323777,77,359096
26295,0.00236,172.31.40.0-255,66,323843,77,359096
26296,0.002399,172.253.118.0-255,1484,325327,77,359096
26297,0.002426,172.253.118.0-255,11410,336737,77,359096
26298,0.00243,172.31.40.0-255,66,336803,77,359096
26299,0.002467,172.253.118.0-255,12110,348913,77,359096
26300,0.002471,172.31.40.0-255,66,348979,77,359096
26301,0.002501,172.31.40.0-255,66,349045,77,359096
26302,0.002508,172.253.118.0-255,5020,354065,77,359096
26303,0.00251,172.31.40.0-255,66,354131,77,359096
26304,0.002517,172.253.118.0-255,4456,358587,77,359096
26305,0.002521,172.31.40.0-255,66,358653,77,359096
26306,0.005019,172.253.118.0-255,105,358758,77,359096
26307,0.007515,172.31.40.0-255,101,358859,77,359096
26308,0.009738,172.31.40.0-255,105,358964,77,359096
26309,0.009997,172.253.118.0-255,66,359030,77,359096
26310,0.012229,172.253.118.0-255,66,359096,77,359096
26311,0.0,172.217.194.0-255,153,153,77,311560
26312,2.2e-05,172.31.40.0-255,66,219,77,311560
26313,2.9e-05,172.217.194.0-255,1484,1703,77,311560
26314,3.4e-05,172.31.40.0-255,66,1769,77,311560
26315,3.9e-05,172.217.194.0-255,2902,4671,77,311560
26316,5e-05,172.31.40.0-255,66,4737,77,311560
26317,5.7e-05,172.217.194.0-255,7156,11893,77,311560
26318,6e-05,172.31.40.0-255,66,11959,77,311560
26319,6.4e-05,172.217.194.0-255,2135,14094,77,311560
26320,6.6e-05,172.31.40.0-255,66,14160,77,311560
26321,0.000106,172.217.194.0-255,5738,19898,77,311560
26322,0.00011,172.31.40.0-255,66,19964,77,311560
26323,0.000117,172.217.194.0-255,7156,27120,77,311560
26324,0.000119,172.31.40.0-255,66,27186,77,311560
26325,0.000143,172.217.194.0-255,1484,28670,77,311560
26326,0.000145,172.31.40.0-255,66,28736,77,311560
26327,0.000177,172.217.194.0-255,9633,38369,77,311560
26328,0.000179,172.31.40.0-255,66,38435,77,311560
26329,0.00021,172.217.194.0-255,9633,48068,77,311560
26330,0.000213,172.31.40.0-255,66,48134,77,311560
26331,0.000246,172.217.194.0-255,1484,49618,77,311560
26332,0.000248,172.31.40.0-255,66,49684,77,311560
26333,0.000253,172.217.194.0-255,2902,52586,77,311560
26334,0.000256,172.31.40.0-255,66,52652,77,311560
26335,0.000292,172.217.194.0-255,2902,55554,77,311560
26336,0.000294,172.31.40.0-255,66,55620,77,311560
26337,0.000324,172.217.194.0-255,2902,58522,77,311560
26338,0.000326,172.31.40.0-255,66,58588,77,311560
26339,0.000334,172.217.194.0-255,7096,65684,77,311560
26340,0.000336,172.31.40.0-255,66,65750,77,311560
26341,0.000343,172.217.194.0-255,379,66129,77,311560
26342,0.000346,172.31.40.0-255,66,66195,77,311560
26343,0.000558,172.217.194.0-255,1484,67679,77,311560
26344,0.000566,172.217.194.0-255,2902,70581,77,311560
26345,0.00057,172.31.40.0-255,66,70647,77,311560
26346,0.000577,172.217.194.0-255,5738,76385,77,311560
26347,0.00058,172.31.40.0-255,66,76451,77,311560
26348,0.000608,172.217.194.0-255,6797,83248,77,311560
26349,0.000611,172.31.40.0-255,66,83314,77,311560
26350,0.000709,172.217.194.0-255,1484,84798,77,311560
26351,0.000716,172.217.194.0-255,2902,87700,77,311560
26352,0.000718,172.31.40.0-255,66,87766,77,311560
26353,0.000722,172.217.194.0-255,1484,89250,77,311560
26354,0.000753,172.217.194.0-255,4320,93570,77,311560
26355,0.000755,172.31.40.0-255,66,93636,77,311560
26356,0.000763,172.217.194.0-255,6797,100433,77,311560
26357,0.000765,172.31.40.0-255,66,100499,77,311560
26358,0.000864,172.31.40.0-255,101,100600,77,311560
26359,0.001239,172.217.194.0-255,1484,102084,77,311560
26360,0.001246,172.217.194.0-255,2902,104986,77,311560
26361,0.001249,172.31.40.0-255,66,105052,77,311560
26362,0.001256,172.217.194.0-255,5738,110790,77,311560
26363,0.001258,172.31.40.0-255,66,110856,77,311560
26364,0.001275,172.217.194.0-255,12828,123684,77,311560
26365,0.001277,172.31.40.0-255,66,123750,77,311560
26366,0.001287,172.217.194.0-255,10692,134442,77,311560
26367,0.00129,172.31.40.0-255,66,134508,77,311560
26368,0.00168,172.217.194.0-255,1484,135992,77,311560
26369,0.001687,172.217.194.0-255,2902,138894,77,311560
26370,0.00169,172.31.40.0-255,66,138960,77,311560
26371,0.001722,172.217.194.0-255,5738,144698,77,311560
26372,0.001727,172.217.194.0-255,5738,150436,77,311560
26373,0.001731,172.31.40.0-255,66,150502,77,311560
26374,0.001734,172.31.40.0-255,66,150568,77,311560
26375,0.001772,172.217.194.0-255,12828,163396,77,311560
26376,0.001775,172.31.40.0-255,66,163462,77,311560
26377,0.001782,172.217.194.0-255,5020,168482,77,311560
26378,0.001784,172.31.40.0-255,66,168548,77,311560
26379,0.001911,172.217.194.0-255,1484,170032,77,311560
26380,0.001916,172.217.194.0-255,2902,172934,77,311560
26381,0.001919,172.31.40.0-255,66,173000,77,311560
26382,0.001925,172.217.194.0-255,2902,175902,77,311560
26383,0.001927,172.31.40.0-255,66,175968,77,311560
26384,0.001948,172.217.194.0-255,2902,178870,77,311560
26385,0.001956,172.217.194.0-255,8574,187444,77,311560
26386,0.00196,172.31.40.0-255,66,187510,77,311560
26387,0.001962,172.31.40.0-255,66,187576,77,311560
26388,0.001982,172.217.194.0-255,4320,191896,77,311560
26389,0.001985,172.31.40.0-255,66,191962,77,311560
26390,0.001998,172.217.194.0-255,10692,202654,77,311560
26391,0.002001,172.31.40.0-255,66,202720,77,311560
26392,0.002114,172.217.194.0-255,1484,204204,77,311560
26393,0.002118,172.217.194.0-255,1484,205688,77,311560
26394,0.002121,172.31.40.0-255,66,205754,77,311560
26395,0.002146,172.217.194.0-255,1484,207238,77,311560
26396,0.002152,172.217.194.0-255,5738,212976,77,311560
26397,0.002154,172.31.40.0-255,66,213042,77,311560
26398,0.00216,172.217.194.0-255,4320,217362,77,311560
26399,0.002162,172.31.40.0-255,66,217428,77,311560
26400,0.002202,172.217.194.0-255,8574,226002,77,311560
26401,0.002205,172.31.40.0-255,66,226068,77,311560
26402,0.002214,172.217.194.0-255,8574,234642,77,311560
26403,0.002223,172.31.40.0-255,66,234708,77,311560
26404,0.002227,172.217.194.0-255,2184,236892,77,311560
26405,0.00223,172.31.40.0-255,66,236958,77,311560
26406,0.00226,172.217.194.0-255,2902,239860,77,311560
26407,0.002264,172.31.40.0-255,66,239926,77,311560
26408,0.002272,172.217.194.0-255,7156,247082,77,311560
26409,0.002274,172.31.40.0-255,66,247148,77,311560
26410,0.002294,172.217.194.0-255,8574,255722,77,311560
26411,0.002297,172.31.40.0-255,66,255788,77,311560
26412,0.002332,172.217.194.0-255,1484,257272,77,311560
26413,0.002371,172.217.194.0-255,13528,270800,77,311560
26414,0.002374,172.31.40.0-255,66,270866,77,311560
26415,0.00311,172.217.194.0-255,66,270932,77,311560
26416,0.004686,172.217.194.0-255,5738,276670,77,311560
26417,0.004703,172.31.40.0-255,66,276736,77,311560
26418,0.007088,172.217.194.0-255,5738,282474,77,311560
26419,0.007107,172.31.40.0-255,66,282540,77,311560
26420,0.009413,172.217.194.0-255,5738,288278,77,311560
26421,0.009423,172.31.40.0-255,66,288344,77,311560
26422,0.011733,172.217.194.0-255,5738,294082,77,311560
26423,0.01174,172.31.40.0-255,66,294148,77,311560
26424,0.014041,172.217.194.0-255,5738,299886,77,311560
26425,0.014049,172.31.40.0-255,66,299952,77,311560
26426,0.01641,172.217.194.0-255,5738,305690,77,311560
26427,0.016428,172.31.40.0-255,66,305756,77,311560
26428,0.018746,172.217.194.0-255,5738,311494,77,311560
26429,0.018763,172.31.40.0-255,66,311560,77,311560
26430,0.0,172.217.194.0-255,152,152,77,393731
26431,2.7e-05,172.31.40.0-255,66,218,77,393731
26432,3.5e-05,172.217.194.0-255,1484,1702,77,393731
26433,3.9e-05,172.31.40.0-255,66,1768,77,393731
26434,4.5e-05,172.217.194.0-255,2902,4670,77,393731
26435,4.9e-05,172.31.40.0-255,66,4736,77,393731
26436,5.8e-05,172.217.194.0-255,7156,11892,77,393731
26437,6e-05,172.31.40.0-255,66,11958,77,393731
26438,6.5e-05,172.217.194.0-255,3346,15304,77,393731
26439,6.8e-05,172.31.40.0-255,66,15370,77,393731
26440,7.9e-05,172.217.194.0-255,12828,28198,77,393731
26441,8.2e-05,172.31.40.0-255,66,28264,77,393731
26442,8.7e-05,172.217.194.0-255,2543,30807,77,393731
26443,8.9e-05,172.31.40.0-255,66,30873,77,393731
26444,0.000145,172.217.194.0-255,1484,32357,77,393731
26445,0.000148,172.31.40.0-255,66,32423,77,393731
26446,0.000153,172.217.194.0-255,2902,35325,77,393731
26447,0.000155,172.31.40.0-255,66,35391,77,393731
26448,0.000158,172.217.194.0-255,1484,36875,77,393731
26449,0.00016,172.31.40.0-255,66,36941,77,393731
26450,0.000176,172.217.194.0-255,4320,41261,77,393731
26451,0.000178,172.31.40.0-255,66,41327,77,393731
26452,0.000181,172.217.194.0-255,1484,42811,77,393731
26453,0.000183,172.31.40.0-255,66,42877,77,393731
26454,0.000212,172.217.194.0-255,6797,49674,77,393731
26455,0.000214,172.31.40.0-255,66,49740,77,393731
26456,0.000226,172.217.194.0-255,11410,61150,77,393731
26457,0.000228,172.31.40.0-255,66,61216,77,393731
26458,0.000243,172.217.194.0-255,4253,65469,77,393731
26459,0.000249,172.31.40.0-255,66,65535,77,393731
26460,0.000302,172.217.194.0-255,367,65902,77,393731
26461,0.000305,172.31.40.0-255,66,65968,77,393731
26462,0.000448,172.217.194.0-255,1484,67452,77,393731
26463,0.000456,172.217.194.0-255,2902,70354,77,393731
26464,0.00046,172.31.40.0-255,66,70420,77,393731
26465,0.000463,172.217.194.0-255,1484,71904,77,393731
26466,0.000483,172.217.194.0-255,4320,76224,77,393731
26467,0.000486,172.31.40.0-255,66,76290,77,393731
26468,0.00049,172.217.194.0-255,2902,79192,77,393731
26469,0.000492,172.31.40.0-255,66,79258,77,393731
26470,0.000516,172.217.194.0-255,11051,90309,77,393731
26471,0.000519,172.31.40.0-255,66,90375,77,393731
26472,0.000579,172.217.194.0-255,2902,93277,77,393731
26473,0.000582,172.31.40.0-255,66,93343,77,393731
26474,0.000602,172.217.194.0-255,6797,100140,77,393731
26475,0.000604,172.31.40.0-255,66,100206,77,393731
26476,0.00077,172.217.194.0-255,1484,101690,77,393731
26477,0.000777,172.217.194.0-255,2902,104592,77,393731
26478,0.000781,172.31.40.0-255,66,104658,77,393731
26479,0.000785,172.217.194.0-255,1484,106142,77,393731
26480,0.000804,172.217.194.0-255,4320,110462,77,393731
26481,0.000808,172.31.40.0-255,66,110528,77,393731
26482,0.000815,172.217.194.0-255,7156,117684,77,393731
26483,0.000818,172.31.40.0-255,66,117750,77,393731
26484,0.000866,172.217.194.0-255,7156,124906,77,393731
26485,0.00087,172.31.40.0-255,66,124972,77,393731
26486,0.000898,172.217.194.0-255,7156,132128,77,393731
26487,0.000901,172.217.194.0-255,2184,134312,77,393731
26488,0.000906,172.31.40.0-255,66,134378,77,393731
26489,0.000909,172.31.40.0-255,66,134444,77,393731
26490,0.000936,172.217.194.0-255,4320,138764,77,393731
26491,0.000938,172.31.40.0-255,66,138830,77,393731
26492,0.000967,172.217.194.0-255,12828,151658,77,393731
26493,0.000971,172.31.40.0-255,66,151724,77,393731
26494,0.000992,172.217.194.0-255,5738,157462,77,393731
26495,0.000995,172.31.40.0-255,66,157528,77,393731
26496,0.001021,172.217.194.0-255,10692,168220,77,393731
26497,0.001024,172.31.40.0-255,66,168286,77,393731
26498,0.001085,172.217.194.0-255,1484,169770,77,393731
26499,0.001101,172.217.194.0-255,2902,172672,77,393731
26500,0.001104,172.31.40.0-255,66,172738,77,393731
26501,0.001111,172.217.194.0-255,5738,178476,77,393731
26502,0.001113,172.31.40.0-255,66,178542,77,393731
26503,0.001117,172.217.194.0-255,2902,181444,77,393731
26504,0.00112,172.31.40.0-255,66,181510,77,393731
26505,0.001147,172.217.194.0-255,9992,191502,77,393731
26506,0.001149,172.31.40.0-255,66,191568,77,393731
26507,0.001158,172.217.194.0-255,8574,200142,77,393731
26508,0.001161,172.31.40.0-255,66,200208,77,393731
26509,0.001185,172.217.194.0-255,2184,202392,77,393731
26510,0.001188,172.31.40.0-255,66,202458,77,393731
26511,0.00136,172.217.194.0-255,1484,203942,77,393731
26512,0.001368,172.217.194.0-255,2902,206844,77,393731
26513,0.001372,172.31.40.0-255,66,206910,77,393731
26514,0.001396,172.217.194.0-255,5738,212648,77,393731
26515,0.001399,172.31.40.0-255,66,212714,77,393731
26516,0.001405,172.217.194.0-255,5738,218452,77,393731
26517,0.001407,172.31.40.0-255,66,218518,77,393731
26518,0.001425,172.217.194.0-255,2902,221420,77,393731
26519,0.001427,172.31.40.0-255,66,221486,77,393731
26520,0.001462,172.217.194.0-255,9992,231478,77,393731
26521,0.001466,172.31.40.0-255,66,231544,77,393731
26522,0.001477,172.217.194.0-255,12110,243654,77,393731
26523,0.00148,172.31.40.0-255,66,243720,77,393731
26524,0.001486,172.217.194.0-255,5738,249458,77,393731
26525,0.001488,172.31.40.0-255,66,249524,77,393731
26526,0.001517,172.217.194.0-255,7156,256680,77,393731
26527,0.00152,172.31.40.0-255,66,256746,77,393731
26528,0.001531,172.217.194.0-255,13528,270274,77,393731
26529,0.001533,172.31.40.0-255,66,270340,77,393731
26530,0.001536,172.217.194.0-255,1484,271824,77,393731
26531,0.001562,172.217.194.0-255,2902,274726,77,393731
26532,0.001565,172.31.40.0-255,66,274792,77,393731
26533,0.00157,172.217.194.0-255,5738,280530,77,393731
26534,0.001572,172.31.40.0-255,66,280596,77,393731
26535,0.001609,172.217.194.0-255,9992,290588,77,393731
26536,0.001611,172.31.40.0-255,66,290654,77,393731
26537,0.001638,172.217.194.0-255,1484,292138,77,393731
26538,0.001648,172.217.194.0-255,12110,304248,77,393731
26539,0.001651,172.31.40.0-255,66,304314,77,393731
26540,0.001661,172.217.194.0-255,12828,317142,77,393731
26541,0.001663,172.31.40.0-255,66,317208,77,393731
26542,0.001669,172.217.194.0-255,7156,324364,77,393731
26543,0.001671,172.31.40.0-255,66,324430,77,393731
26544,0.001677,172.217.194.0-255,5738,330168,77,393731
26545,0.001679,172.31.40.0-255,66,330234,77,393731
26546,0.001696,172.217.194.0-255,2902,333136,77,393731
26547,0.001699,172.31.40.0-255,66,333202,77,393731
26548,0.001711,172.217.194.0-255,1484,334686,77,393731
26549,0.001726,172.217.194.0-255,4320,339006,77,393731
26550,0.001729,172.31.40.0-255,66,339072,77,393731
26551,0.001754,172.217.194.0-255,12110,351182,77,393731
26552,0.001756,172.31.40.0-255,66,351248,77,393731
26553,0.001763,172.217.194.0-255,7156,358404,77,393731
26554,0.001765,172.31.40.0-255,66,358470,77,393731
26555,0.001782,172.217.194.0-255,11410,369880,77,393731
26556,0.001784,172.31.40.0-255,66,369946,77,393731
26557,0.00179,172.217.194.0-255,5738,375684,77,393731
26558,0.001791,172.31.40.0-255,66,375750,77,393731
26559,0.001806,172.217.194.0-255,6438,382188,77,393731
26560,0.00181,172.31.40.0-255,66,382254,77,393731
26561,0.001858,172.31.40.0-255,66,382320,77,393731
26562,0.001883,172.217.194.0-255,11003,393323,77,393731
26563,0.001885,172.217.194.0-255,105,393428,77,393731
26564,0.001889,172.31.40.0-255,66,393494,77,393731
26565,0.004466,172.31.40.0-255,66,393560,77,393731
26566,0.004504,172.31.40.0-255,105,393665,77,393731
26567,0.006847,172.217.194.0-255,66,393731,77,393731
26568,0.0,74.125.24.0-255,150,150,77,202544
26569,2.3e-05,172.31.40.0-255,66,216,77,202544
26570,3.1e-05,74.125.24.0-255,1484,1700,77,202544
26571,3.6e-05,172.31.40.0-255,66,1766,77,202544
26572,4.2e-05,74.125.24.0-255,2902,4668,77,202544
26573,4.6e-05,172.31.40.0-255,66,4734,77,202544
26574,5.4e-05,74.125.24.0-255,7156,11890,77,202544
26575,5.7e-05,172.31.40.0-255,66,11956,77,202544
26576,6.1e-05,74.125.24.0-255,2138,14094,77,202544
26577,6.3e-05,172.31.40.0-255,66,14160,77,202544
26578,0.000294,74.125.24.0-255,1484,15644,77,202544
26579,0.0003,172.31.40.0-255,66,15710,77,202544
26580,0.000306,74.125.24.0-255,2902,18612,77,202544
26581,0.000308,172.31.40.0-255,66,18678,77,202544
26582,0.000315,74.125.24.0-255,5738,24416,77,202544
26583,0.000317,172.31.40.0-255,66,24482,77,202544
26584,0.000352,74.125.24.0-255,6797,31279,77,202544
26585,0.000355,172.31.40.0-255,66,31345,77,202544
26586,0.00043,74.125.24.0-255,1484,32829,77,202544
26587,0.000434,172.31.40.0-255,66,32895,77,202544
26588,0.000438,74.125.24.0-255,2902,35797,77,202544
26589,0.00044,172.31.40.0-255,66,35863,77,202544
26590,0.000445,74.125.24.0-255,2902,38765,77,202544
26591,0.000447,172.31.40.0-255,66,38831,77,202544
26592,0.000462,74.125.24.0-255,2902,41733,77,202544
26593,0.000465,172.31.40.0-255,66,41799,77,202544
26594,0.000506,74.125.24.0-255,6797,48596,77,202544
26595,0.00051,172.31.40.0-255,66,48662,77,202544
26596,0.000539,74.125.24.0-255,7156,55818,77,202544
26597,0.000542,172.31.40.0-255,66,55884,77,202544
26598,0.000548,74.125.24.0-255,4320,60204,77,202544
26599,0.00055,172.31.40.0-255,66,60270,77,202544
26600,0.000604,74.125.24.0-255,5676,65946,77,202544
26601,0.000608,172.31.40.0-255,66,66012,77,202544
26602,0.000986,74.125.24.0-255,126,66138,77,202544
26603,0.00102,74.125.24.0-255,1484,67622,77,202544
26604,0.001024,172.31.40.0-255,66,67688,77,202544
26605,0.00103,74.125.24.0-255,2902,70590,77,202544
26606,0.001032,172.31.40.0-255,66,70656,77,202544
26607,0.001038,74.125.24.0-255,4320,74976,77,202544
26608,0.00104,172.31.40.0-255,66,75042,77,202544
26609,0.001069,74.125.24.0-255,2902,77944,77,202544
26610,0.001071,172.31.40.0-255,66,78010,77,202544
26611,0.00108,74.125.24.0-255,8574,86584,77,202544
26612,0.001082,172.31.40.0-255,66,86650,77,202544
26613,0.001103,74.125.24.0-255,2902,89552,77,202544
26614,0.001106,172.31.40.0-255,66,89618,77,202544
26615,0.001137,74.125.24.0-255,10692,100310,77,202544
26616,0.001139,172.31.40.0-255,66,100376,77,202544
26617,0.001142,74.125.24.0-255,352,100728,77,202544
26618,0.001435,172.31.40.0-255,66,100794,77,202544
26619,0.001742,74.125.24.0-255,1484,102278,77,202544
26620,0.001751,74.125.24.0-255,2902,105180,77,202544
26621,0.001755,172.31.40.0-255,66,105246,77,202544
26622,0.001759,74.125.24.0-255,1484,106730,77,202544
26623,0.001778,74.125.24.0-255,4320,111050,77,202544
26624,0.00178,172.31.40.0-255,66,111116,77,202544
26625,0.001787,74.125.24.0-255,5738,116854,77,202544
26626,0.001789,172.31.40.0-255,66,116920,77,202544
26627,0.00181,74.125.24.0-255,7156,124076,77,202544
26628,0.001812,172.31.40.0-255,66,124142,77,202544
26629,0.001822,74.125.24.0-255,10692,134834,77,202544
26630,0.001824,172.31.40.0-255,66,134900,77,202544
26631,0.002054,74.125.24.0-255,1484,136384,77,202544
26632,0.00206,74.125.24.0-255,1484,137868,77,202544
26633,0.002064,172.31.40.0-255,66,137934,77,202544
26634,0.002079,74.125.24.0-255,1484,139418,77,202544
26635,0.002084,74.125.24.0-255,4320,143738,77,202544
26636,0.002086,172.31.40.0-255,66,143804,77,202544
26637,0.002105,74.125.24.0-255,1484,145288,77,202544
26638,0.002117,74.125.24.0-255,12828,158116,77,202544
26639,0.002119,172.31.40.0-255,66,158182,77,202544
26640,0.002124,74.125.24.0-255,4320,162502,77,202544
26641,0.002126,172.31.40.0-255,66,162568,77,202544
26642,0.002147,74.125.24.0-255,6438,169006,77,202544
26643,0.00215,172.31.40.0-255,66,169072,77,202544
26644,0.004726,74.125.24.0-255,4320,173392,77,202544
26645,0.004733,172.31.40.0-255,66,173458,77,202544
26646,0.00475,74.125.24.0-255,1484,174942,77,202544
26647,0.00733,74.125.24.0-255,4320,179262,77,202544
26648,0.007335,172.31.40.0-255,66,179328,77,202544
26649,0.009896,74.125.24.0-255,5738,185066,77,202544
26650,0.009903,172.31.40.0-255,66,185132,77,202544
26651,0.012519,74.125.24.0-255,5738,190870,77,202544
26652,0.012528,172.31.40.0-255,66,190936,77,202544
26653,0.015098,74.125.24.0-255,5738,196674,77,202544
26654,0.015108,172.31.40.0-255,66,196740,77,202544
26655,0.017692,74.125.24.0-255,5738,202478,77,202544
26656,0.017701,172.31.40.0-255,66,202544,77,202544
26657,0.0,74.125.24.0-255,153,153,77,296842
26658,2.5e-05,172.31.40.0-255,66,219,77,296842
26659,3.2e-05,74.125.24.0-255,1484,1703,77,296842
26660,3.7e-05,172.31.40.0-255,66,1769,77,296842
26661,4.3e-05,74.125.24.0-255,2902,4671,77,296842
26662,4.6e-05,172.31.40.0-255,66,4737,77,296842
26663,5.4e-05,74.125.24.0-255,7156,11893,77,296842
26664,5.7e-05,172.31.40.0-255,66,11959,77,296842
26665,6.2e-05,74.125.24.0-255,2075,14034,77,296842
26666,6.5e-05,172.31.40.0-255,66,14100,77,296842
26667,0.000113,74.125.24.0-255,1484,15584,77,296842
26668,0.000115,172.31.40.0-255,66,15650,77,296842
26669,0.000136,74.125.24.0-255,2902,18552,77,296842
26670,0.000138,172.31.40.0-255,66,18618,77,296842
26671,0.000145,74.125.24.0-255,5738,24356,77,296842
26672,0.000147,172.31.40.0-255,66,24422,77,296842
26673,0.000153,74.125.24.0-255,4320,28742,77,296842
26674,0.000155,172.31.40.0-255,66,28808,77,296842
26675,0.000174,74.125.24.0-255,2543,31351,77,296842
26676,0.000176,172.31.40.0-255,66,31417,77,296842
26677,0.000236,74.125.24.0-255,1484,32901,77,296842
26678,0.000239,172.31.40.0-255,66,32967,77,296842
26679,0.000244,74.125.24.0-255,2902,35869,77,296842
26680,0.000247,172.31.40.0-255,66,35935,77,296842
26681,0.000275,74.125.24.0-255,5738,41673,77,296842
26682,0.000277,172.31.40.0-255,66,41739,77,296842
26683,0.000321,74.125.24.0-255,13887,55626,77,296842
26684,0.000324,172.31.40.0-255,66,55692,77,296842
26685,0.000334,74.125.24.0-255,9633,65325,77,296842
26686,0.000336,172.31.40.0-255,66,65391,77,296842
26687,0.000588,74.125.24.0-255,395,65786,77,296842
26688,0.000593,172.31.40.0-255,66,65852,77,296842
26689,0.000644,74.125.24.0-255,348,66200,77,296842
26690,0.000937,74.125.24.0-255,1484,67684,77,296842
26691,0.000941,172.31.40.0-255,66,67750,77,296842
26692,0.000948,74.125.24.0-255,2902,70652,77,296842
26693,0.000949,172.31.40.0-255,66,70718,77,296842
26694,0.000973,74.125.24.0-255,4320,75038,77,296842
26695,0.000977,74.125.24.0-255,2902,77940,77,296842
26696,0.000981,172.31.40.0-255,66,78006,77,296842
26697,0.000984,172.31.40.0-255,66,78072,77,296842
26698,0.000993,74.125.24.0-255,2902,80974,77,296842
26699,0.000995,172.31.40.0-255,66,81040,77,296842
26700,0.001,74.125.24.0-255,4320,85360,77,296842
26701,0.001003,172.31.40.0-255,66,85426,77,296842
26702,0.001023,74.125.24.0-255,7156,92582,77,296842
26703,0.001025,172.31.40.0-255,66,92648,77,296842
26704,0.001035,74.125.24.0-255,7856,100504,77,296842
26705,0.001037,172.31.40.0-255,66,100570,77,296842
26706,0.00115,74.125.24.0-255,1484,102054,77,296842
26707,0.001172,74.125.24.0-255,2902,104956,77,296842
26708,0.001175,172.31.40.0-255,66,105022,77,296842
26709,0.001183,74.125.24.0-255,5738,110760,77,296842
26710,0.001185,172.31.40.0-255,66,110826,77,296842
26711,0.001188,74.125.24.0-255,1484,112310,77,296842
26712,0.00122,74.125.24.0-255,11410,123720,77,296842
26713,0.001223,172.31.40.0-255,66,123786,77,296842
26714,0.001232,74.125.24.0-255,8574,132360,77,296842
26715,0.001234,172.31.40.0-255,66,132426,77,296842
26716,0.00126,74.125.24.0-255,2184,134610,77,296842
26717,0.001262,172.31.40.0-255,66,134676,77,296842
26718,0.001273,74.125.24.0-255,11410,146086,77,296842
26719,0.001276,172.31.40.0-255,66,146152,77,296842
26720,0.001287,74.125.24.0-255,9992,156144,77,296842
26721,0.001289,172.31.40.0-255,66,156210,77,296842
26722,0.001317,74.125.24.0-255,7156,163366,77,296842
26723,0.00132,172.31.40.0-255,66,163432,77,296842
26724,0.001327,74.125.24.0-255,5020,168452,77,296842
26725,0.001329,172.31.40.0-255,66,168518,77,296842
26726,0.00137,74.125.24.0-255,1484,170002,77,296842
26727,0.001374,74.125.24.0-255,1484,171486,77,296842
26728,0.001376,172.31.40.0-255,66,171552,77,296842
26729,0.001401,74.125.24.0-255,1484,173036,77,296842
26730,0.001409,74.125.24.0-255,5738,178774,77,296842
26731,0.001411,172.31.40.0-255,66,178840,77,296842
26732,0.001453,74.125.24.0-255,2902,181742,77,296842
26733,0.001454,172.31.40.0-255,66,181808,77,296842
26734,0.001485,74.125.24.0-255,9992,191800,77,296842
26735,0.001488,172.31.40.0-255,66,191866,77,296842
26736,0.001496,74.125.24.0-255,7156,199022,77,296842
26737,0.001498,172.31.40.0-255,66,199088,77,296842
26738,0.001503,74.125.24.0-255,3602,202690,77,296842
26739,0.001505,172.31.40.0-255,66,202756,77,296842
26740,0.001608,74.125.24.0-255,1484,204240,77,296842
26741,0.001613,74.125.24.0-255,2902,207142,77,296842
26742,0.001616,172.31.40.0-255,66,207208,77,296842
26743,0.001619,74.125.24.0-255,1484,208692,77,296842
26744,0.001641,74.125.24.0-255,4320,213012,77,296842
26745,0.001644,172.31.40.0-255,66,213078,77,296842
26746,0.001651,74.125.24.0-255,7156,220234,77,296842
26747,0.001653,172.31.40.0-255,66,220300,77,296842
26748,0.00169,172.31.40.0-255,66,220366,77,296842
26749,0.001695,74.125.24.0-255,3602,223968,77,296842
26750,0.001697,172.31.40.0-255,66,224034,77,296842
26751,0.001722,74.125.24.0-255,5738,229772,77,296842
26752,0.001727,172.31.40.0-255,66,229838,77,296842
26753,0.001761,172.31.40.0-255,66,229904,77,296842
26754,0.001771,74.125.24.0-255,11410,241314,77,296842
26755,0.001774,172.31.40.0-255,66,241380,77,296842
26756,0.001814,172.31.40.0-255,66,241446,77,296842
26757,0.00182,74.125.24.0-255,4320,245766,77,296842
26758,0.001822,172.31.40.0-255,66,245832,77,296842
26759,0.001845,74.125.24.0-255,12828,258660,77,296842
26760,0.001847,172.31.40.0-255,66,258726,77,296842
26761,0.001853,74.125.24.0-255,5020,263746,77,296842
26762,0.001856,172.31.40.0-255,66,263812,77,296842
26763,0.001874,74.125.24.0-255,2902,266714,77,296842
26764,0.001877,172.31.40.0-255,66,266780,77,296842
26765,0.001919,172.31.40.0-255,66,266846,77,296842
26766,0.001942,74.125.24.0-255,5738,272584,77,296842
26767,0.001946,172.31.40.0-255,66,272650,77,296842
26768,0.001953,74.125.24.0-255,7856,280506,77,296842
26769,0.001955,172.31.40.0-255,66,280572,77,296842
26770,0.001972,172.31.40.0-255,66,280638,77,296842
26771,0.001999,74.125.24.0-255,9992,290630,77,296842
26772,0.002002,172.31.40.0-255,66,290696,77,296842
26773,0.002042,74.125.24.0-255,5738,296434,77,296842
26774,0.002045,172.31.40.0-255,66,296500,77,296842
26775,0.002113,74.125.24.0-255,105,296605,77,296842
26776,0.002124,172.31.40.0-255,66,296671,77,296842
26777,0.00872,172.31.40.0-255,105,296776,77,296842
26778,0.010969,74.125.24.0-255,66,296842,77,296842
26779,0.0,172.217.194.0-255,154,154,77,252068
26780,2.3e-05,172.31.40.0-255,66,220,77,252068
26781,2.9e-05,172.217.194.0-255,1484,1704,77,252068
26782,3.4e-05,172.31.40.0-255,66,1770,77,252068
26783,4.7e-05,172.217.194.0-255,2902,4672,77,252068
26784,5.1e-05,172.31.40.0-255,66,4738,77,252068
26785,5.8e-05,172.217.194.0-255,7156,11894,77,252068
26786,6.1e-05,172.31.40.0-255,66,11960,77,252068
26787,9.8e-05,172.217.194.0-255,3401,15361,77,252068
26788,0.000101,172.31.40.0-255,66,15427,77,252068
26789,0.000107,172.217.194.0-255,4320,19747,77,252068
26790,0.00011,172.31.40.0-255,66,19813,77,252068
26791,0.000115,172.217.194.0-255,4320,24133,77,252068
26792,0.000118,172.31.40.0-255,66,24199,77,252068
26793,0.000149,172.217.194.0-255,5738,29937,77,252068
26794,0.000152,172.31.40.0-255,66,30003,77,252068
26795,0.000154,172.217.194.0-255,1125,31128,77,252068
26796,0.000156,172.31.40.0-255,66,31194,77,252068
26797,0.000222,172.217.194.0-255,1484,32678,77,252068
26798,0.000226,172.31.40.0-255,66,32744,77,252068
26799,0.000231,172.217.194.0-255,2902,35646,77,252068
26800,0.000234,172.31.40.0-255,66,35712,77,252068
26801,0.000238,172.217.194.0-255,2902,38614,77,252068
26802,0.000244,172.31.40.0-255,66,38680,77,252068
26803,0.000256,172.217.194.0-255,2902,41582,77,252068
26804,0.000259,172.31.40.0-255,66,41648,77,252068
26805,0.000267,172.217.194.0-255,1484,43132,77,252068
26806,0.000269,172.31.40.0-255,66,43198,77,252068
26807,0.000304,172.217.194.0-255,12469,55667,77,252068
26808,0.000307,172.31.40.0-255,66,55733,77,252068
26809,0.000315,172.217.194.0-255,8574,64307,77,252068
26810,0.000317,172.31.40.0-255,66,64373,77,252068
26811,0.000359,172.217.194.0-255,1413,65786,77,252068
26812,0.000598,172.217.194.0-255,366,66152,77,252068
26813,0.000603,172.31.40.0-255,66,66218,77,252068
26814,0.000627,172.217.194.0-255,1484,67702,77,252068
26815,0.000635,172.217.194.0-255,4320,72022,77,252068
26816,0.000638,172.31.40.0-255,66,72088,77,252068
26817,0.000642,172.217.194.0-255,2902,74990,77,252068
26818,0.000645,172.31.40.0-255,66,75056,77,252068
26819,0.000674,172.217.194.0-255,2902,77958,77,252068
26820,0.000677,172.31.40.0-255,66,78024,77,252068
26821,0.000692,172.217.194.0-255,11410,89434,77,252068
26822,0.000694,172.31.40.0-255,66,89500,77,252068
26823,0.000731,172.217.194.0-255,10692,100192,77,252068
26824,0.000736,172.31.40.0-255,66,100258,77,252068
26825,0.000895,172.217.194.0-255,1484,101742,77,252068
26826,0.000901,172.217.194.0-255,2902,104644,77,252068
26827,0.000904,172.31.40.0-255,66,104710,77,252068
26828,0.000909,172.217.194.0-255,2902,107612,77,252068
26829,0.000911,172.31.40.0-255,66,107678,77,252068
26830,0.000946,172.217.194.0-255,2902,110580,77,252068
26831,0.000948,172.31.40.0-255,66,110646,77,252068
26832,0.00096,172.217.194.0-255,12828,123474,77,252068
26833,0.000963,172.31.40.0-255,66,123540,77,252068
26834,0.000971,172.217.194.0-255,8574,132114,77,252068
26835,0.000974,172.31.40.0-255,66,132180,77,252068
26836,0.001003,172.217.194.0-255,5020,137200,77,252068
26837,0.00102,172.31.40.0-255,66,137266,77,252068
26838,0.001023,172.31.40.0-255,66,137332,77,252068
26839,0.001067,172.31.40.0-255,66,137398,77,252068
26840,0.001181,172.217.194.0-255,1484,138882,77,252068
26841,0.001201,172.217.194.0-255,2902,141784,77,252068
26842,0.001205,172.31.40.0-255,66,141850,77,252068
26843,0.001212,172.217.194.0-255,5738,147588,77,252068
26844,0.001214,172.31.40.0-255,66,147654,77,252068
26845,0.001219,172.217.194.0-255,4320,151974,77,252068
26846,0.001226,172.31.40.0-255,66,152040,77,252068
26847,0.001252,172.217.194.0-255,4320,156360,77,252068
26848,0.001255,172.31.40.0-255,66,156426,77,252068
26849,0.001302,172.31.40.0-255,66,156492,77,252068
26850,0.001583,172.217.194.0-255,1484,157976,77,252068
26851,0.00159,172.217.194.0-255,2902,160878,77,252068
26852,0.001594,172.31.40.0-255,66,160944,77,252068
26853,0.001599,172.217.194.0-255,2902,163846,77,252068
26854,0.001602,172.31.40.0-255,66,163912,77,252068
26855,0.001626,172.217.194.0-255,2902,166814,77,252068
26856,0.001628,172.31.40.0-255,66,166880,77,252068
26857,0.001637,172.217.194.0-255,8574,175454,77,252068
26858,0.001639,172.31.40.0-255,66,175520,77,252068
26859,0.001661,172.217.194.0-255,2902,178422,77,252068
26860,0.001665,172.31.40.0-255,66,178488,77,252068
26861,0.001698,172.217.194.0-255,12110,190598,77,252068
26862,0.001701,172.31.40.0-255,66,190664,77,252068
26863,0.002268,172.217.194.0-255,1484,192148,77,252068
26864,0.002274,172.217.194.0-255,2902,195050,77,252068
26865,0.00228,172.31.40.0-255,66,195116,77,252068
26866,0.002292,172.217.194.0-255,4320,199436,77,252068
26867,0.002294,172.31.40.0-255,66,199502,77,252068
26868,0.002336,172.217.194.0-255,5738,205240,77,252068
26869,0.002338,172.31.40.0-255,66,205306,77,252068
26870,0.002372,172.217.194.0-255,2902,208208,77,252068
26871,0.002375,172.31.40.0-255,66,208274,77,252068
26872,0.002391,172.31.40.0-255,66,208340,77,252068
26873,0.002395,172.217.194.0-255,2902,211242,77,252068
26874,0.002397,172.31.40.0-255,66,211308,77,252068
26875,0.004713,172.217.194.0-255,2902,214210,77,252068
26876,0.00472,172.31.40.0-255,66,214276,77,252068
26877,0.004741,172.217.194.0-255,2902,217178,77,252068
26878,0.004743,172.31.40.0-255,66,217244,77,252068
26879,0.007061,172.217.194.0-255,5738,222982,77,252068
26880,0.007066,172.31.40.0-255,66,223048,77,252068
26881,0.009425,172.217.194.0-255,5738,228786,77,252068
26882,0.009432,172.31.40.0-255,66,228852,77,252068
26883,0.011781,172.217.194.0-255,5738,234590,77,252068
26884,0.011789,172.31.40.0-255,66,234656,77,252068
26885,0.014148,172.217.194.0-255,5738,240394,77,252068
26886,0.014157,172.31.40.0-255,66,240460,77,252068
26887,0.016503,172.217.194.0-255,5738,246198,77,252068
26888,0.01651,172.31.40.0-255,66,246264,77,252068
26889,0.018858,172.217.194.0-255,5738,252002,77,252068
26890,0.018866,172.31.40.0-255,66,252068,77,252068
26891,0.0,74.125.68.0-255,298,298,77,331080
26892,2.8e-05,172.31.40.0-255,66,364,77,331080
26893,3.6e-05,74.125.68.0-255,1484,1848,77,331080
26894,4e-05,172.31.40.0-255,66,1914,77,331080
26895,7.1e-05,74.125.68.0-255,2902,4816,77,331080
26896,7.6e-05,172.31.40.0-255,66,4882,77,331080
26897,8.3e-05,74.125.68.0-255,5738,10620,77,331080
26898,8.6e-05,172.31.40.0-255,66,10686,77,331080
26899,9.2e-05,74.125.68.0-255,3349,14035,77,331080
26900,9.5e-05,172.31.40.0-255,66,14101,77,331080
26901,0.000103,74.125.68.0-255,4320,18421,77,331080
26902,0.000106,172.31.40.0-255,66,18487,77,331080
26903,0.000115,74.125.68.0-255,8574,27061,77,331080
26904,0.000118,172.31.40.0-255,66,27127,77,331080
26905,0.000143,74.125.68.0-255,1484,28611,77,331080
26906,0.000146,172.31.40.0-255,66,28677,77,331080
26907,0.000171,74.125.68.0-255,2543,31220,77,331080
26908,0.000178,172.31.40.0-255,66,31286,77,331080
26909,0.000435,74.125.68.0-255,1484,32770,77,331080
26910,0.00044,172.31.40.0-255,66,32836,77,331080
26911,0.000463,74.125.68.0-255,2902,35738,77,331080
26912,0.000467,172.31.40.0-255,66,35804,77,331080
26913,0.000496,74.125.68.0-255,1484,37288,77,331080
26914,0.000498,172.31.40.0-255,66,37354,77,331080
26915,0.000501,74.125.68.0-255,1484,38838,77,331080
26916,0.000504,172.31.40.0-255,66,38904,77,331080
26917,0.000542,74.125.68.0-255,1484,40388,77,331080
26918,0.000545,172.31.40.0-255,66,40454,77,331080
26919,0.000552,74.125.68.0-255,5738,46192,77,331080
26920,0.000554,172.31.40.0-255,66,46258,77,331080
26921,0.00056,74.125.68.0-255,3961,50219,77,331080
26922,0.000562,172.31.40.0-255,66,50285,77,331080
26923,0.000568,74.125.68.0-255,4320,54605,77,331080
26924,0.00057,172.31.40.0-255,66,54671,77,331080
26925,0.00058,74.125.68.0-255,9992,64663,77,331080
26926,0.000582,172.31.40.0-255,66,64729,77,331080
26927,0.000584,74.125.68.0-255,1398,66127,77,331080
26928,0.000652,74.125.68.0-255,125,66252,77,331080
26929,0.000735,74.125.68.0-255,1484,67736,77,331080
26930,0.00074,172.31.40.0-255,66,67802,77,331080
26931,0.000761,74.125.68.0-255,2902,70704,77,331080
26932,0.000765,172.31.40.0-255,66,70770,77,331080
26933,0.000783,74.125.68.0-255,5738,76508,77,331080
26934,0.000786,172.31.40.0-255,66,76574,77,331080
26935,0.000789,74.125.68.0-255,1484,78058,77,331080
26936,0.000842,74.125.68.0-255,2902,80960,77,331080
26937,0.000845,172.31.40.0-255,66,81026,77,331080
26938,0.000851,74.125.68.0-255,3961,84987,77,331080
26939,0.000853,172.31.40.0-255,66,85053,77,331080
26940,0.000862,74.125.68.0-255,4320,89373,77,331080
26941,0.000865,172.31.40.0-255,66,89439,77,331080
26942,0.000899,74.125.68.0-255,9992,99431,77,331080
26943,0.000903,172.31.40.0-255,66,99497,77,331080
26944,0.000927,74.125.68.0-255,1125,100622,77,331080
26945,0.001335,74.125.68.0-255,1484,102106,77,331080
26946,0.001341,172.31.40.0-255,66,102172,77,331080
26947,0.001349,74.125.68.0-255,1484,103656,77,331080
26948,0.001365,74.125.68.0-255,1484,105140,77,331080
26949,0.001368,172.31.40.0-255,66,105206,77,331080
26950,0.001374,74.125.68.0-255,4320,109526,77,331080
26951,0.001376,172.31.40.0-255,66,109592,77,331080
26952,0.001403,74.125.68.0-255,1484,111076,77,331080
26953,0.001413,74.125.68.0-255,11410,122486,77,331080
26954,0.001416,172.31.40.0-255,66,122552,77,331080
26955,0.001452,74.125.68.0-255,12110,134662,77,331080
26956,0.001454,172.31.40.0-255,66,134728,77,331080
26957,0.001521,74.125.68.0-255,1484,136212,77,331080
26958,0.001527,74.125.68.0-255,2902,139114,77,331080
26959,0.00153,172.31.40.0-255,66,139180,77,331080
26960,0.001557,74.125.68.0-255,5738,144918,77,331080
26961,0.00156,172.31.40.0-255,66,144984,77,331080
26962,0.001565,74.125.68.0-255,2902,147886,77,331080
26963,0.001567,172.31.40.0-255,66,147952,77,331080
26964,0.001573,74.125.68.0-255,4320,152272,77,331080
26965,0.001575,172.31.40.0-255,66,152338,77,331080
26966,0.001585,74.125.68.0-255,4320,156658,77,331080
26967,0.001588,172.31.40.0-255,66,156724,77,331080
26968,0.001622,74.125.68.0-255,4320,161044,77,331080
26969,0.001624,172.31.40.0-255,66,161110,77,331080
26970,0.001632,74.125.68.0-255,7156,168266,77,331080
26971,0.001634,172.31.40.0-255,66,168332,77,331080
26972,0.001637,74.125.68.0-255,766,169098,77,331080
26973,0.001759,74.125.68.0-255,1484,170582,77,331080
26974,0.001764,172.31.40.0-255,66,170648,77,331080
26975,0.001792,74.125.68.0-255,2902,173550,77,331080
26976,0.001796,172.31.40.0-255,66,173616,77,331080
26977,0.001802,74.125.68.0-255,5738,179354,77,331080
26978,0.001804,172.31.40.0-255,66,179420,77,331080
26979,0.001807,74.125.68.0-255,1484,180904,77,331080
26980,0.001866,74.125.68.0-255,2902,183806,77,331080
26981,0.001869,172.31.40.0-255,66,183872,77,331080
26982,0.001875,74.125.68.0-255,5738,189610,77,331080
26983,0.001878,172.31.40.0-255,66,189676,77,331080
26984,0.001881,74.125.68.0-255,1484,191160,77,331080
26985,0.001918,74.125.68.0-255,8574,199734,77,331080
26986,0.001921,172.31.40.0-255,66,199800,77,331080
26987,0.001926,74.125.68.0-255,2902,202702,77,331080
26988,0.001927,172.31.40.0-255,66,202768,77,331080
26989,0.001962,74.125.68.0-255,766,203534,77,331080
26990,0.002094,74.125.68.0-255,1484,205018,77,331080
26991,0.002098,172.31.40.0-255,66,205084,77,331080
26992,0.002117,74.125.68.0-255,2902,207986,77,331080
26993,0.00212,172.31.40.0-255,66,208052,77,331080
26994,0.002127,74.125.68.0-255,5738,213790,77,331080
26995,0.002129,172.31.40.0-255,66,213856,77,331080
26996,0.002165,74.125.68.0-255,5738,219594,77,331080
26997,0.002168,172.31.40.0-255,66,219660,77,331080
26998,0.002199,74.125.68.0-255,7156,226816,77,331080
26999,0.002202,172.31.40.0-255,66,226882,77,331080
27000,0.002205,74.125.68.0-255,1484,228366,77,331080
27001,0.002236,74.125.68.0-255,9274,237640,77,331080
27002,0.002239,172.31.40.0-255,66,237706,77,331080
27003,0.002271,74.125.68.0-255,1484,239190,77,331080
27004,0.002275,74.125.68.0-255,1484,240674,77,331080
27005,0.002278,172.31.40.0-255,66,240740,77,331080
27006,0.002295,74.125.68.0-255,1484,242224,77,331080
27007,0.002302,74.125.68.0-255,5738,247962,77,331080
27008,0.002305,172.31.40.0-255,66,248028,77,331080
27009,0.002309,74.125.68.0-255,2902,250930,77,331080
27010,0.002312,172.31.40.0-255,66,250996,77,331080
27011,0.002351,74.125.68.0-255,1484,252480,77,331080
27012,0.002357,74.125.68.0-255,5738,258218,77,331080
27013,0.002389,74.125.68.0-255,7156,265374,77,331080
27014,0.002403,74.125.68.0-255,1484,266858,77,331080
27015,0.002418,74.125.68.0-255,1484,268342,77,331080
27016,0.002437,74.125.68.0-255,7856,276198,77,331080
27017,0.002441,74.125.68.0-255,2902,279100,77,331080
27018,0.002456,74.125.68.0-255,1484,280584,77,331080
27019,0.002471,74.125.68.0-255,4320,284904,77,331080
27020,0.002507,74.125.68.0-255,8574,293478,77,331080
27021,0.002512,74.125.68.0-255,4320,297798,77,331080
27022,0.002555,74.125.68.0-255,7156,304954,77,331080
27023,0.002576,74.125.68.0-255,6438,311392,77,331080
27024,0.002594,74.125.68.0-255,4320,315712,77,331080
27025,0.002606,74.125.68.0-255,1484,317196,77,331080
27026,0.002624,74.125.68.0-255,7156,324352,77,331080
27027,0.013764,74.125.68.0-255,1484,325836,77,331080
27028,0.015042,172.31.40.0-255,66,325902,77,331080
27029,0.015049,172.31.40.0-255,66,325968,77,331080
27030,0.015056,172.31.40.0-255,66,326034,77,331080
27031,0.015059,172.31.40.0-255,66,326100,77,331080
27032,0.015072,172.31.40.0-255,66,326166,77,331080
27033,0.015077,172.31.40.0-255,66,326232,77,331080
27034,0.01508,172.31.40.0-255,66,326298,77,331080
27035,0.015083,172.31.40.0-255,66,326364,77,331080
27036,0.015087,172.31.40.0-255,66,326430,77,331080
27037,0.01509,172.31.40.0-255,66,326496,77,331080
27038,0.015093,172.31.40.0-255,66,326562,77,331080
27039,0.015096,172.31.40.0-255,66,326628,77,331080
27040,0.015101,172.31.40.0-255,66,326694,77,331080
27041,0.017701,74.125.68.0-255,4320,331014,77,331080
27042,0.01771,172.31.40.0-255,66,331080,77,331080
27043,0.0,172.217.194.0-255,154,154,77,353099
27044,2.7e-05,172.31.40.0-255,66,220,77,353099
27045,3.5e-05,172.217.194.0-255,1484,1704,77,353099
27046,4e-05,172.31.40.0-255,66,1770,77,353099
27047,5.3e-05,172.217.194.0-255,2902,4672,77,353099
27048,5.7e-05,172.31.40.0-255,66,4738,77,353099
27049,6.5e-05,172.217.194.0-255,7156,11894,77,353099
27050,6.9e-05,172.31.40.0-255,66,11960,77,353099
27051,8e-05,172.217.194.0-255,11873,23833,77,353099
27052,8.4e-05,172.31.40.0-255,66,23899,77,353099
27053,0.000114,172.217.194.0-255,6797,30696,77,353099
27054,0.000117,172.31.40.0-255,66,30762,77,353099
27055,0.000144,172.217.194.0-255,1484,32246,77,353099
27056,0.000147,172.31.40.0-255,66,32312,77,353099
27057,0.000178,172.217.194.0-255,5738,38050,77,353099
27058,0.00018,172.31.40.0-255,66,38116,77,353099
27059,0.000188,172.217.194.0-255,7156,45272,77,353099
27060,0.000191,172.31.40.0-255,66,45338,77,353099
27061,0.000253,172.31.40.0-255,66,45404,77,353099
27062,0.000257,172.217.194.0-255,2800,48204,77,353099
27063,0.000259,172.31.40.0-255,66,48270,77,353099
27064,0.000262,172.217.194.0-255,114,48384,77,353099
27065,0.000264,172.31.40.0-255,66,48450,77,353099
27066,0.000293,172.217.194.0-255,1484,49934,77,353099
27067,0.000296,172.31.40.0-255,66,50000,77,353099
27068,0.000301,172.217.194.0-255,2902,52902,77,353099
27069,0.000303,172.31.40.0-255,66,52968,77,353099
27070,0.000335,172.217.194.0-255,5738,58706,77,353099
27071,0.000337,172.31.40.0-255,66,58772,77,353099
27072,0.000345,172.217.194.0-255,7156,65928,77,353099
27073,0.000347,172.31.40.0-255,66,65994,77,353099
27074,0.000373,172.217.194.0-255,5738,71732,77,353099
27075,0.000376,172.31.40.0-255,66,71798,77,353099
27076,0.000385,172.217.194.0-255,8574,80372,77,353099
27077,0.000387,172.31.40.0-255,66,80438,77,353099
27078,0.000418,172.217.194.0-255,1919,82357,77,353099
27079,0.000421,172.31.40.0-255,66,82423,77,353099
27080,0.000454,172.217.194.0-255,1484,83907,77,353099
27081,0.000582,172.217.194.0-255,1484,85391,77,353099
27082,0.000588,172.217.194.0-255,2902,88293,77,353099
27083,0.000606,172.217.194.0-255,5738,94031,77,353099
27084,0.000628,172.217.194.0-255,9992,104023,77,353099
27085,0.000674,172.217.194.0-255,4320,108343,77,353099
27086,0.000692,172.217.194.0-255,9274,117617,77,353099
27087,0.000749,172.31.40.0-255,66,117683,77,353099
27088,0.000793,172.217.194.0-255,1484,119167,77,353099
27089,0.000797,172.217.194.0-255,1484,120651,77,353099
27090,0.000808,172.217.194.0-255,1484,122135,77,353099
27091,0.000815,172.217.194.0-255,5738,127873,77,353099
27092,0.000824,172.31.40.0-255,66,127939,77,353099
27093,0.000835,172.217.194.0-255,7156,135095,77,353099
27094,0.000853,172.217.194.0-255,1484,136579,77,353099
27095,0.000857,172.31.40.0-255,66,136645,77,353099
27096,0.000887,172.217.194.0-255,12828,149473,77,353099
27097,0.000891,172.217.194.0-255,2184,151657,77,353099
27098,0.000911,172.31.40.0-255,66,151723,77,353099
27099,0.000925,172.217.194.0-255,2902,154625,77,353099
27100,0.000936,172.217.194.0-255,4320,158945,77,353099
27101,0.000949,172.31.40.0-255,66,159011,77,353099
27102,0.000964,172.217.194.0-255,8574,167585,77,353099
27103,0.000996,172.217.194.0-255,9992,177577,77,353099
27104,0.001003,172.31.40.0-255,66,177643,77,353099
27105,0.001035,172.217.194.0-255,7856,185499,77,353099
27106,0.001039,172.217.194.0-255,1484,186983,77,353099
27107,0.001043,172.217.194.0-255,2902,189885,77,353099
27108,0.001049,172.217.194.0-255,5738,195623,77,353099
27109,0.001072,172.217.194.0-255,4320,199943,77,353099
27110,0.001076,172.31.40.0-255,66,200009,77,353099
27111,0.001081,172.31.40.0-255,66,200075,77,353099
27112,0.001117,172.217.194.0-255,8574,208649,77,353099
27113,0.001126,172.217.194.0-255,8574,217223,77,353099
27114,0.001129,172.217.194.0-255,2184,219407,77,353099
27115,0.001133,172.217.194.0-255,2902,222309,77,353099
27116,0.001169,172.217.194.0-255,7156,229465,77,353099
27117,0.00118,172.217.194.0-255,12828,242293,77,353099
27118,0.001191,172.31.40.0-255,66,242359,77,353099
27119,0.00121,172.217.194.0-255,2902,245261,77,353099
27120,0.001219,172.217.194.0-255,7856,253117,77,353099
27121,0.00127,172.31.40.0-255,66,253183,77,353099
27122,0.001311,172.217.194.0-255,1484,254667,77,353099
27123,0.001319,172.217.194.0-255,6438,261105,77,353099
27124,0.001326,172.217.194.0-255,5738,266843,77,353099
27125,0.001344,172.217.194.0-255,1484,268327,77,353099
27126,0.001349,172.217.194.0-255,4320,272647,77,353099
27127,0.001356,172.31.40.0-255,66,272713,77,353099
27128,0.001387,172.217.194.0-255,9992,282705,77,353099
27129,0.001393,172.217.194.0-255,4320,287025,77,353099
27130,0.001412,172.31.40.0-255,66,287091,77,353099
27131,0.00142,172.217.194.0-255,7856,294947,77,353099
27132,0.001425,172.217.194.0-255,2902,297849,77,353099
27133,0.001431,172.31.40.0-255,66,297915,77,353099
27134,0.001454,172.217.194.0-255,9992,307907,77,353099
27135,0.001464,172.217.194.0-255,9992,317899,77,353099
27136,0.001488,172.217.194.0-255,1484,319383,77,353099
27137,0.001495,172.31.40.0-255,66,319449,77,353099
27138,0.001512,172.217.194.0-255,13528,332977,77,353099
27139,0.001516,172.217.194.0-255,2902,335879,77,353099
27140,0.001522,172.31.40.0-255,66,335945,77,353099
27141,0.001565,172.217.194.0-255,12828,348773,77,353099
27142,0.001572,172.217.194.0-255,3984,352757,77,353099
27143,0.001575,172.217.194.0-255,105,352862,77,353099
27144,0.001589,172.31.40.0-255,66,352928,77,353099
27145,0.004467,172.31.40.0-255,105,353033,77,353099
27146,0.006729,172.217.194.0-255,66,353099,77,353099
27147,0.0,172.217.194.0-255,152,152,77,284665
27148,2.4e-05,172.31.40.0-255,66,218,77,284665
27149,3.1e-05,172.217.194.0-255,1484,1702,77,284665
27150,3.7e-05,172.31.40.0-255,66,1768,77,284665
27151,4.3e-05,172.217.194.0-255,2902,4670,77,284665
27152,5.4e-05,172.31.40.0-255,66,4736,77,284665
27153,6.2e-05,172.217.194.0-255,5738,10474,77,284665
27154,6.5e-05,172.31.40.0-255,66,10540,77,284665
27155,6.8e-05,172.217.194.0-255,1484,12024,77,284665
27156,7.1e-05,172.31.40.0-255,66,12090,77,284665
27157,0.000123,172.217.194.0-255,11954,24044,77,284665
27158,0.000127,172.31.40.0-255,66,24110,77,284665
27159,0.000137,172.217.194.0-255,11410,35520,77,284665
27160,0.00014,172.31.40.0-255,66,35586,77,284665
27161,0.000146,172.217.194.0-255,4320,39906,77,284665
27162,0.000148,172.31.40.0-255,66,39972,77,284665
27163,0.000207,172.217.194.0-255,12110,52082,77,284665
27164,0.000211,172.31.40.0-255,66,52148,77,284665
27165,0.000223,172.217.194.0-255,12781,64929,77,284665
27166,0.000225,172.31.40.0-255,66,64995,77,284665
27167,0.000227,172.217.194.0-255,365,65360,77,284665
27168,0.000229,172.31.40.0-255,66,65426,77,284665
27169,0.000274,172.217.194.0-255,1484,66910,77,284665
27170,0.000277,172.31.40.0-255,66,66976,77,284665
27171,0.000282,172.217.194.0-255,2902,69878,77,284665
27172,0.000284,172.31.40.0-255,66,69944,77,284665
27173,0.000307,172.217.194.0-255,1484,71428,77,284665
27174,0.000309,172.31.40.0-255,66,71494,77,284665
27175,0.000321,172.217.194.0-255,7156,78650,77,284665
27176,0.000323,172.31.40.0-255,66,78716,77,284665
27177,0.000326,172.217.194.0-255,1484,80200,77,284665
27178,0.000328,172.31.40.0-255,66,80266,77,284665
27179,0.000381,172.31.40.0-255,66,80332,77,284665
27180,0.000387,172.217.194.0-255,5020,85352,77,284665
27181,0.00039,172.31.40.0-255,66,85418,77,284665
27182,0.000414,172.217.194.0-255,1484,86902,77,284665
27183,0.000419,172.217.194.0-255,2902,89804,77,284665
27184,0.000422,172.31.40.0-255,66,89870,77,284665
27185,0.000425,172.217.194.0-255,1484,91354,77,284665
27186,0.000455,172.217.194.0-255,4320,95674,77,284665
27187,0.000459,172.31.40.0-255,66,95740,77,284665
27188,0.000468,172.217.194.0-255,8574,104314,77,284665
27189,0.00047,172.31.40.0-255,66,104380,77,284665
27190,0.00051,172.217.194.0-255,9992,114372,77,284665
27191,0.000534,172.217.194.0-255,5020,119392,77,284665
27192,0.000549,172.217.194.0-255,1484,120876,77,284665
27193,0.000553,172.217.194.0-255,1484,122360,77,284665
27194,0.000573,172.217.194.0-255,1484,123844,77,284665
27195,0.000581,172.217.194.0-255,5738,129582,77,284665
27196,0.000619,172.217.194.0-255,2902,132484,77,284665
27197,0.000642,172.217.194.0-255,9992,142476,77,284665
27198,0.000652,172.217.194.0-255,9992,152468,77,284665
27199,0.000673,172.217.194.0-255,9992,162460,77,284665
27200,0.000694,172.217.194.0-255,13528,175988,77,284665
27201,0.000721,172.217.194.0-255,4320,180308,77,284665
27202,0.000747,172.217.194.0-255,6438,186746,77,284665
27203,0.001398,172.217.194.0-255,1484,188230,77,284665
27204,0.001405,172.217.194.0-255,2902,191132,77,284665
27205,0.001428,172.217.194.0-255,4320,195452,77,284665
27206,0.001432,172.217.194.0-255,1484,196936,77,284665
27207,0.001456,172.217.194.0-255,7156,204092,77,284665
27208,0.001624,172.31.40.0-255,66,204158,77,284665
27209,0.001633,172.217.194.0-255,1484,205642,77,284665
27210,0.001636,172.217.194.0-255,1484,207126,77,284665
27211,0.001655,172.217.194.0-255,1484,208610,77,284665
27212,0.001661,172.217.194.0-255,5738,214348,77,284665
27213,0.001666,172.31.40.0-255,66,214414,77,284665
27214,0.001707,172.217.194.0-255,11410,225824,77,284665
27215,0.001716,172.217.194.0-255,8574,234398,77,284665
27216,0.001734,172.217.194.0-255,3602,238000,77,284665
27217,0.001953,172.31.40.0-255,66,238066,77,284665
27218,0.002965,172.31.40.0-255,101,238167,77,284665
27219,0.003998,172.217.194.0-255,5738,243905,77,284665
27220,0.004015,172.31.40.0-255,66,243971,77,284665
27221,0.00498,172.217.194.0-255,66,244037,77,284665
27222,0.006055,172.217.194.0-255,5738,249775,77,284665
27223,0.006066,172.31.40.0-255,66,249841,77,284665
27224,0.008155,172.217.194.0-255,5738,255579,77,284665
27225,0.008174,172.31.40.0-255,66,255645,77,284665
27226,0.01022,172.217.194.0-255,5738,261383,77,284665
27227,0.01023,172.31.40.0-255,66,261449,77,284665
27228,0.012274,172.217.194.0-255,5738,267187,77,284665
27229,0.012278,172.31.40.0-255,66,267253,77,284665
27230,0.014333,172.217.194.0-255,5738,272991,77,284665
27231,0.014338,172.31.40.0-255,66,273057,77,284665
27232,0.016443,172.217.194.0-255,5738,278795,77,284665
27233,0.01646,172.31.40.0-255,66,278861,77,284665
27234,0.018526,172.217.194.0-255,5738,284599,77,284665
27235,0.01854,172.31.40.0-255,66,284665,77,284665
27236,0.0,172.217.194.0-255,153,153,77,342335
27237,1.3e-05,172.31.40.0-255,66,219,77,342335
27238,1.9e-05,172.217.194.0-255,1484,1703,77,342335
27239,2.3e-05,172.31.40.0-255,66,1769,77,342335
27240,2.9e-05,172.217.194.0-255,2902,4671,77,342335
27241,3.1e-05,172.31.40.0-255,66,4737,77,342335
27242,4.5e-05,172.217.194.0-255,4320,9057,77,342335
27243,4.8e-05,172.31.40.0-255,66,9123,77,342335
27244,6.8e-05,172.217.194.0-255,2902,12025,77,342335
27245,7e-05,172.31.40.0-255,66,12091,77,342335
27246,7.6e-05,172.217.194.0-255,1983,14074,77,342335
27247,7.9e-05,172.31.40.0-255,66,14140,77,342335
27248,8.8e-05,172.217.194.0-255,8574,22714,77,342335
27249,9e-05,172.31.40.0-255,66,22780,77,342335
27250,0.000115,172.217.194.0-255,2902,25682,77,342335
27251,0.000117,172.31.40.0-255,66,25748,77,342335
27252,0.000123,172.217.194.0-255,5379,31127,77,342335
27253,0.000126,172.31.40.0-255,66,31193,77,342335
27254,0.000183,172.217.194.0-255,1484,32677,77,342335
27255,0.000185,172.31.40.0-255,66,32743,77,342335
27256,0.00019,172.217.194.0-255,2902,35645,77,342335
27257,0.000193,172.31.40.0-255,66,35711,77,342335
27258,0.0002,172.217.194.0-255,5738,41449,77,342335
27259,0.000202,172.31.40.0-255,66,41515,77,342335
27260,0.000208,172.217.194.0-255,5738,47253,77,342335
27261,0.00021,172.31.40.0-255,66,47319,77,342335
27262,0.000226,172.217.194.0-255,1125,48444,77,342335
27263,0.000228,172.31.40.0-255,66,48510,77,342335
27264,0.000233,172.217.194.0-255,2902,51412,77,342335
27265,0.000235,172.31.40.0-255,66,51478,77,342335
27266,0.000268,172.217.194.0-255,11410,62888,77,342335
27267,0.000271,172.31.40.0-255,66,62954,77,342335
27268,0.000276,172.217.194.0-255,2835,65789,77,342335
27269,0.000278,172.31.40.0-255,66,65855,77,342335
27270,0.00042,172.217.194.0-255,363,66218,77,342335
27271,0.000488,172.217.194.0-255,1484,67702,77,342335
27272,0.000493,172.31.40.0-255,66,67768,77,342335
27273,0.000499,172.217.194.0-255,2902,70670,77,342335
27274,0.000501,172.31.40.0-255,66,70736,77,342335
27275,0.000507,172.217.194.0-255,4320,75056,77,342335
27276,0.000509,172.31.40.0-255,66,75122,77,342335
27277,0.00053,172.217.194.0-255,1484,76606,77,342335
27278,0.000556,172.217.194.0-255,5738,82344,77,342335
27279,0.000559,172.31.40.0-255,66,82410,77,342335
27280,0.000586,172.217.194.0-255,8215,90625,77,342335
27281,0.000588,172.31.40.0-255,66,90691,77,342335
27282,0.000597,172.217.194.0-255,9633,100324,77,342335
27283,0.0006,172.31.40.0-255,66,100390,77,342335
27284,0.000798,172.217.194.0-255,1484,101874,77,342335
27285,0.000804,172.217.194.0-255,2902,104776,77,342335
27286,0.000807,172.31.40.0-255,66,104842,77,342335
27287,0.000815,172.217.194.0-255,5738,110580,77,342335
27288,0.000817,172.31.40.0-255,66,110646,77,342335
27289,0.000844,172.217.194.0-255,12828,123474,77,342335
27290,0.000847,172.31.40.0-255,66,123540,77,342335
27291,0.000853,172.217.194.0-255,5738,129278,77,342335
27292,0.000856,172.31.40.0-255,66,129344,77,342335
27293,0.000883,172.217.194.0-255,5020,134364,77,342335
27294,0.000887,172.31.40.0-255,66,134430,77,342335
27295,0.001081,172.217.194.0-255,1484,135914,77,342335
27296,0.001095,172.217.194.0-255,2902,138816,77,342335
27297,0.001098,172.31.40.0-255,66,138882,77,342335
27298,0.001104,172.217.194.0-255,4320,143202,77,342335
27299,0.001107,172.31.40.0-255,66,143268,77,342335
27300,0.001119,172.217.194.0-255,1484,144752,77,342335
27301,0.001135,172.217.194.0-255,1484,146236,77,342335
27302,0.001137,172.31.40.0-255,66,146302,77,342335
27303,0.001167,172.217.194.0-255,11410,157712,77,342335
27304,0.00117,172.31.40.0-255,66,157778,77,342335
27305,0.001178,172.217.194.0-255,7156,164934,77,342335
27306,0.001181,172.31.40.0-255,66,165000,77,342335
27307,0.001198,172.217.194.0-255,3602,168602,77,342335
27308,0.001201,172.31.40.0-255,66,168668,77,342335
27309,0.001317,172.217.194.0-255,1484,170152,77,342335
27310,0.001323,172.217.194.0-255,2902,173054,77,342335
27311,0.001326,172.31.40.0-255,66,173120,77,342335
27312,0.001344,172.217.194.0-255,1484,174604,77,342335
27313,0.001364,172.217.194.0-255,4320,178924,77,342335
27314,0.001367,172.31.40.0-255,66,178990,77,342335
27315,0.001374,172.217.194.0-255,7156,186146,77,342335
27316,0.001377,172.31.40.0-255,66,186212,77,342335
27317,0.001397,172.217.194.0-255,4320,190532,77,342335
27318,0.001399,172.31.40.0-255,66,190598,77,342335
27319,0.001432,172.217.194.0-255,9992,200590,77,342335
27320,0.001435,172.31.40.0-255,66,200656,77,342335
27321,0.001439,172.217.194.0-255,2184,202840,77,342335
27322,0.001441,172.31.40.0-255,66,202906,77,342335
27323,0.001513,172.217.194.0-255,1484,204390,77,342335
27324,0.001517,172.217.194.0-255,1484,205874,77,342335
27325,0.00152,172.31.40.0-255,66,205940,77,342335
27326,0.001538,172.217.194.0-255,1484,207424,77,342335
27327,0.001545,172.217.194.0-255,5738,213162,77,342335
27328,0.001547,172.31.40.0-255,66,213228,77,342335
27329,0.001571,172.217.194.0-255,7156,220384,77,342335
27330,0.001576,172.31.40.0-255,66,220450,77,342335
27331,0.001592,172.217.194.0-255,5738,226188,77,342335
27332,0.001595,172.31.40.0-255,66,226254,77,342335
27333,0.001633,172.217.194.0-255,10692,236946,77,342335
27334,0.001637,172.31.40.0-255,66,237012,77,342335
27335,0.001668,172.217.194.0-255,5738,242750,77,342335
27336,0.001672,172.31.40.0-255,66,242816,77,342335
27337,0.001676,172.217.194.0-255,2902,245718,77,342335
27338,0.001678,172.31.40.0-255,66,245784,77,342335
27339,0.001699,172.217.194.0-255,4320,250104,77,342335
27340,0.001701,172.31.40.0-255,66,250170,77,342335
27341,0.00171,172.217.194.0-255,2902,253072,77,342335
27342,0.001713,172.31.40.0-255,66,253138,77,342335
27343,0.001747,172.217.194.0-255,11410,264548,77,342335
27344,0.00175,172.31.40.0-255,66,264614,77,342335
27345,0.001758,172.217.194.0-255,6438,271052,77,342335
27346,0.00176,172.31.40.0-255,66,271118,77,342335
27347,0.001766,172.217.194.0-255,5738,276856,77,342335
27348,0.001769,172.31.40.0-255,66,276922,77,342335
27349,0.001807,172.217.194.0-255,2902,279824,77,342335
27350,0.001816,172.217.194.0-255,10692,290516,77,342335
27351,0.001833,172.31.40.0-255,66,290582,77,342335
27352,0.001842,172.217.194.0-255,1484,292066,77,342335
27353,0.001904,172.217.194.0-255,9992,302058,77,342335
27354,0.001922,172.217.194.0-255,11410,313468,77,342335
27355,0.001931,172.31.40.0-255,66,313534,77,342335
27356,0.00196,172.217.194.0-255,12110,325644,77,342335
27357,0.002054,172.217.194.0-255,9274,334918,77,342335
27358,0.002061,172.217.194.0-255,7009,341927,77,342335
27359,0.007854,172.31.40.0-255,66,341993,77,342335
27360,0.009803,172.217.194.0-255,105,342098,77,342335
27361,0.010401,172.31.40.0-255,66,342164,77,342335
27362,0.010438,172.31.40.0-255,105,342269,77,342335
27363,0.012386,172.217.194.0-255,66,342335,77,342335
27364,0.0,74.125.24.0-255,299,299,77,255709
27365,2.3e-05,172.31.40.0-255,66,365,77,255709
27366,3e-05,74.125.24.0-255,1484,1849,77,255709
27367,3.4e-05,172.31.40.0-255,66,1915,77,255709
27368,4e-05,74.125.24.0-255,4320,6235,77,255709
27369,4.4e-05,172.31.40.0-255,66,6301,77,255709
27370,4.6e-05,74.125.24.0-255,1484,7785,77,255709
27371,4.9e-05,172.31.40.0-255,66,7851,77,255709
27372,5.5e-05,74.125.24.0-255,2902,10753,77,255709
27373,5.8e-05,172.31.40.0-255,66,10819,77,255709
27374,7.8e-05,74.125.24.0-255,3242,14061,77,255709
27375,8.2e-05,172.31.40.0-255,66,14127,77,255709
27376,0.000309,74.125.24.0-255,1484,15611,77,255709
27377,0.000315,172.31.40.0-255,66,15677,77,255709
27378,0.00033,74.125.24.0-255,2902,18579,77,255709
27379,0.000333,172.31.40.0-255,66,18645,77,255709
27380,0.00035,74.125.24.0-255,4320,22965,77,255709
27381,0.000354,172.31.40.0-255,66,23031,77,255709
27382,0.000373,74.125.24.0-255,4320,27351,77,255709
27383,0.000376,172.31.40.0-255,66,27417,77,255709
27384,0.000404,74.125.24.0-255,5379,32796,77,255709
27385,0.000407,172.31.40.0-255,66,32862,77,255709
27386,0.000412,74.125.24.0-255,4320,37182,77,255709
27387,0.000414,172.31.40.0-255,66,37248,77,255709
27388,0.00042,74.125.24.0-255,5738,42986,77,255709
27389,0.000422,172.31.40.0-255,66,43052,77,255709
27390,0.000461,74.125.24.0-255,9992,53044,77,255709
27391,0.000464,172.31.40.0-255,66,53110,77,255709
27392,0.000474,74.125.24.0-255,12110,65220,77,255709
27393,0.000477,172.31.40.0-255,66,65286,77,255709
27394,0.000525,74.125.24.0-255,358,65644,77,255709
27395,0.000528,172.31.40.0-255,66,65710,77,255709
27396,0.000591,74.125.24.0-255,132,65842,77,255709
27397,0.000689,74.125.24.0-255,1484,67326,77,255709
27398,0.000693,172.31.40.0-255,66,67392,77,255709
27399,0.000699,74.125.24.0-255,2902,70294,77,255709
27400,0.000702,172.31.40.0-255,66,70360,77,255709
27401,0.000731,74.125.24.0-255,5738,76098,77,255709
27402,0.000734,172.31.40.0-255,66,76164,77,255709
27403,0.000744,74.125.24.0-255,9992,86156,77,255709
27404,0.000746,172.31.40.0-255,66,86222,77,255709
27405,0.000775,74.125.24.0-255,2902,89124,77,255709
27406,0.000778,172.31.40.0-255,66,89190,77,255709
27407,0.000786,74.125.24.0-255,8574,97764,77,255709
27408,0.000789,172.31.40.0-255,66,97830,77,255709
27409,0.00083,74.125.24.0-255,2467,100297,77,255709
27410,0.000833,172.31.40.0-255,66,100363,77,255709
27411,0.000837,74.125.24.0-255,2902,103265,77,255709
27412,0.00084,172.31.40.0-255,66,103331,77,255709
27413,0.000874,74.125.24.0-255,7156,110487,77,255709
27414,0.000877,172.31.40.0-255,66,110553,77,255709
27415,0.000887,74.125.24.0-255,11410,121963,77,255709
27416,0.000889,172.31.40.0-255,66,122029,77,255709
27417,0.00092,74.125.24.0-255,5738,127767,77,255709
27418,0.000923,172.31.40.0-255,66,127833,77,255709
27419,0.000945,74.125.24.0-255,6438,134271,77,255709
27420,0.000948,172.31.40.0-255,66,134337,77,255709
27421,0.001188,74.125.24.0-255,1484,135821,77,255709
27422,0.001201,74.125.24.0-255,2902,138723,77,255709
27423,0.001204,172.31.40.0-255,66,138789,77,255709
27424,0.00121,74.125.24.0-255,4320,143109,77,255709
27425,0.001213,172.31.40.0-255,66,143175,77,255709
27426,0.001227,74.125.24.0-255,1484,144659,77,255709
27427,0.001234,74.125.24.0-255,5738,150397,77,255709
27428,0.001238,172.31.40.0-255,66,150463,77,255709
27429,0.00126,74.125.24.0-255,7156,157619,77,255709
27430,0.001263,172.31.40.0-255,66,157685,77,255709
27431,0.001273,74.125.24.0-255,10692,168377,77,255709
27432,0.001276,172.31.40.0-255,66,168443,77,255709
27433,0.001838,74.125.24.0-255,1484,169927,77,255709
27434,0.001841,74.125.24.0-255,1484,171411,77,255709
27435,0.001847,172.31.40.0-255,66,171477,77,255709
27436,0.001857,74.125.24.0-255,1484,172961,77,255709
27437,0.001863,74.125.24.0-255,5738,178699,77,255709
27438,0.001866,172.31.40.0-255,66,178765,77,255709
27439,0.001893,74.125.24.0-255,7156,185921,77,255709
27440,0.001896,172.31.40.0-255,66,185987,77,255709
27441,0.001912,74.125.24.0-255,5738,191725,77,255709
27442,0.001914,172.31.40.0-255,66,191791,77,255709
27443,0.001922,74.125.24.0-255,8574,200365,77,255709
27444,0.001924,172.31.40.0-255,66,200431,77,255709
27445,0.001959,74.125.24.0-255,2184,202615,77,255709
27446,0.001962,172.31.40.0-255,66,202681,77,255709
27447,0.001999,74.125.24.0-255,1484,204165,77,255709
27448,0.002021,74.125.24.0-255,2902,207067,77,255709
27449,0.002024,172.31.40.0-255,66,207133,77,255709
27450,0.002044,74.125.24.0-255,2902,210035,77,255709
27451,0.002046,172.31.40.0-255,66,210101,77,255709
27452,0.004026,74.125.24.0-255,2902,213003,77,255709
27453,0.004034,172.31.40.0-255,66,213069,77,255709
27454,0.004074,74.125.24.0-255,2902,215971,77,255709
27455,0.004076,172.31.40.0-255,66,216037,77,255709
27456,0.006026,74.125.24.0-255,2902,218939,77,255709
27457,0.006029,172.31.40.0-255,66,219005,77,255709
27458,0.006126,74.125.24.0-255,2902,221907,77,255709
27459,0.006128,172.31.40.0-255,66,221973,77,255709
27460,0.008054,74.125.24.0-255,2902,224875,77,255709
27461,0.008059,172.31.40.0-255,66,224941,77,255709
27462,0.008114,74.125.24.0-255,2902,227843,77,255709
27463,0.008129,172.31.40.0-255,66,227909,77,255709
27464,0.010085,74.125.24.0-255,2902,230811,77,255709
27465,0.010092,172.31.40.0-255,66,230877,77,255709
27466,0.01012,74.125.24.0-255,2902,233779,77,255709
27467,0.010123,172.31.40.0-255,66,233845,77,255709
27468,0.012134,74.125.24.0-255,5738,239583,77,255709
27469,0.012141,172.31.40.0-255,66,239649,77,255709
27470,0.014147,74.125.24.0-255,4320,243969,77,255709
27471,0.014154,172.31.40.0-255,66,244035,77,255709
27472,0.014175,74.125.24.0-255,1484,245519,77,255709
27473,0.01619,74.125.24.0-255,4320,249839,77,255709
27474,0.016196,172.31.40.0-255,66,249905,77,255709
27475,0.018204,74.125.24.0-255,5738,255643,77,255709
27476,0.018212,172.31.40.0-255,66,255709,77,255709
27477,0.0,74.125.200.0-255,143,143,77,214840
27478,2e-05,172.31.40.0-255,66,209,77,214840
27479,3.7e-05,74.125.200.0-255,1484,1693,77,214840
27480,4.1e-05,172.31.40.0-255,66,1759,77,214840
27481,8.3e-05,74.125.200.0-255,2902,4661,77,214840
27482,8.6e-05,172.31.40.0-255,66,4727,77,214840
27483,8.9e-05,74.125.200.0-255,1484,6211,77,214840
27484,9.1e-05,172.31.40.0-255,66,6277,77,214840
27485,0.000112,74.125.200.0-255,2902,9179,77,214840
27486,0.000115,172.31.40.0-255,66,9245,77,214840
27487,0.000146,74.125.200.0-255,6227,15472,77,214840
27488,0.000148,172.31.40.0-255,66,15538,77,214840
27489,0.000152,74.125.200.0-255,2902,18440,77,214840
27490,0.000154,172.31.40.0-255,66,18506,77,214840
27491,0.000197,74.125.200.0-255,7156,25662,77,214840
27492,0.000199,172.31.40.0-255,66,25728,77,214840
27493,0.000214,74.125.200.0-255,4320,30048,77,214840
27494,0.000217,172.31.40.0-255,66,30114,77,214840
27495,0.000227,74.125.200.0-255,1125,31239,77,214840
27496,0.000229,172.31.40.0-255,66,31305,77,214840
27497,0.000319,74.125.200.0-255,1484,32789,77,214840
27498,0.000322,172.31.40.0-255,66,32855,77,214840
27499,0.000326,74.125.200.0-255,1484,34339,77,214840
27500,0.000327,172.31.40.0-255,66,34405,77,214840
27501,0.000342,74.125.200.0-255,1484,35889,77,214840
27502,0.000345,172.31.40.0-255,66,35955,77,214840
27503,0.000347,74.125.200.0-255,1484,37439,77,214840
27504,0.000349,172.31.40.0-255,66,37505,77,214840
27505,0.000352,74.125.200.0-255,1484,38989,77,214840
27506,0.000353,172.31.40.0-255,66,39055,77,214840
27507,0.000368,74.125.200.0-255,1484,40539,77,214840
27508,0.00037,172.31.40.0-255,66,40605,77,214840
27509,0.000384,74.125.200.0-255,4320,44925,77,214840
27510,0.000386,172.31.40.0-255,66,44991,77,214840
27511,0.000401,74.125.200.0-255,1484,46475,77,214840
27512,0.000409,74.125.200.0-255,5738,52213,77,214840
27513,0.000411,172.31.40.0-255,66,52279,77,214840
27514,0.000441,74.125.200.0-255,7156,59435,77,214840
27515,0.000444,172.31.40.0-255,66,59501,77,214840
27516,0.000449,74.125.200.0-255,4320,63821,77,214840
27517,0.00045,172.31.40.0-255,66,63887,77,214840
27518,0.000469,74.125.200.0-255,2184,66071,77,214840
27519,0.000471,172.31.40.0-255,66,66137,77,214840
27520,0.000518,74.125.200.0-255,368,66505,77,214840
27521,0.000523,74.125.200.0-255,375,66880,77,214840
27522,0.000953,74.125.200.0-255,1484,68364,77,214840
27523,0.000958,172.31.40.0-255,66,68430,77,214840
27524,0.000971,74.125.200.0-255,2902,71332,77,214840
27525,0.000973,172.31.40.0-255,66,71398,77,214840
27526,0.001001,74.125.200.0-255,4320,75718,77,214840
27527,0.001004,172.31.40.0-255,66,75784,77,214840
27528,0.001021,74.125.200.0-255,1484,77268,77,214840
27529,0.001049,74.125.200.0-255,1484,78752,77,214840
27530,0.001052,172.31.40.0-255,66,78818,77,214840
27531,0.001063,74.125.200.0-255,1484,80302,77,214840
27532,0.001091,74.125.200.0-255,2902,83204,77,214840
27533,0.001093,172.31.40.0-255,66,83270,77,214840
27534,0.001107,74.125.200.0-255,1484,84754,77,214840
27535,0.001111,74.125.200.0-255,2902,87656,77,214840
27536,0.001113,172.31.40.0-255,66,87722,77,214840
27537,0.001137,74.125.200.0-255,4320,92042,77,214840
27538,0.001139,172.31.40.0-255,66,92108,77,214840
27539,0.001158,74.125.200.0-255,2902,95010,77,214840
27540,0.00116,172.31.40.0-255,66,95076,77,214840
27541,0.001182,74.125.200.0-255,4320,99396,77,214840
27542,0.001185,172.31.40.0-255,66,99462,77,214840
27543,0.001197,74.125.200.0-255,2184,101646,77,214840
27544,0.0012,172.31.40.0-255,66,101712,77,214840
27545,0.001321,74.125.200.0-255,1484,103196,77,214840
27546,0.001342,74.125.200.0-255,2902,106098,77,214840
27547,0.001345,172.31.40.0-255,66,106164,77,214840
27548,0.001349,74.125.200.0-255,2902,109066,77,214840
27549,0.001351,172.31.40.0-255,66,109132,77,214840
27550,0.001365,74.125.200.0-255,1484,110616,77,214840
27551,0.001377,74.125.200.0-255,2902,113518,77,214840
27552,0.00138,172.31.40.0-255,66,113584,77,214840
27553,0.001398,74.125.200.0-255,1484,115068,77,214840
27554,0.001421,74.125.200.0-255,7156,122224,77,214840
27555,0.001424,172.31.40.0-255,66,122290,77,214840
27556,0.00145,74.125.200.0-255,1484,123774,77,214840
27557,0.001462,74.125.200.0-255,2902,126676,77,214840
27558,0.001465,172.31.40.0-255,66,126742,77,214840
27559,0.001498,74.125.200.0-255,1484,128226,77,214840
27560,0.001519,74.125.200.0-255,4320,132546,77,214840
27561,0.001521,172.31.40.0-255,66,132612,77,214840
27562,0.001561,74.125.200.0-255,3602,136214,77,214840
27563,0.001564,172.31.40.0-255,66,136280,77,214840
27564,0.001725,74.125.200.0-255,1484,137764,77,214840
27565,0.001815,74.125.200.0-255,1484,139248,77,214840
27566,0.001818,172.31.40.0-255,66,139314,77,214840
27567,0.001842,74.125.200.0-255,2902,142216,77,214840
27568,0.001845,172.31.40.0-255,66,142282,77,214840
27569,0.001872,74.125.200.0-255,1484,143766,77,214840
27570,0.001921,74.125.200.0-255,1484,145250,77,214840
27571,0.001925,172.31.40.0-255,66,145316,77,214840
27572,0.001945,74.125.200.0-255,2902,148218,77,214840
27573,0.001947,172.31.40.0-255,66,148284,77,214840
27574,0.001962,74.125.200.0-255,1484,149768,77,214840
27575,0.001978,74.125.200.0-255,2902,152670,77,214840
27576,0.001981,172.31.40.0-255,66,152736,77,214840
27577,0.002003,74.125.200.0-255,5738,158474,77,214840
27578,0.002005,172.31.40.0-255,66,158540,77,214840
27579,0.002009,74.125.200.0-255,1484,160024,77,214840
27580,0.002042,74.125.200.0-255,2902,162926,77,214840
27581,0.002044,172.31.40.0-255,66,162992,77,214840
27582,0.002072,74.125.200.0-255,5738,168730,77,214840
27583,0.002074,172.31.40.0-255,66,168796,77,214840
27584,0.002079,74.125.200.0-255,2184,170980,77,214840
27585,0.00208,172.31.40.0-255,66,171046,77,214840
27586,0.002318,74.125.200.0-255,1484,172530,77,214840
27587,0.002326,74.125.200.0-255,2902,175432,77,214840
27588,0.00233,172.31.40.0-255,66,175498,77,214840
27589,0.004389,74.125.200.0-255,1484,176982,77,214840
27590,0.00463,74.125.200.0-255,4320,181302,77,214840
27591,0.004635,172.31.40.0-255,66,181368,77,214840
27592,0.006938,74.125.200.0-255,4320,185688,77,214840
27593,0.006941,172.31.40.0-255,66,185754,77,214840
27594,0.006955,74.125.200.0-255,1484,187238,77,214840
27595,0.009256,74.125.200.0-255,4320,191558,77,214840
27596,0.009264,172.31.40.0-255,66,191624,77,214840
27597,0.011582,74.125.200.0-255,5738,197362,77,214840
27598,0.011591,172.31.40.0-255,66,197428,77,214840
27599,0.013941,74.125.200.0-255,5738,203166,77,214840
27600,0.013953,172.31.40.0-255,66,203232,77,214840
27601,0.016274,74.125.200.0-255,5738,208970,77,214840
27602,0.016283,172.31.40.0-255,66,209036,77,214840
27603,0.018616,74.125.200.0-255,5738,214774,77,214840
27604,0.018623,172.31.40.0-255,66,214840,77,214840
27605,0.0,74.125.130.0-255,153,153,77,255423
27606,1.6e-05,172.31.40.0-255,66,219,77,255423
27607,3.3e-05,74.125.130.0-255,1484,1703,77,255423
27608,4.2e-05,172.31.40.0-255,66,1769,77,255423
27609,4.5e-05,74.125.130.0-255,1484,3253,77,255423
27610,4.8e-05,172.31.40.0-255,66,3319,77,255423
27611,5.2e-05,74.125.130.0-255,2902,6221,77,255423
27612,5.5e-05,172.31.40.0-255,66,6287,77,255423
27613,9e-05,74.125.130.0-255,4320,10607,77,255423
27614,9.3e-05,172.31.40.0-255,66,10673,77,255423
27615,0.000103,74.125.130.0-255,1484,12157,77,255423
27616,0.000104,172.31.40.0-255,66,12223,77,255423
27617,0.00013,74.125.130.0-255,6294,18517,77,255423
27618,0.000133,172.31.40.0-255,66,18583,77,255423
27619,0.000161,74.125.130.0-255,8574,27157,77,255423
27620,0.000163,172.31.40.0-255,66,27223,77,255423
27621,0.000198,74.125.130.0-255,2902,30125,77,255423
27622,0.0002,172.31.40.0-255,66,30191,77,255423
27623,0.000228,74.125.130.0-255,1125,31316,77,255423
27624,0.00023,172.31.40.0-255,66,31382,77,255423
27625,0.000361,74.125.130.0-255,1484,32866,77,255423
27626,0.000364,172.31.40.0-255,66,32932,77,255423
27627,0.000367,74.125.130.0-255,1484,34416,77,255423
27628,0.000369,172.31.40.0-255,66,34482,77,255423
27629,0.0004,74.125.130.0-255,1484,35966,77,255423
27630,0.000402,172.31.40.0-255,66,36032,77,255423
27631,0.000408,74.125.130.0-255,5738,41770,77,255423
27632,0.000411,172.31.40.0-255,66,41836,77,255423
27633,0.000417,74.125.130.0-255,6797,48633,77,255423
27634,0.000419,172.31.40.0-255,66,48699,77,255423
27635,0.000453,74.125.130.0-255,2902,51601,77,255423
27636,0.000455,172.31.40.0-255,66,51667,77,255423
27637,0.000477,74.125.130.0-255,5738,57405,77,255423
27638,0.000479,172.31.40.0-255,66,57471,77,255423
27639,0.000509,74.125.130.0-255,8505,65976,77,255423
27640,0.000511,172.31.40.0-255,66,66042,77,255423
27641,0.000552,74.125.130.0-255,364,66406,77,255423
27642,0.000703,74.125.130.0-255,1484,67890,77,255423
27643,0.000706,172.31.40.0-255,66,67956,77,255423
27644,0.000732,74.125.130.0-255,2902,70858,77,255423
27645,0.000734,172.31.40.0-255,66,70924,77,255423
27646,0.000759,74.125.130.0-255,1484,72408,77,255423
27647,0.000763,74.125.130.0-255,2902,75310,77,255423
27648,0.000766,172.31.40.0-255,66,75376,77,255423
27649,0.000792,74.125.130.0-255,5738,81114,77,255423
27650,0.000795,172.31.40.0-255,66,81180,77,255423
27651,0.0008,74.125.130.0-255,4320,85500,77,255423
27652,0.000802,172.31.40.0-255,66,85566,77,255423
27653,0.000823,74.125.130.0-255,2902,88468,77,255423
27654,0.000826,172.31.40.0-255,66,88534,77,255423
27655,0.000851,74.125.130.0-255,1484,90018,77,255423
27656,0.00087,74.125.130.0-255,7156,97174,77,255423
27657,0.000873,172.31.40.0-255,66,97240,77,255423
27658,0.000901,74.125.130.0-255,2902,100142,77,255423
27659,0.000904,172.31.40.0-255,66,100208,77,255423
27660,0.000915,74.125.130.0-255,218,100426,77,255423
27661,0.001394,74.125.130.0-255,1484,101910,77,255423
27662,0.0014,172.31.40.0-255,66,101976,77,255423
27663,0.001408,74.125.130.0-255,2902,104878,77,255423
27664,0.001411,172.31.40.0-255,66,104944,77,255423
27665,0.001422,74.125.130.0-255,4320,109264,77,255423
27666,0.001424,172.31.40.0-255,66,109330,77,255423
27667,0.001468,74.125.130.0-255,5738,115068,77,255423
27668,0.001471,172.31.40.0-255,66,115134,77,255423
27669,0.001496,74.125.130.0-255,1484,116618,77,255423
27670,0.001498,74.125.130.0-255,1111,117729,77,255423
27671,0.001503,172.31.40.0-255,66,117795,77,255423
27672,0.001659,74.125.130.0-255,1484,119279,77,255423
27673,0.001676,74.125.130.0-255,2902,122181,77,255423
27674,0.001679,172.31.40.0-255,66,122247,77,255423
27675,0.001683,74.125.130.0-255,1484,123731,77,255423
27676,0.001709,74.125.130.0-255,4320,128051,77,255423
27677,0.001712,172.31.40.0-255,66,128117,77,255423
27678,0.001718,74.125.130.0-255,5738,133855,77,255423
27679,0.00172,172.31.40.0-255,66,133921,77,255423
27680,0.001723,74.125.130.0-255,1484,135405,77,255423
27681,0.001747,74.125.130.0-255,5738,141143,77,255423
27682,0.00175,172.31.40.0-255,66,141209,77,255423
27683,0.001756,74.125.130.0-255,4320,145529,77,255423
27684,0.001758,172.31.40.0-255,66,145595,77,255423
27685,0.001791,74.125.130.0-255,5406,151001,77,255423
27686,0.001794,172.31.40.0-255,66,151067,77,255423
27687,0.001828,74.125.130.0-255,7156,158223,77,255423
27688,0.001831,172.31.40.0-255,66,158289,77,255423
27689,0.001854,74.125.130.0-255,2902,161191,77,255423
27690,0.001857,172.31.40.0-255,66,161257,77,255423
27691,0.001878,74.125.130.0-255,5738,166995,77,255423
27692,0.001881,172.31.40.0-255,66,167061,77,255423
27693,0.001885,74.125.130.0-255,2902,169963,77,255423
27694,0.001887,172.31.40.0-255,66,170029,77,255423
27695,0.00199,74.125.130.0-255,2902,172931,77,255423
27696,0.001995,172.31.40.0-255,66,172997,77,255423
27697,0.002029,74.125.130.0-255,9992,182989,77,255423
27698,0.002032,172.31.40.0-255,66,183055,77,255423
27699,0.002036,74.125.130.0-255,2184,185239,77,255423
27700,0.002038,172.31.40.0-255,66,185305,77,255423
27701,0.002226,74.125.130.0-255,1484,186789,77,255423
27702,0.002241,74.125.130.0-255,2902,189691,77,255423
27703,0.002245,172.31.40.0-255,66,189757,77,255423
27704,0.002249,74.125.130.0-255,1484,191241,77,255423
27705,0.002281,74.125.130.0-255,4320,195561,77,255423
27706,0.002286,172.31.40.0-255,66,195627,77,255423
27707,0.00229,74.125.130.0-255,2902,198529,77,255423
27708,0.002292,172.31.40.0-255,66,198595,77,255423
27709,0.002297,74.125.130.0-255,4320,202915,77,255423
27710,0.002303,74.125.130.0-255,4320,207235,77,255423
27711,0.002307,172.31.40.0-255,66,207301,77,255423
27712,0.002309,172.31.40.0-255,66,207367,77,255423
27713,0.002336,74.125.130.0-255,4320,211687,77,255423
27714,0.002344,74.125.130.0-255,5738,217425,77,255423
27715,0.002348,172.31.40.0-255,66,217491,77,255423
27716,0.00235,172.31.40.0-255,66,217557,77,255423
27717,0.002367,74.125.130.0-255,2184,219741,77,255423
27718,0.002375,172.31.40.0-255,66,219807,77,255423
27719,0.004885,74.125.130.0-255,2902,222709,77,255423
27720,0.004892,172.31.40.0-255,66,222775,77,255423
27721,0.004906,74.125.130.0-255,2902,225677,77,255423
27722,0.004913,172.31.40.0-255,66,225743,77,255423
27723,0.007411,74.125.130.0-255,2902,228645,77,255423
27724,0.007417,172.31.40.0-255,66,228711,77,255423
27725,0.007453,74.125.130.0-255,2902,231613,77,255423
27726,0.007456,172.31.40.0-255,66,231679,77,255423
27727,0.009945,74.125.130.0-255,2902,234581,77,255423
27728,0.009951,172.31.40.0-255,66,234647,77,255423
27729,0.00999,74.125.130.0-255,2902,237549,77,255423
27730,0.009993,172.31.40.0-255,66,237615,77,255423
27731,0.012478,74.125.130.0-255,2902,240517,77,255423
27732,0.012486,172.31.40.0-255,66,240583,77,255423
27733,0.01252,74.125.130.0-255,2902,243485,77,255423
27734,0.012524,172.31.40.0-255,66,243551,77,255423
27735,0.015012,74.125.130.0-255,2902,246453,77,255423
27736,0.015019,172.31.40.0-255,66,246519,77,255423
27737,0.015045,74.125.130.0-255,2902,249421,77,255423
27738,0.015048,172.31.40.0-255,66,249487,77,255423
27739,0.017552,74.125.130.0-255,2902,252389,77,255423
27740,0.01756,172.31.40.0-255,66,252455,77,255423
27741,0.017597,74.125.130.0-255,2902,255357,77,255423
27742,0.0176,172.31.40.0-255,66,255423,77,255423
27743,0.0,172.217.194.0-255,153,153,77,195805
27744,2.2e-05,172.31.40.0-255,66,219,77,195805
27745,2.9e-05,172.217.194.0-255,1484,1703,77,195805
27746,3.3e-05,172.31.40.0-255,66,1769,77,195805
27747,3.9e-05,172.217.194.0-255,2902,4671,77,195805
27748,4.3e-05,172.31.40.0-255,66,4737,77,195805
27749,4.8e-05,172.217.194.0-255,2902,7639,77,195805
27750,5.1e-05,172.31.40.0-255,66,7705,77,195805
27751,7.3e-05,172.217.194.0-255,4320,12025,77,195805
27752,7.7e-05,172.31.40.0-255,66,12091,77,195805
27753,0.000194,172.217.194.0-255,9992,22083,77,195805
27754,0.000198,172.31.40.0-255,66,22149,77,195805
27755,0.000218,172.217.194.0-255,6390,28539,77,195805
27756,0.000221,172.31.40.0-255,66,28605,77,195805
27757,0.000473,172.217.194.0-255,2543,31148,77,195805
27758,0.000478,172.31.40.0-255,66,31214,77,195805
27759,0.000532,172.217.194.0-255,4320,35534,77,195805
27760,0.000536,172.31.40.0-255,66,35600,77,195805
27761,0.000559,172.217.194.0-255,13887,49487,77,195805
27762,0.000564,172.31.40.0-255,66,49553,77,195805
27763,0.000847,172.217.194.0-255,4320,53873,77,195805
27764,0.000851,172.31.40.0-255,66,53939,77,195805
27765,0.000876,172.217.194.0-255,11630,65569,77,195805
27766,0.000878,172.31.40.0-255,66,65635,77,195805
27767,0.00112,172.217.194.0-255,7156,72791,77,195805
27768,0.001125,172.31.40.0-255,66,72857,77,195805
27769,0.001151,172.217.194.0-255,9992,82849,77,195805
27770,0.001154,172.31.40.0-255,66,82915,77,195805
27771,0.001438,172.217.194.0-255,11410,94325,77,195805
27772,0.001444,172.31.40.0-255,66,94391,77,195805
27773,0.001469,172.217.194.0-255,5020,99411,77,195805
27774,0.001472,172.31.40.0-255,66,99477,77,195805
27775,0.001728,172.217.194.0-255,11410,110887,77,195805
27776,0.001787,172.217.194.0-255,1636,112523,77,195805
27777,0.002396,172.217.194.0-255,8574,121097,77,195805
27778,0.002891,172.217.194.0-255,2902,123999,77,195805
27779,0.002908,172.217.194.0-255,7156,131155,77,195805
27780,0.002953,172.217.194.0-255,6438,137593,77,195805
27781,0.003497,172.217.194.0-255,5738,143331,77,195805
27782,0.003547,172.217.194.0-255,9274,152605,77,195805
27783,0.004081,172.217.194.0-255,5738,158343,77,195805
27784,0.004101,172.217.194.0-255,9992,168335,77,195805
27785,0.004121,172.217.194.0-255,9992,178327,77,195805
27786,0.004591,172.31.40.0-255,66,178393,77,195805
27787,0.007185,172.217.194.0-255,5738,184131,77,195805
27788,0.007194,172.31.40.0-255,66,184197,77,195805
27789,0.009818,172.217.194.0-255,5738,189935,77,195805
27790,0.015155,172.31.40.0-255,66,190001,77,195805
27791,0.017739,172.217.194.0-255,5738,195739,77,195805
27792,0.017749,172.31.40.0-255,66,195805,77,195805
27793,0.0,74.125.68.0-255,153,153,77,226633
27794,1.5e-05,172.31.40.0-255,66,219,77,226633
27795,2.2e-05,74.125.68.0-255,1484,1703,77,226633
27796,2.7e-05,172.31.40.0-255,66,1769,77,226633
27797,4.8e-05,74.125.68.0-255,2902,4671,77,226633
27798,5.1e-05,172.31.40.0-255,66,4737,77,226633
27799,6.7e-05,74.125.68.0-255,4320,9057,77,226633
27800,7.1e-05,172.31.40.0-255,66,9123,77,226633
27801,9e-05,74.125.68.0-255,1484,10607,77,226633
27802,9.2e-05,172.31.40.0-255,66,10673,77,226633
27803,9.6e-05,74.125.68.0-255,1484,12157,77,226633
27804,9.8e-05,172.31.40.0-255,66,12223,77,226633
27805,0.000137,74.125.68.0-255,5738,17961,77,226633
27806,0.000139,172.31.40.0-255,66,18027,77,226633
27807,0.000162,74.125.68.0-255,3526,21553,77,226633
27808,0.000164,172.31.40.0-255,66,21619,77,226633
27809,0.00017,74.125.68.0-255,4320,25939,77,226633
27810,0.000172,172.31.40.0-255,66,26005,77,226633
27811,0.000206,74.125.68.0-255,5379,31384,77,226633
27812,0.000209,172.31.40.0-255,66,31450,77,226633
27813,0.000514,74.125.68.0-255,1484,32934,77,226633
27814,0.00052,172.31.40.0-255,66,33000,77,226633
27815,0.000527,74.125.68.0-255,2902,35902,77,226633
27816,0.00053,172.31.40.0-255,66,35968,77,226633
27817,0.000532,74.125.68.0-255,1484,37452,77,226633
27818,0.000535,172.31.40.0-255,66,37518,77,226633
27819,0.000541,74.125.68.0-255,2902,40420,77,226633
27820,0.000544,172.31.40.0-255,66,40486,77,226633
27821,0.000574,74.125.68.0-255,5738,46224,77,226633
27822,0.000578,172.31.40.0-255,66,46290,77,226633
27823,0.000581,74.125.68.0-255,1484,47774,77,226633
27824,0.000583,172.31.40.0-255,66,47840,77,226633
27825,0.000647,74.125.68.0-255,2902,50742,77,226633
27826,0.00065,172.31.40.0-255,66,50808,77,226633
27827,0.000672,74.125.68.0-255,6797,57605,77,226633
27828,0.000674,172.31.40.0-255,66,57671,77,226633
27829,0.000702,74.125.68.0-255,7156,64827,77,226633
27830,0.000705,172.31.40.0-255,66,64893,77,226633
27831,0.000724,74.125.68.0-255,1436,66329,77,226633
27832,0.001015,172.31.40.0-255,66,66395,77,226633
27833,0.001108,74.125.68.0-255,110,66505,77,226633
27834,0.001637,74.125.68.0-255,1484,67989,77,226633
27835,0.001644,172.31.40.0-255,66,68055,77,226633
27836,0.001649,74.125.68.0-255,1484,69539,77,226633
27837,0.001654,74.125.68.0-255,2902,72441,77,226633
27838,0.001656,172.31.40.0-255,66,72507,77,226633
27839,0.001684,74.125.68.0-255,5738,78245,77,226633
27840,0.001686,172.31.40.0-255,66,78311,77,226633
27841,0.0017,74.125.68.0-255,4320,82631,77,226633
27842,0.001702,172.31.40.0-255,66,82697,77,226633
27843,0.001717,74.125.68.0-255,1484,84181,77,226633
27844,0.001725,74.125.68.0-255,7156,91337,77,226633
27845,0.001727,172.31.40.0-255,66,91403,77,226633
27846,0.00178,74.125.68.0-255,9274,100677,77,226633
27847,0.001783,172.31.40.0-255,66,100743,77,226633
27848,0.001974,74.125.68.0-255,1484,102227,77,226633
27849,0.001993,74.125.68.0-255,2902,105129,77,226633
27850,0.001997,172.31.40.0-255,66,105195,77,226633
27851,0.002003,74.125.68.0-255,4320,109515,77,226633
27852,0.002005,172.31.40.0-255,66,109581,77,226633
27853,0.002019,74.125.68.0-255,1484,111065,77,226633
27854,0.002045,74.125.68.0-255,5738,116803,77,226633
27855,0.002048,172.31.40.0-255,66,116869,77,226633
27856,0.00206,74.125.68.0-255,1484,118353,77,226633
27857,0.002065,74.125.68.0-255,4320,122673,77,226633
27858,0.002067,172.31.40.0-255,66,122739,77,226633
27859,0.002071,74.125.68.0-255,1484,124223,77,226633
27860,0.002103,74.125.68.0-255,4320,128543,77,226633
27861,0.002105,172.31.40.0-255,66,128609,77,226633
27862,0.00211,74.125.68.0-255,4320,132929,77,226633
27863,0.002113,172.31.40.0-255,66,132995,77,226633
27864,0.002126,74.125.68.0-255,1484,134479,77,226633
27865,0.002161,74.125.68.0-255,5020,139499,77,226633
27866,0.002164,172.31.40.0-255,66,139565,77,226633
27867,0.002181,74.125.68.0-255,1484,141049,77,226633
27868,0.002206,74.125.68.0-255,4320,145369,77,226633
27869,0.002208,172.31.40.0-255,66,145435,77,226633
27870,0.002213,74.125.68.0-255,2902,148337,77,226633
27871,0.002215,172.31.40.0-255,66,148403,77,226633
27872,0.002219,74.125.68.0-255,1484,149887,77,226633
27873,0.002243,74.125.68.0-255,2902,152789,77,226633
27874,0.002245,172.31.40.0-255,66,152855,77,226633
27875,0.002271,74.125.68.0-255,7156,160011,77,226633
27876,0.002273,172.31.40.0-255,66,160077,77,226633
27877,0.002303,74.125.68.0-255,8574,168651,77,226633
27878,0.002305,172.31.40.0-255,66,168717,77,226633
27879,0.002308,74.125.68.0-255,766,169483,77,226633
27880,0.002384,74.125.68.0-255,1484,170967,77,226633
27881,0.002386,172.31.40.0-255,66,171033,77,226633
27882,0.002405,74.125.68.0-255,1484,172517,77,226633
27883,0.002421,74.125.68.0-255,1484,174001,77,226633
27884,0.002423,172.31.40.0-255,66,174067,77,226633
27885,0.002426,74.125.68.0-255,1484,175551,77,226633
27886,0.002446,74.125.68.0-255,2902,178453,77,226633
27887,0.002448,172.31.40.0-255,66,178519,77,226633
27888,0.002454,74.125.68.0-255,4320,182839,77,226633
27889,0.002456,172.31.40.0-255,66,182905,77,226633
27890,0.002471,74.125.68.0-255,2902,185807,77,226633
27891,0.002474,172.31.40.0-255,66,185873,77,226633
27892,0.002493,74.125.68.0-255,1484,187357,77,226633
27893,0.002514,74.125.68.0-255,5738,193095,77,226633
27894,0.002517,172.31.40.0-255,66,193161,77,226633
27895,0.005005,74.125.68.0-255,5738,198899,77,226633
27896,0.005009,172.31.40.0-255,66,198965,77,226633
27897,0.007505,74.125.68.0-255,5738,204703,77,226633
27898,0.007511,172.31.40.0-255,66,204769,77,226633
27899,0.010003,74.125.68.0-255,4320,209089,77,226633
27900,0.01001,172.31.40.0-255,66,209155,77,226633
27901,0.010031,74.125.68.0-255,1484,210639,77,226633
27902,0.012512,74.125.68.0-255,4320,214959,77,226633
27903,0.012524,172.31.40.0-255,66,215025,77,226633
27904,0.015018,74.125.68.0-255,5738,220763,77,226633
27905,0.015027,172.31.40.0-255,66,220829,77,226633
27906,0.017541,74.125.68.0-255,5738,226567,77,226633
27907,0.017552,172.31.40.0-255,66,226633,77,226633
27908,0.0,74.125.24.0-255,153,153,77,349920
27909,2e-05,172.31.40.0-255,66,219,77,349920
27910,2.6e-05,74.125.24.0-255,1484,1703,77,349920
27911,3e-05,172.31.40.0-255,66,1769,77,349920
27912,3.5e-05,74.125.24.0-255,2902,4671,77,349920
27913,5.7e-05,172.31.40.0-255,66,4737,77,349920
27914,6.2e-05,74.125.24.0-255,2902,7639,77,349920
27915,6.4e-05,172.31.40.0-255,66,7705,77,349920
27916,6.9e-05,74.125.24.0-255,4320,12025,77,349920
27917,7.1e-05,172.31.40.0-255,66,12091,77,349920
27918,7.5e-05,74.125.24.0-255,2902,14993,77,349920
27919,7.7e-05,172.31.40.0-255,66,15059,77,349920
27920,0.000112,74.125.24.0-255,6282,21341,77,349920
27921,0.000115,172.31.40.0-255,66,21407,77,349920
27922,0.000121,74.125.24.0-255,7156,28563,77,349920
27923,0.000124,172.31.40.0-255,66,28629,77,349920
27924,0.000139,74.125.24.0-255,2543,31172,77,349920
27925,0.000141,172.31.40.0-255,66,31238,77,349920
27926,0.000189,74.125.24.0-255,1484,32722,77,349920
27927,0.000191,172.31.40.0-255,66,32788,77,349920
27928,0.000195,74.125.24.0-255,1484,34272,77,349920
27929,0.000196,172.31.40.0-255,66,34338,77,349920
27930,0.000222,74.125.24.0-255,1484,35822,77,349920
27931,0.000228,172.31.40.0-255,66,35888,77,349920
27932,0.000234,74.125.24.0-255,5738,41626,77,349920
27933,0.000236,172.31.40.0-255,66,41692,77,349920
27934,0.000239,74.125.24.0-255,2902,44594,77,349920
27935,0.000241,172.31.40.0-255,66,44660,77,349920
27936,0.000272,74.125.24.0-255,9633,54293,77,349920
27937,0.000274,172.31.40.0-255,66,54359,77,349920
27938,0.000295,74.125.24.0-255,5738,60097,77,349920
27939,0.000297,172.31.40.0-255,66,60163,77,349920
27940,0.000326,74.125.24.0-255,5735,65898,77,349920
27941,0.000328,172.31.40.0-255,66,65964,77,349920
27942,0.000331,74.125.24.0-255,331,66295,77,349920
27943,0.00045,74.125.24.0-255,1484,67779,77,349920
27944,0.000453,172.31.40.0-255,66,67845,77,349920
27945,0.00049,74.125.24.0-255,2902,70747,77,349920
27946,0.000492,172.31.40.0-255,66,70813,77,349920
27947,0.000498,74.125.24.0-255,5738,76551,77,349920
27948,0.0005,172.31.40.0-255,66,76617,77,349920
27949,0.000504,74.125.24.0-255,4320,80937,77,349920
27950,0.000506,172.31.40.0-255,66,81003,77,349920
27951,0.000509,74.125.24.0-255,1484,82487,77,349920
27952,0.000542,74.125.24.0-255,11051,93538,77,349920
27953,0.000545,172.31.40.0-255,66,93604,77,349920
27954,0.000551,74.125.24.0-255,6797,100401,77,349920
27955,0.000553,172.31.40.0-255,66,100467,77,349920
27956,0.000942,74.125.24.0-255,1484,101951,77,349920
27957,0.000948,74.125.24.0-255,2902,104853,77,349920
27958,0.00095,172.31.40.0-255,66,104919,77,349920
27959,0.000991,74.125.24.0-255,5738,110657,77,349920
27960,0.000993,172.31.40.0-255,66,110723,77,349920
27961,0.001,74.125.24.0-255,8574,119297,77,349920
27962,0.001001,172.31.40.0-255,66,119363,77,349920
27963,0.001021,74.125.24.0-255,4320,123683,77,349920
27964,0.001026,172.31.40.0-255,66,123749,77,349920
27965,0.001041,74.125.24.0-255,2902,126651,77,349920
27966,0.001043,172.31.40.0-255,66,126717,77,349920
27967,0.00108,74.125.24.0-255,7856,134573,77,349920
27968,0.001082,172.31.40.0-255,66,134639,77,349920
27969,0.001085,74.125.24.0-255,1484,136123,77,349920
27970,0.001089,74.125.24.0-255,2902,139025,77,349920
27971,0.001091,172.31.40.0-255,66,139091,77,349920
27972,0.00112,74.125.24.0-255,5738,144829,77,349920
27973,0.001122,172.31.40.0-255,66,144895,77,349920
27974,0.001156,74.125.24.0-255,12828,157723,77,349920
27975,0.001159,172.31.40.0-255,66,157789,77,349920
27976,0.001167,74.125.24.0-255,9992,167781,77,349920
27977,0.001169,172.31.40.0-255,66,167847,77,349920
27978,0.001192,74.125.24.0-255,766,168613,77,349920
27979,0.001247,74.125.24.0-255,1484,170097,77,349920
27980,0.00125,172.31.40.0-255,66,170163,77,349920
27981,0.001254,74.125.24.0-255,2902,173065,77,349920
27982,0.001256,172.31.40.0-255,66,173131,77,349920
27983,0.001286,74.125.24.0-255,5738,178869,77,349920
27984,0.001288,172.31.40.0-255,66,178935,77,349920
27985,0.001297,74.125.24.0-255,9992,188927,77,349920
27986,0.001298,172.31.40.0-255,66,188993,77,349920
27987,0.001323,74.125.24.0-255,2902,191895,77,349920
27988,0.001328,172.31.40.0-255,66,191961,77,349920
27989,0.001335,74.125.24.0-255,8574,200535,77,349920
27990,0.001337,172.31.40.0-255,66,200601,77,349920
27991,0.001356,74.125.24.0-255,2184,202785,77,349920
27992,0.001362,172.31.40.0-255,66,202851,77,349920
27993,0.001391,74.125.24.0-255,2902,205753,77,349920
27994,0.001394,172.31.40.0-255,66,205819,77,349920
27995,0.001397,74.125.24.0-255,2902,208721,77,349920
27996,0.001399,172.31.40.0-255,66,208787,77,349920
27997,0.001404,74.125.24.0-255,2902,211689,77,349920
27998,0.001405,172.31.40.0-255,66,211755,77,349920
27999,0.001419,74.125.24.0-255,1484,213239,77,349920
28000,0.001424,74.125.24.0-255,4320,217559,77,349920
28001,0.001426,172.31.40.0-255,66,217625,77,349920
28002,0.001457,74.125.24.0-255,4320,221945,77,349920
28003,0.00146,172.31.40.0-255,66,222011,77,349920
28004,0.001469,74.125.24.0-255,11410,233421,77,349920
28005,0.001472,172.31.40.0-255,66,233487,77,349920
28006,0.001502,74.125.24.0-255,3602,237089,77,349920
28007,0.001505,172.31.40.0-255,66,237155,77,349920
28008,0.001519,172.31.40.0-255,66,237221,77,349920
28009,0.001537,172.31.40.0-255,66,237287,77,349920
28010,0.001565,74.125.24.0-255,3602,240889,77,349920
28011,0.001568,172.31.40.0-255,66,240955,77,349920
28012,0.001591,74.125.24.0-255,1484,242439,77,349920
28013,0.001596,74.125.24.0-255,2902,245341,77,349920
28014,0.001599,172.31.40.0-255,66,245407,77,349920
28015,0.001629,74.125.24.0-255,4320,249727,77,349920
28016,0.001631,172.31.40.0-255,66,249793,77,349920
28017,0.001635,74.125.24.0-255,2902,252695,77,349920
28018,0.001637,172.31.40.0-255,66,252761,77,349920
28019,0.001664,74.125.24.0-255,5738,258499,77,349920
28020,0.001666,172.31.40.0-255,66,258565,77,349920
28021,0.001704,74.125.24.0-255,8574,267139,77,349920
28022,0.001706,172.31.40.0-255,66,267205,77,349920
28023,0.001726,74.125.24.0-255,4320,271525,77,349920
28024,0.001728,172.31.40.0-255,66,271591,77,349920
28025,0.001732,74.125.24.0-255,3602,275193,77,349920
28026,0.001734,172.31.40.0-255,66,275259,77,349920
28027,0.00178,74.125.24.0-255,1484,276743,77,349920
28028,0.001799,74.125.24.0-255,2902,279645,77,349920
28029,0.001802,172.31.40.0-255,66,279711,77,349920
28030,0.001806,74.125.24.0-255,2902,282613,77,349920
28031,0.001807,172.31.40.0-255,66,282679,77,349920
28032,0.001837,74.125.24.0-255,2902,285581,77,349920
28033,0.00184,172.31.40.0-255,66,285647,77,349920
28034,0.001847,74.125.24.0-255,7156,292803,77,349920
28035,0.001849,172.31.40.0-255,66,292869,77,349920
28036,0.001855,74.125.24.0-255,7156,300025,77,349920
28037,0.001858,172.31.40.0-255,66,300091,77,349920
28038,0.001889,74.125.24.0-255,7156,307247,77,349920
28039,0.001892,172.31.40.0-255,66,307313,77,349920
28040,0.001897,74.125.24.0-255,5020,312333,77,349920
28041,0.001899,172.31.40.0-255,66,312399,77,349920
28042,0.001905,74.125.24.0-255,5738,318137,77,349920
28043,0.001907,172.31.40.0-255,66,318203,77,349920
28044,0.001958,74.125.24.0-255,9274,327477,77,349920
28045,0.001977,74.125.24.0-255,2902,330379,77,349920
28046,0.001984,172.31.40.0-255,66,330445,77,349920
28047,0.002027,74.125.24.0-255,5738,336183,77,349920
28048,0.002047,172.31.40.0-255,66,336249,77,349920
28049,0.002057,74.125.24.0-255,10692,346941,77,349920
28050,0.002069,74.125.24.0-255,2571,349512,77,349920
28051,0.002075,172.31.40.0-255,66,349578,77,349920
28052,0.002099,74.125.24.0-255,105,349683,77,349920
28053,0.003991,172.31.40.0-255,66,349749,77,349920
28054,0.004023,172.31.40.0-255,105,349854,77,349920
28055,0.006634,74.125.24.0-255,66,349920,77,349920
28056,0.0,74.125.68.0-255,291,291,77,328882
28057,2.2e-05,172.31.40.0-255,66,357,77,328882
28058,2.9e-05,74.125.68.0-255,1484,1841,77,328882
28059,3.3e-05,172.31.40.0-255,66,1907,77,328882
28060,4e-05,74.125.68.0-255,4320,6227,77,328882
28061,5.1e-05,172.31.40.0-255,66,6293,77,328882
28062,5.9e-05,74.125.68.0-255,7156,13449,77,328882
28063,6.2e-05,172.31.40.0-255,66,13515,77,328882
28064,8.5e-05,74.125.68.0-255,7542,21057,77,328882
28065,9.2e-05,172.31.40.0-255,66,21123,77,328882
28066,9.9e-05,74.125.68.0-255,5738,26861,77,328882
28067,0.000102,172.31.40.0-255,66,26927,77,328882
28068,0.000131,74.125.68.0-255,1484,28411,77,328882
28069,0.000134,172.31.40.0-255,66,28477,77,328882
28070,0.000155,74.125.68.0-255,2543,31020,77,328882
28071,0.000158,172.31.40.0-255,66,31086,77,328882
28072,0.000463,74.125.68.0-255,1484,32570,77,328882
28073,0.000468,172.31.40.0-255,66,32636,77,328882
28074,0.000475,74.125.68.0-255,2902,35538,77,328882
28075,0.000478,172.31.40.0-255,66,35604,77,328882
28076,0.000481,74.125.68.0-255,1484,37088,77,328882
28077,0.000483,172.31.40.0-255,66,37154,77,328882
28078,0.000513,74.125.68.0-255,4320,41474,77,328882
28079,0.000517,172.31.40.0-255,66,41540,77,328882
28080,0.000525,74.125.68.0-255,2902,44442,77,328882
28081,0.000527,172.31.40.0-255,66,44508,77,328882
28082,0.000533,74.125.68.0-255,4320,48828,77,328882
28083,0.000535,172.31.40.0-255,66,48894,77,328882
28084,0.000538,74.125.68.0-255,1484,50378,77,328882
28085,0.00054,172.31.40.0-255,66,50444,77,328882
28086,0.00058,74.125.68.0-255,7156,57600,77,328882
28087,0.000587,172.31.40.0-255,66,57666,77,328882
28088,0.000594,74.125.68.0-255,5738,63404,77,328882
28089,0.000635,74.125.68.0-255,2184,65588,77,328882
28090,0.000637,74.125.68.0-255,356,65944,77,328882
28091,0.000658,172.31.40.0-255,66,66010,77,328882
28092,0.000684,74.125.68.0-255,1484,67494,77,328882
28093,0.000706,74.125.68.0-255,2902,70396,77,328882
28094,0.000712,172.31.40.0-255,66,70462,77,328882
28095,0.000721,74.125.68.0-255,1484,71946,77,328882
28096,0.000728,74.125.68.0-255,4320,76266,77,328882
28097,0.000744,74.125.68.0-255,1484,77750,77,328882
28098,0.000759,74.125.68.0-255,1484,79234,77,328882
28099,0.000775,74.125.68.0-255,9992,89226,77,328882
28100,0.00078,74.125.68.0-255,2902,92128,77,328882
28101,0.000788,172.31.40.0-255,66,92194,77,328882
28102,0.000797,74.125.68.0-255,2902,95096,77,328882
28103,0.000806,172.31.40.0-255,66,95162,77,328882
28104,0.000833,74.125.68.0-255,4320,99482,77,328882
28105,0.000847,74.125.68.0-255,766,100248,77,328882
28106,0.000849,74.125.68.0-255,386,100634,77,328882
28107,0.000852,172.31.40.0-255,66,100700,77,328882
28108,0.001139,74.125.68.0-255,1484,102184,77,328882
28109,0.001144,172.31.40.0-255,66,102250,77,328882
28110,0.00115,74.125.68.0-255,2902,105152,77,328882
28111,0.00116,172.31.40.0-255,66,105218,77,328882
28112,0.001194,74.125.68.0-255,2902,108120,77,328882
28113,0.0012,74.125.68.0-255,4320,112440,77,328882
28114,0.001206,74.125.68.0-255,5738,118178,77,328882
28115,0.001211,172.31.40.0-255,66,118244,77,328882
28116,0.001242,74.125.68.0-255,2902,121146,77,328882
28117,0.001249,74.125.68.0-255,5738,126884,77,328882
28118,0.001256,74.125.68.0-255,7156,134040,77,328882
28119,0.001259,74.125.68.0-255,766,134806,77,328882
28120,0.001267,172.31.40.0-255,66,134872,77,328882
28121,0.001626,74.125.68.0-255,1484,136356,77,328882
28122,0.001648,74.125.68.0-255,2902,139258,77,328882
28123,0.001652,172.31.40.0-255,66,139324,77,328882
28124,0.001666,74.125.68.0-255,1484,140808,77,328882
28125,0.001692,74.125.68.0-255,4320,145128,77,328882
28126,0.001696,74.125.68.0-255,2902,148030,77,328882
28127,0.001702,74.125.68.0-255,5738,153768,77,328882
28128,0.001721,172.31.40.0-255,66,153834,77,328882
28129,0.001727,74.125.68.0-255,4320,158154,77,328882
28130,0.001731,74.125.68.0-255,2902,161056,77,328882
28131,0.001763,74.125.68.0-255,5738,166794,77,328882
28132,0.00177,172.31.40.0-255,66,166860,77,328882
28133,0.001782,74.125.68.0-255,2184,169044,77,328882
28134,0.001811,74.125.68.0-255,1484,170528,77,328882
28135,0.001815,172.31.40.0-255,66,170594,77,328882
28136,0.001822,74.125.68.0-255,1484,172078,77,328882
28137,0.001824,74.125.68.0-255,1484,173562,77,328882
28138,0.00183,172.31.40.0-255,66,173628,77,328882
28139,0.001864,74.125.68.0-255,2902,176530,77,328882
28140,0.001871,74.125.68.0-255,5738,182268,77,328882
28141,0.001876,74.125.68.0-255,4320,186588,77,328882
28142,0.001883,172.31.40.0-255,66,186654,77,328882
28143,0.001902,74.125.68.0-255,7156,193810,77,328882
28144,0.001916,172.31.40.0-255,66,193876,77,328882
28145,0.001949,74.125.68.0-255,7156,201032,77,328882
28146,0.001965,74.125.68.0-255,2184,203216,77,328882
28147,0.001976,172.31.40.0-255,66,203282,77,328882
28148,0.002004,74.125.68.0-255,1484,204766,77,328882
28149,0.002022,74.125.68.0-255,2902,207668,77,328882
28150,0.002028,172.31.40.0-255,66,207734,77,328882
28151,0.002053,74.125.68.0-255,5738,213472,77,328882
28152,0.002069,172.31.40.0-255,66,213538,77,328882
28153,0.002102,74.125.68.0-255,7156,220694,77,328882
28154,0.002117,172.31.40.0-255,66,220760,77,328882
28155,0.002122,74.125.68.0-255,4320,225080,77,328882
28156,0.00215,74.125.68.0-255,1484,226564,77,328882
28157,0.002156,74.125.68.0-255,4320,230884,77,328882
28158,0.002167,172.31.40.0-255,66,230950,77,328882
28159,0.002174,74.125.68.0-255,6438,237388,77,328882
28160,0.002189,172.31.40.0-255,66,237454,77,328882
28161,0.002215,74.125.68.0-255,1484,238938,77,328882
28162,0.002219,74.125.68.0-255,1484,240422,77,328882
28163,0.002235,74.125.68.0-255,1484,241906,77,328882
28164,0.002237,74.125.68.0-255,1484,243390,77,328882
28165,0.002242,172.31.40.0-255,66,243456,77,328882
28166,0.002291,74.125.68.0-255,4320,247776,77,328882
28167,0.002302,74.125.68.0-255,1484,249260,77,328882
28168,0.002315,74.125.68.0-255,7156,256416,77,328882
28169,0.002344,74.125.68.0-255,5738,262154,77,328882
28170,0.002349,74.125.68.0-255,4320,266474,77,328882
28171,0.00237,74.125.68.0-255,4320,270794,77,328882
28172,0.002386,74.125.68.0-255,766,271560,77,328882
28173,0.002424,74.125.68.0-255,1484,273044,77,328882
28174,0.002441,74.125.68.0-255,2902,275946,77,328882
28175,0.002463,74.125.68.0-255,4320,280266,77,328882
28176,0.002467,74.125.68.0-255,1484,281750,77,328882
28177,0.002484,74.125.68.0-255,5738,287488,77,328882
28178,0.002502,74.125.68.0-255,1484,288972,77,328882
28179,0.002509,74.125.68.0-255,7156,296128,77,328882
28180,0.002523,74.125.68.0-255,4320,300448,77,328882
28181,0.002541,74.125.68.0-255,4320,304768,77,328882
28182,0.002544,74.125.68.0-255,766,305534,77,328882
28183,0.002614,74.125.68.0-255,1484,307018,77,328882
28184,0.00262,74.125.68.0-255,2902,309920,77,328882
28185,0.002623,74.125.68.0-255,1484,311404,77,328882
28186,0.008428,172.31.40.0-255,66,311470,77,328882
28187,0.011048,74.125.68.0-255,5738,317208,77,328882
28188,0.011059,172.31.40.0-255,66,317274,77,328882
28189,0.013661,74.125.68.0-255,5738,323012,77,328882
28190,0.013668,172.31.40.0-255,66,323078,77,328882
28191,0.01629,74.125.68.0-255,5738,328816,77,328882
28192,0.01802,172.31.40.0-255,66,328882,77,328882
28193,0.0,74.125.24.0-255,152,152,77,346029
28194,2e-05,172.31.40.0-255,66,218,77,346029
28195,2.6e-05,74.125.24.0-255,1484,1702,77,346029
28196,3.2e-05,172.31.40.0-255,66,1768,77,346029
28197,3.7e-05,74.125.24.0-255,2902,4670,77,346029
28198,4e-05,172.31.40.0-255,66,4736,77,346029
28199,4.7e-05,74.125.24.0-255,7156,11892,77,346029
28200,5e-05,172.31.40.0-255,66,11958,77,346029
28201,7.7e-05,74.125.24.0-255,3446,15404,77,346029
28202,8e-05,172.31.40.0-255,66,15470,77,346029
28203,8.5e-05,74.125.24.0-255,4320,19790,77,346029
28204,8.8e-05,172.31.40.0-255,66,19856,77,346029
28205,9.7e-05,74.125.24.0-255,9992,29848,77,346029
28206,0.0001,172.31.40.0-255,66,29914,77,346029
28207,0.000102,74.125.24.0-255,1125,31039,77,346029
28208,0.000104,172.31.40.0-255,66,31105,77,346029
28209,0.000192,74.125.24.0-255,1484,32589,77,346029
28210,0.000195,172.31.40.0-255,66,32655,77,346029
28211,0.0002,74.125.24.0-255,2902,35557,77,346029
28212,0.000202,172.31.40.0-255,66,35623,77,346029
28213,0.000215,74.125.24.0-255,2902,38525,77,346029
28214,0.000218,172.31.40.0-255,66,38591,77,346029
28215,0.000234,74.125.24.0-255,2902,41493,77,346029
28216,0.000236,172.31.40.0-255,66,41559,77,346029
28217,0.000258,74.125.24.0-255,7156,48715,77,346029
28218,0.00026,172.31.40.0-255,66,48781,77,346029
28219,0.000287,74.125.24.0-255,6797,55578,77,346029
28220,0.00029,172.31.40.0-255,66,55644,77,346029
28221,0.000299,74.125.24.0-255,9942,65586,77,346029
28222,0.000301,172.31.40.0-255,66,65652,77,346029
28223,0.000304,74.125.24.0-255,112,65764,77,346029
28224,0.000305,172.31.40.0-255,66,65830,77,346029
28225,0.000328,74.125.24.0-255,332,66162,77,346029
28226,0.000679,74.125.24.0-255,1484,67646,77,346029
28227,0.000684,172.31.40.0-255,66,67712,77,346029
28228,0.00069,74.125.24.0-255,2902,70614,77,346029
28229,0.000692,172.31.40.0-255,66,70680,77,346029
28230,0.000695,74.125.24.0-255,1484,72164,77,346029
28231,0.00072,74.125.24.0-255,4320,76484,77,346029
28232,0.000729,74.125.24.0-255,9992,86476,77,346029
28233,0.000732,172.31.40.0-255,66,86542,77,346029
28234,0.000735,172.31.40.0-255,66,86608,77,346029
28235,0.000751,74.125.24.0-255,2902,89510,77,346029
28236,0.000754,172.31.40.0-255,66,89576,77,346029
28237,0.000779,74.125.24.0-255,7156,96732,77,346029
28238,0.000782,172.31.40.0-255,66,96798,77,346029
28239,0.000806,74.125.24.0-255,3602,100400,77,346029
28240,0.000809,172.31.40.0-255,66,100466,77,346029
28241,0.001425,74.125.24.0-255,1484,101950,77,346029
28242,0.00144,74.125.24.0-255,2902,104852,77,346029
28243,0.001444,172.31.40.0-255,66,104918,77,346029
28244,0.001458,74.125.24.0-255,1484,106402,77,346029
28245,0.001473,74.125.24.0-255,4320,110722,77,346029
28246,0.001476,172.31.40.0-255,66,110788,77,346029
28247,0.001482,74.125.24.0-255,4320,115108,77,346029
28248,0.001483,172.31.40.0-255,66,115174,77,346029
28249,0.001506,74.125.24.0-255,5738,120912,77,346029
28250,0.001509,172.31.40.0-255,66,120978,77,346029
28251,0.001536,74.125.24.0-255,11410,132388,77,346029
28252,0.001539,172.31.40.0-255,66,132454,77,346029
28253,0.001543,74.125.24.0-255,2184,134638,77,346029
28254,0.001545,172.31.40.0-255,66,134704,77,346029
28255,0.001597,74.125.24.0-255,2902,137606,77,346029
28256,0.001599,172.31.40.0-255,66,137672,77,346029
28257,0.001607,74.125.24.0-255,7156,144828,77,346029
28258,0.001609,172.31.40.0-255,66,144894,77,346029
28259,0.001613,74.125.24.0-255,2902,147796,77,346029
28260,0.001615,172.31.40.0-255,66,147862,77,346029
28261,0.001623,74.125.24.0-255,8574,156436,77,346029
28262,0.001626,172.31.40.0-255,66,156502,77,346029
28263,0.001642,74.125.24.0-255,2902,159404,77,346029
28264,0.001644,172.31.40.0-255,66,159470,77,346029
28265,0.00165,74.125.24.0-255,5738,165208,77,346029
28266,0.001652,172.31.40.0-255,66,165274,77,346029
28267,0.001657,74.125.24.0-255,4320,169594,77,346029
28268,0.001659,172.31.40.0-255,66,169660,77,346029
28269,0.001683,74.125.24.0-255,2184,171844,77,346029
28270,0.001685,172.31.40.0-255,66,171910,77,346029
28271,0.001695,74.125.24.0-255,9992,181902,77,346029
28272,0.001697,172.31.40.0-255,66,181968,77,346029
28273,0.001725,74.125.24.0-255,4320,186288,77,346029
28274,0.001728,172.31.40.0-255,66,186354,77,346029
28275,0.001736,74.125.24.0-255,8574,194928,77,346029
28276,0.001738,172.31.40.0-255,66,194994,77,346029
28277,0.001764,74.125.24.0-255,7856,202850,77,346029
28278,0.001767,172.31.40.0-255,66,202916,77,346029
28279,0.001846,74.125.24.0-255,1484,204400,77,346029
28280,0.001852,74.125.24.0-255,2902,207302,77,346029
28281,0.001855,172.31.40.0-255,66,207368,77,346029
28282,0.001879,74.125.24.0-255,5738,213106,77,346029
28283,0.001881,172.31.40.0-255,66,213172,77,346029
28284,0.001905,74.125.24.0-255,7156,220328,77,346029
28285,0.001908,172.31.40.0-255,66,220394,77,346029
28286,0.001925,74.125.24.0-255,5738,226132,77,346029
28287,0.001927,172.31.40.0-255,66,226198,77,346029
28288,0.001968,74.125.24.0-255,10692,236890,77,346029
28289,0.001972,172.31.40.0-255,66,236956,77,346029
28290,0.002097,74.125.24.0-255,1484,238440,77,346029
28291,0.002104,74.125.24.0-255,2902,241342,77,346029
28292,0.002108,172.31.40.0-255,66,241408,77,346029
28293,0.002115,74.125.24.0-255,5738,247146,77,346029
28294,0.002118,172.31.40.0-255,66,247212,77,346029
28295,0.002159,74.125.24.0-255,12828,260040,77,346029
28296,0.002163,172.31.40.0-255,66,260106,77,346029
28297,0.00217,74.125.24.0-255,5738,265844,77,346029
28298,0.002172,172.31.40.0-255,66,265910,77,346029
28299,0.002197,74.125.24.0-255,1484,267394,77,346029
28300,0.002214,74.125.24.0-255,3602,270996,77,346029
28301,0.002217,172.31.40.0-255,66,271062,77,346029
28302,0.002221,74.125.24.0-255,1484,272546,77,346029
28303,0.002242,74.125.24.0-255,4320,276866,77,346029
28304,0.002246,172.31.40.0-255,66,276932,77,346029
28305,0.002249,74.125.24.0-255,1484,278416,77,346029
28306,0.002272,74.125.24.0-255,8574,286990,77,346029
28307,0.002276,172.31.40.0-255,66,287056,77,346029
28308,0.002282,74.125.24.0-255,5738,292794,77,346029
28309,0.002284,172.31.40.0-255,66,292860,77,346029
28310,0.00231,74.125.24.0-255,5738,298598,77,346029
28311,0.002313,172.31.40.0-255,66,298664,77,346029
28312,0.002333,74.125.24.0-255,1484,300148,77,346029
28313,0.002351,74.125.24.0-255,5020,305168,77,346029
28314,0.002354,172.31.40.0-255,66,305234,77,346029
28315,0.004622,74.125.24.0-255,5738,310972,77,346029
28316,0.004629,172.31.40.0-255,66,311038,77,346029
28317,0.006945,74.125.24.0-255,5738,316776,77,346029
28318,0.006949,172.31.40.0-255,66,316842,77,346029
28319,0.009334,74.125.24.0-255,5738,322580,77,346029
28320,0.009352,172.31.40.0-255,66,322646,77,346029
28321,0.011684,74.125.24.0-255,5738,328384,77,346029
28322,0.011704,172.31.40.0-255,66,328450,77,346029
28323,0.01195,172.31.40.0-255,101,328551,77,346029
28324,0.014069,74.125.24.0-255,5738,334289,77,346029
28325,0.014076,172.31.40.0-255,66,334355,77,346029
28326,0.014236,74.125.24.0-255,66,334421,77,346029
28327,0.01637,74.125.24.0-255,5738,340159,77,346029
28328,0.016385,172.31.40.0-255,66,340225,77,346029
28329,0.018731,74.125.24.0-255,5738,345963,77,346029
28330,0.018749,172.31.40.0-255,66,346029,77,346029
28331,0.0,172.253.118.0-255,151,151,77,367509
28332,1.6e-05,172.31.40.0-255,66,217,77,367509
28333,2.3e-05,172.253.118.0-255,1484,1701,77,367509
28334,2.7e-05,172.31.40.0-255,66,1767,77,367509
28335,3.3e-05,172.253.118.0-255,2902,4669,77,367509
28336,4.4e-05,172.31.40.0-255,66,4735,77,367509
28337,5e-05,172.253.118.0-255,4320,9055,77,367509
28338,5.4e-05,172.31.40.0-255,66,9121,77,367509
28339,9e-05,172.253.118.0-255,4875,13996,77,367509
28340,9.4e-05,172.31.40.0-255,66,14062,77,367509
28341,0.000153,172.253.118.0-255,1484,15546,77,367509
28342,0.000155,172.31.40.0-255,66,15612,77,367509
28343,0.00016,172.253.118.0-255,2902,18514,77,367509
28344,0.000162,172.31.40.0-255,66,18580,77,367509
28345,0.000191,172.253.118.0-255,5738,24318,77,367509
28346,0.000194,172.31.40.0-255,66,24384,77,367509
28347,0.000198,172.253.118.0-255,2902,27286,77,367509
28348,0.0002,172.31.40.0-255,66,27352,77,367509
28349,0.000243,172.253.118.0-255,3961,31313,77,367509
28350,0.000246,172.31.40.0-255,66,31379,77,367509
28351,0.000327,172.253.118.0-255,1484,32863,77,367509
28352,0.00033,172.31.40.0-255,66,32929,77,367509
28353,0.000336,172.253.118.0-255,2902,35831,77,367509
28354,0.000339,172.31.40.0-255,66,35897,77,367509
28355,0.000371,172.253.118.0-255,5738,41635,77,367509
28356,0.000373,172.31.40.0-255,66,41701,77,367509
28357,0.000401,172.253.118.0-255,8574,50275,77,367509
28358,0.000404,172.31.40.0-255,66,50341,77,367509
28359,0.000434,172.253.118.0-255,5379,55720,77,367509
28360,0.000437,172.31.40.0-255,66,55786,77,367509
28361,0.000445,172.253.118.0-255,7156,62942,77,367509
28362,0.000447,172.31.40.0-255,66,63008,77,367509
28363,0.000457,172.253.118.0-255,2543,65551,77,367509
28364,0.000459,172.31.40.0-255,66,65617,77,367509
28365,0.000462,172.253.118.0-255,360,65977,77,367509
28366,0.000545,172.253.118.0-255,382,66359,77,367509
28367,0.000705,172.253.118.0-255,1484,67843,77,367509
28368,0.000713,172.31.40.0-255,66,67909,77,367509
28369,0.000719,172.253.118.0-255,2902,70811,77,367509
28370,0.000721,172.31.40.0-255,66,70877,77,367509
28371,0.000754,172.253.118.0-255,5738,76615,77,367509
28372,0.000757,172.31.40.0-255,66,76681,77,367509
28373,0.000767,172.253.118.0-255,9633,86314,77,367509
28374,0.000774,172.31.40.0-255,66,86380,77,367509
28375,0.000779,172.253.118.0-255,2902,89282,77,367509
28376,0.000781,172.31.40.0-255,66,89348,77,367509
28377,0.00082,172.253.118.0-255,7156,96504,77,367509
28378,0.000824,172.31.40.0-255,66,96570,77,367509
28379,0.000829,172.253.118.0-255,3961,100531,77,367509
28380,0.000831,172.31.40.0-255,66,100597,77,367509
28381,0.001323,172.253.118.0-255,1484,102081,77,367509
28382,0.00133,172.253.118.0-255,2902,104983,77,367509
28383,0.001334,172.31.40.0-255,66,105049,77,367509
28384,0.001363,172.253.118.0-255,5738,110787,77,367509
28385,0.001365,172.31.40.0-255,66,110853,77,367509
28386,0.001371,172.253.118.0-255,4320,115173,77,367509
28387,0.001372,172.31.40.0-255,66,115239,77,367509
28388,0.001402,172.253.118.0-255,2902,118141,77,367509
28389,0.001404,172.31.40.0-255,66,118207,77,367509
28390,0.001416,172.31.40.0-255,66,118273,77,367509
28391,0.001424,172.253.118.0-255,2184,120457,77,367509
28392,0.001426,172.31.40.0-255,66,120523,77,367509
28393,0.001704,172.253.118.0-255,1484,122007,77,367509
28394,0.001708,172.253.118.0-255,1484,123491,77,367509
28395,0.001711,172.31.40.0-255,66,123557,77,367509
28396,0.001736,172.253.118.0-255,1484,125041,77,367509
28397,0.001742,172.253.118.0-255,5738,130779,77,367509
28398,0.001744,172.31.40.0-255,66,130845,77,367509
28399,0.001757,172.253.118.0-255,1484,132329,77,367509
28400,0.001781,172.253.118.0-255,9992,142321,77,367509
28401,0.001783,172.31.40.0-255,66,142387,77,367509
28402,0.001789,172.253.118.0-255,7156,149543,77,367509
28403,0.001791,172.31.40.0-255,66,149609,77,367509
28404,0.001821,172.253.118.0-255,5020,154629,77,367509
28405,0.001824,172.31.40.0-255,66,154695,77,367509
28406,0.001833,172.253.118.0-255,11410,166105,77,367509
28407,0.001834,172.31.40.0-255,66,166171,77,367509
28408,0.001849,172.253.118.0-255,12828,178999,77,367509
28409,0.001851,172.31.40.0-255,66,179065,77,367509
28410,0.001883,172.253.118.0-255,2902,181967,77,367509
28411,0.001885,172.31.40.0-255,66,182033,77,367509
28412,0.001915,172.253.118.0-255,6438,188471,77,367509
28413,0.001918,172.31.40.0-255,66,188537,77,367509
28414,0.001921,172.253.118.0-255,1484,190021,77,367509
28415,0.001924,172.253.118.0-255,2902,192923,77,367509
28416,0.001926,172.31.40.0-255,66,192989,77,367509
28417,0.001928,172.253.118.0-255,1484,194473,77,367509
28418,0.001959,172.253.118.0-255,4320,198793,77,367509
28419,0.001962,172.31.40.0-255,66,198859,77,367509
28420,0.001986,172.253.118.0-255,7156,206015,77,367509
28421,0.001989,172.31.40.0-255,66,206081,77,367509
28422,0.002015,172.253.118.0-255,4320,210401,77,367509
28423,0.002017,172.31.40.0-255,66,210467,77,367509
28424,0.002022,172.253.118.0-255,5738,216205,77,367509
28425,0.002024,172.31.40.0-255,66,216271,77,367509
28426,0.002054,172.253.118.0-255,5738,222009,77,367509
28427,0.002057,172.31.40.0-255,66,222075,77,367509
28428,0.002061,172.253.118.0-255,2902,224977,77,367509
28429,0.002062,172.31.40.0-255,66,225043,77,367509
28430,0.002095,172.253.118.0-255,3602,228645,77,367509
28431,0.002098,172.31.40.0-255,66,228711,77,367509
28432,0.002104,172.253.118.0-255,7156,235867,77,367509
28433,0.002106,172.31.40.0-255,66,235933,77,367509
28434,0.002122,172.253.118.0-255,9992,245925,77,367509
28435,0.002124,172.31.40.0-255,66,245991,77,367509
28436,0.002156,172.253.118.0-255,5738,251729,77,367509
28437,0.002159,172.31.40.0-255,66,251795,77,367509
28438,0.002164,172.253.118.0-255,5020,256815,77,367509
28439,0.002165,172.31.40.0-255,66,256881,77,367509
28440,0.002195,172.253.118.0-255,8574,265455,77,367509
28441,0.0022,172.31.40.0-255,66,265521,77,367509
28442,0.002234,172.31.40.0-255,66,265587,77,367509
28443,0.002268,172.253.118.0-255,9992,275579,77,367509
28444,0.002271,172.31.40.0-255,66,275645,77,367509
28445,0.002301,172.253.118.0-255,5020,280665,77,367509
28446,0.002304,172.31.40.0-255,66,280731,77,367509
28447,0.002319,172.31.40.0-255,66,280797,77,367509
28448,0.002332,172.253.118.0-255,13528,294325,77,367509
28449,0.002335,172.31.40.0-255,66,294391,77,367509
28450,0.002344,172.253.118.0-255,11410,305801,77,367509
28451,0.002346,172.31.40.0-255,66,305867,77,367509
28452,0.00235,172.253.118.0-255,2902,308769,77,367509
28453,0.002352,172.31.40.0-255,66,308835,77,367509
28454,0.00239,172.253.118.0-255,9992,318827,77,367509
28455,0.002393,172.31.40.0-255,66,318893,77,367509
28456,0.002401,172.253.118.0-255,9274,328167,77,367509
28457,0.002403,172.31.40.0-255,66,328233,77,367509
28458,0.004764,172.253.118.0-255,5738,333971,77,367509
28459,0.004771,172.31.40.0-255,66,334037,77,367509
28460,0.007119,172.253.118.0-255,4320,338357,77,367509
28461,0.007123,172.31.40.0-255,66,338423,77,367509
28462,0.007146,172.253.118.0-255,1484,339907,77,367509
28463,0.009458,172.253.118.0-255,4320,344227,77,367509
28464,0.009465,172.31.40.0-255,66,344293,77,367509
28465,0.011822,172.253.118.0-255,5738,350031,77,367509
28466,0.01183,172.31.40.0-255,66,350097,77,367509
28467,0.014178,172.253.118.0-255,5738,355835,77,367509
28468,0.014188,172.31.40.0-255,66,355901,77,367509
28469,0.016551,172.253.118.0-255,5738,361639,77,367509
28470,0.016562,172.31.40.0-255,66,361705,77,367509
28471,0.0189,172.253.118.0-255,5738,367443,77,367509
28472,0.01891,172.31.40.0-255,66,367509,77,367509
28473,0.0,172.217.194.0-255,152,152,77,318263
28474,2.1e-05,172.31.40.0-255,66,218,77,318263
28475,2.8e-05,172.217.194.0-255,1484,1702,77,318263
28476,3.2e-05,172.31.40.0-255,66,1768,77,318263
28477,3.9e-05,172.217.194.0-255,2902,4670,77,318263
28478,5.1e-05,172.31.40.0-255,66,4736,77,318263
28479,5.9e-05,172.217.194.0-255,7156,11892,77,318263
28480,6.2e-05,172.31.40.0-255,66,11958,77,318263
28481,6.8e-05,172.217.194.0-255,3519,15477,77,318263
28482,7.1e-05,172.31.40.0-255,66,15543,77,318263
28483,8.1e-05,172.217.194.0-255,9992,25535,77,318263
28484,8.4e-05,172.31.40.0-255,66,25601,77,318263
28485,0.000101,172.217.194.0-255,2902,28503,77,318263
28486,0.000108,172.31.40.0-255,66,28569,77,318263
28487,0.000112,172.217.194.0-255,2543,31112,77,318263
28488,0.000115,172.31.40.0-255,66,31178,77,318263
28489,0.000139,172.217.194.0-255,2902,34080,77,318263
28490,0.000142,172.31.40.0-255,66,34146,77,318263
28491,0.000167,172.217.194.0-255,4320,38466,77,318263
28492,0.00017,172.31.40.0-255,66,38532,77,318263
28493,0.000177,172.217.194.0-255,5738,44270,77,318263
28494,0.000179,172.31.40.0-255,66,44336,77,318263
28495,0.00021,172.217.194.0-255,2902,47238,77,318263
28496,0.000212,172.31.40.0-255,66,47304,77,318263
28497,0.000222,172.217.194.0-255,9633,56937,77,318263
28498,0.000224,172.31.40.0-255,66,57003,77,318263
28499,0.000284,172.217.194.0-255,8215,65218,77,318263
28500,0.000287,172.31.40.0-255,66,65284,77,318263
28501,0.000289,172.217.194.0-255,646,65930,77,318263
28502,0.000292,172.31.40.0-255,66,65996,77,318263
28503,0.00068,172.217.194.0-255,1484,67480,77,318263
28504,0.000687,172.31.40.0-255,66,67546,77,318263
28505,0.000693,172.217.194.0-255,2902,70448,77,318263
28506,0.000696,172.31.40.0-255,66,70514,77,318263
28507,0.000701,172.217.194.0-255,4320,74834,77,318263
28508,0.000703,172.31.40.0-255,66,74900,77,318263
28509,0.000734,172.217.194.0-255,1484,76384,77,318263
28510,0.000743,172.217.194.0-255,5738,82122,77,318263
28511,0.000745,172.31.40.0-255,66,82188,77,318263
28512,0.000753,172.217.194.0-255,7156,89344,77,318263
28513,0.000755,172.31.40.0-255,66,89410,77,318263
28514,0.000762,172.217.194.0-255,5738,95148,77,318263
28515,0.000764,172.31.40.0-255,66,95214,77,318263
28516,0.000799,172.217.194.0-255,4471,99685,77,318263
28517,0.000802,172.31.40.0-255,66,99751,77,318263
28518,0.001295,172.217.194.0-255,1484,101235,77,318263
28519,0.001301,172.217.194.0-255,2902,104137,77,318263
28520,0.001305,172.31.40.0-255,66,104203,77,318263
28521,0.001335,172.217.194.0-255,5738,109941,77,318263
28522,0.001338,172.31.40.0-255,66,110007,77,318263
28523,0.001374,172.217.194.0-255,12828,122835,77,318263
28524,0.001377,172.31.40.0-255,66,122901,77,318263
28525,0.001387,172.217.194.0-255,9992,132893,77,318263
28526,0.001389,172.31.40.0-255,66,132959,77,318263
28527,0.001405,172.217.194.0-255,766,133725,77,318263
28528,0.001664,172.217.194.0-255,1484,135209,77,318263
28529,0.001669,172.31.40.0-255,66,135275,77,318263
28530,0.001675,172.217.194.0-255,2902,138177,77,318263
28531,0.001677,172.31.40.0-255,66,138243,77,318263
28532,0.001681,172.217.194.0-255,1484,139727,77,318263
28533,0.001691,172.217.194.0-255,4320,144047,77,318263
28534,0.001694,172.31.40.0-255,66,144113,77,318263
28535,0.001717,172.217.194.0-255,1484,145597,77,318263
28536,0.001726,172.217.194.0-255,7156,152753,77,318263
28537,0.001728,172.31.40.0-255,66,152819,77,318263
28538,0.00175,172.217.194.0-255,5738,158557,77,318263
28539,0.001753,172.31.40.0-255,66,158623,77,318263
28540,0.001762,172.217.194.0-255,8574,167197,77,318263
28541,0.001764,172.31.40.0-255,66,167263,77,318263
28542,0.0018,172.217.194.0-255,6438,173701,77,318263
28543,0.001803,172.31.40.0-255,66,173767,77,318263
28544,0.00181,172.217.194.0-255,7156,180923,77,318263
28545,0.001812,172.31.40.0-255,66,180989,77,318263
28546,0.00182,172.217.194.0-255,7156,188145,77,318263
28547,0.001823,172.31.40.0-255,66,188211,77,318263
28548,0.00185,172.217.194.0-255,8574,196785,77,318263
28549,0.001853,172.31.40.0-255,66,196851,77,318263
28550,0.001856,172.217.194.0-255,1484,198335,77,318263
28551,0.001886,172.217.194.0-255,3602,201937,77,318263
28552,0.001888,172.31.40.0-255,66,202003,77,318263
28553,0.001906,172.217.194.0-255,1484,203487,77,318263
28554,0.001911,172.217.194.0-255,2902,206389,77,318263
28555,0.001914,172.31.40.0-255,66,206455,77,318263
28556,0.001934,172.217.194.0-255,5738,212193,77,318263
28557,0.001937,172.31.40.0-255,66,212259,77,318263
28558,0.001951,172.217.194.0-255,12828,225087,77,318263
28559,0.001953,172.31.40.0-255,66,225153,77,318263
28560,0.00196,172.217.194.0-255,8574,233727,77,318263
28561,0.001963,172.31.40.0-255,66,233793,77,318263
28562,0.001983,172.217.194.0-255,2184,235977,77,318263
28563,0.001985,172.31.40.0-255,66,236043,77,318263
28564,0.001988,172.217.194.0-255,1484,237527,77,318263
28565,0.002016,172.217.194.0-255,2902,240429,77,318263
28566,0.002019,172.31.40.0-255,66,240495,77,318263
28567,0.002055,172.217.194.0-255,4320,244815,77,318263
28568,0.002057,172.31.40.0-255,66,244881,77,318263
28569,0.002082,172.217.194.0-255,1484,246365,77,318263
28570,0.002095,172.217.194.0-255,11410,257775,77,318263
28571,0.002098,172.31.40.0-255,66,257841,77,318263
28572,0.002108,172.217.194.0-255,12110,269951,77,318263
28573,0.002111,172.31.40.0-255,66,270017,77,318263
28574,0.002574,172.217.194.0-255,1484,271501,77,318263
28575,0.002579,172.217.194.0-255,2902,274403,77,318263
28576,0.002582,172.31.40.0-255,66,274469,77,318263
28577,0.002587,172.217.194.0-255,4320,278789,77,318263
28578,0.002589,172.31.40.0-255,66,278855,77,318263
28579,0.00261,172.217.194.0-255,1484,280339,77,318263
28580,0.002618,172.217.194.0-255,2902,283241,77,318263
28581,0.00262,172.31.40.0-255,66,283307,77,318263
28582,0.00517,172.217.194.0-255,1484,284791,77,318263
28583,0.005217,172.217.194.0-255,4320,289111,77,318263
28584,0.005223,172.31.40.0-255,66,289177,77,318263
28585,0.007832,172.217.194.0-255,5738,294915,77,318263
28586,0.007853,172.31.40.0-255,66,294981,77,318263
28587,0.010433,172.217.194.0-255,5738,300719,77,318263
28588,0.010449,172.31.40.0-255,66,300785,77,318263
28589,0.013078,172.217.194.0-255,5738,306523,77,318263
28590,0.013097,172.31.40.0-255,66,306589,77,318263
28591,0.01567,172.217.194.0-255,5738,312327,77,318263
28592,0.015676,172.31.40.0-255,66,312393,77,318263
28593,0.018254,172.217.194.0-255,4320,316713,77,318263
28594,0.018262,172.31.40.0-255,66,316779,77,318263
28595,0.018292,172.217.194.0-255,1484,318263,77,318263
28596,0.0,172.217.194.0-255,297,297,77,190461
28597,1.5e-05,172.31.40.0-255,66,363,77,190461
28598,2.3e-05,172.217.194.0-255,1484,1847,77,190461
28599,2.7e-05,172.31.40.0-255,66,1913,77,190461
28600,3.4e-05,172.217.194.0-255,4320,6233,77,190461
28601,3.8e-05,172.31.40.0-255,66,6299,77,190461
28602,6.1e-05,172.217.194.0-255,1484,7783,77,190461
28603,6.3e-05,172.31.40.0-255,66,7849,77,190461
28604,8.6e-05,172.217.194.0-255,6103,13952,77,190461
28605,8.9e-05,172.31.40.0-255,66,14018,77,190461
28606,0.000211,172.217.194.0-255,1484,15502,77,190461
28607,0.000214,172.31.40.0-255,66,15568,77,190461
28608,0.00022,172.217.194.0-255,2902,18470,77,190461
28609,0.000223,172.31.40.0-255,66,18536,77,190461
28610,0.000259,172.217.194.0-255,5738,24274,77,190461
28611,0.000261,172.31.40.0-255,66,24340,77,190461
28612,0.000284,172.217.194.0-255,6797,31137,77,190461
28613,0.000286,172.31.40.0-255,66,31203,77,190461
28614,0.000318,172.217.194.0-255,4320,35523,77,190461
28615,0.000321,172.31.40.0-255,66,35589,77,190461
28616,0.000341,172.217.194.0-255,5738,41327,77,190461
28617,0.000344,172.31.40.0-255,66,41393,77,190461
28618,0.000382,172.217.194.0-255,6797,48190,77,190461
28619,0.000384,172.31.40.0-255,66,48256,77,190461
28620,0.001387,172.217.194.0-255,1484,49740,77,190461
28621,0.001394,172.31.40.0-255,66,49806,77,190461
28622,0.001403,172.217.194.0-255,2902,52708,77,190461
28623,0.001406,172.31.40.0-255,66,52774,77,190461
28624,0.001413,172.217.194.0-255,5738,58512,77,190461
28625,0.001415,172.31.40.0-255,66,58578,77,190461
28626,0.001444,172.217.194.0-255,6797,65375,77,190461
28627,0.001447,172.31.40.0-255,66,65441,77,190461
28628,0.001497,172.217.194.0-255,7156,72597,77,190461
28629,0.0015,172.31.40.0-255,66,72663,77,190461
28630,0.001507,172.217.194.0-255,5738,78401,77,190461
28631,0.001509,172.31.40.0-255,66,78467,77,190461
28632,0.001527,172.217.194.0-255,2902,81369,77,190461
28633,0.001529,172.31.40.0-255,66,81435,77,190461
28634,0.00155,172.217.194.0-255,5738,87173,77,190461
28635,0.001552,172.31.40.0-255,66,87239,77,190461
28636,0.001577,172.217.194.0-255,12110,99349,77,190461
28637,0.001579,172.31.40.0-255,66,99415,77,190461
28638,0.001582,172.217.194.0-255,647,100062,77,190461
28639,0.00172,172.217.194.0-255,1484,101546,77,190461
28640,0.001726,172.31.40.0-255,66,101612,77,190461
28641,0.001732,172.217.194.0-255,2902,104514,77,190461
28642,0.001735,172.31.40.0-255,66,104580,77,190461
28643,0.00174,172.217.194.0-255,4320,108900,77,190461
28644,0.001744,172.31.40.0-255,66,108966,77,190461
28645,0.001757,172.217.194.0-255,1484,110450,77,190461
28646,0.0018,172.217.194.0-255,4320,114770,77,190461
28647,0.001804,172.31.40.0-255,66,114836,77,190461
28648,0.001819,172.217.194.0-255,1878,116714,77,190461
28649,0.001822,172.31.40.0-255,66,116780,77,190461
28650,0.002011,172.217.194.0-255,198,116978,77,190461
28651,0.002291,172.217.194.0-255,1484,118462,77,190461
28652,0.002295,172.31.40.0-255,66,118528,77,190461
28653,0.0023,172.217.194.0-255,1484,120012,77,190461
28654,0.002314,172.217.194.0-255,1484,121496,77,190461
28655,0.002317,172.31.40.0-255,66,121562,77,190461
28656,0.002324,172.217.194.0-255,5738,127300,77,190461
28657,0.002327,172.31.40.0-255,66,127366,77,190461
28658,0.002363,172.217.194.0-255,12828,140194,77,190461
28659,0.002365,172.31.40.0-255,66,140260,77,190461
28660,0.002376,172.217.194.0-255,10692,150952,77,190461
28661,0.002379,172.31.40.0-255,66,151018,77,190461
28662,0.004264,172.31.40.0-255,101,151119,77,190461
28663,0.004718,172.217.194.0-255,5738,156857,77,190461
28664,0.004723,172.31.40.0-255,66,156923,77,190461
28665,0.006565,172.217.194.0-255,66,156989,77,190461
28666,0.007115,172.217.194.0-255,4320,161309,77,190461
28667,0.007118,172.31.40.0-255,66,161375,77,190461
28668,0.007132,172.217.194.0-255,1484,162859,77,190461
28669,0.009457,172.217.194.0-255,4320,167179,77,190461
28670,0.009464,172.31.40.0-255,66,167245,77,190461
28671,0.01178,172.217.194.0-255,5738,172983,77,190461
28672,0.011788,172.31.40.0-255,66,173049,77,190461
28673,0.014107,172.217.194.0-255,5738,178787,77,190461
28674,0.014114,172.31.40.0-255,66,178853,77,190461
28675,0.016431,172.217.194.0-255,5738,184591,77,190461
28676,0.016439,172.31.40.0-255,66,184657,77,190461
28677,0.018827,172.217.194.0-255,5738,190395,77,190461
28678,0.018836,172.31.40.0-255,66,190461,77,190461
28679,0.0,74.125.200.0-255,147,147,77,417849
28680,1.8e-05,172.31.40.0-255,66,213,77,417849
28681,2.5e-05,74.125.200.0-255,1484,1697,77,417849
28682,3e-05,172.31.40.0-255,66,1763,77,417849
28683,4.3e-05,74.125.200.0-255,2902,4665,77,417849
28684,4.7e-05,172.31.40.0-255,66,4731,77,417849
28685,7.7e-05,74.125.200.0-255,1484,6215,77,417849
28686,8e-05,172.31.40.0-255,66,6281,77,417849
28687,0.000104,74.125.200.0-255,5738,12019,77,417849
28688,0.000107,172.31.40.0-255,66,12085,77,417849
28689,0.000111,74.125.200.0-255,2049,14134,77,417849
28690,0.000113,172.31.40.0-255,66,14200,77,417849
28691,0.000893,74.125.200.0-255,1484,15684,77,417849
28692,0.0009,172.31.40.0-255,66,15750,77,417849
28693,0.000911,74.125.200.0-255,2902,18652,77,417849
28694,0.000913,172.31.40.0-255,66,18718,77,417849
28695,0.000925,74.125.200.0-255,5738,24456,77,417849
28696,0.000928,172.31.40.0-255,66,24522,77,417849
28697,0.000931,74.125.200.0-255,1484,26006,77,417849
28698,0.000933,172.31.40.0-255,66,26072,77,417849
28699,0.000938,74.125.200.0-255,2902,28974,77,417849
28700,0.000941,172.31.40.0-255,66,29040,77,417849
28701,0.000966,74.125.200.0-255,1484,30524,77,417849
28702,0.00097,172.31.40.0-255,66,30590,77,417849
28703,0.001014,74.125.200.0-255,2543,33133,77,417849
28704,0.001017,172.31.40.0-255,66,33199,77,417849
28705,0.00102,74.125.200.0-255,1484,34683,77,417849
28706,0.001022,172.31.40.0-255,66,34749,77,417849
28707,0.001026,74.125.200.0-255,2902,37651,77,417849
28708,0.001033,172.31.40.0-255,66,37717,77,417849
28709,0.001048,74.125.200.0-255,4320,42037,77,417849
28710,0.001051,172.31.40.0-255,66,42103,77,417849
28711,0.001074,74.125.200.0-255,1484,43587,77,417849
28712,0.001081,74.125.200.0-255,5379,48966,77,417849
28713,0.001084,172.31.40.0-255,66,49032,77,417849
28714,0.001209,74.125.200.0-255,1484,50516,77,417849
28715,0.001213,74.125.200.0-255,1484,52000,77,417849
28716,0.001217,172.31.40.0-255,66,52066,77,417849
28717,0.001236,74.125.200.0-255,2902,54968,77,417849
28718,0.001239,172.31.40.0-255,66,55034,77,417849
28719,0.001271,74.125.200.0-255,5738,60772,77,417849
28720,0.001274,172.31.40.0-255,66,60838,77,417849
28721,0.001281,74.125.200.0-255,5379,66217,77,417849
28722,0.001283,172.31.40.0-255,66,66283,77,417849
28723,0.001727,74.125.200.0-255,1484,67767,77,417849
28724,0.001735,74.125.200.0-255,2902,70669,77,417849
28725,0.001739,172.31.40.0-255,66,70735,77,417849
28726,0.001766,74.125.200.0-255,5738,76473,77,417849
28727,0.00177,172.31.40.0-255,66,76539,77,417849
28728,0.001773,74.125.200.0-255,1484,78023,77,417849
28729,0.00179,74.125.200.0-255,2902,80925,77,417849
28730,0.001793,172.31.40.0-255,66,80991,77,417849
28731,0.001834,74.125.200.0-255,5960,86951,77,417849
28732,0.001837,172.31.40.0-255,66,87017,77,417849
28733,0.001886,74.125.200.0-255,7156,94173,77,417849
28734,0.00189,172.31.40.0-255,66,94239,77,417849
28735,0.001893,74.125.200.0-255,1484,95723,77,417849
28736,0.001918,74.125.200.0-255,2902,98625,77,417849
28737,0.00192,172.31.40.0-255,66,98691,77,417849
28738,0.001924,74.125.200.0-255,1484,100175,77,417849
28739,0.001949,74.125.200.0-255,4320,104495,77,417849
28740,0.001952,172.31.40.0-255,66,104561,77,417849
28741,0.001975,74.125.200.0-255,8574,113135,77,417849
28742,0.001977,172.31.40.0-255,66,113201,77,417849
28743,0.002009,74.125.200.0-255,1484,114685,77,417849
28744,0.002037,74.125.200.0-255,3602,118287,77,417849
28745,0.00204,172.31.40.0-255,66,118353,77,417849
28746,0.002046,74.125.200.0-255,4320,122673,77,417849
28747,0.002048,172.31.40.0-255,66,122739,77,417849
28748,0.002056,74.125.200.0-255,1484,124223,77,417849
28749,0.002082,74.125.200.0-255,2902,127125,77,417849
28750,0.002084,172.31.40.0-255,66,127191,77,417849
28751,0.002091,74.125.200.0-255,5738,132929,77,417849
28752,0.002093,172.31.40.0-255,66,132995,77,417849
28753,0.002118,74.125.200.0-255,2543,135538,77,417849
28754,0.00212,172.31.40.0-255,66,135604,77,417849
28755,0.002174,74.125.200.0-255,1484,137088,77,417849
28756,0.002199,74.125.200.0-255,2902,139990,77,417849
28757,0.002203,172.31.40.0-255,66,140056,77,417849
28758,0.00223,74.125.200.0-255,5738,145794,77,417849
28759,0.002233,172.31.40.0-255,66,145860,77,417849
28760,0.002237,74.125.200.0-255,2902,148762,77,417849
28761,0.002239,172.31.40.0-255,66,148828,77,417849
28762,0.002245,74.125.200.0-255,4320,153148,77,417849
28763,0.002247,172.31.40.0-255,66,153214,77,417849
28764,0.002252,74.125.200.0-255,2902,156116,77,417849
28765,0.002254,172.31.40.0-255,66,156182,77,417849
28766,0.002286,74.125.200.0-255,5738,161920,77,417849
28767,0.00229,172.31.40.0-255,66,161986,77,417849
28768,0.002297,74.125.200.0-255,7856,169842,77,417849
28769,0.0023,172.31.40.0-255,66,169908,77,417849
28770,0.00238,74.125.200.0-255,1484,171392,77,417849
28771,0.002384,74.125.200.0-255,1484,172876,77,417849
28772,0.002386,172.31.40.0-255,66,172942,77,417849
28773,0.002411,74.125.200.0-255,1484,174426,77,417849
28774,0.002419,74.125.200.0-255,5738,180164,77,417849
28775,0.002422,172.31.40.0-255,66,180230,77,417849
28776,0.002456,74.125.200.0-255,9992,190222,77,417849
28777,0.002459,172.31.40.0-255,66,190288,77,417849
28778,0.002466,74.125.200.0-255,5738,196026,77,417849
28779,0.002468,172.31.40.0-255,66,196092,77,417849
28780,0.002499,74.125.200.0-255,5738,201830,77,417849
28781,0.002502,172.31.40.0-255,66,201896,77,417849
28782,0.002506,74.125.200.0-255,2184,204080,77,417849
28783,0.002508,172.31.40.0-255,66,204146,77,417849
28784,0.002541,74.125.200.0-255,1484,205630,77,417849
28785,0.002559,74.125.200.0-255,2902,208532,77,417849
28786,0.002562,172.31.40.0-255,66,208598,77,417849
28787,0.002567,74.125.200.0-255,4320,212918,77,417849
28788,0.00257,172.31.40.0-255,66,212984,77,417849
28789,0.002589,74.125.200.0-255,1484,214468,77,417849
28790,0.002595,74.125.200.0-255,4320,218788,77,417849
28791,0.002598,172.31.40.0-255,66,218854,77,417849
28792,0.002625,74.125.200.0-255,5738,224592,77,417849
28793,0.002628,172.31.40.0-255,66,224658,77,417849
28794,0.002672,74.125.200.0-255,1484,226142,77,417849
28795,0.002702,74.125.200.0-255,5738,231880,77,417849
28796,0.002704,172.31.40.0-255,66,231946,77,417849
28797,0.002711,74.125.200.0-255,6438,238384,77,417849
28798,0.002713,172.31.40.0-255,66,238450,77,417849
28799,0.002779,74.125.200.0-255,1484,239934,77,417849
28800,0.002784,74.125.200.0-255,1484,241418,77,417849
28801,0.002786,172.31.40.0-255,66,241484,77,417849
28802,0.002814,74.125.200.0-255,2902,244386,77,417849
28803,0.002816,172.31.40.0-255,66,244452,77,417849
28804,0.002819,74.125.200.0-255,1484,245936,77,417849
28805,0.002847,74.125.200.0-255,4320,250256,77,417849
28806,0.00285,172.31.40.0-255,66,250322,77,417849
28807,0.002861,74.125.200.0-255,4320,254642,77,417849
28808,0.00287,172.31.40.0-255,66,254708,77,417849
28809,0.002876,74.125.200.0-255,5738,260446,77,417849
28810,0.002879,172.31.40.0-255,66,260512,77,417849
28811,0.002904,74.125.200.0-255,4320,264832,77,417849
28812,0.002906,172.31.40.0-255,66,264898,77,417849
28813,0.00291,74.125.200.0-255,1484,266382,77,417849
28814,0.002941,74.125.200.0-255,2902,269284,77,417849
28815,0.002944,172.31.40.0-255,66,269350,77,417849
28816,0.002947,74.125.200.0-255,1484,270834,77,417849
28817,0.00295,74.125.200.0-255,1484,272318,77,417849
28818,0.002952,172.31.40.0-255,66,272384,77,417849
28819,0.002955,74.125.200.0-255,766,273150,77,417849
28820,0.002977,74.125.200.0-255,1484,274634,77,417849
28821,0.00298,172.31.40.0-255,66,274700,77,417849
28822,0.003009,74.125.200.0-255,4320,279020,77,417849
28823,0.003012,172.31.40.0-255,66,279086,77,417849
28824,0.003015,74.125.200.0-255,1484,280570,77,417849
28825,0.003019,74.125.200.0-255,2902,283472,77,417849
28826,0.003022,172.31.40.0-255,66,283538,77,417849
28827,0.003027,74.125.200.0-255,2902,286440,77,417849
28828,0.003029,172.31.40.0-255,66,286506,77,417849
28829,0.003057,74.125.200.0-255,4320,290826,77,417849
28830,0.00306,172.31.40.0-255,66,290892,77,417849
28831,0.003066,74.125.200.0-255,5738,296630,77,417849
28832,0.003068,172.31.40.0-255,66,296696,77,417849
28833,0.003075,74.125.200.0-255,7156,303852,77,417849
28834,0.003078,172.31.40.0-255,66,303918,77,417849
28835,0.003081,74.125.200.0-255,1484,305402,77,417849
28836,0.003085,74.125.200.0-255,2184,307586,77,417849
28837,0.003087,172.31.40.0-255,66,307652,77,417849
28838,0.003553,74.125.200.0-255,1484,309136,77,417849
28839,0.003561,74.125.200.0-255,2902,312038,77,417849
28840,0.003571,74.125.200.0-255,1484,313522,77,417849
28841,0.003587,74.125.200.0-255,4320,317842,77,417849
28842,0.003603,74.125.200.0-255,5738,323580,77,417849
28843,0.003616,74.125.200.0-255,2902,326482,77,417849
28844,0.003622,74.125.200.0-255,5738,332220,77,417849
28845,0.003643,74.125.200.0-255,4320,336540,77,417849
28846,0.003664,74.125.200.0-255,5020,341560,77,417849
28847,0.003733,74.125.200.0-255,1484,343044,77,417849
28848,0.003749,74.125.200.0-255,2902,345946,77,417849
28849,0.003752,74.125.200.0-255,1484,347430,77,417849
28850,0.003763,74.125.200.0-255,1484,348914,77,417849
28851,0.003801,74.125.200.0-255,5738,354652,77,417849
28852,0.003815,74.125.200.0-255,2902,357554,77,417849
28853,0.003819,74.125.200.0-255,2902,360456,77,417849
28854,0.003841,74.125.200.0-255,5738,366194,77,417849
28855,0.003877,74.125.200.0-255,9274,375468,77,417849
28856,0.00466,74.125.200.0-255,1484,376952,77,417849
28857,0.004666,74.125.200.0-255,2902,379854,77,417849
28858,0.00467,74.125.200.0-255,1484,381338,77,417849
28859,0.00469,74.125.200.0-255,4320,385658,77,417849
28860,0.004693,74.125.200.0-255,1484,387142,77,417849
28861,0.004706,74.125.200.0-255,2902,390044,77,417849
28862,0.004723,74.125.200.0-255,1484,391528,77,417849
28863,0.004727,74.125.200.0-255,2902,394430,77,417849
28864,0.004744,74.125.200.0-255,2902,397332,77,417849
28865,0.004747,74.125.200.0-255,1484,398816,77,417849
28866,0.004769,74.125.200.0-255,7156,405972,77,417849
28867,0.004774,74.125.200.0-255,3602,409574,77,417849
28868,0.004842,74.125.200.0-255,5738,415312,77,417849
28869,0.004846,74.125.200.0-255,1915,417227,77,417849
28870,0.004892,74.125.200.0-255,97,417324,77,417849
28871,0.005018,74.125.200.0-255,105,417429,77,417849
28872,0.009957,172.31.40.0-255,66,417495,77,417849
28873,0.011901,74.125.200.0-255,105,417600,77,417849
28874,0.011912,172.31.40.0-255,78,417678,77,417849
28875,0.013339,172.31.40.0-255,105,417783,77,417849
28876,0.01529,74.125.200.0-255,66,417849,77,417849
28877,0.0,74.125.24.0-255,291,291,77,282610
28878,1.3e-05,172.31.40.0-255,66,357,77,282610
28879,1.9e-05,74.125.24.0-255,1484,1841,77,282610
28880,2.3e-05,172.31.40.0-255,66,1907,77,282610
28881,3.9e-05,74.125.24.0-255,4320,6227,77,282610
28882,4.1e-05,172.31.40.0-255,66,6293,77,282610
28883,5e-05,74.125.24.0-255,7450,13743,77,282610
28884,5.4e-05,172.31.40.0-255,66,13809,77,282610
28885,8.3e-05,74.125.24.0-255,4320,18129,77,282610
28886,8.6e-05,172.31.40.0-255,66,18195,77,282610
28887,0.000104,74.125.24.0-255,4320,22515,77,282610
28888,0.000107,172.31.40.0-255,66,22581,77,282610
28889,0.000111,74.125.24.0-255,1484,24065,77,282610
28890,0.000113,172.31.40.0-255,66,24131,77,282610
28891,0.000154,74.125.24.0-255,4320,28451,77,282610
28892,0.000157,172.31.40.0-255,66,28517,77,282610
28893,0.000175,74.125.24.0-255,2543,31060,77,282610
28894,0.000178,172.31.40.0-255,66,31126,77,282610
28895,0.000217,74.125.24.0-255,1484,32610,77,282610
28896,0.00022,172.31.40.0-255,66,32676,77,282610
28897,0.000237,74.125.24.0-255,1484,34160,77,282610
28898,0.000243,172.31.40.0-255,66,34226,77,282610
28899,0.00027,74.125.24.0-255,1484,35710,77,282610
28900,0.000273,172.31.40.0-255,66,35776,77,282610
28901,0.00028,74.125.24.0-255,5738,41514,77,282610
28902,0.000282,172.31.40.0-255,66,41580,77,282610
28903,0.000309,74.125.24.0-255,4320,45900,77,282610
28904,0.000312,172.31.40.0-255,66,45966,77,282610
28905,0.000336,74.125.24.0-255,2543,48509,77,282610
28906,0.000339,172.31.40.0-255,66,48575,77,282610
28907,0.000594,74.125.24.0-255,1484,50059,77,282610
28908,0.000601,172.31.40.0-255,66,50125,77,282610
28909,0.000615,74.125.24.0-255,2902,53027,77,282610
28910,0.000619,172.31.40.0-255,66,53093,77,282610
28911,0.000629,74.125.24.0-255,5738,58831,77,282610
28912,0.000632,172.31.40.0-255,66,58897,77,282610
28913,0.000659,74.125.24.0-255,5738,64635,77,282610
28914,0.000662,172.31.40.0-255,66,64701,77,282610
28915,0.000687,74.125.24.0-255,1705,66406,77,282610
28916,0.00069,172.31.40.0-255,66,66472,77,282610
28917,0.000776,74.125.24.0-255,1484,67956,77,282610
28918,0.000781,74.125.24.0-255,1484,69440,77,282610
28919,0.000784,172.31.40.0-255,66,69506,77,282610
28920,0.000796,74.125.24.0-255,1484,70990,77,282610
28921,0.000805,74.125.24.0-255,2902,73892,77,282610
28922,0.000808,172.31.40.0-255,66,73958,77,282610
28923,0.000821,74.125.24.0-255,2902,76860,77,282610
28924,0.000829,172.31.40.0-255,66,76926,77,282610
28925,0.000833,74.125.24.0-255,2902,79828,77,282610
28926,0.000836,172.31.40.0-255,66,79894,77,282610
28927,0.000907,74.125.24.0-255,11051,90945,77,282610
28928,0.000911,172.31.40.0-255,66,91011,77,282610
28929,0.00092,74.125.24.0-255,7156,98167,77,282610
28930,0.000922,172.31.40.0-255,66,98233,77,282610
28931,0.000926,74.125.24.0-255,2543,100776,77,282610
28932,0.000929,172.31.40.0-255,66,100842,77,282610
28933,0.00117,74.125.24.0-255,1484,102326,77,282610
28934,0.001184,74.125.24.0-255,2902,105228,77,282610
28935,0.001188,172.31.40.0-255,66,105294,77,282610
28936,0.001223,74.125.24.0-255,5738,111032,77,282610
28937,0.001226,172.31.40.0-255,66,111098,77,282610
28938,0.001236,74.125.24.0-255,9992,121090,77,282610
28939,0.001238,172.31.40.0-255,66,121156,77,282610
28940,0.00126,74.125.24.0-255,4320,125476,77,282610
28941,0.001263,172.31.40.0-255,66,125542,77,282610
28942,0.001302,74.125.24.0-255,9274,134816,77,282610
28943,0.001305,172.31.40.0-255,66,134882,77,282610
28944,0.001327,74.125.24.0-255,1484,136366,77,282610
28945,0.001349,74.125.24.0-255,2902,139268,77,282610
28946,0.001352,172.31.40.0-255,66,139334,77,282610
28947,0.001358,74.125.24.0-255,4320,143654,77,282610
28948,0.00136,172.31.40.0-255,66,143720,77,282610
28949,0.00139,74.125.24.0-255,1484,145204,77,282610
28950,0.001405,74.125.24.0-255,12828,158032,77,282610
28951,0.001409,172.31.40.0-255,66,158098,77,282610
28952,0.001415,74.125.24.0-255,5738,163836,77,282610
28953,0.001417,172.31.40.0-255,66,163902,77,282610
28954,0.001421,74.125.24.0-255,1484,165386,77,282610
28955,0.001448,74.125.24.0-255,3602,168988,77,282610
28956,0.001456,172.31.40.0-255,66,169054,77,282610
28957,0.001483,74.125.24.0-255,1484,170538,77,282610
28958,0.001488,74.125.24.0-255,2902,173440,77,282610
28959,0.001492,172.31.40.0-255,66,173506,77,282610
28960,0.001497,74.125.24.0-255,4320,177826,77,282610
28961,0.0015,172.31.40.0-255,66,177892,77,282610
28962,0.001528,74.125.24.0-255,1484,179376,77,282610
28963,0.001535,74.125.24.0-255,7156,186532,77,282610
28964,0.001543,74.125.24.0-255,8574,195106,77,282610
28965,0.001549,172.31.40.0-255,66,195172,77,282610
28966,0.001552,172.31.40.0-255,66,195238,77,282610
28967,0.001578,74.125.24.0-255,5738,200976,77,282610
28968,0.001581,172.31.40.0-255,66,201042,77,282610
28969,0.001585,74.125.24.0-255,2184,203226,77,282610
28970,0.001587,172.31.40.0-255,66,203292,77,282610
28971,0.00169,74.125.24.0-255,1484,204776,77,282610
28972,0.001696,74.125.24.0-255,2902,207678,77,282610
28973,0.0017,172.31.40.0-255,66,207744,77,282610
28974,0.001731,74.125.24.0-255,5738,213482,77,282610
28975,0.001734,172.31.40.0-255,66,213548,77,282610
28976,0.001739,74.125.24.0-255,2902,216450,77,282610
28977,0.001741,172.31.40.0-255,66,216516,77,282610
28978,0.001771,74.125.24.0-255,9992,226508,77,282610
28979,0.001775,172.31.40.0-255,66,226574,77,282610
28980,0.001801,74.125.24.0-255,7156,233730,77,282610
28981,0.001803,172.31.40.0-255,66,233796,77,282610
28982,0.001827,74.125.24.0-255,3602,237398,77,282610
28983,0.00183,172.31.40.0-255,66,237464,77,282610
28984,0.00384,74.125.24.0-255,1484,238948,77,282610
28985,0.003866,74.125.24.0-255,4320,243268,77,282610
28986,0.003872,172.31.40.0-255,66,243334,77,282610
28987,0.005888,74.125.24.0-255,5738,249072,77,282610
28988,0.005896,172.31.40.0-255,66,249138,77,282610
28989,0.00792,74.125.24.0-255,5738,254876,77,282610
28990,0.007926,172.31.40.0-255,66,254942,77,282610
28991,0.009964,74.125.24.0-255,5738,260680,77,282610
28992,0.00998,172.31.40.0-255,66,260746,77,282610
28993,0.012063,74.125.24.0-255,5738,266484,77,282610
28994,0.012075,172.31.40.0-255,66,266550,77,282610
28995,0.014081,74.125.24.0-255,5738,272288,77,282610
28996,0.014092,172.31.40.0-255,66,272354,77,282610
28997,0.016117,74.125.24.0-255,4320,276674,77,282610
28998,0.016123,172.31.40.0-255,66,276740,77,282610
28999,0.016144,74.125.24.0-255,1484,278224,77,282610
29000,0.018158,74.125.24.0-255,4320,282544,77,282610
29001,0.018162,172.31.40.0-255,66,282610,77,282610
29002,0.0,172.217.194.0-255,155,155,77,238595
29003,1.8e-05,172.31.40.0-255,66,221,77,238595
29004,2.5e-05,172.217.194.0-255,1484,1705,77,238595
29005,3e-05,172.31.40.0-255,66,1771,77,238595
29006,3.6e-05,172.217.194.0-255,2902,4673,77,238595
29007,4.1e-05,172.31.40.0-255,66,4739,77,238595
29008,4.9e-05,172.217.194.0-255,7156,11895,77,238595
29009,5.1e-05,172.31.40.0-255,66,11961,77,238595
29010,5.5e-05,172.217.194.0-255,2067,14028,77,238595
29011,5.8e-05,172.31.40.0-255,66,14094,77,238595
29012,0.000244,172.217.194.0-255,1484,15578,77,238595
29013,0.000249,172.31.40.0-255,66,15644,77,238595
29014,0.000255,172.217.194.0-255,2902,18546,77,238595
29015,0.000258,172.31.40.0-255,66,18612,77,238595
29016,0.000288,172.217.194.0-255,1484,20096,77,238595
29017,0.00029,172.31.40.0-255,66,20162,77,238595
29018,0.000322,172.217.194.0-255,4320,24482,77,238595
29019,0.000325,172.31.40.0-255,66,24548,77,238595
29020,0.000332,172.217.194.0-255,6797,31345,77,238595
29021,0.000335,172.31.40.0-255,66,31411,77,238595
29022,0.000341,172.217.194.0-255,7156,38567,77,238595
29023,0.000344,172.31.40.0-255,66,38633,77,238595
29024,0.000354,172.217.194.0-255,9633,48266,77,238595
29025,0.000357,172.31.40.0-255,66,48332,77,238595
29026,0.00039,172.217.194.0-255,1484,49816,77,238595
29027,0.000393,172.31.40.0-255,66,49882,77,238595
29028,0.000397,172.217.194.0-255,2902,52784,77,238595
29029,0.000399,172.31.40.0-255,66,52850,77,238595
29030,0.000427,172.217.194.0-255,5738,58588,77,238595
29031,0.00043,172.31.40.0-255,66,58654,77,238595
29032,0.000445,172.217.194.0-255,2902,61556,77,238595
29033,0.000448,172.31.40.0-255,66,61622,77,238595
29034,0.000472,172.217.194.0-255,4255,65877,77,238595
29035,0.0005,172.31.40.0-255,66,65943,77,238595
29036,0.000836,172.217.194.0-255,382,66325,77,238595
29037,0.001042,172.31.40.0-255,66,66391,77,238595
29038,0.00109,172.217.194.0-255,1484,67875,77,238595
29039,0.001094,172.217.194.0-255,1484,69359,77,238595
29040,0.001096,172.31.40.0-255,66,69425,77,238595
29041,0.001117,172.217.194.0-255,1484,70909,77,238595
29042,0.001123,172.217.194.0-255,4320,75229,77,238595
29043,0.001125,172.31.40.0-255,66,75295,77,238595
29044,0.001133,172.217.194.0-255,8574,83869,77,238595
29045,0.001136,172.31.40.0-255,66,83935,77,238595
29046,0.00117,172.217.194.0-255,4320,88255,77,238595
29047,0.001173,172.31.40.0-255,66,88321,77,238595
29048,0.001197,172.217.194.0-255,12110,100431,77,238595
29049,0.001217,172.31.40.0-255,66,100497,77,238595
29050,0.001704,172.217.194.0-255,1484,101981,77,238595
29051,0.001713,172.217.194.0-255,2902,104883,77,238595
29052,0.001717,172.31.40.0-255,66,104949,77,238595
29053,0.001723,172.217.194.0-255,2902,107851,77,238595
29054,0.001725,172.31.40.0-255,66,107917,77,238595
29055,0.001743,172.217.194.0-255,2902,110819,77,238595
29056,0.001745,172.31.40.0-255,66,110885,77,238595
29057,0.001753,172.217.194.0-255,7156,118041,77,238595
29058,0.001755,172.31.40.0-255,66,118107,77,238595
29059,0.001784,172.217.194.0-255,5738,123845,77,238595
29060,0.001787,172.31.40.0-255,66,123911,77,238595
29061,0.001797,172.217.194.0-255,10692,134603,77,238595
29062,0.002119,172.217.194.0-255,1484,136087,77,238595
29063,0.002127,172.217.194.0-255,2902,138989,77,238595
29064,0.002132,172.217.194.0-255,2902,141891,77,238595
29065,0.00215,172.217.194.0-255,2902,144793,77,238595
29066,0.002155,172.217.194.0-255,4320,149113,77,238595
29067,0.002184,172.217.194.0-255,8574,157687,77,238595
29068,0.002193,172.217.194.0-255,10692,168379,77,238595
29069,0.002263,172.217.194.0-255,1484,169863,77,238595
29070,0.002268,172.217.194.0-255,2902,172765,77,238595
29071,0.002271,172.217.194.0-255,1484,174249,77,238595
29072,0.002303,172.217.194.0-255,5738,179987,77,238595
29073,0.002309,172.217.194.0-255,2902,182889,77,238595
29074,0.002333,172.217.194.0-255,9992,192881,77,238595
29075,0.002338,172.217.194.0-255,4320,197201,77,238595
29076,0.002354,172.217.194.0-255,5020,202221,77,238595
29077,0.002615,172.217.194.0-255,1484,203705,77,238595
29078,0.002622,172.217.194.0-255,2902,206607,77,238595
29079,0.002637,172.217.194.0-255,2902,209509,77,238595
29080,0.002649,172.217.194.0-255,2902,212411,77,238595
29081,0.002655,172.217.194.0-255,4320,216731,77,238595
29082,0.002674,172.217.194.0-255,2902,219633,77,238595
29083,0.002676,172.217.194.0-255,1484,221117,77,238595
29084,0.009751,172.31.40.0-255,66,221183,77,238595
29085,0.012398,172.217.194.0-255,5738,226921,77,238595
29086,0.012409,172.31.40.0-255,66,226987,77,238595
29087,0.014991,172.217.194.0-255,5738,232725,77,238595
29088,0.015007,172.31.40.0-255,66,232791,77,238595
29089,0.017588,172.217.194.0-255,5738,238529,77,238595
29090,0.017595,172.31.40.0-255,66,238595,77,238595
29091,0.0,74.125.24.0-255,153,153,77,261574
29092,2.4e-05,172.31.40.0-255,66,219,77,261574
29093,3.1e-05,74.125.24.0-255,1484,1703,77,261574
29094,3.6e-05,172.31.40.0-255,66,1769,77,261574
29095,4.2e-05,74.125.24.0-255,2902,4671,77,261574
29096,5.3e-05,172.31.40.0-255,66,4737,77,261574
29097,6.1e-05,74.125.24.0-255,7156,11893,77,261574
29098,6.4e-05,172.31.40.0-255,66,11959,77,261574
29099,7.3e-05,74.125.24.0-255,7613,19572,77,261574
29100,7.6e-05,172.31.40.0-255,66,19638,77,261574
29101,9e-05,74.125.24.0-255,2902,22540,77,261574
29102,9.2e-05,172.31.40.0-255,66,22606,77,261574
29103,0.000141,172.31.40.0-255,66,22672,77,261574
29104,0.000151,74.125.24.0-255,9992,32664,77,261574
29105,0.000154,172.31.40.0-255,66,32730,77,261574
29106,0.000192,74.125.24.0-255,7856,40586,77,261574
29107,0.000195,172.31.40.0-255,66,40652,77,261574
29108,0.000204,74.125.24.0-255,8574,49226,77,261574
29109,0.000206,172.31.40.0-255,66,49292,77,261574
29110,0.000209,74.125.24.0-255,1438,50730,77,261574
29111,0.000211,172.31.40.0-255,66,50796,77,261574
29112,0.000457,74.125.24.0-255,343,51139,77,261574
29113,0.000462,172.31.40.0-255,66,51205,77,261574
29114,0.000615,74.125.24.0-255,1484,52689,77,261574
29115,0.000619,172.31.40.0-255,66,52755,77,261574
29116,0.000624,74.125.24.0-255,2902,55657,77,261574
29117,0.000627,172.31.40.0-255,66,55723,77,261574
29118,0.000632,74.125.24.0-255,2902,58625,77,261574
29119,0.000639,172.31.40.0-255,66,58691,77,261574
29120,0.000667,74.125.24.0-255,2902,61593,77,261574
29121,0.00067,172.31.40.0-255,66,61659,77,261574
29122,0.000676,74.125.24.0-255,5738,67397,77,261574
29123,0.000679,172.31.40.0-255,66,67463,77,261574
29124,0.000683,74.125.24.0-255,2902,70365,77,261574
29125,0.000685,172.31.40.0-255,66,70431,77,261574
29126,0.000733,74.125.24.0-255,9992,80423,77,261574
29127,0.000737,172.31.40.0-255,66,80489,77,261574
29128,0.000743,74.125.24.0-255,5020,85509,77,261574
29129,0.000745,172.31.40.0-255,66,85575,77,261574
29130,0.001194,74.125.24.0-255,1484,87059,77,261574
29131,0.001201,74.125.24.0-255,2902,89961,77,261574
29132,0.001205,172.31.40.0-255,66,90027,77,261574
29133,0.00121,74.125.24.0-255,2902,92929,77,261574
29134,0.001212,172.31.40.0-255,66,92995,77,261574
29135,0.001238,74.125.24.0-255,2902,95897,77,261574
29136,0.00124,172.31.40.0-255,66,95963,77,261574
29137,0.001251,74.125.24.0-255,12828,108791,77,261574
29138,0.001253,172.31.40.0-255,66,108857,77,261574
29139,0.001288,74.125.24.0-255,2902,111759,77,261574
29140,0.00129,172.31.40.0-255,66,111825,77,261574
29141,0.001323,74.125.24.0-255,7856,119681,77,261574
29142,0.001326,172.31.40.0-255,66,119747,77,261574
29143,0.001371,74.125.24.0-255,1484,121231,77,261574
29144,0.001385,74.125.24.0-255,2902,124133,77,261574
29145,0.001387,172.31.40.0-255,66,124199,77,261574
29146,0.00142,74.125.24.0-255,5738,129937,77,261574
29147,0.001423,172.31.40.0-255,66,130003,77,261574
29148,0.001427,74.125.24.0-255,2902,132905,77,261574
29149,0.001429,172.31.40.0-255,66,132971,77,261574
29150,0.001436,74.125.24.0-255,7156,140127,77,261574
29151,0.001439,172.31.40.0-255,66,140193,77,261574
29152,0.00146,74.125.24.0-255,2902,143095,77,261574
29153,0.001462,172.31.40.0-255,66,143161,77,261574
29154,0.001471,74.125.24.0-255,9992,153153,77,261574
29155,0.001473,172.31.40.0-255,66,153219,77,261574
29156,0.001498,74.125.24.0-255,766,153985,77,261574
29157,0.001554,74.125.24.0-255,1484,155469,77,261574
29158,0.001558,172.31.40.0-255,66,155535,77,261574
29159,0.001596,74.125.24.0-255,2902,158437,77,261574
29160,0.001599,172.31.40.0-255,66,158503,77,261574
29161,0.001607,74.125.24.0-255,5738,164241,77,261574
29162,0.001609,172.31.40.0-255,66,164307,77,261574
29163,0.001615,74.125.24.0-255,7156,171463,77,261574
29164,0.001618,172.31.40.0-255,66,171529,77,261574
29165,0.001654,74.125.24.0-255,5738,177267,77,261574
29166,0.001658,172.31.40.0-255,66,177333,77,261574
29167,0.001664,74.125.24.0-255,7156,184489,77,261574
29168,0.00167,74.125.24.0-255,3602,188091,77,261574
29169,0.001695,172.31.40.0-255,66,188157,77,261574
29170,0.001925,172.31.40.0-255,101,188258,77,261574
29171,0.002039,74.125.24.0-255,1484,189742,77,261574
29172,0.002056,74.125.24.0-255,2902,192644,77,261574
29173,0.00206,172.31.40.0-255,66,192710,77,261574
29174,0.002085,74.125.24.0-255,5738,198448,77,261574
29175,0.002088,172.31.40.0-255,66,198514,77,261574
29176,0.002092,74.125.24.0-255,1484,199998,77,261574
29177,0.002122,74.125.24.0-255,8574,208572,77,261574
29178,0.002124,172.31.40.0-255,66,208638,77,261574
29179,0.002159,74.125.24.0-255,13528,222166,77,261574
29180,0.002179,172.31.40.0-255,66,222232,77,261574
29181,0.004209,74.125.24.0-255,66,222298,77,261574
29182,0.004451,74.125.24.0-255,4320,226618,77,261574
29183,0.004456,172.31.40.0-255,66,226684,77,261574
29184,0.004483,74.125.24.0-255,1484,228168,77,261574
29185,0.006744,74.125.24.0-255,4320,232488,77,261574
29186,0.006748,172.31.40.0-255,66,232554,77,261574
29187,0.009052,74.125.24.0-255,5738,238292,77,261574
29188,0.009058,172.31.40.0-255,66,238358,77,261574
29189,0.011381,74.125.24.0-255,5738,244096,77,261574
29190,0.011389,172.31.40.0-255,66,244162,77,261574
29191,0.013717,74.125.24.0-255,5738,249900,77,261574
29192,0.013736,172.31.40.0-255,66,249966,77,261574
29193,0.016057,74.125.24.0-255,5738,255704,77,261574
29194,0.01607,172.31.40.0-255,66,255770,77,261574
29195,0.018363,74.125.24.0-255,5738,261508,77,261574
29196,0.018374,172.31.40.0-255,66,261574,77,261574
29197,0.0,74.125.130.0-255,298,298,77,145491
29198,2.1e-05,172.31.40.0-255,66,364,77,145491
29199,2.8e-05,74.125.130.0-255,1484,1848,77,145491
29200,3.2e-05,172.31.40.0-255,66,1914,77,145491
29201,3.8e-05,74.125.130.0-255,4320,6234,77,145491
29202,4.1e-05,172.31.40.0-255,66,6300,77,145491
29203,5.3e-05,74.125.130.0-255,4320,10620,77,145491
29204,5.7e-05,172.31.40.0-255,66,10686,77,145491
29205,7.7e-05,74.125.130.0-255,2902,13588,77,145491
29206,8e-05,172.31.40.0-255,66,13654,77,145491
29207,0.000111,74.125.130.0-255,1805,15459,77,145491
29208,0.000113,172.31.40.0-255,66,15525,77,145491
29209,0.000121,74.125.130.0-255,8574,24099,77,145491
29210,0.000123,172.31.40.0-255,66,24165,77,145491
29211,0.000156,74.125.130.0-255,6797,30962,77,145491
29212,0.000159,172.31.40.0-255,66,31028,77,145491
29213,0.000246,74.125.130.0-255,1484,32512,77,145491
29214,0.000249,172.31.40.0-255,66,32578,77,145491
29215,0.000254,74.125.130.0-255,2902,35480,77,145491
29216,0.000256,172.31.40.0-255,66,35546,77,145491
29217,0.000289,74.125.130.0-255,5738,41284,77,145491
29218,0.000293,172.31.40.0-255,66,41350,77,145491
29219,0.000324,74.125.130.0-255,8574,49924,77,145491
29220,0.000326,172.31.40.0-255,66,49990,77,145491
29221,0.000354,74.125.130.0-255,4320,54310,77,145491
29222,0.000356,172.31.40.0-255,66,54376,77,145491
29223,0.000385,74.125.130.0-255,5738,60114,77,145491
29224,0.000388,172.31.40.0-255,66,60180,77,145491
29225,0.000413,74.125.130.0-255,5331,65511,77,145491
29226,0.000415,172.31.40.0-255,66,65577,77,145491
29227,0.000459,74.125.130.0-255,99,65676,77,145491
29228,0.000462,172.31.40.0-255,66,65742,77,145491
29229,0.000665,74.125.130.0-255,1484,67226,77,145491
29230,0.00069,74.125.130.0-255,2902,70128,77,145491
29231,0.000693,172.31.40.0-255,66,70194,77,145491
29232,0.0007,74.125.130.0-255,5738,75932,77,145491
29233,0.000702,172.31.40.0-255,66,75998,77,145491
29234,0.000705,74.125.130.0-255,1484,77482,77,145491
29235,0.00072,74.125.130.0-255,1484,78966,77,145491
29236,0.000722,172.31.40.0-255,66,79032,77,145491
29237,0.000751,74.125.130.0-255,4320,83352,77,145491
29238,0.000753,172.31.40.0-255,66,83418,77,145491
29239,0.000761,74.125.130.0-255,8574,91992,77,145491
29240,0.000763,172.31.40.0-255,66,92058,77,145491
29241,0.000771,74.125.130.0-255,2902,94960,77,145491
29242,0.000773,172.31.40.0-255,66,95026,77,145491
29243,0.000809,74.125.130.0-255,4320,99346,77,145491
29244,0.000812,172.31.40.0-255,66,99412,77,145491
29245,0.000835,74.125.130.0-255,766,100178,77,145491
29246,0.001281,172.31.40.0-255,66,100244,77,145491
29247,0.003041,74.125.130.0-255,4320,104564,77,145491
29248,0.003047,172.31.40.0-255,66,104630,77,145491
29249,0.003493,74.125.130.0-255,1484,106114,77,145491
29250,0.005281,74.125.130.0-255,4320,110434,77,145491
29251,0.005285,172.31.40.0-255,66,110500,77,145491
29252,0.007524,74.125.130.0-255,5738,116238,77,145491
29253,0.007531,172.31.40.0-255,66,116304,77,145491
29254,0.009793,74.125.130.0-255,5738,122042,77,145491
29255,0.009801,172.31.40.0-255,66,122108,77,145491
29256,0.01062,172.31.40.0-255,101,122209,77,145491
29257,0.012055,74.125.130.0-255,5738,127947,77,145491
29258,0.012063,172.31.40.0-255,66,128013,77,145491
29259,0.012825,74.125.130.0-255,66,128079,77,145491
29260,0.014313,74.125.130.0-255,5738,133817,77,145491
29261,0.01432,172.31.40.0-255,66,133883,77,145491
29262,0.016555,74.125.130.0-255,5738,139621,77,145491
29263,0.016561,172.31.40.0-255,66,139687,77,145491
29264,0.018803,74.125.130.0-255,5738,145425,77,145491
29265,0.018811,172.31.40.0-255,66,145491,77,145491
29266,0.0,172.217.27.0-255,146,146,77,165520
29267,2.1e-05,172.31.40.0-255,66,212,77,165520
29268,2.8e-05,172.217.27.0-255,1484,1696,77,165520
29269,3.2e-05,172.31.40.0-255,66,1762,77,165520
29270,3.7e-05,172.217.27.0-255,2902,4664,77,165520
29271,3.9e-05,172.31.40.0-255,66,4730,77,165520
29272,4.5e-05,172.217.27.0-255,5738,10468,77,165520
29273,4.8e-05,172.31.40.0-255,66,10534,77,165520
29274,6.8e-05,172.217.27.0-255,3556,14090,77,165520
29275,7e-05,172.31.40.0-255,66,14156,77,165520
29276,0.000113,172.217.27.0-255,1484,15640,77,165520
29277,0.000116,172.31.40.0-255,66,15706,77,165520
29278,0.000127,172.217.27.0-255,2902,18608,77,165520
29279,0.00013,172.31.40.0-255,66,18674,77,165520
29280,0.000132,172.217.27.0-255,1484,20158,77,165520
29281,0.000134,172.31.40.0-255,66,20224,77,165520
29282,0.000154,172.217.27.0-255,4320,24544,77,165520
29283,0.000156,172.217.27.0-255,1484,26028,77,165520
29284,0.00016,172.31.40.0-255,66,26094,77,165520
29285,0.000162,172.31.40.0-255,66,26160,77,165520
29286,0.000181,172.217.27.0-255,5379,31539,77,165520
29287,0.000183,172.31.40.0-255,66,31605,77,165520
29288,0.00031,172.217.27.0-255,1484,33089,77,165520
29289,0.000313,172.31.40.0-255,66,33155,77,165520
29290,0.000318,172.217.27.0-255,2902,36057,77,165520
29291,0.00032,172.31.40.0-255,66,36123,77,165520
29292,0.000344,172.217.27.0-255,1484,37607,77,165520
29293,0.000346,172.31.40.0-255,66,37673,77,165520
29294,0.000365,172.217.27.0-255,2902,40575,77,165520
29295,0.000368,172.31.40.0-255,66,40641,77,165520
29296,0.000371,172.217.27.0-255,1484,42125,77,165520
29297,0.000372,172.31.40.0-255,66,42191,77,165520
29298,0.000388,172.217.27.0-255,2902,45093,77,165520
29299,0.00039,172.31.40.0-255,66,45159,77,165520
29300,0.000396,172.217.27.0-255,4320,49479,77,165520
29301,0.000397,172.31.40.0-255,66,49545,77,165520
29302,0.000411,172.217.27.0-255,5379,54924,77,165520
29303,0.000413,172.31.40.0-255,66,54990,77,165520
29304,0.000455,172.217.27.0-255,8574,63564,77,165520
29305,0.000458,172.31.40.0-255,66,63630,77,165520
29306,0.00051,172.217.27.0-255,2813,66443,77,165520
29307,0.000513,172.31.40.0-255,66,66509,77,165520
29308,0.000748,172.217.27.0-255,137,66646,77,165520
29309,0.000845,172.217.27.0-255,1484,68130,77,165520
29310,0.000849,172.31.40.0-255,66,68196,77,165520
29311,0.000854,172.217.27.0-255,2902,71098,77,165520
29312,0.000856,172.31.40.0-255,66,71164,77,165520
29313,0.000871,172.217.27.0-255,4320,75484,77,165520
29314,0.000874,172.31.40.0-255,66,75550,77,165520
29315,0.000885,172.217.27.0-255,4320,79870,77,165520
29316,0.000887,172.31.40.0-255,66,79936,77,165520
29317,0.000898,172.217.27.0-255,1484,81420,77,165520
29318,0.000925,172.217.27.0-255,2543,83963,77,165520
29319,0.000928,172.31.40.0-255,66,84029,77,165520
29320,0.000947,172.217.27.0-255,2902,86931,77,165520
29321,0.000949,172.31.40.0-255,66,86997,77,165520
29322,0.000952,172.217.27.0-255,1484,88481,77,165520
29323,0.000975,172.217.27.0-255,5738,94219,77,165520
29324,0.000978,172.31.40.0-255,66,94285,77,165520
29325,0.001004,172.217.27.0-255,4320,98605,77,165520
29326,0.001007,172.31.40.0-255,66,98671,77,165520
29327,0.001023,172.217.27.0-255,2543,101214,77,165520
29328,0.001026,172.31.40.0-255,66,101280,77,165520
29329,0.002635,172.217.27.0-255,2902,104182,77,165520
29330,0.002642,172.31.40.0-255,66,104248,77,165520
29331,0.002666,172.217.27.0-255,2902,107150,77,165520
29332,0.002669,172.31.40.0-255,66,107216,77,165520
29333,0.004267,172.217.27.0-255,2902,110118,77,165520
29334,0.00427,172.31.40.0-255,66,110184,77,165520
29335,0.00429,172.217.27.0-255,2902,113086,77,165520
29336,0.004292,172.31.40.0-255,66,113152,77,165520
29337,0.005904,172.217.27.0-255,2902,116054,77,165520
29338,0.005911,172.31.40.0-255,66,116120,77,165520
29339,0.005925,172.217.27.0-255,2902,119022,77,165520
29340,0.005928,172.31.40.0-255,66,119088,77,165520
29341,0.007548,172.217.27.0-255,5738,124826,77,165520
29342,0.007555,172.31.40.0-255,66,124892,77,165520
29343,0.009196,172.217.27.0-255,5738,130630,77,165520
29344,0.009203,172.31.40.0-255,66,130696,77,165520
29345,0.010877,172.217.27.0-255,5738,136434,77,165520
29346,0.010886,172.31.40.0-255,66,136500,77,165520
29347,0.012542,172.217.27.0-255,5738,142238,77,165520
29348,0.012549,172.31.40.0-255,66,142304,77,165520
29349,0.01419,172.217.27.0-255,5738,148042,77,165520
29350,0.014198,172.31.40.0-255,66,148108,77,165520
29351,0.015845,172.217.27.0-255,5738,153846,77,165520
29352,0.015853,172.31.40.0-255,66,153912,77,165520
29353,0.017502,172.217.27.0-255,5738,159650,77,165520
29354,0.017513,172.31.40.0-255,66,159716,77,165520
29355,0.019158,172.217.27.0-255,5738,165454,77,165520
29356,0.019166,172.31.40.0-255,66,165520,77,165520
29357,0.0,74.125.130.0-255,150,150,77,261722
29358,2.2e-05,172.31.40.0-255,66,216,77,261722
29359,2.9e-05,74.125.130.0-255,1484,1700,77,261722
29360,3.3e-05,172.31.40.0-255,66,1766,77,261722
29361,6.2e-05,74.125.130.0-255,2902,4668,77,261722
29362,6.6e-05,172.31.40.0-255,66,4734,77,261722
29363,7.2e-05,74.125.130.0-255,5738,10472,77,261722
29364,7.6e-05,172.31.40.0-255,66,10538,77,261722
29365,9.5e-05,74.125.130.0-255,1484,12022,77,261722
29366,9.7e-05,172.31.40.0-255,66,12088,77,261722
29367,0.000119,74.125.130.0-255,2020,14108,77,261722
29368,0.000122,172.31.40.0-255,66,14174,77,261722
29369,0.000134,74.125.130.0-255,1484,15658,77,261722
29370,0.000137,172.31.40.0-255,66,15724,77,261722
29371,0.00015,74.125.130.0-255,1484,17208,77,261722
29372,0.000153,172.31.40.0-255,66,17274,77,261722
29373,0.000172,74.125.130.0-255,1484,18758,77,261722
29374,0.000175,172.31.40.0-255,66,18824,77,261722
29375,0.000196,74.125.130.0-255,5738,24562,77,261722
29376,0.000199,172.31.40.0-255,66,24628,77,261722
29377,0.000241,74.125.130.0-255,6797,31425,77,261722
29378,0.000244,172.31.40.0-255,66,31491,77,261722
29379,0.000469,74.125.130.0-255,1484,32975,77,261722
29380,0.000473,172.31.40.0-255,66,33041,77,261722
29381,0.000477,74.125.130.0-255,1484,34525,77,261722
29382,0.00048,172.31.40.0-255,66,34591,77,261722
29383,0.000496,74.125.130.0-255,2902,37493,77,261722
29384,0.000499,172.31.40.0-255,66,37559,77,261722
29385,0.000531,74.125.130.0-255,5738,43297,77,261722
29386,0.000535,172.31.40.0-255,66,43363,77,261722
29387,0.000539,74.125.130.0-255,1484,44847,77,261722
29388,0.000541,172.31.40.0-255,66,44913,77,261722
29389,0.000545,74.125.130.0-255,2902,47815,77,261722
29390,0.000549,172.31.40.0-255,66,47881,77,261722
29391,0.000588,74.125.130.0-255,2902,50783,77,261722
29392,0.000592,172.31.40.0-255,66,50849,77,261722
29393,0.000607,74.125.130.0-255,3961,54810,77,261722
29394,0.00061,172.31.40.0-255,66,54876,77,261722
29395,0.000616,74.125.130.0-255,5738,60614,77,261722
29396,0.000619,172.31.40.0-255,66,60680,77,261722
29397,0.000637,74.125.130.0-255,1484,62164,77,261722
29398,0.000642,74.125.130.0-255,2902,65066,77,261722
29399,0.000644,172.31.40.0-255,66,65132,77,261722
29400,0.000681,74.125.130.0-255,1383,66515,77,261722
29401,0.000718,74.125.130.0-255,115,66630,77,261722
29402,0.000856,74.125.130.0-255,1484,68114,77,261722
29403,0.00086,172.31.40.0-255,66,68180,77,261722
29404,0.000864,74.125.130.0-255,1484,69664,77,261722
29405,0.000879,74.125.130.0-255,1484,71148,77,261722
29406,0.000881,172.31.40.0-255,66,71214,77,261722
29407,0.000886,74.125.130.0-255,2902,74116,77,261722
29408,0.000888,172.31.40.0-255,66,74182,77,261722
29409,0.000901,74.125.130.0-255,1484,75666,77,261722
29410,0.000917,74.125.130.0-255,2902,78568,77,261722
29411,0.000919,172.31.40.0-255,66,78634,77,261722
29412,0.000937,74.125.130.0-255,5738,84372,77,261722
29413,0.00094,172.31.40.0-255,66,84438,77,261722
29414,0.000956,74.125.130.0-255,1484,85922,77,261722
29415,0.000975,74.125.130.0-255,8574,94496,77,261722
29416,0.000978,172.31.40.0-255,66,94562,77,261722
29417,0.000981,74.125.130.0-255,1484,96046,77,261722
29418,0.000998,74.125.130.0-255,2902,98948,77,261722
29419,0.001,172.31.40.0-255,66,99014,77,261722
29420,0.001038,74.125.130.0-255,2184,101198,77,261722
29421,0.001043,172.31.40.0-255,66,101264,77,261722
29422,0.001153,74.125.130.0-255,1484,102748,77,261722
29423,0.001165,74.125.130.0-255,1484,104232,77,261722
29424,0.001168,172.31.40.0-255,66,104298,77,261722
29425,0.001185,74.125.130.0-255,1484,105782,77,261722
29426,0.00119,74.125.130.0-255,2902,108684,77,261722
29427,0.001192,172.31.40.0-255,66,108750,77,261722
29428,0.00121,74.125.130.0-255,4320,113070,77,261722
29429,0.001212,172.31.40.0-255,66,113136,77,261722
29430,0.001244,74.125.130.0-255,5738,118874,77,261722
29431,0.001247,172.31.40.0-255,66,118940,77,261722
29432,0.001265,74.125.130.0-255,2902,121842,77,261722
29433,0.001268,172.31.40.0-255,66,121908,77,261722
29434,0.001272,74.125.130.0-255,2902,124810,77,261722
29435,0.001274,172.31.40.0-255,66,124876,77,261722
29436,0.001292,74.125.130.0-255,7156,132032,77,261722
29437,0.001295,172.31.40.0-255,66,132098,77,261722
29438,0.001299,74.125.130.0-255,2902,135000,77,261722
29439,0.001301,172.31.40.0-255,66,135066,77,261722
29440,0.001321,74.125.130.0-255,766,135832,77,261722
29441,0.00147,74.125.130.0-255,1484,137316,77,261722
29442,0.001474,172.31.40.0-255,66,137382,77,261722
29443,0.001491,74.125.130.0-255,2902,140284,77,261722
29444,0.001494,172.31.40.0-255,66,140350,77,261722
29445,0.001521,74.125.130.0-255,4320,144670,77,261722
29446,0.001524,172.31.40.0-255,66,144736,77,261722
29447,0.00154,74.125.130.0-255,4320,149056,77,261722
29448,0.001542,172.31.40.0-255,66,149122,77,261722
29449,0.001564,74.125.130.0-255,4320,153442,77,261722
29450,0.001566,172.31.40.0-255,66,153508,77,261722
29451,0.001587,74.125.130.0-255,7156,160664,77,261722
29452,0.00159,172.31.40.0-255,66,160730,77,261722
29453,0.001615,74.125.130.0-255,2902,163632,77,261722
29454,0.001618,172.31.40.0-255,66,163698,77,261722
29455,0.001621,74.125.130.0-255,2902,166600,77,261722
29456,0.001623,172.31.40.0-255,66,166666,77,261722
29457,0.001628,74.125.130.0-255,3602,170268,77,261722
29458,0.00163,172.31.40.0-255,66,170334,77,261722
29459,0.001847,74.125.130.0-255,1484,171818,77,261722
29460,0.001866,74.125.130.0-255,2902,174720,77,261722
29461,0.001869,172.31.40.0-255,66,174786,77,261722
29462,0.001888,74.125.130.0-255,4320,179106,77,261722
29463,0.001891,172.31.40.0-255,66,179172,77,261722
29464,0.001906,74.125.130.0-255,1484,180656,77,261722
29465,0.00191,74.125.130.0-255,2902,183558,77,261722
29466,0.001912,172.31.40.0-255,66,183624,77,261722
29467,0.001947,74.125.130.0-255,4320,187944,77,261722
29468,0.001951,172.31.40.0-255,66,188010,77,261722
29469,0.001973,74.125.130.0-255,5738,193748,77,261722
29470,0.001976,172.31.40.0-255,66,193814,77,261722
29471,0.001981,74.125.130.0-255,2902,196716,77,261722
29472,0.001982,172.31.40.0-255,66,196782,77,261722
29473,0.002016,74.125.130.0-255,7156,203938,77,261722
29474,0.002019,172.31.40.0-255,66,204004,77,261722
29475,0.002037,74.125.130.0-255,766,204770,77,261722
29476,0.00204,74.125.130.0-255,1484,206254,77,261722
29477,0.002042,172.31.40.0-255,66,206320,77,261722
29478,0.002071,74.125.130.0-255,7156,213476,77,261722
29479,0.002074,172.31.40.0-255,66,213542,77,261722
29480,0.002078,74.125.130.0-255,2902,216444,77,261722
29481,0.00208,172.31.40.0-255,66,216510,77,261722
29482,0.004108,74.125.130.0-255,5738,222248,77,261722
29483,0.004115,172.31.40.0-255,66,222314,77,261722
29484,0.006159,74.125.130.0-255,2902,225216,77,261722
29485,0.006163,172.31.40.0-255,66,225282,77,261722
29486,0.006181,74.125.130.0-255,2902,228184,77,261722
29487,0.006183,172.31.40.0-255,66,228250,77,261722
29488,0.008204,74.125.130.0-255,4320,232570,77,261722
29489,0.008208,172.31.40.0-255,66,232636,77,261722
29490,0.008226,74.125.130.0-255,1484,234120,77,261722
29491,0.01025,74.125.130.0-255,4320,238440,77,261722
29492,0.010257,172.31.40.0-255,66,238506,77,261722
29493,0.012298,74.125.130.0-255,5738,244244,77,261722
29494,0.012305,172.31.40.0-255,66,244310,77,261722
29495,0.014342,74.125.130.0-255,5738,250048,77,261722
29496,0.01435,172.31.40.0-255,66,250114,77,261722
29497,0.016413,74.125.130.0-255,5738,255852,77,261722
29498,0.016429,172.31.40.0-255,66,255918,77,261722
29499,0.018481,74.125.130.0-255,5738,261656,77,261722
29500,0.018492,172.31.40.0-255,66,261722,77,261722
29501,0.0,172.217.194.0-255,154,154,77,139785
29502,2.4e-05,172.31.40.0-255,66,220,77,139785
29503,3.1e-05,172.217.194.0-255,1484,1704,77,139785
29504,3.5e-05,172.31.40.0-255,66,1770,77,139785
29505,4e-05,172.217.194.0-255,2902,4672,77,139785
29506,4.3e-05,172.31.40.0-255,66,4738,77,139785
29507,5.9e-05,172.217.194.0-255,7156,11894,77,139785
29508,6.2e-05,172.31.40.0-255,66,11960,77,139785
29509,6.6e-05,172.217.194.0-255,2112,14072,77,139785
29510,6.9e-05,172.31.40.0-255,66,14138,77,139785
29511,0.00018,172.217.194.0-255,1484,15622,77,139785
29512,0.000183,172.31.40.0-255,66,15688,77,139785
29513,0.000188,172.217.194.0-255,2902,18590,77,139785
29514,0.000191,172.31.40.0-255,66,18656,77,139785
29515,0.000194,172.217.194.0-255,1484,20140,77,139785
29516,0.000195,172.31.40.0-255,66,20206,77,139785
29517,0.000224,172.217.194.0-255,4320,24526,77,139785
29518,0.000227,172.31.40.0-255,66,24592,77,139785
29519,0.00023,172.217.194.0-255,1484,26076,77,139785
29520,0.000232,172.31.40.0-255,66,26142,77,139785
29521,0.000239,172.217.194.0-255,7156,33298,77,139785
29522,0.000241,172.31.40.0-255,66,33364,77,139785
29523,0.000281,172.217.194.0-255,6797,40161,77,139785
29524,0.000285,172.31.40.0-255,66,40227,77,139785
29525,0.000294,172.217.194.0-255,9992,50219,77,139785
29526,0.000296,172.31.40.0-255,66,50285,77,139785
29527,0.000322,172.217.194.0-255,9992,60277,77,139785
29528,0.000326,172.31.40.0-255,66,60343,77,139785
29529,0.000354,172.217.194.0-255,5020,65363,77,139785
29530,0.000356,172.31.40.0-255,66,65429,77,139785
29531,0.000359,172.217.194.0-255,338,65767,77,139785
29532,0.000361,172.31.40.0-255,66,65833,77,139785
29533,0.000567,172.217.194.0-255,116,65949,77,139785
29534,0.000671,172.217.194.0-255,1484,67433,77,139785
29535,0.000677,172.31.40.0-255,66,67499,77,139785
29536,0.000682,172.217.194.0-255,2902,70401,77,139785
29537,0.000684,172.31.40.0-255,66,70467,77,139785
29538,0.000689,172.217.194.0-255,2902,73369,77,139785
29539,0.000691,172.31.40.0-255,66,73435,77,139785
29540,0.00072,172.217.194.0-255,2902,76337,77,139785
29541,0.000723,172.31.40.0-255,66,76403,77,139785
29542,0.000734,172.217.194.0-255,12828,89231,77,139785
29543,0.000736,172.31.40.0-255,66,89297,77,139785
29544,0.000776,172.217.194.0-255,9992,99289,77,139785
29545,0.000779,172.31.40.0-255,66,99355,77,139785
29546,0.000782,172.217.194.0-255,1088,100443,77,139785
29547,0.003234,172.217.194.0-255,1484,101927,77,139785
29548,0.003242,172.31.40.0-255,66,101993,77,139785
29549,0.003248,172.217.194.0-255,2902,104895,77,139785
29550,0.00325,172.31.40.0-255,66,104961,77,139785
29551,0.005516,172.217.194.0-255,5738,110699,77,139785
29552,0.005522,172.31.40.0-255,66,110765,77,139785
29553,0.007977,172.217.194.0-255,5738,116503,77,139785
29554,0.007984,172.31.40.0-255,66,116569,77,139785
29555,0.01048,172.217.194.0-255,5738,122307,77,139785
29556,0.010489,172.31.40.0-255,66,122373,77,139785
29557,0.012863,172.217.194.0-255,5738,128111,77,139785
29558,0.012873,172.31.40.0-255,66,128177,77,139785
29559,0.015284,172.217.194.0-255,5738,133915,77,139785
29560,0.015297,172.31.40.0-255,66,133981,77,139785
29561,0.017708,172.217.194.0-255,5738,139719,77,139785
29562,0.017723,172.31.40.0-255,66,139785,77,139785
29563,0.0,172.217.194.0-255,151,151,77,399251
29564,2e-05,172.31.40.0-255,66,217,77,399251
29565,2.8e-05,172.217.194.0-255,1484,1701,77,399251
29566,3.2e-05,172.31.40.0-255,66,1767,77,399251
29567,3.9e-05,172.217.194.0-255,2902,4669,77,399251
29568,4.3e-05,172.31.40.0-255,66,4735,77,399251
29569,5.1e-05,172.217.194.0-255,7156,11891,77,399251
29570,5.5e-05,172.31.40.0-255,66,11957,77,399251
29571,8.8e-05,172.217.194.0-255,7656,19613,77,399251
29572,9.1e-05,172.31.40.0-255,66,19679,77,399251
29573,9.9e-05,172.217.194.0-255,7156,26835,77,399251
29574,0.000101,172.31.40.0-255,66,26901,77,399251
29575,0.000118,172.217.194.0-255,2902,29803,77,399251
29576,0.00012,172.31.40.0-255,66,29869,77,399251
29577,0.000135,172.217.194.0-255,1125,30994,77,399251
29578,0.000137,172.31.40.0-255,66,31060,77,399251
29579,0.000182,172.217.194.0-255,1484,32544,77,399251
29580,0.000184,172.31.40.0-255,66,32610,77,399251
29581,0.000189,172.217.194.0-255,2902,35512,77,399251
29582,0.000191,172.31.40.0-255,66,35578,77,399251
29583,0.00021,172.217.194.0-255,1484,37062,77,399251
29584,0.000212,172.31.40.0-255,66,37128,77,399251
29585,0.000232,172.217.194.0-255,4320,41448,77,399251
29586,0.000235,172.31.40.0-255,66,41514,77,399251
29587,0.000251,172.217.194.0-255,8574,50088,77,399251
29588,0.000255,172.31.40.0-255,66,50154,77,399251
29589,0.00027,172.217.194.0-255,4320,54474,77,399251
29590,0.000273,172.31.40.0-255,66,54540,77,399251
29591,0.000276,172.217.194.0-255,1484,56024,77,399251
29592,0.000278,172.31.40.0-255,66,56090,77,399251
29593,0.000317,172.217.194.0-255,5738,61828,77,399251
29594,0.00032,172.31.40.0-255,66,61894,77,399251
29595,0.000358,172.217.194.0-255,3911,65805,77,399251
29596,0.000362,172.31.40.0-255,66,65871,77,399251
29597,0.000365,172.217.194.0-255,99,65970,77,399251
29598,0.000426,172.217.194.0-255,1484,67454,77,399251
29599,0.000429,172.31.40.0-255,66,67520,77,399251
29600,0.000435,172.217.194.0-255,2902,70422,77,399251
29601,0.000437,172.31.40.0-255,66,70488,77,399251
29602,0.000454,172.217.194.0-255,5738,76226,77,399251
29603,0.000457,172.31.40.0-255,66,76292,77,399251
29604,0.00047,172.217.194.0-255,2902,79194,77,399251
29605,0.000473,172.31.40.0-255,66,79260,77,399251
29606,0.000504,172.217.194.0-255,9910,89170,77,399251
29607,0.000507,172.31.40.0-255,66,89236,77,399251
29608,0.000516,172.217.194.0-255,8574,97810,77,399251
29609,0.000518,172.31.40.0-255,66,97876,77,399251
29610,0.000536,172.217.194.0-255,2543,100419,77,399251
29611,0.000539,172.31.40.0-255,66,100485,77,399251
29612,0.000863,172.217.194.0-255,1484,101969,77,399251
29613,0.00087,172.217.194.0-255,2902,104871,77,399251
29614,0.000873,172.31.40.0-255,66,104937,77,399251
29615,0.000888,172.217.194.0-255,4320,109257,77,399251
29616,0.00089,172.31.40.0-255,66,109323,77,399251
29617,0.000902,172.217.194.0-255,1484,110807,77,399251
29618,0.000908,172.217.194.0-255,7156,117963,77,399251
29619,0.000912,172.31.40.0-255,66,118029,77,399251
29620,0.000928,172.217.194.0-255,4320,122349,77,399251
29621,0.000931,172.31.40.0-255,66,122415,77,399251
29622,0.000954,172.217.194.0-255,9992,132407,77,399251
29623,0.000957,172.217.194.0-255,2184,134591,77,399251
29624,0.000961,172.31.40.0-255,66,134657,77,399251
29625,0.000964,172.31.40.0-255,66,134723,77,399251
29626,0.001001,172.217.194.0-255,2902,137625,77,399251
29627,0.001005,172.31.40.0-255,66,137691,77,399251
29628,0.001022,172.217.194.0-255,5738,143429,77,399251
29629,0.001025,172.31.40.0-255,66,143495,77,399251
29630,0.001044,172.217.194.0-255,4320,147815,77,399251
29631,0.001048,172.31.40.0-255,66,147881,77,399251
29632,0.001078,172.217.194.0-255,5738,153619,77,399251
29633,0.001082,172.31.40.0-255,66,153685,77,399251
29634,0.001097,172.31.40.0-255,66,153751,77,399251
29635,0.001119,172.217.194.0-255,7156,160907,77,399251
29636,0.001123,172.217.194.0-255,2902,163809,77,399251
29637,0.001126,172.31.40.0-255,66,163875,77,399251
29638,0.001129,172.31.40.0-255,66,163941,77,399251
29639,0.001149,172.217.194.0-255,5738,169679,77,399251
29640,0.001152,172.31.40.0-255,66,169745,77,399251
29641,0.001162,172.217.194.0-255,11410,181155,77,399251
29642,0.001164,172.31.40.0-255,66,181221,77,399251
29643,0.001186,172.217.194.0-255,5738,186959,77,399251
29644,0.001189,172.217.194.0-255,766,187725,77,399251
29645,0.001197,172.31.40.0-255,66,187791,77,399251
29646,0.001214,172.217.194.0-255,2902,190693,77,399251
29647,0.001216,172.31.40.0-255,66,190759,77,399251
29648,0.001247,172.217.194.0-255,7156,197915,77,399251
29649,0.00125,172.31.40.0-255,66,197981,77,399251
29650,0.00126,172.217.194.0-255,11410,209391,77,399251
29651,0.001263,172.31.40.0-255,66,209457,77,399251
29652,0.001312,172.217.194.0-255,8574,218031,77,399251
29653,0.001314,172.31.40.0-255,66,218097,77,399251
29654,0.001332,172.217.194.0-255,3602,221699,77,399251
29655,0.001335,172.31.40.0-255,66,221765,77,399251
29656,0.001379,172.217.194.0-255,1484,223249,77,399251
29657,0.001401,172.217.194.0-255,2902,226151,77,399251
29658,0.001404,172.31.40.0-255,66,226217,77,399251
29659,0.001418,172.217.194.0-255,1484,227701,77,399251
29660,0.001443,172.217.194.0-255,4320,232021,77,399251
29661,0.001447,172.31.40.0-255,66,232087,77,399251
29662,0.001453,172.217.194.0-255,5738,237825,77,399251
29663,0.001455,172.31.40.0-255,66,237891,77,399251
29664,0.001464,172.217.194.0-255,2902,240793,77,399251
29665,0.001466,172.31.40.0-255,66,240859,77,399251
29666,0.001495,172.217.194.0-255,9992,250851,77,399251
29667,0.001498,172.31.40.0-255,66,250917,77,399251
29668,0.001519,172.217.194.0-255,4320,255237,77,399251
29669,0.001522,172.31.40.0-255,66,255303,77,399251
29670,0.001532,172.217.194.0-255,766,256069,77,399251
29671,0.002133,172.217.194.0-255,1484,257553,77,399251
29672,0.002139,172.31.40.0-255,66,257619,77,399251
29673,0.002146,172.217.194.0-255,2902,260521,77,399251
29674,0.002149,172.31.40.0-255,66,260587,77,399251
29675,0.002152,172.217.194.0-255,1484,262071,77,399251
29676,0.002183,172.217.194.0-255,4320,266391,77,399251
29677,0.002186,172.31.40.0-255,66,266457,77,399251
29678,0.002193,172.217.194.0-255,7156,273613,77,399251
29679,0.002196,172.31.40.0-255,66,273679,77,399251
29680,0.002205,172.217.194.0-255,8574,282253,77,399251
29681,0.002207,172.31.40.0-255,66,282319,77,399251
29682,0.002248,172.217.194.0-255,7856,290175,77,399251
29683,0.00225,172.31.40.0-255,66,290241,77,399251
29684,0.00231,172.217.194.0-255,1484,291725,77,399251
29685,0.002314,172.217.194.0-255,1484,293209,77,399251
29686,0.002317,172.31.40.0-255,66,293275,77,399251
29687,0.002336,172.217.194.0-255,1484,294759,77,399251
29688,0.002344,172.217.194.0-255,5738,300497,77,399251
29689,0.002347,172.31.40.0-255,66,300563,77,399251
29690,0.00237,172.217.194.0-255,1484,302047,77,399251
29691,0.002374,172.31.40.0-255,78,302125,77,399251
29692,0.002384,172.217.194.0-255,11410,313535,77,399251
29693,0.002388,172.31.40.0-255,66,313601,77,399251
29694,0.002393,172.217.194.0-255,4320,317921,77,399251
29695,0.002396,172.31.40.0-255,66,317987,77,399251
29696,0.002425,172.217.194.0-255,6438,324425,77,399251
29697,0.002428,172.31.40.0-255,66,324491,77,399251
29698,0.002446,172.217.194.0-255,1484,325975,77,399251
29699,0.00245,172.217.194.0-255,2902,328877,77,399251
29700,0.002453,172.31.40.0-255,66,328943,77,399251
29701,0.002456,172.217.194.0-255,2902,331845,77,399251
29702,0.002459,172.31.40.0-255,66,331911,77,399251
29703,0.002474,172.217.194.0-255,2902,334813,77,399251
29704,0.002476,172.31.40.0-255,66,334879,77,399251
29705,0.002483,172.217.194.0-255,7156,342035,77,399251
29706,0.002485,172.31.40.0-255,66,342101,77,399251
29707,0.002488,172.217.194.0-255,1484,343585,77,399251
29708,0.002518,172.217.194.0-255,9992,353577,77,399251
29709,0.002521,172.31.40.0-255,66,353643,77,399251
29710,0.002527,172.217.194.0-255,5020,358663,77,399251
29711,0.002531,172.217.194.0-255,2902,361565,77,399251
29712,0.002546,172.217.194.0-255,1484,363049,77,399251
29713,0.00258,172.217.194.0-255,8574,371623,77,399251
29714,0.002591,172.217.194.0-255,11410,383033,77,399251
29715,0.002622,172.217.194.0-255,9274,392307,77,399251
29716,0.002627,172.217.194.0-255,4320,396627,77,399251
29717,0.002631,172.217.194.0-255,2282,398909,77,399251
29718,0.002641,172.217.194.0-255,105,399014,77,399251
29719,0.006321,172.31.40.0-255,66,399080,77,399251
29720,0.012328,172.31.40.0-255,105,399185,77,399251
29721,0.014609,172.217.194.0-255,66,399251,77,399251
29722,0.0,172.31.40.0-255,105,105,77,459
29723,0.00023,172.31.40.0-255,90,195,77,459
29724,0.000238,172.31.40.0-255,66,261,77,459
29725,0.002485,74.125.130.0-255,66,327,77,459
29726,0.002513,74.125.130.0-255,66,393,77,459
29727,0.002533,172.31.40.0-255,66,459,77,459
29728,0.0,172.217.194.0-255,147,147,77,230714
29729,1.7e-05,172.31.40.0-255,66,213,77,230714
29730,2.4e-05,172.217.194.0-255,1484,1697,77,230714
29731,2.9e-05,172.31.40.0-255,66,1763,77,230714
29732,3.5e-05,172.217.194.0-255,2902,4665,77,230714
29733,3.8e-05,172.31.40.0-255,66,4731,77,230714
29734,4.6e-05,172.217.194.0-255,7156,11887,77,230714
29735,4.9e-05,172.31.40.0-255,66,11953,77,230714
29736,5.3e-05,172.217.194.0-255,2009,13962,77,230714
29737,5.6e-05,172.31.40.0-255,66,14028,77,230714
29738,0.000418,172.217.194.0-255,1484,15512,77,230714
29739,0.000423,172.31.40.0-255,66,15578,77,230714
29740,0.00043,172.217.194.0-255,2902,18480,77,230714
29741,0.000433,172.31.40.0-255,66,18546,77,230714
29742,0.000436,172.217.194.0-255,1484,20030,77,230714
29743,0.000438,172.31.40.0-255,66,20096,77,230714
29744,0.000454,172.217.194.0-255,4320,24416,77,230714
29745,0.000457,172.217.194.0-255,1484,25900,77,230714
29746,0.000461,172.31.40.0-255,66,25966,77,230714
29747,0.000463,172.31.40.0-255,66,26032,77,230714
29748,0.00048,172.217.194.0-255,5379,31411,77,230714
29749,0.000483,172.31.40.0-255,66,31477,77,230714
29750,0.000525,172.217.194.0-255,9992,41469,77,230714
29751,0.000529,172.31.40.0-255,66,41535,77,230714
29752,0.000544,172.217.194.0-255,1484,43019,77,230714
29753,0.000547,172.31.40.0-255,66,43085,77,230714
29754,0.000566,172.217.194.0-255,5379,48464,77,230714
29755,0.000568,172.31.40.0-255,66,48530,77,230714
29756,0.000748,172.217.194.0-255,1484,50014,77,230714
29757,0.000752,172.31.40.0-255,66,50080,77,230714
29758,0.000778,172.217.194.0-255,2902,52982,77,230714
29759,0.00078,172.31.40.0-255,66,53048,77,230714
29760,0.000787,172.217.194.0-255,5738,58786,77,230714
29761,0.000798,172.217.194.0-255,1484,60270,77,230714
29762,0.000805,172.31.40.0-255,66,60336,77,230714
29763,0.000815,172.217.194.0-255,5692,66028,77,230714
29764,0.000824,172.31.40.0-255,66,66094,77,230714
29765,0.001027,172.217.194.0-255,364,66458,77,230714
29766,0.001065,172.31.40.0-255,66,66524,77,230714
29767,0.001222,172.217.194.0-255,1484,68008,77,230714
29768,0.001231,172.217.194.0-255,2902,70910,77,230714
29769,0.001249,172.217.194.0-255,5738,76648,77,230714
29770,0.001272,172.217.194.0-255,7156,83804,77,230714
29771,0.0013,172.217.194.0-255,5738,89542,77,230714
29772,0.001326,172.217.194.0-255,8574,98116,77,230714
29773,0.00133,172.217.194.0-255,2184,100300,77,230714
29774,0.001588,172.217.194.0-255,1484,101784,77,230714
29775,0.001596,172.217.194.0-255,2902,104686,77,230714
29776,0.001606,172.217.194.0-255,5738,110424,77,230714
29777,0.001655,172.217.194.0-255,11410,121834,77,230714
29778,0.001673,172.217.194.0-255,2902,124736,77,230714
29779,0.001708,172.217.194.0-255,9274,134010,77,230714
29780,0.002024,172.217.194.0-255,1484,135494,77,230714
29781,0.002031,172.217.194.0-255,2902,138396,77,230714
29782,0.00205,172.217.194.0-255,5738,144134,77,230714
29783,0.002065,172.217.194.0-255,1484,145618,77,230714
29784,0.002098,172.217.194.0-255,11410,157028,77,230714
29785,0.002106,172.217.194.0-255,7156,164184,77,230714
29786,0.002133,172.217.194.0-255,3602,167786,77,230714
29787,0.002177,172.217.194.0-255,4320,172106,77,230714
29788,0.002189,172.217.194.0-255,1484,173590,77,230714
29789,0.002204,172.217.194.0-255,4320,177910,77,230714
29790,0.002242,172.217.194.0-255,8574,186484,77,230714
29791,0.002261,172.217.194.0-255,2902,189386,77,230714
29792,0.002264,172.217.194.0-255,1484,190870,77,230714
29793,0.002283,172.217.194.0-255,4320,195190,77,230714
29794,0.002324,172.217.194.0-255,6438,201628,77,230714
29795,0.005711,172.31.40.0-255,66,201694,77,230714
29796,0.008031,172.217.194.0-255,5738,207432,77,230714
29797,0.008037,172.31.40.0-255,66,207498,77,230714
29798,0.010349,172.217.194.0-255,5738,213236,77,230714
29799,0.010357,172.31.40.0-255,66,213302,77,230714
29800,0.012701,172.217.194.0-255,5738,219040,77,230714
29801,0.013742,172.31.40.0-255,66,219106,77,230714
29802,0.016036,172.217.194.0-255,5738,224844,77,230714
29803,0.016051,172.31.40.0-255,66,224910,77,230714
29804,0.018394,172.217.194.0-255,5738,230648,77,230714
29805,0.018404,172.31.40.0-255,66,230714,77,230714
29806,0.0,74.125.24.0-255,153,153,77,154052
29807,2.3e-05,172.31.40.0-255,66,219,77,154052
29808,3.1e-05,74.125.24.0-255,1484,1703,77,154052
29809,3.5e-05,172.31.40.0-255,66,1769,77,154052
29810,4.1e-05,74.125.24.0-255,2902,4671,77,154052
29811,5e-05,172.31.40.0-255,66,4737,77,154052
29812,5.8e-05,74.125.24.0-255,7156,11893,77,154052
29813,6e-05,172.31.40.0-255,66,11959,77,154052
29814,8.3e-05,74.125.24.0-255,2128,14087,77,154052
29815,8.5e-05,172.31.40.0-255,66,14153,77,154052
29816,0.00029,74.125.24.0-255,1484,15637,77,154052
29817,0.000296,172.31.40.0-255,66,15703,77,154052
29818,0.0003,74.125.24.0-255,1484,17187,77,154052
29819,0.000303,172.31.40.0-255,66,17253,77,154052
29820,0.000339,74.125.24.0-255,1484,18737,77,154052
29821,0.000342,172.31.40.0-255,66,18803,77,154052
29822,0.000349,74.125.24.0-255,5738,24541,77,154052
29823,0.000351,172.31.40.0-255,66,24607,77,154052
29824,0.000383,74.125.24.0-255,6797,31404,77,154052
29825,0.000386,172.31.40.0-255,66,31470,77,154052
29826,0.000412,74.125.24.0-255,4320,35790,77,154052
29827,0.000415,172.31.40.0-255,66,35856,77,154052
29828,0.000444,74.125.24.0-255,2902,38758,77,154052
29829,0.000447,172.31.40.0-255,66,38824,77,154052
29830,0.000466,172.31.40.0-255,66,38890,77,154052
29831,0.000475,74.125.24.0-255,9992,48882,77,154052
29832,0.000477,172.31.40.0-255,66,48948,77,154052
29833,0.0005,74.125.24.0-255,1100,50048,77,154052
29834,0.000503,172.31.40.0-255,66,50114,77,154052
29835,0.000629,74.125.24.0-255,110,50224,77,154052
29836,0.000633,172.31.40.0-255,66,50290,77,154052
29837,0.000808,74.125.24.0-255,1484,51774,77,154052
29838,0.000815,74.125.24.0-255,2902,54676,77,154052
29839,0.000818,172.31.40.0-255,66,54742,77,154052
29840,0.000824,74.125.24.0-255,2902,57644,77,154052
29841,0.000826,172.31.40.0-255,66,57710,77,154052
29842,0.000863,74.125.24.0-255,2902,60612,77,154052
29843,0.000865,172.31.40.0-255,66,60678,77,154052
29844,0.000876,74.125.24.0-255,12828,73506,77,154052
29845,0.000878,172.31.40.0-255,66,73572,77,154052
29846,0.000891,74.125.24.0-255,8574,82146,77,154052
29847,0.000893,172.31.40.0-255,66,82212,77,154052
29848,0.00093,74.125.24.0-255,2184,84396,77,154052
29849,0.000932,172.31.40.0-255,66,84462,77,154052
29850,0.002369,74.125.24.0-255,1484,85946,77,154052
29851,0.002391,74.125.24.0-255,2902,88848,77,154052
29852,0.002396,172.31.40.0-255,66,88914,77,154052
29853,0.002401,74.125.24.0-255,1484,90398,77,154052
29854,0.002421,74.125.24.0-255,2902,93300,77,154052
29855,0.002424,172.31.40.0-255,66,93366,77,154052
29856,0.002449,74.125.24.0-255,1484,94850,77,154052
29857,0.002491,74.125.24.0-255,2902,97752,77,154052
29858,0.002494,172.31.40.0-255,66,97818,77,154052
29859,0.002521,74.125.24.0-255,5738,103556,77,154052
29860,0.002523,172.31.40.0-255,66,103622,77,154052
29861,0.00255,74.125.24.0-255,4320,107942,77,154052
29862,0.002553,172.31.40.0-255,66,108008,77,154052
29863,0.002581,74.125.24.0-255,8574,116582,77,154052
29864,0.002584,172.31.40.0-255,66,116648,77,154052
29865,0.002614,74.125.24.0-255,2184,118832,77,154052
29866,0.002616,172.31.40.0-255,66,118898,77,154052
29867,0.005506,74.125.24.0-255,2902,121800,77,154052
29868,0.005512,172.31.40.0-255,66,121866,77,154052
29869,0.005541,74.125.24.0-255,2902,124768,77,154052
29870,0.005543,172.31.40.0-255,66,124834,77,154052
29871,0.008369,74.125.24.0-255,2902,127736,77,154052
29872,0.008375,172.31.40.0-255,66,127802,77,154052
29873,0.008408,74.125.24.0-255,2902,130704,77,154052
29874,0.00841,172.31.40.0-255,66,130770,77,154052
29875,0.011529,74.125.24.0-255,5738,136508,77,154052
29876,0.011539,172.31.40.0-255,66,136574,77,154052
29877,0.014257,74.125.24.0-255,5738,142312,77,154052
29878,0.014265,172.31.40.0-255,66,142378,77,154052
29879,0.01698,74.125.24.0-255,5738,148116,77,154052
29880,0.01699,172.31.40.0-255,66,148182,77,154052
29881,0.019686,74.125.24.0-255,1484,149666,77,154052
29882,0.019709,74.125.24.0-255,4320,153986,77,154052
29883,0.019713,172.31.40.0-255,66,154052,77,154052
29884,0.0,74.125.24.0-255,153,153,77,180107
29885,1.1e-05,172.31.40.0-255,66,219,77,180107
29886,1.9e-05,74.125.24.0-255,1484,1703,77,180107
29887,2.3e-05,172.31.40.0-255,66,1769,77,180107
29888,2.8e-05,74.125.24.0-255,2902,4671,77,180107
29889,4.1e-05,172.31.40.0-255,66,4737,77,180107
29890,5e-05,74.125.24.0-255,7156,11893,77,180107
29891,5.3e-05,172.31.40.0-255,66,11959,77,180107
29892,5.8e-05,74.125.24.0-255,2030,13989,77,180107
29893,6e-05,172.31.40.0-255,66,14055,77,180107
29894,0.0001,74.125.24.0-255,1484,15539,77,180107
29895,0.000102,172.31.40.0-255,66,15605,77,180107
29896,0.000107,74.125.24.0-255,2902,18507,77,180107
29897,0.00011,172.31.40.0-255,66,18573,77,180107
29898,0.000143,74.125.24.0-255,5738,24311,77,180107
29899,0.000146,172.31.40.0-255,66,24377,77,180107
29900,0.000153,74.125.24.0-255,6797,31174,77,180107
29901,0.000156,172.31.40.0-255,66,31240,77,180107
29902,0.00034,74.125.24.0-255,1484,32724,77,180107
29903,0.000345,172.31.40.0-255,66,32790,77,180107
29904,0.000351,74.125.24.0-255,2902,35692,77,180107
29905,0.000353,172.31.40.0-255,66,35758,77,180107
29906,0.000356,74.125.24.0-255,1484,37242,77,180107
29907,0.000359,172.31.40.0-255,66,37308,77,180107
29908,0.000392,74.125.24.0-255,4320,41628,77,180107
29909,0.000395,172.31.40.0-255,66,41694,77,180107
29910,0.000398,74.125.24.0-255,1484,43178,77,180107
29911,0.0004,172.31.40.0-255,66,43244,77,180107
29912,0.000429,74.125.24.0-255,5379,48623,77,180107
29913,0.000431,172.31.40.0-255,66,48689,77,180107
29914,0.000434,74.125.24.0-255,1484,50173,77,180107
29915,0.000436,172.31.40.0-255,66,50239,77,180107
29916,0.00046,74.125.24.0-255,5738,55977,77,180107
29917,0.000468,172.31.40.0-255,66,56043,77,180107
29918,0.000474,74.125.24.0-255,5738,61781,77,180107
29919,0.000476,172.31.40.0-255,66,61847,77,180107
29920,0.000508,74.125.24.0-255,4337,66184,77,180107
29921,0.00051,172.31.40.0-255,66,66250,77,180107
29922,0.000536,74.125.24.0-255,332,66582,77,180107
29923,0.000994,74.125.24.0-255,1484,68066,77,180107
29924,0.000999,172.31.40.0-255,66,68132,77,180107
29925,0.001004,74.125.24.0-255,2902,71034,77,180107
29926,0.001007,172.31.40.0-255,66,71100,77,180107
29927,0.001036,74.125.24.0-255,5738,76838,77,180107
29928,0.001038,172.31.40.0-255,66,76904,77,180107
29929,0.001043,74.125.24.0-255,2902,79806,77,180107
29930,0.001045,172.31.40.0-255,66,79872,77,180107
29931,0.001084,74.125.24.0-255,9992,89864,77,180107
29932,0.001095,74.125.24.0-255,10692,100556,77,180107
29933,0.001098,172.31.40.0-255,66,100622,77,180107
29934,0.001101,172.31.40.0-255,66,100688,77,180107
29935,0.001369,172.31.40.0-255,101,100789,77,180107
29936,0.001652,74.125.24.0-255,1484,102273,77,180107
29937,0.00166,74.125.24.0-255,2902,105175,77,180107
29938,0.001664,172.31.40.0-255,66,105241,77,180107
29939,0.001672,74.125.24.0-255,5738,110979,77,180107
29940,0.001674,172.31.40.0-255,66,111045,77,180107
29941,0.001713,74.125.24.0-255,7156,118201,77,180107
29942,0.001716,172.31.40.0-255,66,118267,77,180107
29943,0.00175,74.125.24.0-255,7156,125423,77,180107
29944,0.001752,172.31.40.0-255,66,125489,77,180107
29945,0.001777,74.125.24.0-255,7156,132645,77,180107
29946,0.001779,172.31.40.0-255,66,132711,77,180107
29947,0.001783,74.125.24.0-255,2184,134895,77,180107
29948,0.001785,172.31.40.0-255,66,134961,77,180107
29949,0.002261,74.125.24.0-255,1484,136445,77,180107
29950,0.002269,74.125.24.0-255,2902,139347,77,180107
29951,0.002273,172.31.40.0-255,66,139413,77,180107
29952,0.003588,74.125.24.0-255,66,139479,77,180107
29953,0.004526,74.125.24.0-255,5738,145217,77,180107
29954,0.004531,172.31.40.0-255,66,145283,77,180107
29955,0.006828,74.125.24.0-255,5738,151021,77,180107
29956,0.006835,172.31.40.0-255,66,151087,77,180107
29957,0.009136,74.125.24.0-255,5738,156825,77,180107
29958,0.009143,172.31.40.0-255,66,156891,77,180107
29959,0.011413,74.125.24.0-255,5738,162629,77,180107
29960,0.01142,172.31.40.0-255,66,162695,77,180107
29961,0.013685,74.125.24.0-255,5738,168433,77,180107
29962,0.013692,172.31.40.0-255,66,168499,77,180107
29963,0.015943,74.125.24.0-255,5738,174237,77,180107
29964,0.01595,172.31.40.0-255,66,174303,77,180107
29965,0.01821,74.125.24.0-255,5738,180041,77,180107
29966,0.018217,172.31.40.0-255,66,180107,77,180107
29967,0.0,74.125.24.0-255,152,152,77,414127
29968,1.7e-05,172.31.40.0-255,66,218,77,414127
29969,2.3e-05,74.125.24.0-255,1484,1702,77,414127
29970,2.8e-05,172.31.40.0-255,66,1768,77,414127
29971,4e-05,74.125.24.0-255,2902,4670,77,414127
29972,4.4e-05,172.31.40.0-255,66,4736,77,414127
29973,5.2e-05,74.125.24.0-255,7156,11892,77,414127
29974,5.4e-05,172.31.40.0-255,66,11958,77,414127
29975,5.8e-05,74.125.24.0-255,2023,13981,77,414127
29976,6.1e-05,172.31.40.0-255,66,14047,77,414127
29977,9.9e-05,74.125.24.0-255,1484,15531,77,414127
29978,0.000102,172.31.40.0-255,66,15597,77,414127
29979,0.000128,74.125.24.0-255,2902,18499,77,414127
29980,0.000131,172.31.40.0-255,66,18565,77,414127
29981,0.000138,74.125.24.0-255,5738,24303,77,414127
29982,0.00014,172.31.40.0-255,66,24369,77,414127
29983,0.000182,74.125.24.0-255,6797,31166,77,414127
29984,0.000185,172.31.40.0-255,66,31232,77,414127
29985,0.000252,74.125.24.0-255,1484,32716,77,414127
29986,0.000255,172.31.40.0-255,66,32782,77,414127
29987,0.000268,74.125.24.0-255,2902,35684,77,414127
29988,0.000275,172.31.40.0-255,66,35750,77,414127
29989,0.000282,74.125.24.0-255,5738,41488,77,414127
29990,0.000285,172.31.40.0-255,66,41554,77,414127
29991,0.000317,74.125.24.0-255,5738,47292,77,414127
29992,0.00032,172.31.40.0-255,66,47358,77,414127
29993,0.000344,74.125.24.0-255,5379,52737,77,414127
29994,0.000347,172.31.40.0-255,66,52803,77,414127
29995,0.000358,74.125.24.0-255,11410,64213,77,414127
29996,0.00036,172.31.40.0-255,66,64279,77,414127
29997,0.000363,74.125.24.0-255,1125,65404,77,414127
29998,0.000365,172.31.40.0-255,66,65470,77,414127
29999,0.0004,74.125.24.0-255,364,65834,77,414127
30000,0.000437,74.125.24.0-255,380,66214,77,414127
30001,0.000579,74.125.24.0-255,1484,67698,77,414127
30002,0.000583,172.31.40.0-255,66,67764,77,414127
30003,0.000589,74.125.24.0-255,2902,70666,77,414127
30004,0.000592,172.31.40.0-255,66,70732,77,414127
30005,0.000603,74.125.24.0-255,5738,76470,77,414127
30006,0.000605,172.31.40.0-255,66,76536,77,414127
30007,0.00061,74.125.24.0-255,2902,79438,77,414127
30008,0.000612,172.31.40.0-255,66,79504,77,414127
30009,0.000641,74.125.24.0-255,3961,83465,77,414127
30010,0.000648,172.31.40.0-255,66,83531,77,414127
30011,0.000686,74.125.24.0-255,11410,94941,77,414127
30012,0.000691,172.31.40.0-255,66,95007,77,414127
30013,0.00072,74.125.24.0-255,5379,100386,77,414127
30014,0.000723,172.31.40.0-255,66,100452,77,414127
30015,0.000939,74.125.24.0-255,1484,101936,77,414127
30016,0.000944,74.125.24.0-255,1484,103420,77,414127
30017,0.000947,172.31.40.0-255,66,103486,77,414127
30018,0.000977,74.125.24.0-255,1484,104970,77,414127
30019,0.000985,74.125.24.0-255,5738,110708,77,414127
30020,0.000988,172.31.40.0-255,66,110774,77,414127
30021,0.000999,74.125.24.0-255,12828,123602,77,414127
30022,0.001005,172.31.40.0-255,66,123668,77,414127
30023,0.001012,74.125.24.0-255,4320,127988,77,414127
30024,0.001014,172.31.40.0-255,66,128054,77,414127
30025,0.001047,74.125.24.0-255,4320,132374,77,414127
30026,0.001052,172.31.40.0-255,66,132440,77,414127
30027,0.001077,74.125.24.0-255,2184,134624,77,414127
30028,0.001079,172.31.40.0-255,66,134690,77,414127
30029,0.001083,74.125.24.0-255,2902,137592,77,414127
30030,0.001086,172.31.40.0-255,66,137658,77,414127
30031,0.001092,74.125.24.0-255,4320,141978,77,414127
30032,0.001099,172.31.40.0-255,66,142044,77,414127
30033,0.00112,74.125.24.0-255,2902,144946,77,414127
30034,0.001122,172.31.40.0-255,66,145012,77,414127
30035,0.001137,74.125.24.0-255,11410,156422,77,414127
30036,0.001139,172.31.40.0-255,66,156488,77,414127
30037,0.001148,74.125.24.0-255,8574,165062,77,414127
30038,0.001151,172.31.40.0-255,66,165128,77,414127
30039,0.001182,74.125.24.0-255,3602,168730,77,414127
30040,0.001185,172.31.40.0-255,66,168796,77,414127
30041,0.001208,74.125.24.0-255,1484,170280,77,414127
30042,0.001211,74.125.24.0-255,1484,171764,77,414127
30043,0.001214,172.31.40.0-255,66,171830,77,414127
30044,0.00124,74.125.24.0-255,1484,173314,77,414127
30045,0.001247,74.125.24.0-255,5738,179052,77,414127
30046,0.00125,172.31.40.0-255,66,179118,77,414127
30047,0.001289,74.125.24.0-255,12828,191946,77,414127
30048,0.001293,172.31.40.0-255,66,192012,77,414127
30049,0.0013,74.125.24.0-255,7156,199168,77,414127
30050,0.001302,172.31.40.0-255,66,199234,77,414127
30051,0.001332,74.125.24.0-255,3602,202836,77,414127
30052,0.001335,172.31.40.0-255,66,202902,77,414127
30053,0.001387,74.125.24.0-255,1484,204386,77,414127
30054,0.001394,74.125.24.0-255,2902,207288,77,414127
30055,0.001397,172.31.40.0-255,66,207354,77,414127
30056,0.00143,74.125.24.0-255,5738,213092,77,414127
30057,0.001433,172.31.40.0-255,66,213158,77,414127
30058,0.001441,74.125.24.0-255,8574,221732,77,414127
30059,0.001443,172.31.40.0-255,66,221798,77,414127
30060,0.00148,74.125.24.0-255,2902,224700,77,414127
30061,0.001482,172.31.40.0-255,66,224766,77,414127
30062,0.001519,74.125.24.0-255,12110,236876,77,414127
30063,0.001523,172.31.40.0-255,66,236942,77,414127
30064,0.001632,74.125.24.0-255,1484,238426,77,414127
30065,0.001637,74.125.24.0-255,2902,241328,77,414127
30066,0.00164,172.31.40.0-255,66,241394,77,414127
30067,0.001673,74.125.24.0-255,5738,247132,77,414127
30068,0.001676,172.31.40.0-255,66,247198,77,414127
30069,0.001697,74.125.24.0-255,12828,260026,77,414127
30070,0.0017,172.31.40.0-255,66,260092,77,414127
30071,0.001708,74.125.24.0-255,7156,267248,77,414127
30072,0.00171,172.31.40.0-255,66,267314,77,414127
30073,0.001772,74.125.24.0-255,3602,270916,77,414127
30074,0.001774,172.31.40.0-255,66,270982,77,414127
30075,0.001778,74.125.24.0-255,1484,272466,77,414127
30076,0.001799,74.125.24.0-255,2902,275368,77,414127
30077,0.001802,172.31.40.0-255,66,275434,77,414127
30078,0.001808,74.125.24.0-255,4320,279754,77,414127
30079,0.00181,172.31.40.0-255,66,279820,77,414127
30080,0.001845,74.125.24.0-255,1484,281304,77,414127
30081,0.001857,74.125.24.0-255,12828,294132,77,414127
30082,0.00186,172.31.40.0-255,66,294198,77,414127
30083,0.001867,74.125.24.0-255,7156,301354,77,414127
30084,0.001869,172.31.40.0-255,66,301420,77,414127
30085,0.001896,74.125.24.0-255,3602,305022,77,414127
30086,0.001902,172.31.40.0-255,66,305088,77,414127
30087,0.002046,172.31.40.0-255,101,305189,77,414127
30088,0.002073,74.125.24.0-255,1484,306673,77,414127
30089,0.002093,74.125.24.0-255,2902,309575,77,414127
30090,0.002096,172.31.40.0-255,66,309641,77,414127
30091,0.002102,74.125.24.0-255,4320,313961,77,414127
30092,0.002105,172.31.40.0-255,66,314027,77,414127
30093,0.002125,74.125.24.0-255,1484,315511,77,414127
30094,0.002156,74.125.24.0-255,12828,328339,77,414127
30095,0.002166,74.125.24.0-255,9992,338331,77,414127
30096,0.002185,172.31.40.0-255,66,338397,77,414127
30097,0.002192,74.125.24.0-255,766,339163,77,414127
30098,0.002223,74.125.24.0-255,1484,340647,77,414127
30099,0.00224,74.125.24.0-255,4320,344967,77,414127
30100,0.002244,74.125.24.0-255,1484,346451,77,414127
30101,0.002256,74.125.24.0-255,1484,347935,77,414127
30102,0.002264,172.31.40.0-255,66,348001,77,414127
30103,0.002294,74.125.24.0-255,5738,353739,77,414127
30104,0.002304,74.125.24.0-255,8574,362313,77,414127
30105,0.002308,74.125.24.0-255,2902,365215,77,414127
30106,0.002315,172.31.40.0-255,66,365281,77,414127
30107,0.002335,74.125.24.0-255,7156,372437,77,414127
30108,0.002349,172.31.40.0-255,66,372503,77,414127
30109,0.002439,74.125.24.0-255,766,373269,77,414127
30110,0.002443,74.125.24.0-255,1484,374753,77,414127
30111,0.002446,172.31.40.0-255,66,374819,77,414127
30112,0.002452,74.125.24.0-255,4320,379139,77,414127
30113,0.002461,74.125.24.0-255,9992,389131,77,414127
30114,0.002473,74.125.24.0-255,7156,396287,77,414127
30115,0.002477,74.125.24.0-255,1484,397771,77,414127
30116,0.002486,74.125.24.0-255,9274,407045,77,414127
30117,0.002507,172.31.40.0-255,66,407111,77,414127
30118,0.002515,74.125.24.0-255,6608,413719,77,414127
30119,0.002529,74.125.24.0-255,105,413824,77,414127
30120,0.002532,172.31.40.0-255,66,413890,77,414127
30121,0.004341,74.125.24.0-255,66,413956,77,414127
30122,0.004916,172.31.40.0-255,105,414061,77,414127
30123,0.007176,74.125.24.0-255,66,414127,77,414127
30124,0.0,172.217.194.0-255,143,143,77,349988
30125,2.2e-05,172.31.40.0-255,66,209,77,349988
30126,2.9e-05,172.217.194.0-255,1484,1693,77,349988
30127,3.4e-05,172.31.40.0-255,66,1759,77,349988
30128,4e-05,172.217.194.0-255,2902,4661,77,349988
30129,5e-05,172.31.40.0-255,66,4727,77,349988
30130,5.8e-05,172.217.194.0-255,7156,11883,77,349988
30131,6.2e-05,172.31.40.0-255,66,11949,77,349988
30132,6.6e-05,172.217.194.0-255,2018,13967,77,349988
30133,6.9e-05,172.31.40.0-255,66,14033,77,349988
30134,0.000291,172.217.194.0-255,1484,15517,77,349988
30135,0.000297,172.31.40.0-255,66,15583,77,349988
30136,0.000304,172.217.194.0-255,2902,18485,77,349988
30137,0.000307,172.31.40.0-255,66,18551,77,349988
30138,0.000318,172.217.194.0-255,5738,24289,77,349988
30139,0.000321,172.31.40.0-255,66,24355,77,349988
30140,0.000327,172.217.194.0-255,5738,30093,77,349988
30141,0.00033,172.31.40.0-255,66,30159,77,349988
30142,0.000365,172.217.194.0-255,7156,37315,77,349988
30143,0.000368,172.31.40.0-255,66,37381,77,349988
30144,0.000405,172.217.194.0-255,6797,44178,77,349988
30145,0.000408,172.31.40.0-255,66,44244,77,349988
30146,0.000413,172.217.194.0-255,3961,48205,77,349988
30147,0.000415,172.31.40.0-255,66,48271,77,349988
30148,0.001247,172.217.194.0-255,1484,49755,77,349988
30149,0.001254,172.31.40.0-255,66,49821,77,349988
30150,0.001265,172.217.194.0-255,2902,52723,77,349988
30151,0.001267,172.31.40.0-255,66,52789,77,349988
30152,0.001278,172.217.194.0-255,5738,58527,77,349988
30153,0.001281,172.31.40.0-255,66,58593,77,349988
30154,0.001284,172.217.194.0-255,1484,60077,77,349988
30155,0.001286,172.31.40.0-255,66,60143,77,349988
30156,0.001323,172.217.194.0-255,12469,72612,77,349988
30157,0.001334,172.217.194.0-255,9992,82604,77,349988
30158,0.001363,172.217.194.0-255,8574,91178,77,349988
30159,0.001387,172.217.194.0-255,8436,99614,77,349988
30160,0.001703,172.217.194.0-255,1484,101098,77,349988
30161,0.001711,172.217.194.0-255,2902,104000,77,349988
30162,0.00174,172.217.194.0-255,5738,109738,77,349988
30163,0.001746,172.217.194.0-255,4320,114058,77,349988
30164,0.001772,172.217.194.0-255,8574,122632,77,349988
30165,0.00178,172.217.194.0-255,9992,132624,77,349988
30166,0.001818,172.217.194.0-255,766,133390,77,349988
30167,0.001821,172.217.194.0-255,1484,134874,77,349988
30168,0.001823,172.217.194.0-255,1484,136358,77,349988
30169,0.001831,172.217.194.0-255,1484,137842,77,349988
30170,0.001845,172.217.194.0-255,1484,139326,77,349988
30171,0.001849,172.217.194.0-255,2902,142228,77,349988
30172,0.001868,172.217.194.0-255,7156,149384,77,349988
30173,0.001874,172.217.194.0-255,7156,156540,77,349988
30174,0.001883,172.217.194.0-255,1484,158024,77,349988
30175,0.00192,172.217.194.0-255,5738,163762,77,349988
30176,0.001937,172.217.194.0-255,8574,172336,77,349988
30177,0.001968,172.217.194.0-255,6438,178774,77,349988
30178,0.001978,172.217.194.0-255,12828,191602,77,349988
30179,0.001986,172.217.194.0-255,9274,200876,77,349988
30180,0.002021,172.217.194.0-255,1484,202360,77,349988
30181,0.002033,172.217.194.0-255,1484,203844,77,349988
30182,0.002042,172.217.194.0-255,1484,205328,77,349988
30183,0.002055,172.217.194.0-255,5738,211066,77,349988
30184,0.002073,172.217.194.0-255,5738,216804,77,349988
30185,0.002097,172.217.194.0-255,7156,223960,77,349988
30186,0.002104,172.217.194.0-255,8574,232534,77,349988
30187,0.002131,172.217.194.0-255,2184,234718,77,349988
30188,0.002215,172.217.194.0-255,1484,236202,77,349988
30189,0.002233,172.217.194.0-255,2902,239104,77,349988
30190,0.00225,172.217.194.0-255,5738,244842,77,349988
30191,0.002266,172.217.194.0-255,2902,247744,77,349988
30192,0.002295,172.217.194.0-255,9992,257736,77,349988
30193,0.002303,172.217.194.0-255,9992,267728,77,349988
30194,0.002325,172.217.194.0-255,766,268494,77,349988
30195,0.002349,172.217.194.0-255,1484,269978,77,349988
30196,0.002362,172.217.194.0-255,4320,274298,77,349988
30197,0.002376,172.217.194.0-255,4320,278618,77,349988
30198,0.002391,172.217.194.0-255,5738,284356,77,349988
30199,0.002396,172.217.194.0-255,4320,288676,77,349988
30200,0.002407,172.217.194.0-255,4320,292996,77,349988
30201,0.002437,172.217.194.0-255,5738,298734,77,349988
30202,0.002484,172.217.194.0-255,12828,311562,77,349988
30203,0.002558,172.217.194.0-255,5738,317300,77,349988
30204,0.002575,172.217.194.0-255,3602,320902,77,349988
30205,0.006936,172.31.40.0-255,66,320968,77,349988
30206,0.009494,172.217.194.0-255,5738,326706,77,349988
30207,0.009501,172.31.40.0-255,66,326772,77,349988
30208,0.012046,172.217.194.0-255,5738,332510,77,349988
30209,0.012054,172.31.40.0-255,66,332576,77,349988
30210,0.014614,172.217.194.0-255,5738,338314,77,349988
30211,0.014677,172.31.40.0-255,66,338380,77,349988
30212,0.017219,172.217.194.0-255,5738,344118,77,349988
30213,0.017229,172.31.40.0-255,66,344184,77,349988
30214,0.019778,172.217.194.0-255,5738,349922,77,349988
30215,0.019787,172.31.40.0-255,66,349988,77,349988
30216,0.0,74.125.24.0-255,150,150,77,146386
30217,2.3e-05,172.31.40.0-255,66,216,77,146386
30218,3.1e-05,74.125.24.0-255,1484,1700,77,146386
30219,3.5e-05,172.31.40.0-255,66,1766,77,146386
30220,4.2e-05,74.125.24.0-255,2902,4668,77,146386
30221,4.5e-05,172.31.40.0-255,66,4734,77,146386
30222,6.1e-05,74.125.24.0-255,7156,11890,77,146386
30223,6.3e-05,172.31.40.0-255,66,11956,77,146386
30224,6.8e-05,74.125.24.0-255,2111,14067,77,146386
30225,7.1e-05,172.31.40.0-255,66,14133,77,146386
30226,0.000118,74.125.24.0-255,1484,15617,77,146386
30227,0.000121,172.31.40.0-255,66,15683,77,146386
30228,0.000142,74.125.24.0-255,2902,18585,77,146386
30229,0.000145,172.31.40.0-255,66,18651,77,146386
30230,0.000152,74.125.24.0-255,5738,24389,77,146386
30231,0.000155,172.31.40.0-255,66,24455,77,146386
30232,0.000197,74.125.24.0-255,2902,27357,77,146386
30233,0.000201,172.31.40.0-255,66,27423,77,146386
30234,0.000228,74.125.24.0-255,3961,31384,77,146386
30235,0.000231,172.31.40.0-255,66,31450,77,146386
30236,0.000238,74.125.24.0-255,7156,38606,77,146386
30237,0.000241,172.31.40.0-255,66,38672,77,146386
30238,0.000245,74.125.24.0-255,2902,41574,77,146386
30239,0.000247,172.31.40.0-255,66,41640,77,146386
30240,0.000287,74.125.24.0-255,5738,47378,77,146386
30241,0.00029,172.31.40.0-255,66,47444,77,146386
30242,0.000293,74.125.24.0-255,1125,48569,77,146386
30243,0.000295,172.31.40.0-255,66,48635,77,146386
30244,0.000989,74.125.24.0-255,1484,50119,77,146386
30245,0.000995,172.31.40.0-255,66,50185,77,146386
30246,0.001004,74.125.24.0-255,2902,53087,77,146386
30247,0.001007,172.31.40.0-255,66,53153,77,146386
30248,0.001017,74.125.24.0-255,2902,56055,77,146386
30249,0.001023,74.125.24.0-255,4320,60375,77,146386
30250,0.001057,74.125.24.0-255,5674,66049,77,146386
30251,0.001892,74.125.24.0-255,1484,67533,77,146386
30252,0.001901,74.125.24.0-255,2902,70435,77,146386
30253,0.001909,74.125.24.0-255,5738,76173,77,146386
30254,0.001912,74.125.24.0-255,2902,79075,77,146386
30255,0.001936,74.125.24.0-255,9992,89067,77,146386
30256,0.001967,74.125.24.0-255,5738,94805,77,146386
30257,0.001986,74.125.24.0-255,5083,99888,77,146386
30258,0.003101,172.31.40.0-255,66,99954,77,146386
30259,0.005171,74.125.24.0-255,5738,105692,77,146386
30260,0.005176,172.31.40.0-255,66,105758,77,146386
30261,0.007264,74.125.24.0-255,5738,111496,77,146386
30262,0.007271,172.31.40.0-255,66,111562,77,146386
30263,0.009379,74.125.24.0-255,5738,117300,77,146386
30264,0.009387,172.31.40.0-255,66,117366,77,146386
30265,0.011502,74.125.24.0-255,5738,123104,77,146386
30266,0.011511,172.31.40.0-255,66,123170,77,146386
30267,0.013579,74.125.24.0-255,5738,128908,77,146386
30268,0.01359,172.31.40.0-255,66,128974,77,146386
30269,0.015672,74.125.24.0-255,5738,134712,77,146386
30270,0.015684,172.31.40.0-255,66,134778,77,146386
30271,0.017798,74.125.24.0-255,5738,140516,77,146386
30272,0.017806,172.31.40.0-255,66,140582,77,146386
30273,0.019905,74.125.24.0-255,5738,146320,77,146386
30274,0.019911,172.31.40.0-255,66,146386,77,146386
30275,0.0,74.125.24.0-255,147,147,77,393376
30276,2.2e-05,172.31.40.0-255,66,213,77,393376
30277,3e-05,74.125.24.0-255,1484,1697,77,393376
30278,3.4e-05,172.31.40.0-255,66,1763,77,393376
30279,4e-05,74.125.24.0-255,2902,4665,77,393376
30280,4.3e-05,172.31.40.0-255,66,4731,77,393376
30281,4.7e-05,74.125.24.0-255,2902,7633,77,393376
30282,4.9e-05,172.31.40.0-255,66,7699,77,393376
30283,7.3e-05,74.125.24.0-255,4320,12019,77,393376
30284,7.6e-05,172.31.40.0-255,66,12085,77,393376
30285,9.5e-05,74.125.24.0-255,2076,14161,77,393376
30286,9.8e-05,172.31.40.0-255,66,14227,77,393376
30287,0.000111,74.125.24.0-255,2902,17129,77,393376
30288,0.000113,172.31.40.0-255,66,17195,77,393376
30289,0.000134,74.125.24.0-255,4320,21515,77,393376
30290,0.000137,172.31.40.0-255,66,21581,77,393376
30291,0.000143,74.125.24.0-255,5738,27319,77,393376
30292,0.000145,172.31.40.0-255,66,27385,77,393376
30293,0.000216,74.125.24.0-255,7156,34541,77,393376
30294,0.00022,172.31.40.0-255,66,34607,77,393376
30295,0.000246,74.125.24.0-255,8215,42822,77,393376
30296,0.000249,172.31.40.0-255,66,42888,77,393376
30297,0.000255,74.125.24.0-255,5379,48267,77,393376
30298,0.000258,172.31.40.0-255,66,48333,77,393376
30299,0.000293,74.125.24.0-255,1484,49817,77,393376
30300,0.000296,172.31.40.0-255,66,49883,77,393376
30301,0.0003,74.125.24.0-255,2902,52785,77,393376
30302,0.000302,172.31.40.0-255,66,52851,77,393376
30303,0.000329,74.125.24.0-255,2902,55753,77,393376
30304,0.000332,172.31.40.0-255,66,55819,77,393376
30305,0.000356,74.125.24.0-255,2902,58721,77,393376
30306,0.000358,172.31.40.0-255,66,58787,77,393376
30307,0.000366,74.125.24.0-255,7127,65914,77,393376
30308,0.000368,172.31.40.0-255,66,65980,77,393376
30309,0.000371,74.125.24.0-255,347,66327,77,393376
30310,0.000514,74.125.24.0-255,1484,67811,77,393376
30311,0.000518,172.31.40.0-255,66,67877,77,393376
30312,0.000523,74.125.24.0-255,2902,70779,77,393376
30313,0.000526,172.31.40.0-255,66,70845,77,393376
30314,0.000558,74.125.24.0-255,5738,76583,77,393376
30315,0.000563,74.125.24.0-255,4320,80903,77,393376
30316,0.000567,172.31.40.0-255,66,80969,77,393376
30317,0.000569,172.31.40.0-255,66,81035,77,393376
30318,0.000601,74.125.24.0-255,8215,89250,77,393376
30319,0.000604,172.31.40.0-255,66,89316,77,393376
30320,0.000609,74.125.24.0-255,4320,93636,77,393376
30321,0.000611,172.31.40.0-255,66,93702,77,393376
30322,0.000627,74.125.24.0-255,4320,98022,77,393376
30323,0.00063,172.31.40.0-255,66,98088,77,393376
30324,0.000642,74.125.24.0-255,1994,100082,77,393376
30325,0.000645,172.31.40.0-255,66,100148,77,393376
30326,0.000896,74.125.24.0-255,1484,101632,77,393376
30327,0.000911,74.125.24.0-255,2902,104534,77,393376
30328,0.000914,172.31.40.0-255,66,104600,77,393376
30329,0.000919,74.125.24.0-255,2902,107502,77,393376
30330,0.000922,172.31.40.0-255,66,107568,77,393376
30331,0.000939,74.125.24.0-255,2902,110470,77,393376
30332,0.000941,172.31.40.0-255,66,110536,77,393376
30333,0.000945,74.125.24.0-255,2902,113438,77,393376
30334,0.000947,172.31.40.0-255,66,113504,77,393376
30335,0.000979,74.125.24.0-255,9992,123496,77,393376
30336,0.000982,172.31.40.0-255,66,123562,77,393376
30337,0.000986,74.125.24.0-255,1484,125046,77,393376
30338,0.001006,74.125.24.0-255,8574,133620,77,393376
30339,0.001009,172.31.40.0-255,66,133686,77,393376
30340,0.00103,74.125.24.0-255,766,134452,77,393376
30341,0.001298,74.125.24.0-255,1484,135936,77,393376
30342,0.001303,172.31.40.0-255,66,136002,77,393376
30343,0.001308,74.125.24.0-255,2902,138904,77,393376
30344,0.00131,172.31.40.0-255,66,138970,77,393376
30345,0.001315,74.125.24.0-255,2902,141872,77,393376
30346,0.001317,172.31.40.0-255,66,141938,77,393376
30347,0.001343,74.125.24.0-255,2902,144840,77,393376
30348,0.001346,172.31.40.0-255,66,144906,77,393376
30349,0.001358,74.125.24.0-255,12828,157734,77,393376
30350,0.00136,172.31.40.0-255,66,157800,77,393376
30351,0.001363,74.125.24.0-255,1484,159284,77,393376
30352,0.001389,74.125.24.0-255,7156,166440,77,393376
30353,0.001391,172.31.40.0-255,66,166506,77,393376
30354,0.001395,74.125.24.0-255,2184,168690,77,393376
30355,0.001397,172.31.40.0-255,66,168756,77,393376
30356,0.001627,74.125.24.0-255,1484,170240,77,393376
30357,0.001632,74.125.24.0-255,1484,171724,77,393376
30358,0.001636,172.31.40.0-255,66,171790,77,393376
30359,0.001651,74.125.24.0-255,1484,173274,77,393376
30360,0.001659,74.125.24.0-255,5738,179012,77,393376
30361,0.001661,172.31.40.0-255,66,179078,77,393376
30362,0.001683,74.125.24.0-255,4320,183398,77,393376
30363,0.001685,172.31.40.0-255,66,183464,77,393376
30364,0.001717,74.125.24.0-255,8574,192038,77,393376
30365,0.00172,172.31.40.0-255,66,192104,77,393376
30366,0.001723,74.125.24.0-255,1484,193588,77,393376
30367,0.001745,74.125.24.0-255,9274,202862,77,393376
30368,0.001748,172.31.40.0-255,66,202928,77,393376
30369,0.001817,74.125.24.0-255,1484,204412,77,393376
30370,0.001823,74.125.24.0-255,2902,207314,77,393376
30371,0.001825,172.31.40.0-255,66,207380,77,393376
30372,0.001848,74.125.24.0-255,5738,213118,77,393376
30373,0.00185,172.31.40.0-255,66,213184,77,393376
30374,0.001881,74.125.24.0-255,12828,226012,77,393376
30375,0.001884,172.31.40.0-255,66,226078,77,393376
30376,0.001891,74.125.24.0-255,5738,231816,77,393376
30377,0.001893,172.31.40.0-255,66,231882,77,393376
30378,0.001909,74.125.24.0-255,5020,236902,77,393376
30379,0.001912,172.31.40.0-255,66,236968,77,393376
30380,0.001971,74.125.24.0-255,7156,244124,77,393376
30381,0.001974,172.31.40.0-255,66,244190,77,393376
30382,0.002013,172.31.40.0-255,66,244256,77,393376
30383,0.002021,74.125.24.0-255,7856,252112,77,393376
30384,0.002023,172.31.40.0-255,66,252178,77,393376
30385,0.00203,74.125.24.0-255,7156,259334,77,393376
30386,0.002033,172.31.40.0-255,66,259400,77,393376
30387,0.002042,74.125.24.0-255,8574,267974,77,393376
30388,0.002044,172.31.40.0-255,66,268040,77,393376
30389,0.00205,74.125.24.0-255,5738,273778,77,393376
30390,0.002053,172.31.40.0-255,66,273844,77,393376
30391,0.00209,74.125.24.0-255,11410,285254,77,393376
30392,0.002093,172.31.40.0-255,66,285320,77,393376
30393,0.002096,74.125.24.0-255,766,286086,77,393376
30394,0.002112,74.125.24.0-255,1484,287570,77,393376
30395,0.002114,172.31.40.0-255,66,287636,77,393376
30396,0.002155,74.125.24.0-255,2902,290538,77,393376
30397,0.00216,172.31.40.0-255,66,290604,77,393376
30398,0.002176,74.125.24.0-255,4320,294924,77,393376
30399,0.002179,172.31.40.0-255,66,294990,77,393376
30400,0.00221,74.125.24.0-255,8574,303564,77,393376
30401,0.002213,172.31.40.0-255,66,303630,77,393376
30402,0.002222,74.125.24.0-255,9992,313622,77,393376
30403,0.002224,172.31.40.0-255,66,313688,77,393376
30404,0.002243,74.125.24.0-255,6438,320126,77,393376
30405,0.002245,172.31.40.0-255,66,320192,77,393376
30406,0.002253,74.125.24.0-255,7156,327348,77,393376
30407,0.002255,172.31.40.0-255,66,327414,77,393376
30408,0.0023,74.125.24.0-255,9992,337406,77,393376
30409,0.00231,74.125.24.0-255,11410,348816,77,393376
30410,0.002315,74.125.24.0-255,4320,353136,77,393376
30411,0.002319,172.31.40.0-255,66,353202,77,393376
30412,0.002322,172.31.40.0-255,66,353268,77,393376
30413,0.00233,172.31.40.0-255,66,353334,77,393376
30414,0.002334,74.125.24.0-255,766,354100,77,393376
30415,0.004592,74.125.24.0-255,4320,358420,77,393376
30416,0.004599,172.31.40.0-255,66,358486,77,393376
30417,0.00687,74.125.24.0-255,5738,364224,77,393376
30418,0.006873,172.31.40.0-255,66,364290,77,393376
30419,0.009161,74.125.24.0-255,5738,370028,77,393376
30420,0.009167,172.31.40.0-255,66,370094,77,393376
30421,0.011424,74.125.24.0-255,5738,375832,77,393376
30422,0.011431,172.31.40.0-255,66,375898,77,393376
30423,0.013707,74.125.24.0-255,5738,381636,77,393376
30424,0.013715,172.31.40.0-255,66,381702,77,393376
30425,0.016011,74.125.24.0-255,5738,387440,77,393376
30426,0.016019,172.31.40.0-255,66,387506,77,393376
30427,0.018311,74.125.24.0-255,4320,391826,77,393376
30428,0.018316,172.31.40.0-255,66,391892,77,393376
30429,0.018335,74.125.24.0-255,1484,393376,77,393376
30430,0.0,172.217.194.0-255,146,146,77,226878
30431,2.4e-05,172.31.40.0-255,66,212,77,226878
30432,3.1e-05,172.217.194.0-255,1484,1696,77,226878
30433,3.6e-05,172.31.40.0-255,66,1762,77,226878
30434,4.1e-05,172.217.194.0-255,2902,4664,77,226878
30435,5.2e-05,172.31.40.0-255,66,4730,77,226878
30436,6e-05,172.217.194.0-255,7156,11886,77,226878
30437,6.4e-05,172.31.40.0-255,66,11952,77,226878
30438,6.7e-05,172.217.194.0-255,2137,14089,77,226878
30439,7.1e-05,172.31.40.0-255,66,14155,77,226878
30440,0.000136,172.217.194.0-255,1484,15639,77,226878
30441,0.00014,172.31.40.0-255,66,15705,77,226878
30442,0.000146,172.217.194.0-255,2902,18607,77,226878
30443,0.000148,172.31.40.0-255,66,18673,77,226878
30444,0.000177,172.217.194.0-255,5738,24411,77,226878
30445,0.00018,172.31.40.0-255,66,24477,77,226878
30446,0.000212,172.217.194.0-255,8574,33051,77,226878
30447,0.000215,172.31.40.0-255,66,33117,77,226878
30448,0.000248,172.217.194.0-255,5379,38496,77,226878
30449,0.000251,172.31.40.0-255,66,38562,77,226878
30450,0.00026,172.217.194.0-255,9633,48195,77,226878
30451,0.000268,172.31.40.0-255,66,48261,77,226878
30452,0.000427,172.217.194.0-255,1484,49745,77,226878
30453,0.000432,172.31.40.0-255,66,49811,77,226878
30454,0.000438,172.217.194.0-255,2902,52713,77,226878
30455,0.00044,172.31.40.0-255,66,52779,77,226878
30456,0.000452,172.217.194.0-255,5738,58517,77,226878
30457,0.000455,172.31.40.0-255,66,58583,77,226878
30458,0.000494,172.217.194.0-255,7094,65677,77,226878
30459,0.000498,172.31.40.0-255,66,65743,77,226878
30460,0.000637,172.217.194.0-255,381,66124,77,226878
30461,0.000642,172.31.40.0-255,66,66190,77,226878
30462,0.000822,172.217.194.0-255,1484,67674,77,226878
30463,0.000829,172.217.194.0-255,2902,70576,77,226878
30464,0.000833,172.31.40.0-255,66,70642,77,226878
30465,0.000838,172.217.194.0-255,2902,73544,77,226878
30466,0.00084,172.31.40.0-255,66,73610,77,226878
30467,0.000879,172.217.194.0-255,2902,76512,77,226878
30468,0.000882,172.31.40.0-255,66,76578,77,226878
30469,0.000886,172.217.194.0-255,2902,79480,77,226878
30470,0.000888,172.31.40.0-255,66,79546,77,226878
30471,0.000902,172.217.194.0-255,9992,89538,77,226878
30472,0.000904,172.31.40.0-255,66,89604,77,226878
30473,0.00095,172.217.194.0-255,10692,100296,77,226878
30474,0.000954,172.31.40.0-255,66,100362,77,226878
30475,0.001699,172.217.194.0-255,1484,101846,77,226878
30476,0.00171,172.217.194.0-255,2902,104748,77,226878
30477,0.001714,172.31.40.0-255,66,104814,77,226878
30478,0.00172,172.217.194.0-255,2902,107716,77,226878
30479,0.001722,172.31.40.0-255,66,107782,77,226878
30480,0.001744,172.217.194.0-255,2902,110684,77,226878
30481,0.001746,172.31.40.0-255,66,110750,77,226878
30482,0.001757,172.217.194.0-255,5738,116488,77,226878
30483,0.001759,172.31.40.0-255,66,116554,77,226878
30484,0.00179,172.217.194.0-255,4320,120874,77,226878
30485,0.001793,172.31.40.0-255,66,120940,77,226878
30486,0.001811,172.217.194.0-255,13528,134468,77,226878
30487,0.001813,172.31.40.0-255,66,134534,77,226878
30488,0.001996,172.217.194.0-255,1484,136018,77,226878
30489,0.002004,172.217.194.0-255,2902,138920,77,226878
30490,0.002009,172.31.40.0-255,66,138986,77,226878
30491,0.002013,172.217.194.0-255,1484,140470,77,226878
30492,0.00204,172.217.194.0-255,4320,144790,77,226878
30493,0.002043,172.31.40.0-255,66,144856,77,226878
30494,0.00205,172.217.194.0-255,7156,152012,77,226878
30495,0.002052,172.31.40.0-255,66,152078,77,226878
30496,0.002093,172.31.40.0-255,66,152144,77,226878
30497,0.002098,172.217.194.0-255,2184,154328,77,226878
30498,0.0021,172.31.40.0-255,66,154394,77,226878
30499,0.002219,172.217.194.0-255,1484,155878,77,226878
30500,0.002226,172.217.194.0-255,2902,158780,77,226878
30501,0.002229,172.31.40.0-255,66,158846,77,226878
30502,0.00227,172.217.194.0-255,1484,160330,77,226878
30503,0.002295,172.217.194.0-255,4320,164650,77,226878
30504,0.002298,172.31.40.0-255,66,164716,77,226878
30505,0.00231,172.217.194.0-255,12828,177544,77,226878
30506,0.002317,172.31.40.0-255,66,177610,77,226878
30507,0.002325,172.217.194.0-255,8574,186184,77,226878
30508,0.002327,172.31.40.0-255,66,186250,77,226878
30509,0.00458,172.217.194.0-255,5738,191988,77,226878
30510,0.004586,172.31.40.0-255,66,192054,77,226878
30511,0.006849,172.217.194.0-255,5738,197792,77,226878
30512,0.006853,172.31.40.0-255,66,197858,77,226878
30513,0.009127,172.217.194.0-255,5738,203596,77,226878
30514,0.009134,172.31.40.0-255,66,203662,77,226878
30515,0.011414,172.217.194.0-255,5738,209400,77,226878
30516,0.011423,172.31.40.0-255,66,209466,77,226878
30517,0.013688,172.217.194.0-255,5738,215204,77,226878
30518,0.013696,172.31.40.0-255,66,215270,77,226878
30519,0.015978,172.217.194.0-255,5738,221008,77,226878
30520,0.015988,172.31.40.0-255,66,221074,77,226878
30521,0.018265,172.217.194.0-255,5738,226812,77,226878
30522,0.018273,172.31.40.0-255,66,226878,77,226878
30523,0.0,74.125.68.0-255,153,153,77,371648
30524,3.4e-05,172.31.40.0-255,66,219,77,371648
30525,4e-05,74.125.68.0-255,1484,1703,77,371648
30526,4.5e-05,172.31.40.0-255,66,1769,77,371648
30527,4.8e-05,74.125.68.0-255,1484,3253,77,371648
30528,5.1e-05,172.31.40.0-255,66,3319,77,371648
30529,7.9e-05,74.125.68.0-255,2902,6221,77,371648
30530,8.2e-05,172.31.40.0-255,66,6287,77,371648
30531,8.9e-05,74.125.68.0-255,5738,12025,77,371648
30532,9.1e-05,172.31.40.0-255,66,12091,77,371648
30533,9.3e-05,74.125.68.0-255,1484,13575,77,371648
30534,9.6e-05,172.31.40.0-255,66,13641,77,371648
30535,0.00014,74.125.68.0-255,2039,15680,77,371648
30536,0.000144,172.31.40.0-255,66,15746,77,371648
30537,0.000146,74.125.68.0-255,1484,17230,77,371648
30538,0.000148,172.31.40.0-255,66,17296,77,371648
30539,0.000153,74.125.68.0-255,2902,20198,77,371648
30540,0.000155,172.31.40.0-255,66,20264,77,371648
30541,0.000184,74.125.68.0-255,5738,26002,77,371648
30542,0.000187,172.31.40.0-255,66,26068,77,371648
30543,0.00019,74.125.68.0-255,1484,27552,77,371648
30544,0.000192,172.31.40.0-255,66,27618,77,371648
30545,0.00021,74.125.68.0-255,1484,29102,77,371648
30546,0.000212,172.31.40.0-255,66,29168,77,371648
30547,0.000219,74.125.68.0-255,4320,33488,77,371648
30548,0.000222,172.31.40.0-255,66,33554,77,371648
30549,0.000236,74.125.68.0-255,1484,35038,77,371648
30550,0.000238,172.31.40.0-255,66,35104,77,371648
30551,0.000253,74.125.68.0-255,5738,40842,77,371648
30552,0.000256,172.31.40.0-255,66,40908,77,371648
30553,0.000268,74.125.68.0-255,1484,42392,77,371648
30554,0.00027,172.31.40.0-255,66,42458,77,371648
30555,0.000274,74.125.68.0-255,2902,45360,77,371648
30556,0.000283,172.31.40.0-255,66,45426,77,371648
30557,0.000303,74.125.68.0-255,1484,46910,77,371648
30558,0.000317,74.125.68.0-255,2184,49094,77,371648
30559,0.000327,172.31.40.0-255,66,49160,77,371648
30560,0.000392,74.125.68.0-255,1484,50644,77,371648
30561,0.000396,74.125.68.0-255,1484,52128,77,371648
30562,0.000401,172.31.40.0-255,66,52194,77,371648
30563,0.000413,74.125.68.0-255,1484,53678,77,371648
30564,0.000428,74.125.68.0-255,5738,59416,77,371648
30565,0.000446,172.31.40.0-255,66,59482,77,371648
30566,0.000461,74.125.68.0-255,2902,62384,77,371648
30567,0.000466,172.31.40.0-255,66,62450,77,371648
30568,0.000479,74.125.68.0-255,4264,66714,77,371648
30569,0.000491,172.31.40.0-255,66,66780,77,371648
30570,0.001055,74.125.68.0-255,1484,68264,77,371648
30571,0.001064,74.125.68.0-255,1484,69748,77,371648
30572,0.001068,172.31.40.0-255,66,69814,77,371648
30573,0.001101,74.125.68.0-255,2902,72716,77,371648
30574,0.001109,74.125.68.0-255,4320,77036,77,371648
30575,0.001124,74.125.68.0-255,1484,78520,77,371648
30576,0.001126,74.125.68.0-255,1484,80004,77,371648
30577,0.001143,74.125.68.0-255,2902,82906,77,371648
30578,0.001158,74.125.68.0-255,2902,85808,77,371648
30579,0.001169,74.125.68.0-255,2902,88710,77,371648
30580,0.001172,74.125.68.0-255,1484,90194,77,371648
30581,0.001186,74.125.68.0-255,1484,91678,77,371648
30582,0.001196,74.125.68.0-255,1484,93162,77,371648
30583,0.001218,74.125.68.0-255,4320,97482,77,371648
30584,0.001232,74.125.68.0-255,1484,98966,77,371648
30585,0.001236,74.125.68.0-255,1484,100450,77,371648
30586,0.001255,74.125.68.0-255,766,101216,77,371648
30587,0.001494,74.125.68.0-255,1484,102700,77,371648
30588,0.001514,74.125.68.0-255,2902,105602,77,371648
30589,0.001528,74.125.68.0-255,2902,108504,77,371648
30590,0.001558,74.125.68.0-255,4320,112824,77,371648
30591,0.001579,74.125.68.0-255,8574,121398,77,371648
30592,0.001586,74.125.68.0-255,2902,124300,77,371648
30593,0.001643,74.125.68.0-255,2902,127202,77,371648
30594,0.001667,74.125.68.0-255,7856,135058,77,371648
30595,0.001674,74.125.68.0-255,5738,140796,77,371648
30596,0.001692,74.125.68.0-255,5738,146534,77,371648
30597,0.001697,74.125.68.0-255,4320,150854,77,371648
30598,0.001703,74.125.68.0-255,5738,156592,77,371648
30599,0.00172,74.125.68.0-255,1484,158076,77,371648
30600,0.001749,74.125.68.0-255,5738,163814,77,371648
30601,0.001763,74.125.68.0-255,4320,168134,77,371648
30602,0.001765,74.125.68.0-255,766,168900,77,371648
30603,0.001803,74.125.68.0-255,2902,171802,77,371648
30604,0.001821,74.125.68.0-255,7156,178958,77,371648
30605,0.001874,74.125.68.0-255,11410,190368,77,371648
30606,0.001884,74.125.68.0-255,1484,191852,77,371648
30607,0.001897,74.125.68.0-255,2902,194754,77,371648
30608,0.001913,74.125.68.0-255,7856,202610,77,371648
30609,0.001941,74.125.68.0-255,1484,204094,77,371648
30610,0.001957,74.125.68.0-255,7156,211250,77,371648
30611,0.001979,74.125.68.0-255,5738,216988,77,371648
30612,0.002005,74.125.68.0-255,4320,221308,77,371648
30613,0.002012,74.125.68.0-255,7156,228464,77,371648
30614,0.002017,74.125.68.0-255,5738,234202,77,371648
30615,0.00203,74.125.68.0-255,2184,236386,77,371648
30616,0.002051,74.125.68.0-255,2902,239288,77,371648
30617,0.002069,74.125.68.0-255,2902,242190,77,371648
30618,0.002073,74.125.68.0-255,2902,245092,77,371648
30619,0.002091,74.125.68.0-255,4320,249412,77,371648
30620,0.002094,74.125.68.0-255,1484,250896,77,371648
30621,0.002116,74.125.68.0-255,5738,256634,77,371648
30622,0.002137,74.125.68.0-255,4320,260954,77,371648
30623,0.002165,74.125.68.0-255,12110,273064,77,371648
30624,0.002177,74.125.68.0-255,1484,274548,77,371648
30625,0.002198,74.125.68.0-255,8574,283122,77,371648
30626,0.002224,74.125.68.0-255,2902,286024,77,371648
30627,0.002229,74.125.68.0-255,4320,290344,77,371648
30628,0.002234,74.125.68.0-255,4320,294664,77,371648
30629,0.002247,74.125.68.0-255,1484,296148,77,371648
30630,0.002251,74.125.68.0-255,4320,300468,77,371648
30631,0.002283,74.125.68.0-255,3602,304070,77,371648
30632,0.002299,74.125.68.0-255,2902,306972,77,371648
30633,0.00232,74.125.68.0-255,1484,308456,77,371648
30634,0.002339,74.125.68.0-255,2902,311358,77,371648
30635,0.002341,74.125.68.0-255,1484,312842,77,371648
30636,0.002353,74.125.68.0-255,1484,314326,77,371648
30637,0.002363,74.125.68.0-255,1484,315810,77,371648
30638,0.002368,74.125.68.0-255,4320,320130,77,371648
30639,0.002387,74.125.68.0-255,1484,321614,77,371648
30640,0.00241,74.125.68.0-255,5738,327352,77,371648
30641,0.002428,74.125.68.0-255,2902,330254,77,371648
30642,0.002448,74.125.68.0-255,4320,334574,77,371648
30643,0.002452,74.125.68.0-255,2902,337476,77,371648
30644,0.002493,74.125.68.0-255,3602,341078,77,371648
30645,0.002497,74.125.68.0-255,1484,342562,77,371648
30646,0.00402,172.31.40.0-255,66,342628,77,371648
30647,0.006564,74.125.68.0-255,5738,348366,77,371648
30648,0.006581,172.31.40.0-255,66,348432,77,371648
30649,0.009086,74.125.68.0-255,5738,354170,77,371648
30650,0.009102,172.31.40.0-255,66,354236,77,371648
30651,0.011592,74.125.68.0-255,5738,359974,77,371648
30652,0.013088,172.31.40.0-255,66,360040,77,371648
30653,0.015618,74.125.68.0-255,5738,365778,77,371648
30654,0.015625,172.31.40.0-255,66,365844,77,371648
30655,0.018132,74.125.68.0-255,5738,371582,77,371648
30656,0.018138,172.31.40.0-255,66,371648,77,371648
30657,0.0,172.217.194.0-255,153,153,77,243967
30658,1.7e-05,172.31.40.0-255,66,219,77,243967
30659,2.4e-05,172.217.194.0-255,1484,1703,77,243967
30660,2.8e-05,172.31.40.0-255,66,1769,77,243967
30661,3.5e-05,172.217.194.0-255,2902,4671,77,243967
30662,3.8e-05,172.31.40.0-255,66,4737,77,243967
30663,4.5e-05,172.217.194.0-255,5738,10475,77,243967
30664,4.8e-05,172.31.40.0-255,66,10541,77,243967
30665,9.1e-05,172.217.194.0-255,8574,19115,77,243967
30666,9.5e-05,172.31.40.0-255,66,19181,77,243967
30667,0.000116,172.217.194.0-255,612,19793,77,243967
30668,0.000119,172.31.40.0-255,66,19859,77,243967
30669,0.000129,172.217.194.0-255,9992,29851,77,243967
30670,0.000132,172.31.40.0-255,66,29917,77,243967
30671,0.000134,172.217.194.0-255,1125,31042,77,243967
30672,0.000136,172.31.40.0-255,66,31108,77,243967
30673,0.00017,172.217.194.0-255,1484,32592,77,243967
30674,0.000172,172.31.40.0-255,66,32658,77,243967
30675,0.000188,172.217.194.0-255,1484,34142,77,243967
30676,0.000191,172.31.40.0-255,66,34208,77,243967
30677,0.000198,172.217.194.0-255,4320,38528,77,243967
30678,0.0002,172.31.40.0-255,66,38594,77,243967
30679,0.000229,172.217.194.0-255,5738,44332,77,243967
30680,0.000232,172.31.40.0-255,66,44398,77,243967
30681,0.000257,172.217.194.0-255,5379,49777,77,243967
30682,0.00026,172.31.40.0-255,66,49843,77,243967
30683,0.000266,172.217.194.0-255,5738,55581,77,243967
30684,0.000268,172.31.40.0-255,66,55647,77,243967
30685,0.000309,172.217.194.0-255,9946,65593,77,243967
30686,0.000312,172.31.40.0-255,66,65659,77,243967
30687,0.000638,172.31.40.0-255,101,65760,77,243967
30688,0.000735,172.217.194.0-255,363,66123,77,243967
30689,0.00094,172.217.194.0-255,1484,67607,77,243967
30690,0.000944,172.31.40.0-255,66,67673,77,243967
30691,0.00095,172.217.194.0-255,2902,70575,77,243967
30692,0.000952,172.31.40.0-255,66,70641,77,243967
30693,0.000956,172.217.194.0-255,2902,73543,77,243967
30694,0.000958,172.31.40.0-255,66,73609,77,243967
30695,0.000984,172.217.194.0-255,2902,76511,77,243967
30696,0.000987,172.31.40.0-255,66,76577,77,243967
30697,0.000997,172.217.194.0-255,9992,86569,77,243967
30698,0.000999,172.31.40.0-255,66,86635,77,243967
30699,0.001018,172.217.194.0-255,2902,89537,77,243967
30700,0.001021,172.31.40.0-255,66,89603,77,243967
30701,0.001031,172.217.194.0-255,10692,100295,77,243967
30702,0.001033,172.31.40.0-255,66,100361,77,243967
30703,0.001261,172.217.194.0-255,1484,101845,77,243967
30704,0.001279,172.217.194.0-255,2902,104747,77,243967
30705,0.001282,172.31.40.0-255,66,104813,77,243967
30706,0.00129,172.217.194.0-255,5738,110551,77,243967
30707,0.001292,172.31.40.0-255,66,110617,77,243967
30708,0.001315,172.217.194.0-255,4320,114937,77,243967
30709,0.001318,172.31.40.0-255,66,115003,77,243967
30710,0.001335,172.217.194.0-255,7156,122159,77,243967
30711,0.001338,172.31.40.0-255,66,122225,77,243967
30712,0.001366,172.217.194.0-255,1484,123709,77,243967
30713,0.001375,172.217.194.0-255,8574,132283,77,243967
30714,0.001377,172.31.40.0-255,66,132349,77,243967
30715,0.001403,172.217.194.0-255,2184,134533,77,243967
30716,0.001408,172.31.40.0-255,66,134599,77,243967
30717,0.001744,172.217.194.0-255,1484,136083,77,243967
30718,0.001751,172.217.194.0-255,2902,138985,77,243967
30719,0.001755,172.31.40.0-255,66,139051,77,243967
30720,0.001777,172.217.194.0-255,5738,144789,77,243967
30721,0.00178,172.31.40.0-255,66,144855,77,243967
30722,0.001804,172.217.194.0-255,7156,152011,77,243967
30723,0.001806,172.31.40.0-255,66,152077,77,243967
30724,0.001832,172.217.194.0-255,5738,157815,77,243967
30725,0.001836,172.31.40.0-255,66,157881,77,243967
30726,0.001846,172.217.194.0-255,10692,168573,77,243967
30727,0.001848,172.31.40.0-255,66,168639,77,243967
30728,0.002201,172.217.194.0-255,1484,170123,77,243967
30729,0.00221,172.217.194.0-255,2902,173025,77,243967
30730,0.002214,172.31.40.0-255,66,173091,77,243967
30731,0.00224,172.217.194.0-255,5738,178829,77,243967
30732,0.002243,172.31.40.0-255,66,178895,77,243967
30733,0.002256,172.217.194.0-255,1484,180379,77,243967
30734,0.002281,172.217.194.0-255,11410,191789,77,243967
30735,0.002283,172.31.40.0-255,66,191855,77,243967
30736,0.002291,172.217.194.0-255,8574,200429,77,243967
30737,0.002293,172.31.40.0-255,66,200495,77,243967
30738,0.002326,172.217.194.0-255,2184,202679,77,243967
30739,0.002329,172.31.40.0-255,66,202745,77,243967
30740,0.002934,172.217.194.0-255,66,202811,77,243967
30741,0.00457,172.217.194.0-255,2902,205713,77,243967
30742,0.004577,172.31.40.0-255,66,205779,77,243967
30743,0.004638,172.217.194.0-255,2902,208681,77,243967
30744,0.004642,172.31.40.0-255,66,208747,77,243967
30745,0.006878,172.217.194.0-255,2902,211649,77,243967
30746,0.006883,172.31.40.0-255,66,211715,77,243967
30747,0.006936,172.217.194.0-255,2902,214617,77,243967
30748,0.006939,172.31.40.0-255,66,214683,77,243967
30749,0.009204,172.217.194.0-255,2902,217585,77,243967
30750,0.009213,172.31.40.0-255,66,217651,77,243967
30751,0.009235,172.217.194.0-255,2902,220553,77,243967
30752,0.009238,172.31.40.0-255,66,220619,77,243967
30753,0.011503,172.217.194.0-255,2902,223521,77,243967
30754,0.011511,172.31.40.0-255,66,223587,77,243967
30755,0.011536,172.217.194.0-255,2902,226489,77,243967
30756,0.011539,172.31.40.0-255,66,226555,77,243967
30757,0.013828,172.217.194.0-255,5738,232293,77,243967
30758,0.013838,172.31.40.0-255,66,232359,77,243967
30759,0.016133,172.217.194.0-255,5738,238097,77,243967
30760,0.01614,172.31.40.0-255,66,238163,77,243967
30761,0.018437,172.217.194.0-255,5738,243901,77,243967
30762,0.018446,172.31.40.0-255,66,243967,77,243967
30763,0.0,74.125.200.0-255,298,298,77,186183
30764,2.1e-05,172.31.40.0-255,66,364,77,186183
30765,2.9e-05,74.125.200.0-255,1484,1848,77,186183
30766,3.4e-05,172.31.40.0-255,66,1914,77,186183
30767,4e-05,74.125.200.0-255,2902,4816,77,186183
30768,4.3e-05,172.31.40.0-255,66,4882,77,186183
30769,5e-05,74.125.200.0-255,5738,10620,77,186183
30770,5.3e-05,172.31.40.0-255,66,10686,77,186183
30771,5.8e-05,74.125.200.0-255,2902,13588,77,186183
30772,6e-05,172.31.40.0-255,66,13654,77,186183
30773,8.8e-05,74.125.200.0-255,407,14061,77,186183
30774,9.1e-05,172.31.40.0-255,66,14127,77,186183
30775,0.000135,74.125.200.0-255,1484,15611,77,186183
30776,0.000138,172.31.40.0-255,66,15677,77,186183
30777,0.00015,74.125.200.0-255,1484,17161,77,186183
30778,0.000152,172.31.40.0-255,66,17227,77,186183
30779,0.000182,74.125.200.0-255,2902,20129,77,186183
30780,0.000185,172.31.40.0-255,66,20195,77,186183
30781,0.000209,74.125.200.0-255,5738,25933,77,186183
30782,0.000211,172.31.40.0-255,66,25999,77,186183
30783,0.000251,74.125.200.0-255,5379,31378,77,186183
30784,0.000255,172.31.40.0-255,66,31444,77,186183
30785,0.000282,74.125.200.0-255,5738,37182,77,186183
30786,0.000284,172.31.40.0-255,66,37248,77,186183
30787,0.000313,74.125.200.0-255,8574,45822,77,186183
30788,0.000316,172.31.40.0-255,66,45888,77,186183
30789,0.000334,74.125.200.0-255,2543,48431,77,186183
30790,0.000337,172.31.40.0-255,66,48497,77,186183
30791,0.000369,74.125.200.0-255,1484,49981,77,186183
30792,0.000371,172.31.40.0-255,66,50047,77,186183
30793,0.000376,74.125.200.0-255,2902,52949,77,186183
30794,0.000378,172.31.40.0-255,66,53015,77,186183
30795,0.000392,74.125.200.0-255,4320,57335,77,186183
30796,0.000395,172.31.40.0-255,66,57401,77,186183
30797,0.000417,74.125.200.0-255,1484,58885,77,186183
30798,0.000423,74.125.200.0-255,2902,61787,77,186183
30799,0.000425,172.31.40.0-255,66,61853,77,186183
30800,0.000431,74.125.200.0-255,3961,65814,77,186183
30801,0.000433,172.31.40.0-255,66,65880,77,186183
30802,0.000818,74.125.200.0-255,400,66280,77,186183
30803,0.000853,74.125.200.0-255,1484,67764,77,186183
30804,0.000858,172.31.40.0-255,66,67830,77,186183
30805,0.000872,74.125.200.0-255,2902,70732,77,186183
30806,0.000875,172.31.40.0-255,66,70798,77,186183
30807,0.000898,74.125.200.0-255,2902,73700,77,186183
30808,0.000902,172.31.40.0-255,66,73766,77,186183
30809,0.000911,74.125.200.0-255,2902,76668,77,186183
30810,0.000914,172.31.40.0-255,66,76734,77,186183
30811,0.00092,74.125.200.0-255,4320,81054,77,186183
30812,0.000923,172.31.40.0-255,66,81120,77,186183
30813,0.000947,74.125.200.0-255,8574,89694,77,186183
30814,0.00095,172.31.40.0-255,66,89760,77,186183
30815,0.000981,74.125.200.0-255,10692,100452,77,186183
30816,0.000984,172.31.40.0-255,66,100518,77,186183
30817,0.000987,74.125.200.0-255,345,100863,77,186183
30818,0.001434,172.31.40.0-255,66,100929,77,186183
30819,0.00159,74.125.200.0-255,1484,102413,77,186183
30820,0.001598,74.125.200.0-255,2902,105315,77,186183
30821,0.001601,172.31.40.0-255,66,105381,77,186183
30822,0.001621,74.125.200.0-255,2902,108283,77,186183
30823,0.001623,172.31.40.0-255,66,108349,77,186183
30824,0.00165,74.125.200.0-255,4320,112669,77,186183
30825,0.001652,172.31.40.0-255,66,112735,77,186183
30826,0.001659,74.125.200.0-255,7156,119891,77,186183
30827,0.001661,172.31.40.0-255,66,119957,77,186183
30828,0.001684,74.125.200.0-255,1484,121441,77,186183
30829,0.001691,74.125.200.0-255,7156,128597,77,186183
30830,0.001694,172.31.40.0-255,66,128663,77,186183
30831,0.001721,74.125.200.0-255,4320,132983,77,186183
30832,0.001724,172.31.40.0-255,66,133049,77,186183
30833,0.001742,74.125.200.0-255,2184,135233,77,186183
30834,0.001745,172.31.40.0-255,66,135299,77,186183
30835,0.003732,74.125.200.0-255,5738,141037,77,186183
30836,0.003739,172.31.40.0-255,66,141103,77,186183
30837,0.005744,74.125.200.0-255,5738,146841,77,186183
30838,0.005751,172.31.40.0-255,66,146907,77,186183
30839,0.007744,74.125.200.0-255,5738,152645,77,186183
30840,0.007749,172.31.40.0-255,66,152711,77,186183
30841,0.009747,74.125.200.0-255,5738,158449,77,186183
30842,0.009754,172.31.40.0-255,66,158515,77,186183
30843,0.011756,74.125.200.0-255,5738,164253,77,186183
30844,0.011764,172.31.40.0-255,66,164319,77,186183
30845,0.013787,74.125.200.0-255,5738,170057,77,186183
30846,0.013794,172.31.40.0-255,66,170123,77,186183
30847,0.015805,74.125.200.0-255,5738,175861,77,186183
30848,0.015813,172.31.40.0-255,66,175927,77,186183
30849,0.017819,74.125.200.0-255,4320,180247,77,186183
30850,0.017826,172.31.40.0-255,66,180313,77,186183
30851,0.017847,74.125.200.0-255,1484,181797,77,186183
30852,0.01982,74.125.200.0-255,4320,186117,77,186183
30853,0.019828,172.31.40.0-255,66,186183,77,186183
30854,0.0,74.125.24.0-255,152,152,77,290743
30855,1.6e-05,172.31.40.0-255,66,218,77,290743
30856,2.3e-05,74.125.24.0-255,1484,1702,77,290743
30857,2.7e-05,172.31.40.0-255,66,1768,77,290743
30858,3.3e-05,74.125.24.0-255,2902,4670,77,290743
30859,3.7e-05,172.31.40.0-255,66,4736,77,290743
30860,4e-05,74.125.24.0-255,1484,6220,77,290743
30861,5.1e-05,172.31.40.0-255,66,6286,77,290743
30862,6.8e-05,74.125.24.0-255,5738,12024,77,290743
30863,7.5e-05,172.31.40.0-255,66,12090,77,290743
30864,8e-05,74.125.24.0-255,2023,14113,77,290743
30865,8.3e-05,172.31.40.0-255,66,14179,77,290743
30866,0.000255,74.125.24.0-255,1484,15663,77,290743
30867,0.000262,172.31.40.0-255,66,15729,77,290743
30868,0.000268,74.125.24.0-255,2902,18631,77,290743
30869,0.000271,172.31.40.0-255,66,18697,77,290743
30870,0.000275,74.125.24.0-255,2902,21599,77,290743
30871,0.000281,172.31.40.0-255,66,21665,77,290743
30872,0.000295,74.125.24.0-255,2902,24567,77,290743
30873,0.000298,172.31.40.0-255,66,24633,77,290743
30874,0.000322,74.125.24.0-255,4320,28953,77,290743
30875,0.000325,172.31.40.0-255,66,29019,77,290743
30876,0.000329,74.125.24.0-255,2543,31562,77,290743
30877,0.000332,172.31.40.0-255,66,31628,77,290743
30878,0.000337,74.125.24.0-255,2902,34530,77,290743
30879,0.000339,172.31.40.0-255,66,34596,77,290743
30880,0.000374,74.125.24.0-255,7156,41752,77,290743
30881,0.000377,172.31.40.0-255,66,41818,77,290743
30882,0.000384,74.125.24.0-255,6797,48615,77,290743
30883,0.000387,172.31.40.0-255,66,48681,77,290743
30884,0.000516,74.125.24.0-255,1484,50165,77,290743
30885,0.00052,172.31.40.0-255,66,50231,77,290743
30886,0.000525,74.125.24.0-255,2902,53133,77,290743
30887,0.000527,172.31.40.0-255,66,53199,77,290743
30888,0.000531,74.125.24.0-255,1484,54683,77,290743
30889,0.000558,74.125.24.0-255,4320,59003,77,290743
30890,0.000561,172.31.40.0-255,66,59069,77,290743
30891,0.000583,74.125.24.0-255,7069,66138,77,290743
30892,0.000586,172.31.40.0-255,66,66204,77,290743
30893,0.00061,74.125.24.0-255,131,66335,77,290743
30894,0.000762,74.125.24.0-255,348,66683,77,290743
30895,0.001048,74.125.24.0-255,1484,68167,77,290743
30896,0.001053,172.31.40.0-255,66,68233,77,290743
30897,0.001059,74.125.24.0-255,2902,71135,77,290743
30898,0.001061,172.31.40.0-255,66,71201,77,290743
30899,0.001088,74.125.24.0-255,5738,76939,77,290743
30900,0.001094,172.31.40.0-255,66,77005,77,290743
30901,0.001103,74.125.24.0-255,8574,85579,77,290743
30902,0.001105,172.31.40.0-255,66,85645,77,290743
30903,0.001151,74.125.24.0-255,8574,94219,77,290743
30904,0.001153,172.31.40.0-255,66,94285,77,290743
30905,0.001173,74.125.24.0-255,6438,100723,77,290743
30906,0.001204,172.31.40.0-255,66,100789,77,290743
30907,0.001546,74.125.24.0-255,1484,102273,77,290743
30908,0.001563,74.125.24.0-255,2902,105175,77,290743
30909,0.001567,172.31.40.0-255,66,105241,77,290743
30910,0.001571,74.125.24.0-255,1484,106725,77,290743
30911,0.001589,74.125.24.0-255,4320,111045,77,290743
30912,0.001591,172.31.40.0-255,66,111111,77,290743
30913,0.001594,74.125.24.0-255,1484,112595,77,290743
30914,0.001632,74.125.24.0-255,7156,119751,77,290743
30915,0.001635,172.31.40.0-255,66,119817,77,290743
30916,0.001645,74.125.24.0-255,9992,129809,77,290743
30917,0.001647,172.31.40.0-255,66,129875,77,290743
30918,0.001659,74.125.24.0-255,5020,134895,77,290743
30919,0.001662,172.31.40.0-255,66,134961,77,290743
30920,0.001772,74.125.24.0-255,1484,136445,77,290743
30921,0.001779,74.125.24.0-255,2902,139347,77,290743
30922,0.00179,172.31.40.0-255,66,139413,77,290743
30923,0.001802,74.125.24.0-255,1484,140897,77,290743
30924,0.001827,74.125.24.0-255,2902,143799,77,290743
30925,0.001835,74.125.24.0-255,8574,152373,77,290743
30926,0.001843,172.31.40.0-255,66,152439,77,290743
30927,0.001846,172.31.40.0-255,66,152505,77,290743
30928,0.001852,74.125.24.0-255,4320,156825,77,290743
30929,0.001854,172.31.40.0-255,66,156891,77,290743
30930,0.001885,74.125.24.0-255,8574,165465,77,290743
30931,0.001888,172.31.40.0-255,66,165531,77,290743
30932,0.001919,74.125.24.0-255,3602,169133,77,290743
30933,0.001922,172.31.40.0-255,66,169199,77,290743
30934,0.001928,74.125.24.0-255,4320,173519,77,290743
30935,0.00193,172.31.40.0-255,66,173585,77,290743
30936,0.001965,74.125.24.0-255,9992,183577,77,290743
30937,0.001968,172.31.40.0-255,66,183643,77,290743
30938,0.002003,74.125.24.0-255,11410,195053,77,290743
30939,0.002006,172.31.40.0-255,66,195119,77,290743
30940,0.002013,74.125.24.0-255,5738,200857,77,290743
30941,0.002015,172.31.40.0-255,66,200923,77,290743
30942,0.002076,74.125.24.0-255,2184,203107,77,290743
30943,0.00208,172.31.40.0-255,66,203173,77,290743
30944,0.002163,74.125.24.0-255,1484,204657,77,290743
30945,0.00218,74.125.24.0-255,2902,207559,77,290743
30946,0.002183,172.31.40.0-255,66,207625,77,290743
30947,0.002189,74.125.24.0-255,2902,210527,77,290743
30948,0.002191,172.31.40.0-255,66,210593,77,290743
30949,0.002223,74.125.24.0-255,2902,213495,77,290743
30950,0.002226,172.31.40.0-255,66,213561,77,290743
30951,0.002231,74.125.24.0-255,2902,216463,77,290743
30952,0.002233,172.31.40.0-255,66,216529,77,290743
30953,0.002242,74.125.24.0-255,8574,225103,77,290743
30954,0.002246,172.31.40.0-255,66,225169,77,290743
30955,0.002279,74.125.24.0-255,1484,226653,77,290743
30956,0.00229,74.125.24.0-255,10692,237345,77,290743
30957,0.002293,172.31.40.0-255,66,237411,77,290743
30958,0.002359,74.125.24.0-255,1484,238895,77,290743
30959,0.002363,74.125.24.0-255,1484,240379,77,290743
30960,0.002366,172.31.40.0-255,66,240445,77,290743
30961,0.002387,74.125.24.0-255,1484,241929,77,290743
30962,0.002393,74.125.24.0-255,5738,247667,77,290743
30963,0.002396,172.31.40.0-255,66,247733,77,290743
30964,0.002436,74.125.24.0-255,7156,254889,77,290743
30965,0.002439,172.31.40.0-255,66,254955,77,290743
30966,0.002484,172.31.40.0-255,66,255021,77,290743
30967,0.002487,74.125.24.0-255,2184,257205,77,290743
30968,0.002489,172.31.40.0-255,66,257271,77,290743
30969,0.005113,74.125.24.0-255,4320,261591,77,290743
30970,0.005121,172.31.40.0-255,66,261657,77,290743
30971,0.005147,74.125.24.0-255,1484,263141,77,290743
30972,0.007686,74.125.24.0-255,4320,267461,77,290743
30973,0.007692,172.31.40.0-255,66,267527,77,290743
30974,0.010301,74.125.24.0-255,5738,273265,77,290743
30975,0.010307,172.31.40.0-255,66,273331,77,290743
30976,0.01345,74.125.24.0-255,5738,279069,77,290743
30977,0.013458,172.31.40.0-255,66,279135,77,290743
30978,0.016039,74.125.24.0-255,5738,284873,77,290743
30979,0.016049,172.31.40.0-255,66,284939,77,290743
30980,0.018681,74.125.24.0-255,5738,290677,77,290743
30981,0.01869,172.31.40.0-255,66,290743,77,290743
30982,0.0,172.31.40.0-255,105,105,77,210
30983,0.001809,157.240.25.0-255,105,210,77,210
30984,0.0,74.125.68.0-255,152,152,77,210744
30985,1.9e-05,172.31.40.0-255,66,218,77,210744
30986,2.7e-05,74.125.68.0-255,1484,1702,77,210744
30987,3.2e-05,172.31.40.0-255,66,1768,77,210744
30988,3.8e-05,74.125.68.0-255,2902,4670,77,210744
30989,4.9e-05,172.31.40.0-255,66,4736,77,210744
30990,5.4e-05,74.125.68.0-255,2902,7638,77,210744
30991,5.7e-05,172.31.40.0-255,66,7704,77,210744
30992,6.4e-05,74.125.68.0-255,4320,12024,77,210744
30993,6.6e-05,172.31.40.0-255,66,12090,77,210744
30994,9.9e-05,74.125.68.0-255,2010,14100,77,210744
30995,0.000102,172.31.40.0-255,66,14166,77,210744
30996,0.000275,74.125.68.0-255,1484,15650,77,210744
30997,0.00028,172.31.40.0-255,66,15716,77,210744
30998,0.000285,74.125.68.0-255,2902,18618,77,210744
30999,0.000288,172.31.40.0-255,66,18684,77,210744
31000,0.000311,74.125.68.0-255,4320,23004,77,210744
31001,0.000313,172.31.40.0-255,66,23070,77,210744
31002,0.000323,74.125.68.0-255,5738,28808,77,210744
31003,0.000325,172.31.40.0-255,66,28874,77,210744
31004,0.000351,74.125.68.0-255,2543,31417,77,210744
31005,0.000353,172.31.40.0-255,66,31483,77,210744
31006,0.000441,74.125.68.0-255,1484,32967,77,210744
31007,0.000444,172.31.40.0-255,66,33033,77,210744
31008,0.000447,74.125.68.0-255,1484,34517,77,210744
31009,0.000449,172.31.40.0-255,66,34583,77,210744
31010,0.000453,74.125.68.0-255,1484,36067,77,210744
31011,0.00046,172.31.40.0-255,66,36133,77,210744
31012,0.00049,74.125.68.0-255,1484,37617,77,210744
31013,0.000492,172.31.40.0-255,66,37683,77,210744
31014,0.000498,74.125.68.0-255,5738,43421,77,210744
31015,0.0005,172.31.40.0-255,66,43487,77,210744
31016,0.000511,74.125.68.0-255,5379,48866,77,210744
31017,0.000513,172.31.40.0-255,66,48932,77,210744
31018,0.000516,74.125.68.0-255,1484,50416,77,210744
31019,0.00055,74.125.68.0-255,4320,54736,77,210744
31020,0.000553,172.31.40.0-255,66,54802,77,210744
31021,0.000558,74.125.68.0-255,4320,59122,77,210744
31022,0.00056,172.31.40.0-255,66,59188,77,210744
31023,0.000584,74.125.68.0-255,5738,64926,77,210744
31024,0.000587,172.31.40.0-255,66,64992,77,210744
31025,0.00059,74.125.68.0-255,1125,66117,77,210744
31026,0.000956,74.125.68.0-255,648,66765,77,210744
31027,0.00096,172.31.40.0-255,66,66831,77,210744
31028,0.001063,74.125.68.0-255,1484,68315,77,210744
31029,0.001078,74.125.68.0-255,2902,71217,77,210744
31030,0.00108,172.31.40.0-255,66,71283,77,210744
31031,0.001112,74.125.68.0-255,5738,77021,77,210744
31032,0.001115,172.31.40.0-255,66,77087,77,210744
31033,0.00112,74.125.68.0-255,2902,79989,77,210744
31034,0.001121,172.31.40.0-255,66,80055,77,210744
31035,0.001145,74.125.68.0-255,3410,83465,77,210744
31036,0.001147,172.31.40.0-255,66,83531,77,210744
31037,0.001173,74.125.68.0-255,1484,85015,77,210744
31038,0.001195,74.125.68.0-255,2902,87917,77,210744
31039,0.001198,172.31.40.0-255,66,87983,77,210744
31040,0.001218,74.125.68.0-255,5738,93721,77,210744
31041,0.00122,172.31.40.0-255,66,93787,77,210744
31042,0.001226,74.125.68.0-255,4320,98107,77,210744
31043,0.001228,172.31.40.0-255,66,98173,77,210744
31044,0.001264,74.125.68.0-255,2543,100716,77,210744
31045,0.001266,172.31.40.0-255,66,100782,77,210744
31046,0.001372,74.125.68.0-255,1484,102266,77,210744
31047,0.001377,74.125.68.0-255,2902,105168,77,210744
31048,0.00138,172.31.40.0-255,66,105234,77,210744
31049,0.001411,74.125.68.0-255,5738,110972,77,210744
31050,0.001415,74.125.68.0-255,2902,113874,77,210744
31051,0.001418,172.31.40.0-255,66,113940,77,210744
31052,0.001421,172.31.40.0-255,66,114006,77,210744
31053,0.001447,74.125.68.0-255,4320,118326,77,210744
31054,0.001449,172.31.40.0-255,66,118392,77,210744
31055,0.001491,74.125.68.0-255,8574,126966,77,210744
31056,0.001495,172.31.40.0-255,66,127032,77,210744
31057,0.0015,74.125.68.0-255,4320,131352,77,210744
31058,0.001503,172.31.40.0-255,66,131418,77,210744
31059,0.001527,74.125.68.0-255,3602,135020,77,210744
31060,0.001533,172.31.40.0-255,66,135086,77,210744
31061,0.0016,74.125.68.0-255,1484,136570,77,210744
31062,0.001612,74.125.68.0-255,2902,139472,77,210744
31063,0.001615,172.31.40.0-255,66,139538,77,210744
31064,0.001619,74.125.68.0-255,1484,141022,77,210744
31065,0.001622,74.125.68.0-255,1484,142506,77,210744
31066,0.001624,172.31.40.0-255,66,142572,77,210744
31067,0.001658,74.125.68.0-255,1484,144056,77,210744
31068,0.001666,74.125.68.0-255,5738,149794,77,210744
31069,0.001669,172.31.40.0-255,66,149860,77,210744
31070,0.001712,74.125.68.0-255,1484,151344,77,210744
31071,0.00173,74.125.68.0-255,9992,161336,77,210744
31072,0.001733,172.31.40.0-255,66,161402,77,210744
31073,0.001741,74.125.68.0-255,7856,169258,77,210744
31074,0.001743,172.31.40.0-255,66,169324,77,210744
31075,0.004219,74.125.68.0-255,5738,175062,77,210744
31076,0.004226,172.31.40.0-255,66,175128,77,210744
31077,0.006693,74.125.68.0-255,2902,178030,77,210744
31078,0.006697,172.31.40.0-255,66,178096,77,210744
31079,0.006715,74.125.68.0-255,2902,180998,77,210744
31080,0.006717,172.31.40.0-255,66,181064,77,210744
31081,0.009167,74.125.68.0-255,2902,183966,77,210744
31082,0.009175,172.31.40.0-255,66,184032,77,210744
31083,0.009206,74.125.68.0-255,2902,186934,77,210744
31084,0.009209,172.31.40.0-255,66,187000,77,210744
31085,0.011654,74.125.68.0-255,2902,189902,77,210744
31086,0.011663,172.31.40.0-255,66,189968,77,210744
31087,0.011694,74.125.68.0-255,2902,192870,77,210744
31088,0.011696,172.31.40.0-255,66,192936,77,210744
31089,0.014143,74.125.68.0-255,2902,195838,77,210744
31090,0.014151,172.31.40.0-255,66,195904,77,210744
31091,0.014183,74.125.68.0-255,2902,198806,77,210744
31092,0.014186,172.31.40.0-255,66,198872,77,210744
31093,0.016633,74.125.68.0-255,2902,201774,77,210744
31094,0.016644,172.31.40.0-255,66,201840,77,210744
31095,0.016679,74.125.68.0-255,2902,204742,77,210744
31096,0.016682,172.31.40.0-255,66,204808,77,210744
31097,0.019112,74.125.68.0-255,2902,207710,77,210744
31098,0.01912,172.31.40.0-255,66,207776,77,210744
31099,0.019156,74.125.68.0-255,2902,210678,77,210744
31100,0.019158,172.31.40.0-255,66,210744,77,210744
31101,0.0,74.125.24.0-255,150,150,77,225346
31102,2.2e-05,172.31.40.0-255,66,216,77,225346
31103,2.9e-05,74.125.24.0-255,1484,1700,77,225346
31104,3.5e-05,172.31.40.0-255,66,1766,77,225346
31105,4.8e-05,74.125.24.0-255,2902,4668,77,225346
31106,5.1e-05,172.31.40.0-255,66,4734,77,225346
31107,5.8e-05,74.125.24.0-255,5738,10472,77,225346
31108,6.1e-05,172.31.40.0-255,66,10538,77,225346
31109,6.7e-05,74.125.24.0-255,3488,14026,77,225346
31110,6.9e-05,172.31.40.0-255,66,14092,77,225346
31111,0.000165,74.125.24.0-255,1484,15576,77,225346
31112,0.000169,172.31.40.0-255,66,15642,77,225346
31113,0.000196,74.125.24.0-255,2902,18544,77,225346
31114,0.000199,172.31.40.0-255,66,18610,77,225346
31115,0.000205,74.125.24.0-255,5738,24348,77,225346
31116,0.000208,172.31.40.0-255,66,24414,77,225346
31117,0.00021,74.125.24.0-255,1484,25898,77,225346
31118,0.000213,172.31.40.0-255,66,25964,77,225346
31119,0.000238,74.125.24.0-255,5379,31343,77,225346
31120,0.000241,172.31.40.0-255,66,31409,77,225346
31121,0.000355,74.125.24.0-255,1484,32893,77,225346
31122,0.00036,172.31.40.0-255,66,32959,77,225346
31123,0.000366,74.125.24.0-255,2902,35861,77,225346
31124,0.000368,172.31.40.0-255,66,35927,77,225346
31125,0.000371,74.125.24.0-255,1484,37411,77,225346
31126,0.000379,172.31.40.0-255,66,37477,77,225346
31127,0.00041,74.125.24.0-255,4320,41797,77,225346
31128,0.000413,172.31.40.0-255,66,41863,77,225346
31129,0.000419,74.125.24.0-255,4320,46183,77,225346
31130,0.000421,172.31.40.0-255,66,46249,77,225346
31131,0.000463,74.125.24.0-255,9633,55882,77,225346
31132,0.000467,172.31.40.0-255,66,55948,77,225346
31133,0.000476,74.125.24.0-255,8574,64522,77,225346
31134,0.000483,172.31.40.0-255,66,64588,77,225346
31135,0.000486,74.125.24.0-255,1125,65713,77,225346
31136,0.000532,74.125.24.0-255,396,66109,77,225346
31137,0.000659,74.125.24.0-255,347,66456,77,225346
31138,0.000663,172.31.40.0-255,66,66522,77,225346
31139,0.000751,74.125.24.0-255,1484,68006,77,225346
31140,0.000756,74.125.24.0-255,1484,69490,77,225346
31141,0.000759,172.31.40.0-255,66,69556,77,225346
31142,0.000782,74.125.24.0-255,1484,71040,77,225346
31143,0.000789,74.125.24.0-255,5738,76778,77,225346
31144,0.000792,172.31.40.0-255,66,76844,77,225346
31145,0.000796,74.125.24.0-255,2902,79746,77,225346
31146,0.000798,172.31.40.0-255,66,79812,77,225346
31147,0.000817,74.125.24.0-255,1484,81296,77,225346
31148,0.000822,74.125.24.0-255,1994,83290,77,225346
31149,0.000829,172.31.40.0-255,66,83356,77,225346
31150,0.000989,74.125.24.0-255,1484,84840,77,225346
31151,0.000995,74.125.24.0-255,2902,87742,77,225346
31152,0.000999,172.31.40.0-255,66,87808,77,225346
31153,0.001005,74.125.24.0-255,5738,93546,77,225346
31154,0.001008,172.31.40.0-255,66,93612,77,225346
31155,0.001055,74.125.24.0-255,12828,106440,77,225346
31156,0.001058,172.31.40.0-255,66,106506,77,225346
31157,0.001075,74.125.24.0-255,10692,117198,77,225346
31158,0.001078,172.31.40.0-255,66,117264,77,225346
31159,0.001329,74.125.24.0-255,1484,118748,77,225346
31160,0.001337,74.125.24.0-255,2902,121650,77,225346
31161,0.00134,172.31.40.0-255,66,121716,77,225346
31162,0.001344,74.125.24.0-255,1484,123200,77,225346
31163,0.001373,74.125.24.0-255,4320,127520,77,225346
31164,0.001375,172.31.40.0-255,66,127586,77,225346
31165,0.001393,74.125.24.0-255,1484,129070,77,225346
31166,0.001408,74.125.24.0-255,5379,134449,77,225346
31167,0.00141,172.31.40.0-255,66,134515,77,225346
31168,0.001506,74.125.24.0-255,1484,135999,77,225346
31169,0.00151,74.125.24.0-255,1484,137483,77,225346
31170,0.001513,172.31.40.0-255,66,137549,77,225346
31171,0.001546,74.125.24.0-255,1484,139033,77,225346
31172,0.001553,74.125.24.0-255,5738,144771,77,225346
31173,0.001555,172.31.40.0-255,66,144837,77,225346
31174,0.001563,74.125.24.0-255,6797,151634,77,225346
31175,0.001565,172.31.40.0-255,66,151700,77,225346
31176,0.00201,74.125.24.0-255,1484,153184,77,225346
31177,0.002014,74.125.24.0-255,1484,154668,77,225346
31178,0.002018,172.31.40.0-255,66,154734,77,225346
31179,0.002044,74.125.24.0-255,1484,156218,77,225346
31180,0.002051,74.125.24.0-255,5738,161956,77,225346
31181,0.002053,172.31.40.0-255,66,162022,77,225346
31182,0.002083,74.125.24.0-255,8574,170596,77,225346
31183,0.002086,172.31.40.0-255,66,170662,77,225346
31184,0.002105,74.125.24.0-255,4320,174982,77,225346
31185,0.002108,172.31.40.0-255,66,175048,77,225346
31186,0.002112,74.125.24.0-255,2902,177950,77,225346
31187,0.002114,172.31.40.0-255,66,178016,77,225346
31188,0.002152,74.125.24.0-255,4320,182336,77,225346
31189,0.002155,172.31.40.0-255,66,182402,77,225346
31190,0.00216,74.125.24.0-255,3602,186004,77,225346
31191,0.002162,172.31.40.0-255,66,186070,77,225346
31192,0.00447,74.125.24.0-255,5738,191808,77,225346
31193,0.004476,172.31.40.0-255,66,191874,77,225346
31194,0.006837,74.125.24.0-255,4320,196194,77,225346
31195,0.006841,172.31.40.0-255,66,196260,77,225346
31196,0.006865,74.125.24.0-255,1484,197744,77,225346
31197,0.009171,74.125.24.0-255,4320,202064,77,225346
31198,0.009179,172.31.40.0-255,66,202130,77,225346
31199,0.011523,74.125.24.0-255,5738,207868,77,225346
31200,0.011531,172.31.40.0-255,66,207934,77,225346
31201,0.013865,74.125.24.0-255,5738,213672,77,225346
31202,0.013874,172.31.40.0-255,66,213738,77,225346
31203,0.01619,74.125.24.0-255,5738,219476,77,225346
31204,0.016202,172.31.40.0-255,66,219542,77,225346
31205,0.018558,74.125.24.0-255,5738,225280,77,225346
31206,0.018568,172.31.40.0-255,66,225346,77,225346
31207,0.0,74.125.200.0-255,148,148,77,212823
31208,2.3e-05,172.31.40.0-255,66,214,77,212823
31209,2.9e-05,74.125.200.0-255,1484,1698,77,212823
31210,3.4e-05,172.31.40.0-255,66,1764,77,212823
31211,4e-05,74.125.200.0-255,2902,4666,77,212823
31212,4.3e-05,172.31.40.0-255,66,4732,77,212823
31213,4.7e-05,74.125.200.0-255,1484,6216,77,212823
31214,4.9e-05,172.31.40.0-255,66,6282,77,212823
31215,7.1e-05,74.125.200.0-255,2902,9184,77,212823
31216,7.4e-05,172.31.40.0-255,66,9250,77,212823
31217,9.8e-05,74.125.200.0-255,4836,14086,77,212823
31218,0.000101,172.31.40.0-255,66,14152,77,212823
31219,0.000132,74.125.200.0-255,1484,15636,77,212823
31220,0.000134,172.31.40.0-255,66,15702,77,212823
31221,0.00015,74.125.200.0-255,1484,17186,77,212823
31222,0.000152,172.31.40.0-255,66,17252,77,212823
31223,0.000158,74.125.200.0-255,4320,21572,77,212823
31224,0.00016,172.31.40.0-255,66,21638,77,212823
31225,0.000191,74.125.200.0-255,7156,28794,77,212823
31226,0.000193,172.31.40.0-255,66,28860,77,212823
31227,0.000235,74.125.200.0-255,2543,31403,77,212823
31228,0.000237,172.31.40.0-255,66,31469,77,212823
31229,0.000307,74.125.200.0-255,1484,32953,77,212823
31230,0.00031,172.31.40.0-255,66,33019,77,212823
31231,0.000316,74.125.200.0-255,2902,35921,77,212823
31232,0.000318,172.31.40.0-255,66,35987,77,212823
31233,0.000337,74.125.200.0-255,2902,38889,77,212823
31234,0.00034,172.31.40.0-255,66,38955,77,212823
31235,0.000355,74.125.200.0-255,2902,41857,77,212823
31236,0.000357,172.31.40.0-255,66,41923,77,212823
31237,0.000371,74.125.200.0-255,1484,43407,77,212823
31238,0.000373,172.31.40.0-255,66,43473,77,212823
31239,0.000387,74.125.200.0-255,2902,46375,77,212823
31240,0.000389,172.31.40.0-255,66,46441,77,212823
31241,0.000412,74.125.200.0-255,2543,48984,77,212823
31242,0.000414,172.31.40.0-255,66,49050,77,212823
31243,0.000747,74.125.200.0-255,1484,50534,77,212823
31244,0.000769,74.125.200.0-255,2902,53436,77,212823
31245,0.000773,172.31.40.0-255,66,53502,77,212823
31246,0.00078,74.125.200.0-255,5738,59240,77,212823
31247,0.000782,172.31.40.0-255,66,59306,77,212823
31248,0.000814,74.125.200.0-255,1484,60790,77,212823
31249,0.000819,74.125.200.0-255,2902,63692,77,212823
31250,0.000822,172.31.40.0-255,66,63758,77,212823
31251,0.000835,74.125.200.0-255,2543,66301,77,212823
31252,0.000837,172.31.40.0-255,66,66367,77,212823
31253,0.000901,74.125.200.0-255,1484,67851,77,212823
31254,0.000914,74.125.200.0-255,2902,70753,77,212823
31255,0.000916,172.31.40.0-255,66,70819,77,212823
31256,0.00092,74.125.200.0-255,1484,72303,77,212823
31257,0.000941,74.125.200.0-255,4320,76623,77,212823
31258,0.000944,172.31.40.0-255,66,76689,77,212823
31259,0.000948,74.125.200.0-255,2902,79591,77,212823
31260,0.00095,172.31.40.0-255,66,79657,77,212823
31261,0.000955,74.125.200.0-255,3961,83618,77,212823
31262,0.000958,172.31.40.0-255,66,83684,77,212823
31263,0.000975,74.125.200.0-255,646,84330,77,212823
31264,0.001274,74.125.200.0-255,1484,85814,77,212823
31265,0.00128,172.31.40.0-255,66,85880,77,212823
31266,0.001292,74.125.200.0-255,2902,88782,77,212823
31267,0.001294,172.31.40.0-255,66,88848,77,212823
31268,0.001297,74.125.200.0-255,1484,90332,77,212823
31269,0.0013,74.125.200.0-255,1484,91816,77,212823
31270,0.001303,172.31.40.0-255,66,91882,77,212823
31271,0.001326,74.125.200.0-255,1484,93366,77,212823
31272,0.001333,74.125.200.0-255,5738,99104,77,212823
31273,0.001335,172.31.40.0-255,66,99170,77,212823
31274,0.00136,74.125.200.0-255,8574,107744,77,212823
31275,0.001363,172.31.40.0-255,66,107810,77,212823
31276,0.001397,74.125.200.0-255,9992,117802,77,212823
31277,0.0014,172.31.40.0-255,66,117868,77,212823
31278,0.001403,74.125.200.0-255,203,118071,77,212823
31279,0.00156,74.125.200.0-255,1484,119555,77,212823
31280,0.001567,172.31.40.0-255,66,119621,77,212823
31281,0.001586,74.125.200.0-255,2902,122523,77,212823
31282,0.001588,172.31.40.0-255,66,122589,77,212823
31283,0.001598,74.125.200.0-255,1484,124073,77,212823
31284,0.001621,74.125.200.0-255,4320,128393,77,212823
31285,0.001624,74.125.200.0-255,1484,129877,77,212823
31286,0.001628,74.125.200.0-255,2902,132779,77,212823
31287,0.001631,172.31.40.0-255,66,132845,77,212823
31288,0.001635,172.31.40.0-255,66,132911,77,212823
31289,0.00165,74.125.200.0-255,5738,138649,77,212823
31290,0.001652,172.31.40.0-255,66,138715,77,212823
31291,0.001657,74.125.200.0-255,4320,143035,77,212823
31292,0.001659,172.31.40.0-255,66,143101,77,212823
31293,0.001663,74.125.200.0-255,2902,146003,77,212823
31294,0.001666,172.31.40.0-255,66,146069,77,212823
31295,0.001687,74.125.200.0-255,2902,148971,77,212823
31296,0.001691,172.31.40.0-255,66,149037,77,212823
31297,0.001713,74.125.200.0-255,3602,152639,77,212823
31298,0.001715,172.31.40.0-255,66,152705,77,212823
31299,0.001926,74.125.200.0-255,1484,154189,77,212823
31300,0.001932,74.125.200.0-255,2902,157091,77,212823
31301,0.001935,172.31.40.0-255,66,157157,77,212823
31302,0.001954,74.125.200.0-255,2902,160059,77,212823
31303,0.001956,172.31.40.0-255,66,160125,77,212823
31304,0.001959,74.125.200.0-255,1484,161609,77,212823
31305,0.003864,74.125.200.0-255,1484,163093,77,212823
31306,0.003871,172.31.40.0-255,66,163159,77,212823
31307,0.003894,74.125.200.0-255,2902,166061,77,212823
31308,0.003896,172.31.40.0-255,66,166127,77,212823
31309,0.005813,74.125.200.0-255,2902,169029,77,212823
31310,0.005816,172.31.40.0-255,66,169095,77,212823
31311,0.005835,74.125.200.0-255,2902,171997,77,212823
31312,0.005837,172.31.40.0-255,66,172063,77,212823
31313,0.007762,74.125.200.0-255,2902,174965,77,212823
31314,0.007768,172.31.40.0-255,66,175031,77,212823
31315,0.007787,74.125.200.0-255,2902,177933,77,212823
31316,0.007789,172.31.40.0-255,66,177999,77,212823
31317,0.009771,74.125.200.0-255,5738,183737,77,212823
31318,0.009778,172.31.40.0-255,66,183803,77,212823
31319,0.011738,74.125.200.0-255,5738,189541,77,212823
31320,0.011747,172.31.40.0-255,66,189607,77,212823
31321,0.013688,74.125.200.0-255,5738,195345,77,212823
31322,0.013698,172.31.40.0-255,66,195411,77,212823
31323,0.015645,74.125.200.0-255,5738,201149,77,212823
31324,0.015652,172.31.40.0-255,66,201215,77,212823
31325,0.017604,74.125.200.0-255,5738,206953,77,212823
31326,0.01761,172.31.40.0-255,66,207019,77,212823
31327,0.019597,74.125.200.0-255,5738,212757,77,212823
31328,0.019604,172.31.40.0-255,66,212823,77,212823
31329,0.0,172.31.40.0-255,66,66,77,66
31330,0.0,172.217.194.0-255,153,153,77,243722
31331,1.7e-05,172.31.40.0-255,66,219,77,243722
31332,2.4e-05,172.217.194.0-255,1484,1703,77,243722
31333,2.8e-05,172.31.40.0-255,66,1769,77,243722
31334,3.4e-05,172.217.194.0-255,2902,4671,77,243722
31335,3.7e-05,172.31.40.0-255,66,4737,77,243722
31336,4.3e-05,172.217.194.0-255,4320,9057,77,243722
31337,4.7e-05,172.31.40.0-255,66,9123,77,243722
31338,7.2e-05,172.217.194.0-255,2902,12025,77,243722
31339,7.6e-05,172.31.40.0-255,66,12091,77,243722
31340,8e-05,172.217.194.0-255,1983,14074,77,243722
31341,8.2e-05,172.31.40.0-255,66,14140,77,243722
31342,0.000157,172.217.194.0-255,1484,15624,77,243722
31343,0.00016,172.31.40.0-255,66,15690,77,243722
31344,0.000165,172.217.194.0-255,2902,18592,77,243722
31345,0.000168,172.31.40.0-255,66,18658,77,243722
31346,0.000181,172.217.194.0-255,2902,21560,77,243722
31347,0.000183,172.31.40.0-255,66,21626,77,243722
31348,0.000208,172.217.194.0-255,2902,24528,77,243722
31349,0.000211,172.31.40.0-255,66,24594,77,243722
31350,0.000219,172.217.194.0-255,6797,31391,77,243722
31351,0.000221,172.31.40.0-255,66,31457,77,243722
31352,0.000242,172.217.194.0-255,7156,38613,77,243722
31353,0.000244,172.31.40.0-255,66,38679,77,243722
31354,0.000272,172.217.194.0-255,7156,45835,77,243722
31355,0.000274,172.31.40.0-255,66,45901,77,243722
31356,0.000279,172.217.194.0-255,2543,48444,77,243722
31357,0.00028,172.31.40.0-255,66,48510,77,243722
31358,0.000682,172.217.194.0-255,1484,49994,77,243722
31359,0.000687,172.31.40.0-255,66,50060,77,243722
31360,0.000693,172.217.194.0-255,2902,52962,77,243722
31361,0.000695,172.31.40.0-255,66,53028,77,243722
31362,0.000717,172.217.194.0-255,5738,58766,77,243722
31363,0.00072,172.31.40.0-255,66,58832,77,243722
31364,0.000723,172.217.194.0-255,1484,60316,77,243722
31365,0.000757,172.217.194.0-255,2902,63218,77,243722
31366,0.000759,172.31.40.0-255,66,63284,77,243722
31367,0.000777,172.217.194.0-255,2543,65827,77,243722
31368,0.000779,172.31.40.0-255,66,65893,77,243722
31369,0.000849,172.217.194.0-255,645,66538,77,243722
31370,0.00103,172.31.40.0-255,66,66604,77,243722
31371,0.001238,172.217.194.0-255,1484,68088,77,243722
31372,0.001248,172.217.194.0-255,2902,70990,77,243722
31373,0.001252,172.31.40.0-255,66,71056,77,243722
31374,0.001276,172.217.194.0-255,4320,75376,77,243722
31375,0.001279,172.31.40.0-255,66,75442,77,243722
31376,0.001283,172.217.194.0-255,1484,76926,77,243722
31377,0.001306,172.217.194.0-255,7156,84082,77,243722
31378,0.001309,172.31.40.0-255,66,84148,77,243722
31379,0.001314,172.217.194.0-255,2902,87050,77,243722
31380,0.001316,172.31.40.0-255,66,87116,77,243722
31381,0.001342,172.217.194.0-255,13528,100644,77,243722
31382,0.001345,172.31.40.0-255,66,100710,77,243722
31383,0.001663,172.217.194.0-255,1484,102194,77,243722
31384,0.00167,172.217.194.0-255,2902,105096,77,243722
31385,0.001674,172.31.40.0-255,66,105162,77,243722
31386,0.001677,172.217.194.0-255,1484,106646,77,243722
31387,0.001729,172.217.194.0-255,4320,110966,77,243722
31388,0.001732,172.31.40.0-255,66,111032,77,243722
31389,0.001743,172.217.194.0-255,12828,123860,77,243722
31390,0.001745,172.31.40.0-255,66,123926,77,243722
31391,0.001755,172.217.194.0-255,10692,134618,77,243722
31392,0.001757,172.31.40.0-255,66,134684,77,243722
31393,0.001888,172.217.194.0-255,1484,136168,77,243722
31394,0.001895,172.217.194.0-255,2902,139070,77,243722
31395,0.001898,172.31.40.0-255,66,139136,77,243722
31396,0.001904,172.217.194.0-255,4320,143456,77,243722
31397,0.001905,172.31.40.0-255,66,143522,77,243722
31398,0.001919,172.217.194.0-255,1484,145006,77,243722
31399,0.001938,172.217.194.0-255,7156,152162,77,243722
31400,0.001941,172.31.40.0-255,66,152228,77,243722
31401,0.001963,172.217.194.0-255,5738,157966,77,243722
31402,0.001966,172.31.40.0-255,66,158032,77,243722
31403,0.001978,172.217.194.0-255,2902,160934,77,243722
31404,0.00198,172.31.40.0-255,66,161000,77,243722
31405,0.00201,172.217.194.0-255,7856,168856,77,243722
31406,0.002013,172.31.40.0-255,66,168922,77,243722
31407,0.002255,172.217.194.0-255,1484,170406,77,243722
31408,0.002261,172.217.194.0-255,2902,173308,77,243722
31409,0.002265,172.31.40.0-255,66,173374,77,243722
31410,0.002286,172.217.194.0-255,4320,177694,77,243722
31411,0.002288,172.31.40.0-255,66,177760,77,243722
31412,0.00229,172.217.194.0-255,1484,179244,77,243722
31413,0.002315,172.217.194.0-255,4320,183564,77,243722
31414,0.002317,172.31.40.0-255,66,183630,77,243722
31415,0.002341,172.217.194.0-255,7156,190786,77,243722
31416,0.002343,172.31.40.0-255,66,190852,77,243722
31417,0.002353,172.217.194.0-255,12110,202962,77,243722
31418,0.002355,172.31.40.0-255,66,203028,77,243722
31419,0.004651,172.217.194.0-255,5738,208766,77,243722
31420,0.004655,172.31.40.0-255,66,208832,77,243722
31421,0.006933,172.217.194.0-255,5738,214570,77,243722
31422,0.006941,172.31.40.0-255,66,214636,77,243722
31423,0.009252,172.217.194.0-255,5738,220374,77,243722
31424,0.009259,172.31.40.0-255,66,220440,77,243722
31425,0.011526,172.217.194.0-255,1484,221924,77,243722
31426,0.011549,172.217.194.0-255,4320,226244,77,243722
31427,0.011555,172.31.40.0-255,66,226310,77,243722
31428,0.01385,172.217.194.0-255,5738,232048,77,243722
31429,0.013858,172.31.40.0-255,66,232114,77,243722
31430,0.016163,172.217.194.0-255,5738,237852,77,243722
31431,0.016171,172.31.40.0-255,66,237918,77,243722
31432,0.018449,172.217.194.0-255,5738,243656,77,243722
31433,0.018455,172.31.40.0-255,66,243722,77,243722
31434,0.0,74.125.24.0-255,152,152,77,241855
31435,1.3e-05,172.31.40.0-255,66,218,77,241855
31436,3.7e-05,74.125.24.0-255,1484,1702,77,241855
31437,4.2e-05,172.31.40.0-255,66,1768,77,241855
31438,4.7e-05,74.125.24.0-255,2902,4670,77,241855
31439,5e-05,172.31.40.0-255,66,4736,77,241855
31440,5.6e-05,74.125.24.0-255,5738,10474,77,241855
31441,5.9e-05,172.31.40.0-255,66,10540,77,241855
31442,0.000104,74.125.24.0-255,3368,13908,77,241855
31443,0.000107,172.31.40.0-255,66,13974,77,241855
31444,0.000475,74.125.24.0-255,1484,15458,77,241855
31445,0.00048,172.31.40.0-255,66,15524,77,241855
31446,0.000487,74.125.24.0-255,2902,18426,77,241855
31447,0.000489,172.31.40.0-255,66,18492,77,241855
31448,0.000496,74.125.24.0-255,5738,24230,77,241855
31449,0.000497,172.31.40.0-255,66,24296,77,241855
31450,0.0005,74.125.24.0-255,1484,25780,77,241855
31451,0.000506,172.31.40.0-255,66,25846,77,241855
31452,0.000535,74.125.24.0-255,4320,30166,77,241855
31453,0.000538,172.31.40.0-255,66,30232,77,241855
31454,0.000546,74.125.24.0-255,7156,37388,77,241855
31455,0.000548,172.31.40.0-255,66,37454,77,241855
31456,0.000578,74.125.24.0-255,6797,44251,77,241855
31457,0.00058,172.31.40.0-255,66,44317,77,241855
31458,0.000589,74.125.24.0-255,3961,48278,77,241855
31459,0.00059,172.31.40.0-255,66,48344,77,241855
31460,0.000603,74.125.24.0-255,4320,52664,77,241855
31461,0.000609,172.31.40.0-255,66,52730,77,241855
31462,0.000636,74.125.24.0-255,7156,59886,77,241855
31463,0.000639,172.31.40.0-255,66,59952,77,241855
31464,0.000662,74.125.24.0-255,4320,64272,77,241855
31465,0.000668,172.31.40.0-255,66,64338,77,241855
31466,0.00069,74.125.24.0-255,1716,66054,77,241855
31467,0.000693,172.31.40.0-255,66,66120,77,241855
31468,0.000737,74.125.24.0-255,1484,67604,77,241855
31469,0.000742,74.125.24.0-255,1484,69088,77,241855
31470,0.000744,172.31.40.0-255,66,69154,77,241855
31471,0.000774,74.125.24.0-255,1484,70638,77,241855
31472,0.000781,74.125.24.0-255,5738,76376,77,241855
31473,0.000784,172.31.40.0-255,66,76442,77,241855
31474,0.00079,74.125.24.0-255,7156,83598,77,241855
31475,0.000793,172.31.40.0-255,66,83664,77,241855
31476,0.000812,74.125.24.0-255,6797,90461,77,241855
31477,0.000815,172.31.40.0-255,66,90527,77,241855
31478,0.000833,74.125.24.0-255,7156,97683,77,241855
31479,0.000836,172.31.40.0-255,66,97749,77,241855
31480,0.000863,74.125.24.0-255,2543,100292,77,241855
31481,0.000865,172.31.40.0-255,66,100358,77,241855
31482,0.001151,74.125.24.0-255,1484,101842,77,241855
31483,0.001159,74.125.24.0-255,2902,104744,77,241855
31484,0.001163,172.31.40.0-255,66,104810,77,241855
31485,0.001169,74.125.24.0-255,5738,110548,77,241855
31486,0.001172,172.31.40.0-255,66,110614,77,241855
31487,0.001198,74.125.24.0-255,11410,122024,77,241855
31488,0.001201,172.31.40.0-255,66,122090,77,241855
31489,0.001224,74.125.24.0-255,1484,123574,77,241855
31490,0.001233,74.125.24.0-255,10692,134266,77,241855
31491,0.001236,172.31.40.0-255,66,134332,77,241855
31492,0.001468,74.125.24.0-255,1484,135816,77,241855
31493,0.001475,74.125.24.0-255,2902,138718,77,241855
31494,0.001479,172.31.40.0-255,66,138784,77,241855
31495,0.001485,74.125.24.0-255,5738,144522,77,241855
31496,0.001487,172.31.40.0-255,66,144588,77,241855
31497,0.00149,74.125.24.0-255,1484,146072,77,241855
31498,0.001524,74.125.24.0-255,11410,157482,77,241855
31499,0.001527,172.31.40.0-255,66,157548,77,241855
31500,0.001536,74.125.24.0-255,10692,168240,77,241855
31501,0.001539,172.31.40.0-255,66,168306,77,241855
31502,0.001727,74.125.24.0-255,1484,169790,77,241855
31503,0.001734,74.125.24.0-255,2902,172692,77,241855
31504,0.001738,172.31.40.0-255,66,172758,77,241855
31505,0.001796,74.125.24.0-255,4320,177078,77,241855
31506,0.001799,172.31.40.0-255,66,177144,77,241855
31507,0.001824,74.125.24.0-255,1484,178628,77,241855
31508,0.001836,74.125.24.0-255,12828,191456,77,241855
31509,0.001839,172.31.40.0-255,66,191522,77,241855
31510,0.001847,74.125.24.0-255,8574,200096,77,241855
31511,0.00185,172.31.40.0-255,66,200162,77,241855
31512,0.001854,74.125.24.0-255,2184,202346,77,241855
31513,0.001857,172.31.40.0-255,66,202412,77,241855
31514,0.004135,74.125.24.0-255,5738,208150,77,241855
31515,0.004141,172.31.40.0-255,66,208216,77,241855
31516,0.004505,172.31.40.0-255,101,208317,77,241855
31517,0.006435,74.125.24.0-255,5738,214055,77,241855
31518,0.006442,172.31.40.0-255,66,214121,77,241855
31519,0.006722,74.125.24.0-255,66,214187,77,241855
31520,0.008724,74.125.24.0-255,5738,219925,77,241855
31521,0.008732,172.31.40.0-255,66,219991,77,241855
31522,0.011009,74.125.24.0-255,4320,224311,77,241855
31523,0.011015,172.31.40.0-255,66,224377,77,241855
31524,0.011041,74.125.24.0-255,1484,225861,77,241855
31525,0.013265,74.125.24.0-255,4320,230181,77,241855
31526,0.013272,172.31.40.0-255,66,230247,77,241855
31527,0.015553,74.125.24.0-255,5738,235985,77,241855
31528,0.015561,172.31.40.0-255,66,236051,77,241855
31529,0.017852,74.125.24.0-255,5738,241789,77,241855
31530,0.017859,172.31.40.0-255,66,241855,77,241855
31531,0.0,74.125.130.0-255,151,151,77,175559
31532,1.4e-05,172.31.40.0-255,66,217,77,175559
31533,2.2e-05,74.125.130.0-255,1484,1701,77,175559
31534,2.6e-05,172.31.40.0-255,66,1767,77,175559
31535,2.9e-05,74.125.130.0-255,1484,3251,77,175559
31536,4.1e-05,172.31.40.0-255,66,3317,77,175559
31537,4.7e-05,74.125.130.0-255,2902,6219,77,175559
31538,5.1e-05,172.31.40.0-255,66,6285,77,175559
31539,5.5e-05,74.125.130.0-255,1484,7769,77,175559
31540,5.7e-05,172.31.40.0-255,66,7835,77,175559
31541,9.2e-05,74.125.130.0-255,4320,12155,77,175559
31542,9.6e-05,172.31.40.0-255,66,12221,77,175559
31543,0.0001,74.125.130.0-255,2067,14288,77,175559
31544,0.000103,172.31.40.0-255,66,14354,77,175559
31545,0.000154,74.125.130.0-255,1484,15838,77,175559
31546,0.000157,172.31.40.0-255,66,15904,77,175559
31547,0.000161,74.125.130.0-255,1484,17388,77,175559
31548,0.000163,172.31.40.0-255,66,17454,77,175559
31549,0.000188,74.125.130.0-255,1484,18938,77,175559
31550,0.00019,172.31.40.0-255,66,19004,77,175559
31551,0.000196,74.125.130.0-255,4320,23324,77,175559
31552,0.000198,172.31.40.0-255,66,23390,77,175559
31553,0.000209,74.125.130.0-255,5738,29128,77,175559
31554,0.000212,172.31.40.0-255,66,29194,77,175559
31555,0.000234,74.125.130.0-255,2543,31737,77,175559
31556,0.000236,172.31.40.0-255,66,31803,77,175559
31557,0.000352,74.125.130.0-255,1484,33287,77,175559
31558,0.000357,172.31.40.0-255,66,33353,77,175559
31559,0.000363,74.125.130.0-255,2902,36255,77,175559
31560,0.000365,172.31.40.0-255,66,36321,77,175559
31561,0.00037,74.125.130.0-255,2902,39223,77,175559
31562,0.000376,172.31.40.0-255,66,39289,77,175559
31563,0.000414,74.125.130.0-255,2902,42191,77,175559
31564,0.000421,74.125.130.0-255,4320,46511,77,175559
31565,0.000426,74.125.130.0-255,5379,51890,77,175559
31566,0.000451,74.125.130.0-255,9992,61882,77,175559
31567,0.000485,74.125.130.0-255,3961,65843,77,175559
31568,0.000551,172.31.40.0-255,66,65909,77,175559
31569,0.000623,74.125.130.0-255,361,66270,77,175559
31570,0.000735,74.125.130.0-255,383,66653,77,175559
31571,0.001101,172.31.40.0-255,66,66719,77,175559
31572,0.00116,74.125.130.0-255,1484,68203,77,175559
31573,0.001165,74.125.130.0-255,2902,71105,77,175559
31574,0.001168,172.31.40.0-255,66,71171,77,175559
31575,0.001174,74.125.130.0-255,4320,75491,77,175559
31576,0.001176,172.31.40.0-255,66,75557,77,175559
31577,0.001192,74.125.130.0-255,1484,77041,77,175559
31578,0.001197,74.125.130.0-255,4320,81361,77,175559
31579,0.001199,172.31.40.0-255,66,81427,77,175559
31580,0.001229,74.125.130.0-255,5738,87165,77,175559
31581,0.001231,172.31.40.0-255,66,87231,77,175559
31582,0.001266,74.125.130.0-255,8574,95805,77,175559
31583,0.001279,74.125.130.0-255,2902,98707,77,175559
31584,0.001282,74.125.130.0-255,2184,100891,77,175559
31585,0.001285,172.31.40.0-255,66,100957,77,175559
31586,0.00129,172.31.40.0-255,66,101023,77,175559
31587,0.002064,74.125.130.0-255,1484,102507,77,175559
31588,0.002075,74.125.130.0-255,2902,105409,77,175559
31589,0.00208,172.31.40.0-255,66,105475,77,175559
31590,0.002087,74.125.130.0-255,5738,111213,77,175559
31591,0.002089,172.31.40.0-255,66,111279,77,175559
31592,0.002129,74.125.130.0-255,12828,124107,77,175559
31593,0.002161,74.125.130.0-255,4320,128427,77,175559
31594,0.002186,74.125.130.0-255,6438,134865,77,175559
31595,0.004177,172.31.40.0-255,66,134931,77,175559
31596,0.006393,74.125.130.0-255,5738,140669,77,175559
31597,0.006398,172.31.40.0-255,66,140735,77,175559
31598,0.008615,74.125.130.0-255,5738,146473,77,175559
31599,0.008622,172.31.40.0-255,66,146539,77,175559
31600,0.01084,74.125.130.0-255,5738,152277,77,175559
31601,0.010848,172.31.40.0-255,66,152343,77,175559
31602,0.013076,74.125.130.0-255,5738,158081,77,175559
31603,0.013086,172.31.40.0-255,66,158147,77,175559
31604,0.015305,74.125.130.0-255,5738,163885,77,175559
31605,0.015314,172.31.40.0-255,66,163951,77,175559
31606,0.017542,74.125.130.0-255,5738,169689,77,175559
31607,0.01755,172.31.40.0-255,66,169755,77,175559
31608,0.01977,74.125.130.0-255,5738,175493,77,175559
31609,0.019777,172.31.40.0-255,66,175559,77,175559
31610,0.0,172.217.27.0-255,147,147,77,380799
31611,1.7e-05,172.31.40.0-255,66,213,77,380799
31612,2.3e-05,172.217.27.0-255,1484,1697,77,380799
31613,2.8e-05,172.31.40.0-255,66,1763,77,380799
31614,3.4e-05,172.217.27.0-255,2902,4665,77,380799
31615,3.7e-05,172.31.40.0-255,66,4731,77,380799
31616,4.3e-05,172.217.27.0-255,5738,10469,77,380799
31617,4.6e-05,172.31.40.0-255,66,10535,77,380799
31618,6.6e-05,172.217.27.0-255,1484,12019,77,380799
31619,6.8e-05,172.31.40.0-255,66,12085,77,380799
31620,7.3e-05,172.217.27.0-255,2002,14087,77,380799
31621,7.4e-05,172.31.40.0-255,66,14153,77,380799
31622,9e-05,172.217.27.0-255,1484,15637,77,380799
31623,9.2e-05,172.31.40.0-255,66,15703,77,380799
31624,9.7e-05,172.217.27.0-255,2902,18605,77,380799
31625,9.9e-05,172.31.40.0-255,66,18671,77,380799
31626,0.000127,172.217.27.0-255,5738,24409,77,380799
31627,0.000129,172.31.40.0-255,66,24475,77,380799
31628,0.000148,172.217.27.0-255,2902,27377,77,380799
31629,0.00015,172.31.40.0-255,66,27443,77,380799
31630,0.000181,172.217.27.0-255,3961,31404,77,380799
31631,0.000184,172.31.40.0-255,66,31470,77,380799
31632,0.000198,172.217.27.0-255,1484,32954,77,380799
31633,0.0002,172.31.40.0-255,66,33020,77,380799
31634,0.000227,172.217.27.0-255,2902,35922,77,380799
31635,0.000231,172.31.40.0-255,66,35988,77,380799
31636,0.000237,172.217.27.0-255,5738,41726,77,380799
31637,0.000239,172.31.40.0-255,66,41792,77,380799
31638,0.000242,172.217.27.0-255,1484,43276,77,380799
31639,0.000244,172.31.40.0-255,66,43342,77,380799
31640,0.000266,172.217.27.0-255,5379,48721,77,380799
31641,0.000269,172.31.40.0-255,66,48787,77,380799
31642,0.000302,172.217.27.0-255,5738,54525,77,380799
31643,0.000305,172.31.40.0-255,66,54591,77,380799
31644,0.000331,172.217.27.0-255,5738,60329,77,380799
31645,0.000334,172.31.40.0-255,66,60395,77,380799
31646,0.000356,172.217.27.0-255,1484,61879,77,380799
31647,0.000362,172.217.27.0-255,3961,65840,77,380799
31648,0.000365,172.31.40.0-255,66,65906,77,380799
31649,0.000405,172.217.27.0-255,395,66301,77,380799
31650,0.000647,172.217.27.0-255,116,66417,77,380799
31651,0.000771,172.217.27.0-255,1484,67901,77,380799
31652,0.000776,172.31.40.0-255,66,67967,77,380799
31653,0.000782,172.217.27.0-255,2902,70869,77,380799
31654,0.000784,172.31.40.0-255,66,70935,77,380799
31655,0.000797,172.217.27.0-255,4320,75255,77,380799
31656,0.000801,172.31.40.0-255,66,75321,77,380799
31657,0.000816,172.217.27.0-255,1484,76805,77,380799
31658,0.000822,172.217.27.0-255,4320,81125,77,380799
31659,0.000824,172.31.40.0-255,66,81191,77,380799
31660,0.00083,172.217.27.0-255,5379,86570,77,380799
31661,0.000831,172.31.40.0-255,66,86636,77,380799
31662,0.000836,172.217.27.0-255,2902,89538,77,380799
31663,0.000837,172.31.40.0-255,66,89604,77,380799
31664,0.000868,172.217.27.0-255,8574,98178,77,380799
31665,0.000872,172.217.27.0-255,2543,100721,77,380799
31666,0.000879,172.31.40.0-255,66,100787,77,380799
31667,0.000882,172.31.40.0-255,66,100853,77,380799
31668,0.000884,172.217.27.0-255,331,101184,77,380799
31669,0.001268,172.31.40.0-255,66,101250,77,380799
31670,0.001359,172.217.27.0-255,1484,102734,77,380799
31671,0.001367,172.217.27.0-255,2902,105636,77,380799
31672,0.001369,172.31.40.0-255,66,105702,77,380799
31673,0.001392,172.217.27.0-255,5738,111440,77,380799
31674,0.001394,172.31.40.0-255,66,111506,77,380799
31675,0.001429,172.217.27.0-255,11410,122916,77,380799
31676,0.001431,172.31.40.0-255,66,122982,77,380799
31677,0.001448,172.217.27.0-255,1484,124466,77,380799
31678,0.001465,172.217.27.0-255,4320,128786,77,380799
31679,0.001467,172.31.40.0-255,66,128852,77,380799
31680,0.001485,172.217.27.0-255,6438,135290,77,380799
31681,0.001487,172.31.40.0-255,66,135356,77,380799
31682,0.002432,172.217.27.0-255,1484,136840,77,380799
31683,0.002438,172.217.27.0-255,1484,138324,77,380799
31684,0.002442,172.31.40.0-255,66,138390,77,380799
31685,0.002463,172.217.27.0-255,1484,139874,77,380799
31686,0.002469,172.217.27.0-255,5738,145612,77,380799
31687,0.002471,172.31.40.0-255,66,145678,77,380799
31688,0.002479,172.217.27.0-255,8574,154252,77,380799
31689,0.002481,172.31.40.0-255,66,154318,77,380799
31690,0.002485,172.217.27.0-255,4320,158638,77,380799
31691,0.002487,172.31.40.0-255,66,158704,77,380799
31692,0.002525,172.217.27.0-255,5738,164442,77,380799
31693,0.002527,172.31.40.0-255,66,164508,77,380799
31694,0.002547,172.217.27.0-255,5020,169528,77,380799
31695,0.002549,172.31.40.0-255,66,169594,77,380799
31696,0.002569,172.217.27.0-255,1484,171078,77,380799
31697,0.00259,172.217.27.0-255,2902,173980,77,380799
31698,0.002592,172.31.40.0-255,66,174046,77,380799
31699,0.002599,172.217.27.0-255,5738,179784,77,380799
31700,0.002601,172.31.40.0-255,66,179850,77,380799
31701,0.002623,172.217.27.0-255,9992,189842,77,380799
31702,0.002626,172.31.40.0-255,66,189908,77,380799
31703,0.002652,172.217.27.0-255,2902,192810,77,380799
31704,0.002654,172.31.40.0-255,66,192876,77,380799
31705,0.002662,172.217.27.0-255,8574,201450,77,380799
31706,0.002664,172.31.40.0-255,66,201516,77,380799
31707,0.002667,172.217.27.0-255,1484,203000,77,380799
31708,0.002728,172.31.40.0-255,66,203066,77,380799
31709,0.00274,172.217.27.0-255,12110,215176,77,380799
31710,0.002742,172.31.40.0-255,66,215242,77,380799
31711,0.002745,172.217.27.0-255,1484,216726,77,380799
31712,0.00275,172.217.27.0-255,2902,219628,77,380799
31713,0.002752,172.31.40.0-255,66,219694,77,380799
31714,0.002758,172.217.27.0-255,5738,225432,77,380799
31715,0.002761,172.31.40.0-255,66,225498,77,380799
31716,0.002826,172.217.27.0-255,12828,238326,77,380799
31717,0.002829,172.31.40.0-255,66,238392,77,380799
31718,0.002836,172.217.27.0-255,7156,245548,77,380799
31719,0.002839,172.31.40.0-255,66,245614,77,380799
31720,0.002843,172.217.27.0-255,3602,249216,77,380799
31721,0.002845,172.31.40.0-255,66,249282,77,380799
31722,0.002868,172.217.27.0-255,1484,250766,77,380799
31723,0.002881,172.217.27.0-255,2902,253668,77,380799
31724,0.002884,172.31.40.0-255,66,253734,77,380799
31725,0.002889,172.217.27.0-255,4320,258054,77,380799
31726,0.002891,172.31.40.0-255,66,258120,77,380799
31727,0.002916,172.217.27.0-255,8574,266694,77,380799
31728,0.002918,172.31.40.0-255,66,266760,77,380799
31729,0.002941,172.217.27.0-255,2902,269662,77,380799
31730,0.002943,172.31.40.0-255,66,269728,77,380799
31731,0.002977,172.217.27.0-255,13528,283256,77,380799
31732,0.00298,172.31.40.0-255,66,283322,77,380799
31733,0.003014,172.217.27.0-255,1484,284806,77,380799
31734,0.003033,172.217.27.0-255,2902,287708,77,380799
31735,0.003036,172.31.40.0-255,66,287774,77,380799
31736,0.003042,172.217.27.0-255,5738,293512,77,380799
31737,0.003044,172.31.40.0-255,66,293578,77,380799
31738,0.003049,172.217.27.0-255,2902,296480,77,380799
31739,0.003052,172.31.40.0-255,66,296546,77,380799
31740,0.003084,172.217.27.0-255,4320,300866,77,380799
31741,0.003088,172.31.40.0-255,66,300932,77,380799
31742,0.003102,172.31.40.0-255,66,300998,77,380799
31743,0.003106,172.217.27.0-255,2184,303182,77,380799
31744,0.003108,172.31.40.0-255,66,303248,77,380799
31745,0.003147,172.217.27.0-255,1484,304732,77,380799
31746,0.003151,172.217.27.0-255,2902,307634,77,380799
31747,0.003155,172.31.40.0-255,66,307700,77,380799
31748,0.003173,172.217.27.0-255,5738,313438,77,380799
31749,0.003177,172.31.40.0-255,66,313504,77,380799
31750,0.003202,172.217.27.0-255,11410,324914,77,380799
31751,0.003205,172.31.40.0-255,66,324980,77,380799
31752,0.003212,172.217.27.0-255,7156,332136,77,380799
31753,0.003214,172.31.40.0-255,66,332202,77,380799
31754,0.003237,172.217.27.0-255,5020,337222,77,380799
31755,0.00324,172.31.40.0-255,66,337288,77,380799
31756,0.003257,172.217.27.0-255,1484,338772,77,380799
31757,0.003261,172.217.27.0-255,1484,340256,77,380799
31758,0.003263,172.31.40.0-255,66,340322,77,380799
31759,0.003287,172.217.27.0-255,1484,341806,77,380799
31760,0.003293,172.217.27.0-255,5738,347544,77,380799
31761,0.003296,172.31.40.0-255,66,347610,77,380799
31762,0.0033,172.217.27.0-255,2902,350512,77,380799
31763,0.003303,172.31.40.0-255,66,350578,77,380799
31764,0.003309,172.217.27.0-255,5738,356316,77,380799
31765,0.003312,172.31.40.0-255,66,356382,77,380799
31766,0.003337,172.217.27.0-255,4320,360702,77,380799
31767,0.00334,172.31.40.0-255,66,360768,77,380799
31768,0.003349,172.217.27.0-255,9992,370760,77,380799
31769,0.003352,172.31.40.0-255,66,370826,77,380799
31770,0.003373,172.217.27.0-255,766,371592,77,380799
31771,0.003399,172.217.27.0-255,4320,375912,77,380799
31772,0.003403,172.31.40.0-255,66,375978,77,380799
31773,0.003424,172.217.27.0-255,4413,380391,77,380799
31774,0.003426,172.31.40.0-255,66,380457,77,380799
31775,0.003435,172.217.27.0-255,105,380562,77,380799
31776,0.00521,172.31.40.0-255,66,380628,77,380799
31777,0.005242,172.31.40.0-255,105,380733,77,380799
31778,0.00682,172.217.27.0-255,66,380799,77,380799
31779,0.0,172.31.40.0-255,105,105,77,459
31780,0.000207,172.31.40.0-255,90,195,77,459
31781,0.000216,172.31.40.0-255,66,261,77,459
31782,0.00244,74.125.130.0-255,66,327,77,459
31783,0.00247,74.125.130.0-255,66,393,77,459
31784,0.002492,172.31.40.0-255,66,459,77,459
31785,0.0,172.31.40.0-255,105,105,77,210
31786,0.001843,157.240.13.0-255,105,210,77,210
31787,0.0,172.217.194.0-255,150,150,77,412484
31788,2.2e-05,172.31.40.0-255,66,216,77,412484
31789,2.8e-05,172.217.194.0-255,1484,1700,77,412484
31790,3.3e-05,172.31.40.0-255,66,1766,77,412484
31791,3.9e-05,172.217.194.0-255,2902,4668,77,412484
31792,5e-05,172.31.40.0-255,66,4734,77,412484
31793,5.7e-05,172.217.194.0-255,7156,11890,77,412484
31794,6e-05,172.31.40.0-255,66,11956,77,412484
31795,6.5e-05,172.217.194.0-255,3429,15385,77,412484
31796,6.8e-05,172.31.40.0-255,66,15451,77,412484
31797,7.4e-05,172.217.194.0-255,4320,19771,77,412484
31798,7.6e-05,172.31.40.0-255,66,19837,77,412484
31799,0.000117,172.217.194.0-255,8574,28411,77,412484
31800,0.00012,172.31.40.0-255,66,28477,77,412484
31801,0.000123,172.217.194.0-255,2543,31020,77,412484
31802,0.000125,172.31.40.0-255,66,31086,77,412484
31803,0.000156,172.217.194.0-255,1484,32570,77,412484
31804,0.000159,172.31.40.0-255,66,32636,77,412484
31805,0.000162,172.217.194.0-255,2902,35538,77,412484
31806,0.000165,172.31.40.0-255,66,35604,77,412484
31807,0.00017,172.217.194.0-255,5738,41342,77,412484
31808,0.000172,172.31.40.0-255,66,41408,77,412484
31809,0.000215,172.217.194.0-255,13887,55295,77,412484
31810,0.000218,172.31.40.0-255,66,55361,77,412484
31811,0.000221,172.217.194.0-255,1484,56845,77,412484
31812,0.000222,172.31.40.0-255,66,56911,77,412484
31813,0.000265,172.217.194.0-255,8504,65415,77,412484
31814,0.000267,172.31.40.0-255,66,65481,77,412484
31815,0.00027,172.217.194.0-255,366,65847,77,412484
31816,0.000271,172.31.40.0-255,66,65913,77,412484
31817,0.000354,172.217.194.0-255,1484,67397,77,412484
31818,0.000358,172.31.40.0-255,66,67463,77,412484
31819,0.000364,172.217.194.0-255,2902,70365,77,412484
31820,0.000367,172.31.40.0-255,66,70431,77,412484
31821,0.000404,172.217.194.0-255,5738,76169,77,412484
31822,0.000407,172.31.40.0-255,66,76235,77,412484
31823,0.000417,172.217.194.0-255,9084,85319,77,412484
31824,0.000419,172.31.40.0-255,66,85385,77,412484
31825,0.000453,172.217.194.0-255,2902,88287,77,412484
31826,0.000456,172.31.40.0-255,66,88353,77,412484
31827,0.000493,172.217.194.0-255,13887,102240,77,412484
31828,0.000496,172.31.40.0-255,66,102306,77,412484
31829,0.000531,172.217.194.0-255,13887,116193,77,412484
31830,0.000534,172.31.40.0-255,66,116259,77,412484
31831,0.000649,172.217.194.0-255,1484,117743,77,412484
31832,0.000654,172.217.194.0-255,1484,119227,77,412484
31833,0.000658,172.31.40.0-255,66,119293,77,412484
31834,0.000684,172.217.194.0-255,1484,120777,77,412484
31835,0.000691,172.217.194.0-255,5738,126515,77,412484
31836,0.000694,172.31.40.0-255,66,126581,77,412484
31837,0.000732,172.217.194.0-255,12828,139409,77,412484
31838,0.000735,172.31.40.0-255,66,139475,77,412484
31839,0.000745,172.217.194.0-255,10692,150167,77,412484
31840,0.000752,172.31.40.0-255,66,150233,77,412484
31841,0.000807,172.217.194.0-255,1484,151717,77,412484
31842,0.000812,172.217.194.0-255,2902,154619,77,412484
31843,0.000815,172.31.40.0-255,66,154685,77,412484
31844,0.000821,172.217.194.0-255,5738,160423,77,412484
31845,0.000824,172.31.40.0-255,66,160489,77,412484
31846,0.000837,172.217.194.0-255,9992,170481,77,412484
31847,0.00084,172.31.40.0-255,66,170547,77,412484
31848,0.00088,172.217.194.0-255,13528,184075,77,412484
31849,0.000883,172.31.40.0-255,66,184141,77,412484
31850,0.00091,172.217.194.0-255,1484,185625,77,412484
31851,0.000925,172.217.194.0-255,2902,188527,77,412484
31852,0.000927,172.31.40.0-255,66,188593,77,412484
31853,0.000954,172.217.194.0-255,5738,194331,77,412484
31854,0.000957,172.31.40.0-255,66,194397,77,412484
31855,0.000964,172.217.194.0-255,7156,201553,77,412484
31856,0.000967,172.31.40.0-255,66,201619,77,412484
31857,0.000999,172.217.194.0-255,5738,207357,77,412484
31858,0.001002,172.31.40.0-255,66,207423,77,412484
31859,0.001006,172.217.194.0-255,2902,210325,77,412484
31860,0.001008,172.31.40.0-255,66,210391,77,412484
31861,0.001041,172.217.194.0-255,7856,218247,77,412484
31862,0.001044,172.31.40.0-255,66,218313,77,412484
31863,0.00108,172.217.194.0-255,7156,225469,77,412484
31864,0.001083,172.31.40.0-255,66,225535,77,412484
31865,0.001116,172.217.194.0-255,1484,227019,77,412484
31866,0.00112,172.217.194.0-255,1484,228503,77,412484
31867,0.001122,172.31.40.0-255,66,228569,77,412484
31868,0.001133,172.217.194.0-255,11410,239979,77,412484
31869,0.001135,172.31.40.0-255,66,240045,77,412484
31870,0.001151,172.217.194.0-255,12110,252155,77,412484
31871,0.001154,172.31.40.0-255,66,252221,77,412484
31872,0.001166,172.217.194.0-255,8574,260795,77,412484
31873,0.001169,172.31.40.0-255,66,260861,77,412484
31874,0.0012,172.217.194.0-255,4320,265181,77,412484
31875,0.001202,172.31.40.0-255,66,265247,77,412484
31876,0.001208,172.217.194.0-255,3961,269208,77,412484
31877,0.001211,172.31.40.0-255,66,269274,77,412484
31878,0.001471,172.217.194.0-255,1484,270758,77,412484
31879,0.001478,172.217.194.0-255,2902,273660,77,412484
31880,0.001482,172.31.40.0-255,66,273726,77,412484
31881,0.001486,172.217.194.0-255,1484,275210,77,412484
31882,0.001517,172.217.194.0-255,4320,279530,77,412484
31883,0.001519,172.31.40.0-255,66,279596,77,412484
31884,0.001524,172.217.194.0-255,2902,282498,77,412484
31885,0.001527,172.31.40.0-255,66,282564,77,412484
31886,0.001557,172.217.194.0-255,9992,292556,77,412484
31887,0.00156,172.31.40.0-255,66,292622,77,412484
31888,0.001569,172.217.194.0-255,9992,302614,77,412484
31889,0.001571,172.31.40.0-255,66,302680,77,412484
31890,0.001595,172.217.194.0-255,766,303446,77,412484
31891,0.001723,172.217.194.0-255,1484,304930,77,412484
31892,0.001727,172.31.40.0-255,66,304996,77,412484
31893,0.00173,172.217.194.0-255,1484,306480,77,412484
31894,0.001751,172.217.194.0-255,1484,307964,77,412484
31895,0.001753,172.31.40.0-255,66,308030,77,412484
31896,0.001759,172.217.194.0-255,5738,313768,77,412484
31897,0.001761,172.31.40.0-255,66,313834,77,412484
31898,0.001798,172.217.194.0-255,9992,323826,77,412484
31899,0.001801,172.31.40.0-255,66,323892,77,412484
31900,0.001809,172.217.194.0-255,8574,332466,77,412484
31901,0.001811,172.31.40.0-255,66,332532,77,412484
31902,0.001838,172.217.194.0-255,5020,337552,77,412484
31903,0.001841,172.31.40.0-255,66,337618,77,412484
31904,0.002078,172.217.194.0-255,1484,339102,77,412484
31905,0.002082,172.217.194.0-255,1484,340586,77,412484
31906,0.002085,172.31.40.0-255,66,340652,77,412484
31907,0.002108,172.217.194.0-255,1484,342136,77,412484
31908,0.002114,172.217.194.0-255,5738,347874,77,412484
31909,0.002116,172.31.40.0-255,66,347940,77,412484
31910,0.00212,172.217.194.0-255,2902,350842,77,412484
31911,0.002121,172.31.40.0-255,66,350908,77,412484
31912,0.002151,172.217.194.0-255,7156,358064,77,412484
31913,0.002153,172.31.40.0-255,66,358130,77,412484
31914,0.002183,172.217.194.0-255,8574,366704,77,412484
31915,0.002188,172.31.40.0-255,66,366770,77,412484
31916,0.0022,172.217.194.0-255,5020,371790,77,412484
31917,0.002206,172.31.40.0-255,66,371856,77,412484
31918,0.004512,172.217.194.0-255,5738,377594,77,412484
31919,0.004519,172.31.40.0-255,66,377660,77,412484
31920,0.006794,172.217.194.0-255,5738,383398,77,412484
31921,0.006802,172.31.40.0-255,66,383464,77,412484
31922,0.009105,172.217.194.0-255,5738,389202,77,412484
31923,0.009122,172.31.40.0-255,66,389268,77,412484
31924,0.011404,172.217.194.0-255,5738,395006,77,412484
31925,0.01142,172.31.40.0-255,66,395072,77,412484
31926,0.013661,172.217.194.0-255,5738,400810,77,412484
31927,0.013665,172.31.40.0-255,66,400876,77,412484
31928,0.015974,172.217.194.0-255,5738,406614,77,412484
31929,0.015991,172.31.40.0-255,66,406680,77,412484
31930,0.018305,172.217.194.0-255,5738,412418,77,412484
31931,0.018321,172.31.40.0-255,66,412484,77,412484
31932,0.0,172.217.194.0-255,296,296,77,185272
31933,1.8e-05,172.31.40.0-255,66,362,77,185272
31934,2.4e-05,172.217.194.0-255,1484,1846,77,185272
31935,2.8e-05,172.31.40.0-255,66,1912,77,185272
31936,3.5e-05,172.217.194.0-255,4320,6232,77,185272
31937,4.4e-05,172.31.40.0-255,66,6298,77,185272
31938,8.2e-05,172.217.194.0-255,7536,13834,77,185272
31939,8.5e-05,172.31.40.0-255,66,13900,77,185272
31940,0.000102,172.217.194.0-255,4320,18220,77,185272
31941,0.000107,172.31.40.0-255,66,18286,77,185272
31942,0.000131,172.217.194.0-255,4320,22606,77,185272
31943,0.000134,172.31.40.0-255,66,22672,77,185272
31944,0.000137,172.217.194.0-255,2902,25574,77,185272
31945,0.000139,172.31.40.0-255,66,25640,77,185272
31946,0.000161,172.217.194.0-255,5379,31019,77,185272
31947,0.000167,172.31.40.0-255,66,31085,77,185272
31948,0.000206,172.217.194.0-255,1484,32569,77,185272
31949,0.000208,172.31.40.0-255,66,32635,77,185272
31950,0.000221,172.217.194.0-255,2902,35537,77,185272
31951,0.000223,172.31.40.0-255,66,35603,77,185272
31952,0.000229,172.217.194.0-255,4320,39923,77,185272
31953,0.000234,172.31.40.0-255,66,39989,77,185272
31954,0.000258,172.217.194.0-255,1484,41473,77,185272
31955,0.000259,172.31.40.0-255,66,41539,77,185272
31956,0.000274,172.217.194.0-255,13887,55426,77,185272
31957,0.000277,172.31.40.0-255,66,55492,77,185272
31958,0.000285,172.217.194.0-255,9890,65382,77,185272
31959,0.000287,172.31.40.0-255,66,65448,77,185272
31960,0.00029,172.217.194.0-255,120,65568,77,185272
31961,0.000291,172.31.40.0-255,66,65634,77,185272
31962,0.000315,172.217.194.0-255,375,66009,77,185272
31963,0.000317,172.31.40.0-255,66,66075,77,185272
31964,0.000675,172.217.194.0-255,1484,67559,77,185272
31965,0.000681,172.217.194.0-255,2902,70461,77,185272
31966,0.000684,172.31.40.0-255,66,70527,77,185272
31967,0.000718,172.217.194.0-255,5738,76265,77,185272
31968,0.000721,172.31.40.0-255,66,76331,77,185272
31969,0.000731,172.217.194.0-255,12828,89159,77,185272
31970,0.000733,172.31.40.0-255,66,89225,77,185272
31971,0.000744,172.217.194.0-255,8574,97799,77,185272
31972,0.000746,172.31.40.0-255,66,97865,77,185272
31973,0.000772,172.217.194.0-255,2184,100049,77,185272
31974,0.000774,172.31.40.0-255,66,100115,77,185272
31975,0.001441,172.217.194.0-255,1484,101599,77,185272
31976,0.00145,172.217.194.0-255,2902,104501,77,185272
31977,0.001454,172.31.40.0-255,66,104567,77,185272
31978,0.001461,172.217.194.0-255,5738,110305,77,185272
31979,0.001463,172.31.40.0-255,66,110371,77,185272
31980,0.001489,172.217.194.0-255,9992,120363,77,185272
31981,0.001492,172.31.40.0-255,66,120429,77,185272
31982,0.001521,172.217.194.0-255,2902,123331,77,185272
31983,0.001523,172.31.40.0-255,66,123397,77,185272
31984,0.001527,172.217.194.0-255,1484,124881,77,185272
31985,0.001554,172.217.194.0-255,9274,134155,77,185272
31986,0.001557,172.31.40.0-255,66,134221,77,185272
31987,0.003505,172.217.194.0-255,5738,139959,77,185272
31988,0.003511,172.31.40.0-255,66,140025,77,185272
31989,0.005429,172.217.194.0-255,5738,145763,77,185272
31990,0.005431,172.31.40.0-255,66,145829,77,185272
31991,0.007408,172.217.194.0-255,5738,151567,77,185272
31992,0.007414,172.31.40.0-255,66,151633,77,185272
31993,0.009336,172.217.194.0-255,5738,157371,77,185272
31994,0.009345,172.31.40.0-255,66,157437,77,185272
31995,0.011277,172.217.194.0-255,5738,163175,77,185272
31996,0.011286,172.31.40.0-255,66,163241,77,185272
31997,0.011558,172.31.40.0-255,101,163342,77,185272
31998,0.013222,172.217.194.0-255,5738,169080,77,185272
31999,0.013228,172.31.40.0-255,66,169146,77,185272
32000,0.013451,172.217.194.0-255,66,169212,77,185272
32001,0.015166,172.217.194.0-255,5738,174950,77,185272
32002,0.015174,172.31.40.0-255,66,175016,77,185272
32003,0.01715,172.217.194.0-255,4320,179336,77,185272
32004,0.017159,172.31.40.0-255,66,179402,77,185272
32005,0.01719,172.217.194.0-255,1484,180886,77,185272
32006,0.019089,172.217.194.0-255,4320,185206,77,185272
32007,0.019096,172.31.40.0-255,66,185272,77,185272
32008,0.0,172.253.118.0-255,150,150,77,332624
32009,2.4e-05,172.31.40.0-255,66,216,77,332624
32010,3.2e-05,172.253.118.0-255,1484,1700,77,332624
32011,3.6e-05,172.31.40.0-255,66,1766,77,332624
32012,4.2e-05,172.253.118.0-255,2902,4668,77,332624
32013,4.6e-05,172.31.40.0-255,66,4734,77,332624
32014,6.2e-05,172.253.118.0-255,7156,11890,77,332624
32015,6.5e-05,172.31.40.0-255,66,11956,77,332624
32016,9.4e-05,172.253.118.0-255,2100,14056,77,332624
32017,9.7e-05,172.31.40.0-255,66,14122,77,332624
32018,0.0001,172.253.118.0-255,1484,15606,77,332624
32019,0.000103,172.31.40.0-255,66,15672,77,332624
32020,0.00013,172.253.118.0-255,1484,17156,77,332624
32021,0.000133,172.31.40.0-255,66,17222,77,332624
32022,0.00014,172.253.118.0-255,7156,24378,77,332624
32023,0.000143,172.31.40.0-255,66,24444,77,332624
32024,0.000151,172.253.118.0-255,2902,27346,77,332624
32025,0.000154,172.31.40.0-255,66,27412,77,332624
32026,0.000181,172.253.118.0-255,3961,31373,77,332624
32027,0.000188,172.31.40.0-255,66,31439,77,332624
32028,0.000268,172.253.118.0-255,1484,32923,77,332624
32029,0.00027,172.31.40.0-255,66,32989,77,332624
32030,0.000283,172.253.118.0-255,1484,34473,77,332624
32031,0.000291,172.31.40.0-255,66,34539,77,332624
32032,0.00032,172.253.118.0-255,1484,36023,77,332624
32033,0.000323,172.31.40.0-255,66,36089,77,332624
32034,0.00033,172.253.118.0-255,5738,41827,77,332624
32035,0.000332,172.31.40.0-255,66,41893,77,332624
32036,0.000343,172.253.118.0-255,5738,47631,77,332624
32037,0.000345,172.31.40.0-255,66,47697,77,332624
32038,0.000377,172.253.118.0-255,8215,55912,77,332624
32039,0.00038,172.31.40.0-255,66,55978,77,332624
32040,0.000387,172.253.118.0-255,7156,63134,77,332624
32041,0.000389,172.31.40.0-255,66,63200,77,332624
32042,0.000392,172.253.118.0-255,1484,64684,77,332624
32043,0.000421,172.253.118.0-255,1459,66143,77,332624
32044,0.000424,172.31.40.0-255,66,66209,77,332624
32045,0.000431,172.253.118.0-255,112,66321,77,332624
32046,0.000451,172.253.118.0-255,329,66650,77,332624
32047,0.000826,172.253.118.0-255,1484,68134,77,332624
32048,0.000832,172.31.40.0-255,66,68200,77,332624
32049,0.000836,172.253.118.0-255,1484,69684,77,332624
32050,0.000859,172.253.118.0-255,1484,71168,77,332624
32051,0.000862,172.31.40.0-255,66,71234,77,332624
32052,0.000865,172.253.118.0-255,1484,72718,77,332624
32053,0.000871,172.253.118.0-255,4320,77038,77,332624
32054,0.000873,172.31.40.0-255,66,77104,77,332624
32055,0.0009,172.253.118.0-255,1484,78588,77,332624
32056,0.000907,172.253.118.0-255,7156,85744,77,332624
32057,0.00091,172.31.40.0-255,66,85810,77,332624
32058,0.000943,172.253.118.0-255,1484,87294,77,332624
32059,0.000961,172.253.118.0-255,2902,90196,77,332624
32060,0.000964,172.31.40.0-255,66,90262,77,332624
32061,0.000971,172.253.118.0-255,5738,96000,77,332624
32062,0.000973,172.31.40.0-255,66,96066,77,332624
32063,0.001004,172.253.118.0-255,5020,101086,77,332624
32064,0.001007,172.31.40.0-255,66,101152,77,332624
32065,0.001104,172.253.118.0-255,1484,102636,77,332624
32066,0.00112,172.253.118.0-255,2902,105538,77,332624
32067,0.001123,172.31.40.0-255,66,105604,77,332624
32068,0.001131,172.253.118.0-255,5738,111342,77,332624
32069,0.001133,172.31.40.0-255,66,111408,77,332624
32070,0.001161,172.253.118.0-255,5738,117146,77,332624
32071,0.001164,172.31.40.0-255,66,117212,77,332624
32072,0.001171,172.253.118.0-255,7156,124368,77,332624
32073,0.001173,172.31.40.0-255,66,124434,77,332624
32074,0.001229,172.253.118.0-255,10692,135126,77,332624
32075,0.001232,172.31.40.0-255,66,135192,77,332624
32076,0.001312,172.253.118.0-255,1484,136676,77,332624
32077,0.001317,172.253.118.0-255,2902,139578,77,332624
32078,0.00132,172.31.40.0-255,66,139644,77,332624
32079,0.001326,172.253.118.0-255,4320,143964,77,332624
32080,0.001329,172.31.40.0-255,66,144030,77,332624
32081,0.001353,172.253.118.0-255,1484,145514,77,332624
32082,0.001362,172.253.118.0-255,8574,154088,77,332624
32083,0.001364,172.31.40.0-255,66,154154,77,332624
32084,0.001369,172.253.118.0-255,2902,157056,77,332624
32085,0.001371,172.31.40.0-255,66,157122,77,332624
32086,0.001396,172.253.118.0-255,7156,164278,77,332624
32087,0.001403,172.31.40.0-255,66,164344,77,332624
32088,0.001409,172.253.118.0-255,5020,169364,77,332624
32089,0.001412,172.31.40.0-255,66,169430,77,332624
32090,0.001615,172.253.118.0-255,1484,170914,77,332624
32091,0.001621,172.253.118.0-255,2902,173816,77,332624
32092,0.001624,172.31.40.0-255,66,173882,77,332624
32093,0.001665,172.253.118.0-255,5738,179620,77,332624
32094,0.001668,172.31.40.0-255,66,179686,77,332624
32095,0.001676,172.253.118.0-255,8574,188260,77,332624
32096,0.001684,172.31.40.0-255,66,188326,77,332624
32097,0.001719,172.253.118.0-255,12828,201154,77,332624
32098,0.001723,172.31.40.0-255,66,201220,77,332624
32099,0.001749,172.253.118.0-255,2184,203404,77,332624
32100,0.001752,172.31.40.0-255,66,203470,77,332624
32101,0.001911,172.253.118.0-255,1484,204954,77,332624
32102,0.001941,172.253.118.0-255,2902,207856,77,332624
32103,0.001944,172.31.40.0-255,66,207922,77,332624
32104,0.001948,172.253.118.0-255,1484,209406,77,332624
32105,0.001974,172.253.118.0-255,2902,212308,77,332624
32106,0.001976,172.31.40.0-255,66,212374,77,332624
32107,0.001985,172.253.118.0-255,8574,220948,77,332624
32108,0.001993,172.31.40.0-255,66,221014,77,332624
32109,0.002016,172.253.118.0-255,1484,222498,77,332624
32110,0.002042,172.253.118.0-255,8574,231072,77,332624
32111,0.002046,172.31.40.0-255,66,231138,77,332624
32112,0.002074,172.253.118.0-255,6438,237576,77,332624
32113,0.002077,172.31.40.0-255,66,237642,77,332624
32114,0.00211,172.253.118.0-255,1484,239126,77,332624
32115,0.002132,172.253.118.0-255,2902,242028,77,332624
32116,0.002149,172.31.40.0-255,66,242094,77,332624
32117,0.002156,172.253.118.0-255,5738,247832,77,332624
32118,0.002159,172.31.40.0-255,66,247898,77,332624
32119,0.002176,172.253.118.0-255,5738,253636,77,332624
32120,0.002178,172.31.40.0-255,66,253702,77,332624
32121,0.002197,172.253.118.0-255,7156,260858,77,332624
32122,0.002203,172.31.40.0-255,66,260924,77,332624
32123,0.00221,172.253.118.0-255,7156,268080,77,332624
32124,0.002212,172.31.40.0-255,66,268146,77,332624
32125,0.002248,172.253.118.0-255,6438,274584,77,332624
32126,0.002251,172.31.40.0-255,66,274650,77,332624
32127,0.002262,172.253.118.0-255,11410,286060,77,332624
32128,0.002264,172.31.40.0-255,66,286126,77,332624
32129,0.00227,172.253.118.0-255,5738,291864,77,332624
32130,0.002274,172.31.40.0-255,66,291930,77,332624
32131,0.002321,172.31.40.0-255,66,291996,77,332624
32132,0.004551,172.253.118.0-255,5738,297734,77,332624
32133,0.004569,172.31.40.0-255,66,297800,77,332624
32134,0.006808,172.253.118.0-255,5738,303538,77,332624
32135,0.006815,172.31.40.0-255,66,303604,77,332624
32136,0.009054,172.253.118.0-255,5738,309342,77,332624
32137,0.009067,172.31.40.0-255,66,309408,77,332624
32138,0.011291,172.253.118.0-255,5738,315146,77,332624
32139,0.011296,172.31.40.0-255,66,315212,77,332624
32140,0.013536,172.253.118.0-255,5738,320950,77,332624
32141,0.013543,172.31.40.0-255,66,321016,77,332624
32142,0.015768,172.253.118.0-255,5738,326754,77,332624
32143,0.015776,172.31.40.0-255,66,326820,77,332624
32144,0.018013,172.253.118.0-255,5738,332558,77,332624
32145,0.01802,172.31.40.0-255,66,332624,77,332624
32146,0.0,74.125.24.0-255,152,152,77,152628
32147,2.4e-05,172.31.40.0-255,66,218,77,152628
32148,3.2e-05,74.125.24.0-255,1484,1702,77,152628
32149,3.7e-05,172.31.40.0-255,66,1768,77,152628
32150,4.2e-05,74.125.24.0-255,2902,4670,77,152628
32151,4.6e-05,172.31.40.0-255,66,4736,77,152628
32152,5.4e-05,74.125.24.0-255,7156,11892,77,152628
32153,5.7e-05,172.31.40.0-255,66,11958,77,152628
32154,6.1e-05,74.125.24.0-255,1999,13957,77,152628
32155,6.5e-05,172.31.40.0-255,66,14023,77,152628
32156,0.00034,74.125.24.0-255,1484,15507,77,152628
32157,0.000345,172.31.40.0-255,66,15573,77,152628
32158,0.000352,74.125.24.0-255,2902,18475,77,152628
32159,0.000356,172.31.40.0-255,66,18541,77,152628
32160,0.000362,74.125.24.0-255,5738,24279,77,152628
32161,0.000364,172.31.40.0-255,66,24345,77,152628
32162,0.000372,74.125.24.0-255,6797,31142,77,152628
32163,0.000374,172.31.40.0-255,66,31208,77,152628
32164,0.000397,74.125.24.0-255,1484,32692,77,152628
32165,0.0004,172.31.40.0-255,66,32758,77,152628
32166,0.000431,74.125.24.0-255,12828,45586,77,152628
32167,0.000435,172.31.40.0-255,66,45652,77,152628
32168,0.000439,74.125.24.0-255,2543,48195,77,152628
32169,0.000441,172.31.40.0-255,66,48261,77,152628
32170,0.00048,74.125.24.0-255,7156,55417,77,152628
32171,0.000484,172.31.40.0-255,66,55483,77,152628
32172,0.000508,74.125.24.0-255,9633,65116,77,152628
32173,0.000512,172.31.40.0-255,66,65182,77,152628
32174,0.000514,74.125.24.0-255,395,65577,77,152628
32175,0.000516,172.31.40.0-255,66,65643,77,152628
32176,0.000548,74.125.24.0-255,114,65757,77,152628
32177,0.000551,172.31.40.0-255,66,65823,77,152628
32178,0.000694,74.125.24.0-255,331,66154,77,152628
32179,0.001097,172.31.40.0-255,66,66220,77,152628
32180,0.00129,74.125.24.0-255,1484,67704,77,152628
32181,0.0013,74.125.24.0-255,2902,70606,77,152628
32182,0.001305,172.31.40.0-255,66,70672,77,152628
32183,0.001313,74.125.24.0-255,5738,76410,77,152628
32184,0.001315,172.31.40.0-255,66,76476,77,152628
32185,0.00135,74.125.24.0-255,5738,82214,77,152628
32186,0.001353,172.31.40.0-255,66,82280,77,152628
32187,0.001362,74.125.24.0-255,7156,89436,77,152628
32188,0.001364,172.31.40.0-255,66,89502,77,152628
32189,0.001389,74.125.24.0-255,2902,92404,77,152628
32190,0.001392,172.31.40.0-255,66,92470,77,152628
32191,0.001409,74.125.24.0-255,7856,100326,77,152628
32192,0.001412,172.31.40.0-255,66,100392,77,152628
32193,0.003403,74.125.24.0-255,5738,106130,77,152628
32194,0.00341,172.31.40.0-255,66,106196,77,152628
32195,0.005417,74.125.24.0-255,5738,111934,77,152628
32196,0.005424,172.31.40.0-255,66,112000,77,152628
32197,0.007437,74.125.24.0-255,5738,117738,77,152628
32198,0.007443,172.31.40.0-255,66,117804,77,152628
32199,0.009453,74.125.24.0-255,5738,123542,77,152628
32200,0.00946,172.31.40.0-255,66,123608,77,152628
32201,0.011446,74.125.24.0-255,5738,129346,77,152628
32202,0.011454,172.31.40.0-255,66,129412,77,152628
32203,0.013464,74.125.24.0-255,5738,135150,77,152628
32204,0.013472,172.31.40.0-255,66,135216,77,152628
32205,0.015487,74.125.24.0-255,5738,140954,77,152628
32206,0.015495,172.31.40.0-255,66,141020,77,152628
32207,0.017504,74.125.24.0-255,5738,146758,77,152628
32208,0.017513,172.31.40.0-255,66,146824,77,152628
32209,0.019537,74.125.24.0-255,5738,152562,77,152628
32210,0.019546,172.31.40.0-255,66,152628,77,152628
32211,0.0,74.125.24.0-255,153,153,77,413877
32212,1.5e-05,172.31.40.0-255,66,219,77,413877
32213,2.2e-05,74.125.24.0-255,1484,1703,77,413877
32214,2.7e-05,172.31.40.0-255,66,1769,77,413877
32215,3.3e-05,74.125.24.0-255,2902,4671,77,413877
32216,3.7e-05,172.31.40.0-255,66,4737,77,413877
32217,4.3e-05,74.125.24.0-255,4320,9057,77,413877
32218,4.6e-05,172.31.40.0-255,66,9123,77,413877
32219,6.5e-05,74.125.24.0-255,2902,12025,77,413877
32220,6.8e-05,172.31.40.0-255,66,12091,77,413877
32221,7.3e-05,74.125.24.0-255,2100,14191,77,413877
32222,7.5e-05,172.31.40.0-255,66,14257,77,413877
32223,0.000279,74.125.24.0-255,1484,15741,77,413877
32224,0.000285,172.31.40.0-255,66,15807,77,413877
32225,0.000291,74.125.24.0-255,2902,18709,77,413877
32226,0.000294,172.31.40.0-255,66,18775,77,413877
32227,0.000297,74.125.24.0-255,1484,20259,77,413877
32228,0.000299,172.31.40.0-255,66,20325,77,413877
32229,0.000322,74.125.24.0-255,4320,24645,77,413877
32230,0.000324,172.31.40.0-255,66,24711,77,413877
32231,0.000329,74.125.24.0-255,4320,29031,77,413877
32232,0.000332,172.31.40.0-255,66,29097,77,413877
32233,0.000358,74.125.24.0-255,8574,37671,77,413877
32234,0.000361,172.31.40.0-255,66,37737,77,413877
32235,0.000381,74.125.24.0-255,3961,41698,77,413877
32236,0.000383,172.31.40.0-255,66,41764,77,413877
32237,0.00039,74.125.24.0-255,7156,48920,77,413877
32238,0.000393,172.31.40.0-255,66,48986,77,413877
32239,0.000427,74.125.24.0-255,5738,54724,77,413877
32240,0.00043,172.31.40.0-255,66,54790,77,413877
32241,0.000458,74.125.24.0-255,11303,66093,77,413877
32242,0.000461,172.31.40.0-255,66,66159,77,413877
32243,0.000611,74.125.24.0-255,1484,67643,77,413877
32244,0.000618,74.125.24.0-255,2902,70545,77,413877
32245,0.000621,172.31.40.0-255,66,70611,77,413877
32246,0.000648,74.125.24.0-255,5738,76349,77,413877
32247,0.000651,172.31.40.0-255,66,76415,77,413877
32248,0.00066,74.125.24.0-255,8574,84989,77,413877
32249,0.000662,172.31.40.0-255,66,85055,77,413877
32250,0.000687,74.125.24.0-255,4320,89375,77,413877
32251,0.00069,172.31.40.0-255,66,89441,77,413877
32252,0.0007,74.125.24.0-255,10692,100133,77,413877
32253,0.000702,172.31.40.0-255,66,100199,77,413877
32254,0.000972,172.31.40.0-255,101,100300,77,413877
32255,0.001502,74.125.24.0-255,1484,101784,77,413877
32256,0.001512,74.125.24.0-255,2902,104686,77,413877
32257,0.001517,172.31.40.0-255,66,104752,77,413877
32258,0.001552,74.125.24.0-255,5738,110490,77,413877
32259,0.001556,172.31.40.0-255,66,110556,77,413877
32260,0.001563,74.125.24.0-255,7156,117712,77,413877
32261,0.001566,172.31.40.0-255,66,117778,77,413877
32262,0.001598,74.125.24.0-255,12828,130606,77,413877
32263,0.001601,172.31.40.0-255,66,130672,77,413877
32264,0.001617,74.125.24.0-255,1484,132156,77,413877
32265,0.001621,74.125.24.0-255,2184,134340,77,413877
32266,0.001624,172.31.40.0-255,66,134406,77,413877
32267,0.001967,74.125.24.0-255,1484,135890,77,413877
32268,0.001977,74.125.24.0-255,2902,138792,77,413877
32269,0.001981,172.31.40.0-255,66,138858,77,413877
32270,0.001989,74.125.24.0-255,5738,144596,77,413877
32271,0.001991,172.31.40.0-255,66,144662,77,413877
32272,0.002019,74.125.24.0-255,1484,146146,77,413877
32273,0.002048,74.125.24.0-255,8574,154720,77,413877
32274,0.00205,172.31.40.0-255,66,154786,77,413877
32275,0.002061,74.125.24.0-255,11410,166196,77,413877
32276,0.002063,172.31.40.0-255,66,166262,77,413877
32277,0.00207,74.125.24.0-255,5020,171282,77,413877
32278,0.002072,172.31.40.0-255,66,171348,77,413877
32279,0.002078,74.125.24.0-255,5738,177086,77,413877
32280,0.002081,172.31.40.0-255,66,177152,77,413877
32281,0.002104,74.125.24.0-255,1484,178636,77,413877
32282,0.002123,74.125.24.0-255,9992,188628,77,413877
32283,0.002126,172.31.40.0-255,66,188694,77,413877
32284,0.002143,74.125.24.0-255,1484,190178,77,413877
32285,0.002155,74.125.24.0-255,2902,193080,77,413877
32286,0.002157,172.31.40.0-255,66,193146,77,413877
32287,0.002186,74.125.24.0-255,9274,202420,77,413877
32288,0.002188,172.31.40.0-255,66,202486,77,413877
32289,0.002337,74.125.24.0-255,1484,203970,77,413877
32290,0.002356,74.125.24.0-255,2902,206872,77,413877
32291,0.002362,172.31.40.0-255,66,206938,77,413877
32292,0.002377,74.125.24.0-255,5738,212676,77,413877
32293,0.00238,172.31.40.0-255,66,212742,77,413877
32294,0.002385,74.125.24.0-255,4320,217062,77,413877
32295,0.002388,172.31.40.0-255,66,217128,77,413877
32296,0.002406,74.125.24.0-255,1484,218612,77,413877
32297,0.002409,74.125.24.0-255,1484,220096,77,413877
32298,0.002411,172.31.40.0-255,66,220162,77,413877
32299,0.002417,74.125.24.0-255,4320,224482,77,413877
32300,0.00242,172.31.40.0-255,66,224548,77,413877
32301,0.002436,74.125.24.0-255,1484,226032,77,413877
32302,0.002441,74.125.24.0-255,4320,230352,77,413877
32303,0.002444,172.31.40.0-255,66,230418,77,413877
32304,0.00248,74.125.24.0-255,4320,234738,77,413877
32305,0.002483,172.31.40.0-255,66,234804,77,413877
32306,0.002501,74.125.24.0-255,2184,236988,77,413877
32307,0.002503,172.31.40.0-255,66,237054,77,413877
32308,0.002723,74.125.24.0-255,1484,238538,77,413877
32309,0.002735,74.125.24.0-255,2902,241440,77,413877
32310,0.002738,172.31.40.0-255,66,241506,77,413877
32311,0.002741,74.125.24.0-255,1484,242990,77,413877
32312,0.002757,74.125.24.0-255,4320,247310,77,413877
32313,0.00276,172.31.40.0-255,66,247376,77,413877
32314,0.002765,74.125.24.0-255,4320,251696,77,413877
32315,0.002768,172.31.40.0-255,66,251762,77,413877
32316,0.002788,74.125.24.0-255,1484,253246,77,413877
32317,0.002799,74.125.24.0-255,11410,264656,77,413877
32318,0.002802,172.31.40.0-255,66,264722,77,413877
32319,0.002824,74.125.24.0-255,7856,272578,77,413877
32320,0.002826,172.31.40.0-255,66,272644,77,413877
32321,0.002829,74.125.24.0-255,1484,274128,77,413877
32322,0.002856,74.125.24.0-255,8574,282702,77,413877
32323,0.002859,172.31.40.0-255,66,282768,77,413877
32324,0.002863,74.125.24.0-255,1484,284252,77,413877
32325,0.002884,74.125.24.0-255,8574,292826,77,413877
32326,0.002887,172.31.40.0-255,66,292892,77,413877
32327,0.002912,74.125.24.0-255,9992,302884,77,413877
32328,0.002916,172.31.40.0-255,66,302950,77,413877
32329,0.002919,74.125.24.0-255,2184,305134,77,413877
32330,0.002922,172.31.40.0-255,66,305200,77,413877
32331,0.003006,74.125.24.0-255,1484,306684,77,413877
32332,0.003009,74.125.24.0-255,1484,308168,77,413877
32333,0.003012,172.31.40.0-255,66,308234,77,413877
32334,0.003031,74.125.24.0-255,1484,309718,77,413877
32335,0.003037,74.125.24.0-255,4320,314038,77,413877
32336,0.00304,172.31.40.0-255,66,314104,77,413877
32337,0.003044,74.125.24.0-255,2902,317006,77,413877
32338,0.003047,172.31.40.0-255,66,317072,77,413877
32339,0.003064,74.125.24.0-255,8574,325646,77,413877
32340,0.003067,172.31.40.0-255,66,325712,77,413877
32341,0.003111,74.125.24.0-255,4320,330032,77,413877
32342,0.003114,172.31.40.0-255,66,330098,77,413877
32343,0.00313,74.125.24.0-255,9274,339372,77,413877
32344,0.003133,172.31.40.0-255,66,339438,77,413877
32345,0.003168,74.125.24.0-255,1484,340922,77,413877
32346,0.003181,74.125.24.0-255,2902,343824,77,413877
32347,0.003184,172.31.40.0-255,66,343890,77,413877
32348,0.003189,74.125.24.0-255,4320,348210,77,413877
32349,0.003191,172.31.40.0-255,66,348276,77,413877
32350,0.003207,74.125.24.0-255,1484,349760,77,413877
32351,0.003238,74.125.24.0-255,12828,362588,77,413877
32352,0.003241,172.31.40.0-255,66,362654,77,413877
32353,0.003247,74.125.24.0-255,5738,368392,77,413877
32354,0.003249,172.31.40.0-255,66,368458,77,413877
32355,0.003287,74.125.24.0-255,4320,372778,77,413877
32356,0.003289,172.31.40.0-255,66,372844,77,413877
32357,0.003315,74.125.24.0-255,11410,384254,77,413877
32358,0.003318,172.31.40.0-255,66,384320,77,413877
32359,0.003337,74.125.24.0-255,3602,387922,77,413877
32360,0.00334,172.31.40.0-255,66,387988,77,413877
32361,0.003344,74.125.24.0-255,2902,390890,77,413877
32362,0.003348,172.31.40.0-255,66,390956,77,413877
32363,0.003353,74.125.24.0-255,4320,395276,77,413877
32364,0.003356,172.31.40.0-255,66,395342,77,413877
32365,0.003385,74.125.24.0-255,9992,405334,77,413877
32366,0.003387,172.31.40.0-255,66,405400,77,413877
32367,0.003404,74.125.24.0-255,2184,407584,77,413877
32368,0.003406,172.31.40.0-255,66,407650,77,413877
32369,0.003414,74.125.24.0-255,5885,413535,77,413877
32370,0.003416,172.31.40.0-255,66,413601,77,413877
32371,0.003448,74.125.24.0-255,105,413706,77,413877
32372,0.012577,172.31.40.0-255,105,413811,77,413877
32373,0.018604,74.125.24.0-255,66,413877,77,413877
32374,0.0,172.217.194.0-255,153,153,77,235095
32375,1.5e-05,172.31.40.0-255,66,219,77,235095
32376,2.1e-05,172.217.194.0-255,1484,1703,77,235095
32377,2.5e-05,172.31.40.0-255,66,1769,77,235095
32378,3.1e-05,172.217.194.0-255,2902,4671,77,235095
32379,3.4e-05,172.31.40.0-255,66,4737,77,235095
32380,4.1e-05,172.217.194.0-255,7156,11893,77,235095
32381,4.3e-05,172.31.40.0-255,66,11959,77,235095
32382,4.7e-05,172.217.194.0-255,1931,13890,77,235095
32383,4.9e-05,172.31.40.0-255,66,13956,77,235095
32384,0.000146,172.217.194.0-255,1484,15440,77,235095
32385,0.000149,172.31.40.0-255,66,15506,77,235095
32386,0.000169,172.217.194.0-255,2902,18408,77,235095
32387,0.000171,172.31.40.0-255,66,18474,77,235095
32388,0.000192,172.217.194.0-255,2902,21376,77,235095
32389,0.000195,172.31.40.0-255,66,21442,77,235095
32390,0.000209,172.217.194.0-255,2902,24344,77,235095
32391,0.000211,172.31.40.0-255,66,24410,77,235095
32392,0.000216,172.217.194.0-255,4320,28730,77,235095
32393,0.000218,172.31.40.0-255,66,28796,77,235095
32394,0.000247,172.217.194.0-255,6797,35593,77,235095
32395,0.000249,172.31.40.0-255,66,35659,77,235095
32396,0.000265,172.31.40.0-255,66,35725,77,235095
32397,0.000271,172.217.194.0-255,5738,41463,77,235095
32398,0.000273,172.31.40.0-255,66,41529,77,235095
32399,0.000291,172.217.194.0-255,5332,46861,77,235095
32400,0.000293,172.31.40.0-255,66,46927,77,235095
32401,0.00033,172.217.194.0-255,100,47027,77,235095
32402,0.000333,172.31.40.0-255,66,47093,77,235095
32403,0.000356,172.217.194.0-255,364,47457,77,235095
32404,0.000358,172.31.40.0-255,66,47523,77,235095
32405,0.000549,172.217.194.0-255,1484,49007,77,235095
32406,0.000554,172.217.194.0-255,1484,50491,77,235095
32407,0.000557,172.31.40.0-255,66,50557,77,235095
32408,0.000577,172.217.194.0-255,1484,52041,77,235095
32409,0.000584,172.217.194.0-255,5738,57779,77,235095
32410,0.000586,172.31.40.0-255,66,57845,77,235095
32411,0.00059,172.217.194.0-255,2902,60747,77,235095
32412,0.000592,172.31.40.0-255,66,60813,77,235095
32413,0.000615,172.217.194.0-255,9992,70805,77,235095
32414,0.000618,172.31.40.0-255,66,70871,77,235095
32415,0.000627,172.217.194.0-255,2902,73773,77,235095
32416,0.000629,172.31.40.0-255,66,73839,77,235095
32417,0.000649,172.217.194.0-255,7856,81695,77,235095
32418,0.000651,172.31.40.0-255,66,81761,77,235095
32419,0.001434,172.217.194.0-255,1484,83245,77,235095
32420,0.001443,172.217.194.0-255,2902,86147,77,235095
32421,0.001447,172.31.40.0-255,66,86213,77,235095
32422,0.001454,172.217.194.0-255,5738,91951,77,235095
32423,0.001456,172.31.40.0-255,66,92017,77,235095
32424,0.001477,172.217.194.0-255,1484,93501,77,235095
32425,0.00151,172.217.194.0-255,11410,104911,77,235095
32426,0.001513,172.31.40.0-255,66,104977,77,235095
32427,0.001521,172.217.194.0-255,8574,113551,77,235095
32428,0.001523,172.31.40.0-255,66,113617,77,235095
32429,0.001544,172.217.194.0-255,1484,115101,77,235095
32430,0.001547,172.217.194.0-255,766,115867,77,235095
32431,0.001549,172.31.40.0-255,66,115933,77,235095
32432,0.001552,172.217.194.0-255,1484,117417,77,235095
32433,0.001575,172.217.194.0-255,4320,121737,77,235095
32434,0.001578,172.31.40.0-255,66,121803,77,235095
32435,0.001594,172.217.194.0-255,4320,126123,77,235095
32436,0.001596,172.31.40.0-255,66,126189,77,235095
32437,0.001618,172.217.194.0-255,4320,130509,77,235095
32438,0.001621,172.31.40.0-255,66,130575,77,235095
32439,0.001629,172.217.194.0-255,9992,140567,77,235095
32440,0.001631,172.31.40.0-255,66,140633,77,235095
32441,0.001669,172.217.194.0-255,13528,154161,77,235095
32442,0.001672,172.31.40.0-255,66,154227,77,235095
32443,0.001705,172.217.194.0-255,7156,161383,77,235095
32444,0.001707,172.31.40.0-255,66,161449,77,235095
32445,0.001736,172.217.194.0-255,7156,168605,77,235095
32446,0.001739,172.31.40.0-255,66,168671,77,235095
32447,0.001752,172.31.40.0-255,66,168737,77,235095
32448,0.00186,172.217.194.0-255,1484,170221,77,235095
32449,0.001866,172.217.194.0-255,2902,173123,77,235095
32450,0.00187,172.31.40.0-255,66,173189,77,235095
32451,0.001886,172.217.194.0-255,5738,178927,77,235095
32452,0.001888,172.31.40.0-255,66,178993,77,235095
32453,0.001892,172.217.194.0-255,2902,181895,77,235095
32454,0.001894,172.31.40.0-255,66,181961,77,235095
32455,0.001921,172.217.194.0-255,4320,186281,77,235095
32456,0.001923,172.31.40.0-255,66,186347,77,235095
32457,0.001936,172.31.40.0-255,66,186413,77,235095
32458,0.001952,172.217.194.0-255,2184,188597,77,235095
32459,0.001953,172.31.40.0-255,66,188663,77,235095
32460,0.003982,172.217.194.0-255,5738,194401,77,235095
32461,0.003988,172.31.40.0-255,66,194467,77,235095
32462,0.006038,172.217.194.0-255,5738,200205,77,235095
32463,0.006042,172.31.40.0-255,66,200271,77,235095
32464,0.008071,172.217.194.0-255,5738,206009,77,235095
32465,0.008082,172.31.40.0-255,66,206075,77,235095
32466,0.01014,172.217.194.0-255,5738,211813,77,235095
32467,0.010156,172.31.40.0-255,66,211879,77,235095
32468,0.01222,172.217.194.0-255,5738,217617,77,235095
32469,0.012236,172.31.40.0-255,66,217683,77,235095
32470,0.014266,172.217.194.0-255,5738,223421,77,235095
32471,0.014279,172.31.40.0-255,66,223487,77,235095
32472,0.016336,172.217.194.0-255,5738,229225,77,235095
32473,0.01635,172.31.40.0-255,66,229291,77,235095
32474,0.018397,172.217.194.0-255,5738,235029,77,235095
32475,0.018411,172.31.40.0-255,66,235095,77,235095
32476,0.0,172.217.194.0-255,153,153,77,333365
32477,2.9e-05,172.31.40.0-255,66,219,77,333365
32478,3.5e-05,172.217.194.0-255,1484,1703,77,333365
32479,3.9e-05,172.31.40.0-255,66,1769,77,333365
32480,4.3e-05,172.217.194.0-255,2902,4671,77,333365
32481,4.6e-05,172.31.40.0-255,66,4737,77,333365
32482,5.7e-05,172.217.194.0-255,5738,10475,77,333365
32483,6e-05,172.31.40.0-255,66,10541,77,333365
32484,0.0001,172.217.194.0-255,2902,13443,77,333365
32485,0.000103,172.31.40.0-255,66,13509,77,333365
32486,0.000124,172.217.194.0-255,682,14191,77,333365
32487,0.000126,172.31.40.0-255,66,14257,77,333365
32488,0.000147,172.217.194.0-255,1484,15741,77,333365
32489,0.00015,172.31.40.0-255,66,15807,77,333365
32490,0.000154,172.217.194.0-255,2902,18709,77,333365
32491,0.000156,172.31.40.0-255,66,18775,77,333365
32492,0.000158,172.217.194.0-255,1484,20259,77,333365
32493,0.00016,172.31.40.0-255,66,20325,77,333365
32494,0.000185,172.217.194.0-255,4320,24645,77,333365
32495,0.000188,172.31.40.0-255,66,24711,77,333365
32496,0.000211,172.217.194.0-255,2902,27613,77,333365
32497,0.000213,172.31.40.0-255,66,27679,77,333365
32498,0.000249,172.217.194.0-255,9633,37312,77,333365
32499,0.000252,172.31.40.0-255,66,37378,77,333365
32500,0.000263,172.217.194.0-255,12828,50206,77,333365
32501,0.000265,172.31.40.0-255,66,50272,77,333365
32502,0.000293,172.217.194.0-255,11410,61682,77,333365
32503,0.000296,172.31.40.0-255,66,61748,77,333365
32504,0.00032,172.217.194.0-255,3602,65350,77,333365
32505,0.000322,172.31.40.0-255,66,65416,77,333365
32506,0.000325,172.217.194.0-255,377,65793,77,333365
32507,0.000327,172.31.40.0-255,66,65859,77,333365
32508,0.000329,172.217.194.0-255,367,66226,77,333365
32509,0.000397,172.217.194.0-255,1484,67710,77,333365
32510,0.000399,172.31.40.0-255,66,67776,77,333365
32511,0.000403,172.217.194.0-255,1484,69260,77,333365
32512,0.000425,172.217.194.0-255,1484,70744,77,333365
32513,0.000428,172.31.40.0-255,66,70810,77,333365
32514,0.000434,172.217.194.0-255,5738,76548,77,333365
32515,0.000435,172.31.40.0-255,66,76614,77,333365
32516,0.000457,172.217.194.0-255,9992,86606,77,333365
32517,0.000459,172.31.40.0-255,66,86672,77,333365
32518,0.000488,172.217.194.0-255,2902,89574,77,333365
32519,0.000492,172.31.40.0-255,66,89640,77,333365
32520,0.000495,172.217.194.0-255,10692,100332,77,333365
32521,0.000497,172.31.40.0-255,66,100398,77,333365
32522,0.000555,172.31.40.0-255,101,100499,77,333365
32523,0.000912,172.217.194.0-255,1484,101983,77,333365
32524,0.00092,172.217.194.0-255,2902,104885,77,333365
32525,0.000923,172.31.40.0-255,66,104951,77,333365
32526,0.000926,172.217.194.0-255,1484,106435,77,333365
32527,0.000953,172.217.194.0-255,4320,110755,77,333365
32528,0.000955,172.31.40.0-255,66,110821,77,333365
32529,0.000961,172.217.194.0-255,5738,116559,77,333365
32530,0.000962,172.31.40.0-255,66,116625,77,333365
32531,0.000997,172.217.194.0-255,7156,123781,77,333365
32532,0.001,172.31.40.0-255,66,123847,77,333365
32533,0.001009,172.217.194.0-255,10692,134539,77,333365
32534,0.001011,172.31.40.0-255,66,134605,77,333365
32535,0.001306,172.217.194.0-255,1484,136089,77,333365
32536,0.001311,172.217.194.0-255,1484,137573,77,333365
32537,0.001314,172.31.40.0-255,66,137639,77,333365
32538,0.001343,172.217.194.0-255,1484,139123,77,333365
32539,0.001346,172.217.194.0-255,1484,140607,77,333365
32540,0.001348,172.31.40.0-255,66,140673,77,333365
32541,0.001354,172.217.194.0-255,2902,143575,77,333365
32542,0.001355,172.31.40.0-255,66,143641,77,333365
32543,0.001362,172.217.194.0-255,5738,149379,77,333365
32544,0.001363,172.31.40.0-255,66,149445,77,333365
32545,0.001367,172.217.194.0-255,2902,152347,77,333365
32546,0.001369,172.31.40.0-255,66,152413,77,333365
32547,0.001406,172.217.194.0-255,9992,162405,77,333365
32548,0.001408,172.31.40.0-255,66,162471,77,333365
32549,0.001413,172.217.194.0-255,6438,168909,77,333365
32550,0.001415,172.31.40.0-255,66,168975,77,333365
32551,0.001478,172.217.194.0-255,1484,170459,77,333365
32552,0.001494,172.217.194.0-255,2902,173361,77,333365
32553,0.001497,172.31.40.0-255,66,173427,77,333365
32554,0.001502,172.217.194.0-255,5738,179165,77,333365
32555,0.001504,172.31.40.0-255,66,179231,77,333365
32556,0.001532,172.217.194.0-255,9992,189223,77,333365
32557,0.001534,172.31.40.0-255,66,189289,77,333365
32558,0.001565,172.217.194.0-255,2902,192191,77,333365
32559,0.001579,172.31.40.0-255,66,192257,77,333365
32560,0.001588,172.217.194.0-255,10692,202949,77,333365
32561,0.001594,172.31.40.0-255,66,203015,77,333365
32562,0.001643,172.217.194.0-255,1484,204499,77,333365
32563,0.001646,172.217.194.0-255,1484,205983,77,333365
32564,0.001649,172.31.40.0-255,66,206049,77,333365
32565,0.001668,172.217.194.0-255,1484,207533,77,333365
32566,0.001673,172.217.194.0-255,5738,213271,77,333365
32567,0.001675,172.31.40.0-255,66,213337,77,333365
32568,0.001703,172.217.194.0-255,11410,224747,77,333365
32569,0.001706,172.31.40.0-255,66,224813,77,333365
32570,0.001709,172.217.194.0-255,2902,227715,77,333365
32571,0.001711,172.31.40.0-255,66,227781,77,333365
32572,0.001739,172.217.194.0-255,9274,237055,77,333365
32573,0.001742,172.31.40.0-255,66,237121,77,333365
32574,0.001769,172.217.194.0-255,1484,238605,77,333365
32575,0.001786,172.217.194.0-255,2902,241507,77,333365
32576,0.001788,172.31.40.0-255,66,241573,77,333365
32577,0.001813,172.217.194.0-255,5738,247311,77,333365
32578,0.001868,172.217.194.0-255,12828,260139,77,333365
32579,0.001876,172.217.194.0-255,10692,270831,77,333365
32580,0.001879,172.217.194.0-255,1484,272315,77,333365
32581,0.001926,172.217.194.0-255,10692,283007,77,333365
32582,0.001966,172.217.194.0-255,5738,288745,77,333365
32583,0.002005,172.217.194.0-255,2184,290929,77,333365
32584,0.002055,172.217.194.0-255,10692,301621,77,333365
32585,0.002078,172.217.194.0-255,2902,304523,77,333365
32586,0.002097,172.217.194.0-255,8574,313097,77,333365
32587,0.002105,172.217.194.0-255,1484,314581,77,333365
32588,0.002129,172.217.194.0-255,12110,326691,77,333365
32589,0.002132,172.217.194.0-255,2902,329593,77,333365
32590,0.002149,172.217.194.0-255,3364,332957,77,333365
32591,0.002163,172.217.194.0-255,105,333062,77,333365
32592,0.003053,172.217.194.0-255,66,333128,77,333365
32593,0.01031,172.31.40.0-255,66,333194,77,333365
32594,0.012728,172.31.40.0-255,105,333299,77,333365
32595,0.015265,172.217.194.0-255,66,333365,77,333365
32596,0.0,172.217.194.0-255,298,298,77,349532
32597,2e-05,172.31.40.0-255,66,364,77,349532
32598,2.7e-05,172.217.194.0-255,1484,1848,77,349532
32599,3.1e-05,172.31.40.0-255,66,1914,77,349532
32600,3.9e-05,172.217.194.0-255,4320,6234,77,349532
32601,4.2e-05,172.31.40.0-255,66,6300,77,349532
32602,7e-05,172.217.194.0-255,7156,13456,77,349532
32603,7.3e-05,172.31.40.0-255,66,13522,77,349532
32604,0.000103,172.217.194.0-255,1871,15393,77,349532
32605,0.000105,172.31.40.0-255,66,15459,77,349532
32606,0.000115,172.217.194.0-255,9992,25451,77,349532
32607,0.000118,172.31.40.0-255,66,25517,77,349532
32608,0.000121,172.217.194.0-255,1484,27001,77,349532
32609,0.000123,172.31.40.0-255,66,27067,77,349532
32610,0.000176,172.31.40.0-255,66,27133,77,349532
32611,0.000179,172.217.194.0-255,766,27899,77,349532
32612,0.000181,172.31.40.0-255,66,27965,77,349532
32613,0.000196,172.31.40.0-255,66,28031,77,349532
32614,0.000238,172.217.194.0-255,2796,30827,77,349532
32615,0.000241,172.31.40.0-255,66,30893,77,349532
32616,0.000244,172.217.194.0-255,120,31013,77,349532
32617,0.000246,172.31.40.0-255,66,31079,77,349532
32618,0.000276,172.217.194.0-255,1484,32563,77,349532
32619,0.000278,172.31.40.0-255,66,32629,77,349532
32620,0.000283,172.217.194.0-255,2902,35531,77,349532
32621,0.000285,172.31.40.0-255,66,35597,77,349532
32622,0.000299,172.217.194.0-255,2902,38499,77,349532
32623,0.000301,172.31.40.0-255,66,38565,77,349532
32624,0.000348,172.217.194.0-255,4320,42885,77,349532
32625,0.000352,172.31.40.0-255,66,42951,77,349532
32626,0.000355,172.217.194.0-255,1484,44435,77,349532
32627,0.000361,172.217.194.0-255,4275,48710,77,349532
32628,0.000364,172.31.40.0-255,66,48776,77,349532
32629,0.000402,172.217.194.0-255,1484,50260,77,349532
32630,0.000425,172.217.194.0-255,2902,53162,77,349532
32631,0.000428,172.31.40.0-255,66,53228,77,349532
32632,0.000459,172.217.194.0-255,5738,58966,77,349532
32633,0.000462,172.31.40.0-255,66,59032,77,349532
32634,0.000473,172.217.194.0-255,12828,71860,77,349532
32635,0.000476,172.31.40.0-255,66,71926,77,349532
32636,0.000483,172.217.194.0-255,7156,79082,77,349532
32637,0.000485,172.31.40.0-255,66,79148,77,349532
32638,0.000509,172.217.194.0-255,3052,82200,77,349532
32639,0.000512,172.31.40.0-255,66,82266,77,349532
32640,0.000533,172.217.194.0-255,4320,86586,77,349532
32641,0.000536,172.31.40.0-255,66,86652,77,349532
32642,0.000545,172.217.194.0-255,8574,95226,77,349532
32643,0.000547,172.31.40.0-255,66,95292,77,349532
32644,0.000568,172.217.194.0-255,1484,96776,77,349532
32645,0.000573,172.217.194.0-255,2902,99678,77,349532
32646,0.000575,172.31.40.0-255,66,99744,77,349532
32647,0.000605,172.217.194.0-255,12828,112572,77,349532
32648,0.000607,172.31.40.0-255,66,112638,77,349532
32649,0.00063,172.217.194.0-255,3602,116240,77,349532
32650,0.000632,172.31.40.0-255,66,116306,77,349532
32651,0.000666,172.217.194.0-255,1484,117790,77,349532
32652,0.00068,172.217.194.0-255,2902,120692,77,349532
32653,0.000683,172.31.40.0-255,66,120758,77,349532
32654,0.000686,172.217.194.0-255,1484,122242,77,349532
32655,0.000703,172.217.194.0-255,4320,126562,77,349532
32656,0.000705,172.31.40.0-255,66,126628,77,349532
32657,0.000712,172.217.194.0-255,5738,132366,77,349532
32658,0.000715,172.31.40.0-255,66,132432,77,349532
32659,0.000727,172.217.194.0-255,1125,133557,77,349532
32660,0.000793,172.217.194.0-255,1484,135041,77,349532
32661,0.000796,172.31.40.0-255,66,135107,77,349532
32662,0.000802,172.217.194.0-255,2902,138009,77,349532
32663,0.000805,172.31.40.0-255,66,138075,77,349532
32664,0.000812,172.217.194.0-255,5738,143813,77,349532
32665,0.000814,172.31.40.0-255,66,143879,77,349532
32666,0.000843,172.217.194.0-255,5738,149617,77,349532
32667,0.000846,172.31.40.0-255,66,149683,77,349532
32668,0.000865,172.217.194.0-255,7156,156839,77,349532
32669,0.000868,172.31.40.0-255,66,156905,77,349532
32670,0.000873,172.217.194.0-255,4320,161225,77,349532
32671,0.000875,172.31.40.0-255,66,161291,77,349532
32672,0.000898,172.217.194.0-255,6438,167729,77,349532
32673,0.000908,172.217.194.0-255,11410,179139,77,349532
32674,0.000912,172.217.194.0-255,2902,182041,77,349532
32675,0.000916,172.31.40.0-255,66,182107,77,349532
32676,0.000919,172.31.40.0-255,66,182173,77,349532
32677,0.000922,172.31.40.0-255,66,182239,77,349532
32678,0.000944,172.217.194.0-255,2543,184782,77,349532
32679,0.000948,172.31.40.0-255,66,184848,77,349532
32680,0.001127,172.217.194.0-255,1484,186332,77,349532
32681,0.001145,172.217.194.0-255,2902,189234,77,349532
32682,0.001149,172.31.40.0-255,66,189300,77,349532
32683,0.001156,172.217.194.0-255,5738,195038,77,349532
32684,0.001158,172.31.40.0-255,66,195104,77,349532
32685,0.001192,172.217.194.0-255,6797,201901,77,349532
32686,0.001195,172.31.40.0-255,66,201967,77,349532
32687,0.001352,172.217.194.0-255,1484,203451,77,349532
32688,0.001358,172.217.194.0-255,2902,206353,77,349532
32689,0.001361,172.31.40.0-255,66,206419,77,349532
32690,0.001364,172.217.194.0-255,1484,207903,77,349532
32691,0.001387,172.217.194.0-255,4320,212223,77,349532
32692,0.00139,172.31.40.0-255,66,212289,77,349532
32693,0.001429,172.217.194.0-255,2902,215191,77,349532
32694,0.001431,172.31.40.0-255,66,215257,77,349532
32695,0.001456,172.217.194.0-255,9992,225249,77,349532
32696,0.001459,172.31.40.0-255,66,225315,77,349532
32697,0.001469,172.217.194.0-255,10692,236007,77,349532
32698,0.001471,172.31.40.0-255,66,236073,77,349532
32699,0.001518,172.217.194.0-255,1484,237557,77,349532
32700,0.001523,172.217.194.0-255,2902,240459,77,349532
32701,0.001526,172.31.40.0-255,66,240525,77,349532
32702,0.001552,172.217.194.0-255,5738,246263,77,349532
32703,0.001556,172.31.40.0-255,66,246329,77,349532
32704,0.001578,172.217.194.0-255,5738,252067,77,349532
32705,0.001581,172.31.40.0-255,66,252133,77,349532
32706,0.001599,172.217.194.0-255,7156,259289,77,349532
32707,0.001602,172.31.40.0-255,66,259355,77,349532
32708,0.00161,172.217.194.0-255,8574,267929,77,349532
32709,0.001612,172.31.40.0-255,66,267995,77,349532
32710,0.001636,172.217.194.0-255,2184,270179,77,349532
32711,0.00164,172.31.40.0-255,66,270245,77,349532
32712,0.001834,172.217.194.0-255,1484,271729,77,349532
32713,0.00184,172.217.194.0-255,2902,274631,77,349532
32714,0.001844,172.31.40.0-255,66,274697,77,349532
32715,0.001851,172.217.194.0-255,5738,280435,77,349532
32716,0.001853,172.31.40.0-255,66,280501,77,349532
32717,0.00187,172.217.194.0-255,5738,286239,77,349532
32718,0.001872,172.31.40.0-255,66,286305,77,349532
32719,0.001893,172.217.194.0-255,7156,293461,77,349532
32720,0.001895,172.31.40.0-255,66,293527,77,349532
32721,0.001905,172.217.194.0-255,10692,304219,77,349532
32722,0.001908,172.31.40.0-255,66,304285,77,349532
32723,0.002217,172.31.40.0-255,101,304386,77,349532
32724,0.00414,172.217.194.0-255,4320,308706,77,349532
32725,0.004146,172.31.40.0-255,66,308772,77,349532
32726,0.004165,172.217.194.0-255,1484,310256,77,349532
32727,0.004404,172.217.194.0-255,66,310322,77,349532
32728,0.006356,172.217.194.0-255,4320,314642,77,349532
32729,0.006362,172.31.40.0-255,66,314708,77,349532
32730,0.008576,172.217.194.0-255,5738,320446,77,349532
32731,0.008583,172.31.40.0-255,66,320512,77,349532
32732,0.010777,172.217.194.0-255,5738,326250,77,349532
32733,0.01078,172.31.40.0-255,66,326316,77,349532
32734,0.013014,172.217.194.0-255,5738,332054,77,349532
32735,0.01303,172.31.40.0-255,66,332120,77,349532
32736,0.015261,172.217.194.0-255,5738,337858,77,349532
32737,0.015275,172.31.40.0-255,66,337924,77,349532
32738,0.017493,172.217.194.0-255,5738,343662,77,349532
32739,0.017502,172.31.40.0-255,66,343728,77,349532
32740,0.019707,172.217.194.0-255,5738,349466,77,349532
32741,0.019713,172.31.40.0-255,66,349532,77,349532
32742,0.0,74.125.200.0-255,147,147,77,111940
32743,2.4e-05,172.31.40.0-255,66,213,77,111940
32744,3.2e-05,74.125.200.0-255,1484,1697,77,111940
32745,3.7e-05,172.31.40.0-255,66,1763,77,111940
32746,5.1e-05,74.125.200.0-255,2902,4665,77,111940
32747,5.5e-05,172.31.40.0-255,66,4731,77,111940
32748,7.9e-05,74.125.200.0-255,2902,7633,77,111940
32749,8.2e-05,172.31.40.0-255,66,7699,77,111940
32750,0.000112,74.125.200.0-255,2902,10601,77,111940
32751,0.000115,172.31.40.0-255,66,10667,77,111940
32752,0.000227,74.125.200.0-255,5738,16405,77,111940
32753,0.000231,172.31.40.0-255,66,16471,77,111940
32754,0.000261,74.125.200.0-255,4846,21317,77,111940
32755,0.000264,172.31.40.0-255,66,21383,77,111940
32756,0.000487,74.125.200.0-255,4320,25703,77,111940
32757,0.000492,172.31.40.0-255,66,25769,77,111940
32758,0.000593,74.125.200.0-255,5379,31148,77,111940
32759,0.000598,172.31.40.0-255,66,31214,77,111940
32760,0.000726,74.125.200.0-255,4320,35534,77,111940
32761,0.00073,172.31.40.0-255,66,35600,77,111940
32762,0.000774,172.31.40.0-255,66,35666,77,111940
32763,0.001301,74.125.200.0-255,11664,47330,77,111940
32764,0.001306,172.31.40.0-255,66,47396,77,111940
32765,0.001582,172.31.40.0-255,66,47462,77,111940
32766,0.001984,74.125.200.0-255,4320,51782,77,111940
32767,0.00199,172.31.40.0-255,66,51848,77,111940
32768,0.002044,172.31.40.0-255,66,51914,77,111940
32769,0.002737,74.125.200.0-255,5738,57652,77,111940
32770,0.002741,172.31.40.0-255,66,57718,77,111940
32771,0.002767,74.125.200.0-255,13528,71246,77,111940
32772,0.003575,172.31.40.0-255,66,71312,77,111940
32773,0.005569,74.125.200.0-255,5738,77050,77,111940
32774,0.005575,172.31.40.0-255,66,77116,77,111940
32775,0.007571,74.125.200.0-255,5738,82854,77,111940
32776,0.007577,172.31.40.0-255,66,82920,77,111940
32777,0.009573,74.125.200.0-255,5738,88658,77,111940
32778,0.009581,172.31.40.0-255,66,88724,77,111940
32779,0.011599,74.125.200.0-255,5738,94462,77,111940
32780,0.011607,172.31.40.0-255,66,94528,77,111940
32781,0.013658,74.125.200.0-255,5738,100266,77,111940
32782,0.014158,172.31.40.0-255,66,100332,77,111940
32783,0.016154,74.125.200.0-255,5738,106070,77,111940
32784,0.016162,172.31.40.0-255,66,106136,77,111940
32785,0.018154,74.125.200.0-255,5738,111874,77,111940
32786,0.018191,172.31.40.0-255,66,111940,77,111940
32787,0.0,74.125.24.0-255,152,152,77,304242
32788,1.6e-05,172.31.40.0-255,66,218,77,304242
32789,2.3e-05,74.125.24.0-255,1484,1702,77,304242
32790,2.7e-05,172.31.40.0-255,66,1768,77,304242
32791,3.3e-05,74.125.24.0-255,2902,4670,77,304242
32792,3.6e-05,172.31.40.0-255,66,4736,77,304242
32793,4.3e-05,74.125.24.0-255,7156,11892,77,304242
32794,4.6e-05,172.31.40.0-255,66,11958,77,304242
32795,9.4e-05,74.125.24.0-255,13320,25278,77,304242
32796,9.6e-05,172.31.40.0-255,66,25344,77,304242
32797,0.00012,74.125.24.0-255,5379,30723,77,304242
32798,0.000122,172.31.40.0-255,66,30789,77,304242
32799,0.000515,74.125.24.0-255,1484,32273,77,304242
32800,0.00052,172.31.40.0-255,66,32339,77,304242
32801,0.000526,74.125.24.0-255,2902,35241,77,304242
32802,0.000528,172.31.40.0-255,66,35307,77,304242
32803,0.000535,74.125.24.0-255,5738,41045,77,304242
32804,0.000536,172.31.40.0-255,66,41111,77,304242
32805,0.000564,74.125.24.0-255,4320,45431,77,304242
32806,0.000568,172.31.40.0-255,66,45497,77,304242
32807,0.000586,74.125.24.0-255,2543,48040,77,304242
32808,0.000589,172.31.40.0-255,66,48106,77,304242
32809,0.000661,74.125.24.0-255,1484,49590,77,304242
32810,0.000664,172.31.40.0-255,66,49656,77,304242
32811,0.00067,74.125.24.0-255,2902,52558,77,304242
32812,0.000672,172.31.40.0-255,66,52624,77,304242
32813,0.00068,74.125.24.0-255,5738,58362,77,304242
32814,0.000682,172.31.40.0-255,66,58428,77,304242
32815,0.00073,74.125.24.0-255,7096,65524,77,304242
32816,0.000732,172.31.40.0-255,66,65590,77,304242
32817,0.000818,74.125.24.0-255,129,65719,77,304242
32818,0.000821,172.31.40.0-255,66,65785,77,304242
32819,0.000824,74.125.24.0-255,348,66133,77,304242
32820,0.001016,172.31.40.0-255,66,66199,77,304242
32821,0.001101,74.125.24.0-255,1484,67683,77,304242
32822,0.001108,74.125.24.0-255,2902,70585,77,304242
32823,0.001111,172.31.40.0-255,66,70651,77,304242
32824,0.001134,74.125.24.0-255,5738,76389,77,304242
32825,0.001136,172.31.40.0-255,66,76455,77,304242
32826,0.001149,74.125.24.0-255,5738,82193,77,304242
32827,0.001151,172.31.40.0-255,66,82259,77,304242
32828,0.001172,74.125.24.0-255,7156,89415,77,304242
32829,0.001174,172.31.40.0-255,66,89481,77,304242
32830,0.001183,74.125.24.0-255,10692,100173,77,304242
32831,0.001185,172.31.40.0-255,66,100239,77,304242
32832,0.001225,74.125.24.0-255,8574,108813,77,304242
32833,0.001227,172.31.40.0-255,66,108879,77,304242
32834,0.001231,74.125.24.0-255,2902,111781,77,304242
32835,0.001233,172.31.40.0-255,66,111847,77,304242
32836,0.001251,74.125.24.0-255,7156,119003,77,304242
32837,0.001253,172.31.40.0-255,66,119069,77,304242
32838,0.001273,74.125.24.0-255,1484,120553,77,304242
32839,0.001309,74.125.24.0-255,4320,124873,77,304242
32840,0.001312,172.31.40.0-255,66,124939,77,304242
32841,0.001328,74.125.24.0-255,9274,134213,77,304242
32842,0.001475,74.125.24.0-255,1484,135697,77,304242
32843,0.001481,74.125.24.0-255,2902,138599,77,304242
32844,0.001501,74.125.24.0-255,5738,144337,77,304242
32845,0.001517,74.125.24.0-255,7156,151493,77,304242
32846,0.001532,74.125.24.0-255,5738,157231,77,304242
32847,0.001539,74.125.24.0-255,7156,164387,77,304242
32848,0.001576,74.125.24.0-255,3602,167989,77,304242
32849,0.001695,74.125.24.0-255,1484,169473,77,304242
32850,0.001701,74.125.24.0-255,2902,172375,77,304242
32851,0.001705,74.125.24.0-255,2902,175277,77,304242
32852,0.001722,74.125.24.0-255,2902,178179,77,304242
32853,0.001727,74.125.24.0-255,5738,183917,77,304242
32854,0.001744,74.125.24.0-255,2902,186819,77,304242
32855,0.001788,74.125.24.0-255,2902,189721,77,304242
32856,0.001817,74.125.24.0-255,12110,201831,77,304242
32857,0.001831,74.125.24.0-255,2902,204733,77,304242
32858,0.001844,74.125.24.0-255,7156,211889,77,304242
32859,0.001863,74.125.24.0-255,5738,217627,77,304242
32860,0.001872,74.125.24.0-255,11410,229037,77,304242
32861,0.001892,74.125.24.0-255,5738,234775,77,304242
32862,0.001894,74.125.24.0-255,766,235541,77,304242
32863,0.002144,74.125.24.0-255,1484,237025,77,304242
32864,0.002168,74.125.24.0-255,2902,239927,77,304242
32865,0.002174,74.125.24.0-255,5738,245665,77,304242
32866,0.002189,74.125.24.0-255,4320,249985,77,304242
32867,0.002212,74.125.24.0-255,7156,257141,77,304242
32868,0.002221,74.125.24.0-255,8574,265715,77,304242
32869,0.002232,74.125.24.0-255,3602,269317,77,304242
32870,0.002274,74.125.24.0-255,2902,272219,77,304242
32871,0.0023,74.125.24.0-255,8574,280793,77,304242
32872,0.008617,172.31.40.0-255,66,280859,77,304242
32873,0.009129,172.31.40.0-255,101,280960,77,304242
32874,0.010896,74.125.24.0-255,5738,286698,77,304242
32875,0.010908,172.31.40.0-255,66,286764,77,304242
32876,0.011343,74.125.24.0-255,66,286830,77,304242
32877,0.013156,74.125.24.0-255,5738,292568,77,304242
32878,0.01316,172.31.40.0-255,66,292634,77,304242
32879,0.015427,74.125.24.0-255,5738,298372,77,304242
32880,0.015443,172.31.40.0-255,66,298438,77,304242
32881,0.017701,74.125.24.0-255,5738,304176,77,304242
32882,0.017717,172.31.40.0-255,66,304242,77,304242
32883,0.0,74.125.24.0-255,153,153,77,347613
32884,2.1e-05,172.31.40.0-255,66,219,77,347613
32885,2.8e-05,74.125.24.0-255,1484,1703,77,347613
32886,3.3e-05,172.31.40.0-255,66,1769,77,347613
32887,3.8e-05,74.125.24.0-255,2902,4671,77,347613
32888,4.2e-05,172.31.40.0-255,66,4737,77,347613
32889,5e-05,74.125.24.0-255,7156,11893,77,347613
32890,5.3e-05,172.31.40.0-255,66,11959,77,347613
32891,5.7e-05,74.125.24.0-255,2156,14115,77,347613
32892,6e-05,172.31.40.0-255,66,14181,77,347613
32893,6.7e-05,74.125.24.0-255,5738,19919,77,347613
32894,7e-05,172.31.40.0-255,66,19985,77,347613
32895,9.9e-05,74.125.24.0-255,5738,25723,77,347613
32896,0.000102,172.31.40.0-255,66,25789,77,347613
32897,0.000108,74.125.24.0-255,5379,31168,77,347613
32898,0.000111,172.31.40.0-255,66,31234,77,347613
32899,0.000178,74.125.24.0-255,1484,32718,77,347613
32900,0.000181,172.31.40.0-255,66,32784,77,347613
32901,0.000198,74.125.24.0-255,2902,35686,77,347613
32902,0.0002,172.31.40.0-255,66,35752,77,347613
32903,0.000206,74.125.24.0-255,4320,40072,77,347613
32904,0.000208,172.31.40.0-255,66,40138,77,347613
32905,0.000229,74.125.24.0-255,1484,41622,77,347613
32906,0.000231,172.31.40.0-255,66,41688,77,347613
32907,0.000239,74.125.24.0-255,6797,48485,77,347613
32908,0.000241,172.31.40.0-255,66,48551,77,347613
32909,0.000453,74.125.24.0-255,1484,50035,77,347613
32910,0.000459,172.31.40.0-255,66,50101,77,347613
32911,0.000466,74.125.24.0-255,2902,53003,77,347613
32912,0.000468,172.31.40.0-255,66,53069,77,347613
32913,0.000473,74.125.24.0-255,2902,55971,77,347613
32914,0.000475,172.31.40.0-255,66,56037,77,347613
32915,0.0005,74.125.24.0-255,2902,58939,77,347613
32916,0.000503,172.31.40.0-255,66,59005,77,347613
32917,0.000507,74.125.24.0-255,2902,61907,77,347613
32918,0.00051,172.31.40.0-255,66,61973,77,347613
32919,0.000563,74.125.24.0-255,3961,65934,77,347613
32920,0.000566,172.31.40.0-255,66,66000,77,347613
32921,0.000724,74.125.24.0-255,1484,67484,77,347613
32922,0.00073,74.125.24.0-255,2902,70386,77,347613
32923,0.000734,172.31.40.0-255,66,70452,77,347613
32924,0.00074,74.125.24.0-255,4320,74772,77,347613
32925,0.000743,172.31.40.0-255,66,74838,77,347613
32926,0.000755,74.125.24.0-255,1484,76322,77,347613
32927,0.000762,74.125.24.0-255,6797,83119,77,347613
32928,0.000765,172.31.40.0-255,66,83185,77,347613
32929,0.00078,74.125.24.0-255,1484,84669,77,347613
32930,0.0008,74.125.24.0-255,8574,93243,77,347613
32931,0.000802,172.31.40.0-255,66,93309,77,347613
32932,0.000823,74.125.24.0-255,4320,97629,77,347613
32933,0.000825,74.125.24.0-255,1484,99113,77,347613
32934,0.000829,172.31.40.0-255,66,99179,77,347613
32935,0.000859,172.31.40.0-255,66,99245,77,347613
32936,0.000862,74.125.24.0-255,651,99896,77,347613
32937,0.00091,74.125.24.0-255,212,100108,77,347613
32938,0.001552,74.125.24.0-255,1484,101592,77,347613
32939,0.001557,172.31.40.0-255,66,101658,77,347613
32940,0.001563,74.125.24.0-255,2902,104560,77,347613
32941,0.001565,172.31.40.0-255,66,104626,77,347613
32942,0.001569,74.125.24.0-255,2902,107528,77,347613
32943,0.001571,172.31.40.0-255,66,107594,77,347613
32944,0.001597,74.125.24.0-255,2902,110496,77,347613
32945,0.001602,74.125.24.0-255,4320,114816,77,347613
32946,0.001606,172.31.40.0-255,66,114882,77,347613
32947,0.001609,172.31.40.0-255,66,114948,77,347613
32948,0.001618,74.125.24.0-255,2902,117850,77,347613
32949,0.001621,172.31.40.0-255,66,117916,77,347613
32950,0.001646,74.125.24.0-255,5738,123654,77,347613
32951,0.001649,172.31.40.0-255,66,123720,77,347613
32952,0.001666,74.125.24.0-255,2902,126622,77,347613
32953,0.001668,172.31.40.0-255,66,126688,77,347613
32954,0.001671,74.125.24.0-255,1484,128172,77,347613
32955,0.001689,74.125.24.0-255,6438,134610,77,347613
32956,0.001691,172.31.40.0-255,66,134676,77,347613
32957,0.001928,74.125.24.0-255,1484,136160,77,347613
32958,0.001942,74.125.24.0-255,2902,139062,77,347613
32959,0.001946,172.31.40.0-255,66,139128,77,347613
32960,0.001965,74.125.24.0-255,4320,143448,77,347613
32961,0.001968,172.31.40.0-255,66,143514,77,347613
32962,0.001985,74.125.24.0-255,1484,144998,77,347613
32963,0.001989,74.125.24.0-255,2902,147900,77,347613
32964,0.001991,172.31.40.0-255,66,147966,77,347613
32965,0.002014,74.125.24.0-255,7156,155122,77,347613
32966,0.002017,74.125.24.0-255,2902,158024,77,347613
32967,0.002021,172.31.40.0-255,66,158090,77,347613
32968,0.002023,172.31.40.0-255,66,158156,77,347613
32969,0.002034,74.125.24.0-255,5738,163894,77,347613
32970,0.002037,172.31.40.0-255,66,163960,77,347613
32971,0.002058,74.125.24.0-255,5020,168980,77,347613
32972,0.00206,172.31.40.0-255,66,169046,77,347613
32973,0.002093,74.125.24.0-255,2902,171948,77,347613
32974,0.002096,172.31.40.0-255,66,172014,77,347613
32975,0.002114,74.125.24.0-255,5738,177752,77,347613
32976,0.002117,172.31.40.0-255,66,177818,77,347613
32977,0.002148,74.125.24.0-255,5738,183556,77,347613
32978,0.002151,172.31.40.0-255,66,183622,77,347613
32979,0.002158,74.125.24.0-255,7156,190778,77,347613
32980,0.00216,172.31.40.0-255,66,190844,77,347613
32981,0.002198,74.125.24.0-255,7156,198000,77,347613
32982,0.002202,172.31.40.0-255,66,198066,77,347613
32983,0.002213,74.125.24.0-255,5020,203086,77,347613
32984,0.002215,172.31.40.0-255,66,203152,77,347613
32985,0.002233,74.125.24.0-255,1484,204636,77,347613
32986,0.002246,74.125.24.0-255,4320,208956,77,347613
32987,0.002248,172.31.40.0-255,66,209022,77,347613
32988,0.00227,74.125.24.0-255,5738,214760,77,347613
32989,0.002273,172.31.40.0-255,66,214826,77,347613
32990,0.002286,74.125.24.0-255,1484,216310,77,347613
32991,0.002294,74.125.24.0-255,7156,223466,77,347613
32992,0.002297,172.31.40.0-255,66,223532,77,347613
32993,0.002322,74.125.24.0-255,4320,227852,77,347613
32994,0.002325,172.31.40.0-255,66,227918,77,347613
32995,0.00236,172.31.40.0-255,66,227984,77,347613
32996,0.002366,74.125.24.0-255,5738,233722,77,347613
32997,0.002369,172.31.40.0-255,66,233788,77,347613
32998,0.002412,172.31.40.0-255,66,233854,77,347613
32999,0.002421,74.125.24.0-255,9274,243128,77,347613
33000,0.002423,172.31.40.0-255,66,243194,77,347613
33001,0.002452,74.125.24.0-255,8574,251768,77,347613
33002,0.002455,172.31.40.0-255,66,251834,77,347613
33003,0.002515,74.125.24.0-255,12828,264662,77,347613
33004,0.002518,172.31.40.0-255,66,264728,77,347613
33005,0.002546,74.125.24.0-255,9992,274720,77,347613
33006,0.002549,172.31.40.0-255,66,274786,77,347613
33007,0.002557,74.125.24.0-255,7856,282642,77,347613
33008,0.002559,172.31.40.0-255,66,282708,77,347613
33009,0.002568,74.125.24.0-255,8574,291282,77,347613
33010,0.002571,172.31.40.0-255,66,291348,77,347613
33011,0.00258,74.125.24.0-255,8574,299922,77,347613
33012,0.002582,172.31.40.0-255,66,299988,77,347613
33013,0.002614,74.125.24.0-255,9274,309262,77,347613
33014,0.002617,172.31.40.0-255,66,309328,77,347613
33015,0.00262,74.125.24.0-255,1484,310812,77,347613
33016,0.002636,74.125.24.0-255,1484,312296,77,347613
33017,0.002639,172.31.40.0-255,66,312362,77,347613
33018,0.002645,74.125.24.0-255,4320,316682,77,347613
33019,0.002647,172.31.40.0-255,66,316748,77,347613
33020,0.002668,74.125.24.0-255,4320,321068,77,347613
33021,0.002671,172.31.40.0-255,66,321134,77,347613
33022,0.002687,74.125.24.0-255,1484,322618,77,347613
33023,0.002705,74.125.24.0-255,2902,325520,77,347613
33024,0.002707,172.31.40.0-255,66,325586,77,347613
33025,0.002713,74.125.24.0-255,4320,329906,77,347613
33026,0.002716,172.31.40.0-255,66,329972,77,347613
33027,0.002743,74.125.24.0-255,13528,343500,77,347613
33028,0.002746,172.31.40.0-255,66,343566,77,347613
33029,0.002789,172.31.40.0-255,66,343632,77,347613
33030,0.002795,74.125.24.0-255,3573,347205,77,347613
33031,0.002797,172.31.40.0-255,66,347271,77,347613
33032,0.00283,74.125.24.0-255,105,347376,77,347613
33033,0.014532,172.31.40.0-255,66,347442,77,347613
33034,0.014586,172.31.40.0-255,105,347547,77,347613
33035,0.017333,74.125.24.0-255,66,347613,77,347613
33036,0.0,74.125.24.0-255,153,153,77,298871
33037,1.6e-05,172.31.40.0-255,66,219,77,298871
33038,3.1e-05,74.125.24.0-255,1484,1703,77,298871
33039,3.5e-05,172.31.40.0-255,66,1769,77,298871
33040,4e-05,74.125.24.0-255,2902,4671,77,298871
33041,4.2e-05,172.31.40.0-255,66,4737,77,298871
33042,6.1e-05,74.125.24.0-255,2902,7639,77,298871
33043,6.3e-05,172.31.40.0-255,66,7705,77,298871
33044,8.6e-05,74.125.24.0-255,2902,10607,77,298871
33045,8.8e-05,172.31.40.0-255,66,10673,77,298871
33046,9.3e-05,74.125.24.0-255,3437,14110,77,298871
33047,9.5e-05,172.31.40.0-255,66,14176,77,298871
33048,0.000125,74.125.24.0-255,1484,15660,77,298871
33049,0.000127,172.31.40.0-255,66,15726,77,298871
33050,0.000146,74.125.24.0-255,4320,20046,77,298871
33051,0.000148,172.31.40.0-255,66,20112,77,298871
33052,0.000185,74.125.24.0-255,7156,27268,77,298871
33053,0.000187,172.31.40.0-255,66,27334,77,298871
33054,0.000207,74.125.24.0-255,3961,31295,77,298871
33055,0.00021,172.31.40.0-255,66,31361,77,298871
33056,0.00032,74.125.24.0-255,1484,32845,77,298871
33057,0.000323,172.31.40.0-255,66,32911,77,298871
33058,0.000329,74.125.24.0-255,2902,35813,77,298871
33059,0.000331,172.31.40.0-255,66,35879,77,298871
33060,0.000348,74.125.24.0-255,4320,40199,77,298871
33061,0.00035,172.31.40.0-255,66,40265,77,298871
33062,0.000361,74.125.24.0-255,1484,41749,77,298871
33063,0.000363,172.31.40.0-255,66,41815,77,298871
33064,0.000386,74.125.24.0-255,5738,47553,77,298871
33065,0.000388,172.31.40.0-255,66,47619,77,298871
33066,0.000413,74.125.24.0-255,8215,55834,77,298871
33067,0.000415,172.31.40.0-255,66,55900,77,298871
33068,0.000423,74.125.24.0-255,8574,64474,77,298871
33069,0.000425,74.125.24.0-255,1125,65599,77,298871
33070,0.000509,172.31.40.0-255,66,65665,77,298871
33071,0.001014,74.125.24.0-255,366,66031,77,298871
33072,0.001215,74.125.24.0-255,377,66408,77,298871
33073,0.001249,74.125.24.0-255,1484,67892,77,298871
33074,0.001252,74.125.24.0-255,1484,69376,77,298871
33075,0.001263,74.125.24.0-255,1484,70860,77,298871
33076,0.001277,74.125.24.0-255,1484,72344,77,298871
33077,0.00128,74.125.24.0-255,1484,73828,77,298871
33078,0.001306,74.125.24.0-255,8574,82402,77,298871
33079,0.001311,74.125.24.0-255,4320,86722,77,298871
33080,0.001324,74.125.24.0-255,4320,91042,77,298871
33081,0.001332,172.31.40.0-255,66,91108,77,298871
33082,0.001374,74.125.24.0-255,4320,95428,77,298871
33083,0.001388,74.125.24.0-255,5738,101166,77,298871
33084,0.001399,74.125.24.0-255,4320,105486,77,298871
33085,0.001403,172.31.40.0-255,66,105552,77,298871
33086,0.001414,74.125.24.0-255,6438,111990,77,298871
33087,0.001417,74.125.24.0-255,1484,113474,77,298871
33088,0.001439,74.125.24.0-255,11410,124884,77,298871
33089,0.001444,172.31.40.0-255,66,124950,77,298871
33090,0.001473,74.125.24.0-255,8574,133524,77,298871
33091,0.001479,74.125.24.0-255,6438,139962,77,298871
33092,0.001489,74.125.24.0-255,12828,152790,77,298871
33093,0.00151,74.125.24.0-255,8574,161364,77,298871
33094,0.001513,172.31.40.0-255,66,161430,77,298871
33095,0.001518,172.31.40.0-255,66,161496,77,298871
33096,0.001536,74.125.24.0-255,4320,165816,77,298871
33097,0.00154,74.125.24.0-255,2184,168000,77,298871
33098,0.001561,172.31.40.0-255,66,168066,77,298871
33099,0.001598,74.125.24.0-255,1484,169550,77,298871
33100,0.001613,74.125.24.0-255,2902,172452,77,298871
33101,0.001617,172.31.40.0-255,66,172518,77,298871
33102,0.001625,74.125.24.0-255,2902,175420,77,298871
33103,0.001629,172.31.40.0-255,66,175486,77,298871
33104,0.001642,74.125.24.0-255,2902,178388,77,298871
33105,0.001655,74.125.24.0-255,4320,182708,77,298871
33106,0.001662,172.31.40.0-255,66,182774,77,298871
33107,0.001674,74.125.24.0-255,7156,189930,77,298871
33108,0.001683,74.125.24.0-255,1484,191414,77,298871
33109,0.001697,172.31.40.0-255,66,191480,77,298871
33110,0.001718,74.125.24.0-255,4320,195800,77,298871
33111,0.001738,74.125.24.0-255,6438,202238,77,298871
33112,0.001743,172.31.40.0-255,66,202304,77,298871
33113,0.001768,74.125.24.0-255,2902,205206,77,298871
33114,0.001776,172.31.40.0-255,66,205272,77,298871
33115,0.001779,74.125.24.0-255,1484,206756,77,298871
33116,0.001796,74.125.24.0-255,5738,212494,77,298871
33117,0.001809,172.31.40.0-255,66,212560,77,298871
33118,0.001826,74.125.24.0-255,11410,223970,77,298871
33119,0.001829,74.125.24.0-255,1484,225454,77,298871
33120,0.001855,74.125.24.0-255,8574,234028,77,298871
33121,0.00186,74.125.24.0-255,2184,236212,77,298871
33122,0.001871,172.31.40.0-255,66,236278,77,298871
33123,0.001943,74.125.24.0-255,1484,237762,77,298871
33124,0.001962,74.125.24.0-255,2902,240664,77,298871
33125,0.001985,74.125.24.0-255,1484,242148,77,298871
33126,0.001988,74.125.24.0-255,1484,243632,77,298871
33127,0.001994,172.31.40.0-255,66,243698,77,298871
33128,0.002001,74.125.24.0-255,1484,245182,77,298871
33129,0.002017,74.125.24.0-255,5738,250920,77,298871
33130,0.002075,74.125.24.0-255,5738,256658,77,298871
33131,0.002083,74.125.24.0-255,7156,263814,77,298871
33132,0.002093,172.31.40.0-255,66,263880,77,298871
33133,0.002716,172.31.40.0-255,101,263981,77,298871
33134,0.004107,74.125.24.0-255,5738,269719,77,298871
33135,0.004114,172.31.40.0-255,66,269785,77,298871
33136,0.004724,74.125.24.0-255,66,269851,77,298871
33137,0.006111,74.125.24.0-255,5738,275589,77,298871
33138,0.008601,172.31.40.0-255,66,275655,77,298871
33139,0.010618,74.125.24.0-255,5738,281393,77,298871
33140,0.010626,172.31.40.0-255,66,281459,77,298871
33141,0.01262,74.125.24.0-255,5738,287197,77,298871
33142,0.014061,172.31.40.0-255,66,287263,77,298871
33143,0.016087,74.125.24.0-255,5738,293001,77,298871
33144,0.016097,172.31.40.0-255,66,293067,77,298871
33145,0.018121,74.125.24.0-255,5738,298805,77,298871
33146,0.01813,172.31.40.0-255,66,298871,77,298871
33147,0.0,74.125.24.0-255,146,146,77,354204
33148,1.1e-05,172.31.40.0-255,66,212,77,354204
33149,1.7e-05,74.125.24.0-255,1484,1696,77,354204
33150,2.2e-05,172.31.40.0-255,66,1762,77,354204
33151,2.8e-05,74.125.24.0-255,2902,4664,77,354204
33152,3.1e-05,172.31.40.0-255,66,4730,77,354204
33153,3.8e-05,74.125.24.0-255,7156,11886,77,354204
33154,4.1e-05,172.31.40.0-255,66,11952,77,354204
33155,7.8e-05,74.125.24.0-255,9121,21073,77,354204
33156,8.1e-05,172.31.40.0-255,66,21139,77,354204
33157,8.9e-05,74.125.24.0-255,9633,30772,77,354204
33158,9.2e-05,172.31.40.0-255,66,30838,77,354204
33159,0.000185,74.125.24.0-255,1484,32322,77,354204
33160,0.000188,172.31.40.0-255,66,32388,77,354204
33161,0.000194,74.125.24.0-255,2902,35290,77,354204
33162,0.000196,172.31.40.0-255,66,35356,77,354204
33163,0.00021,74.125.24.0-255,1484,36840,77,354204
33164,0.000212,172.31.40.0-255,66,36906,77,354204
33165,0.000259,74.125.24.0-255,2902,39808,77,354204
33166,0.000261,172.31.40.0-255,66,39874,77,354204
33167,0.000267,74.125.24.0-255,5738,45612,77,354204
33168,0.000269,172.31.40.0-255,66,45678,77,354204
33169,0.000297,74.125.24.0-255,7156,52834,77,354204
33170,0.000299,172.31.40.0-255,66,52900,77,354204
33171,0.000313,74.125.24.0-255,3961,56861,77,354204
33172,0.000316,172.31.40.0-255,66,56927,77,354204
33173,0.000324,74.125.24.0-255,8485,65412,77,354204
33174,0.000326,172.31.40.0-255,66,65478,77,354204
33175,0.000362,74.125.24.0-255,385,65863,77,354204
33176,0.000365,172.31.40.0-255,66,65929,77,354204
33177,0.000458,74.125.24.0-255,1484,67413,77,354204
33178,0.000462,172.31.40.0-255,66,67479,77,354204
33179,0.000482,74.125.24.0-255,2902,70381,77,354204
33180,0.000487,74.125.24.0-255,5738,76119,77,354204
33181,0.000494,172.31.40.0-255,66,76185,77,354204
33182,0.000497,172.31.40.0-255,66,76251,77,354204
33183,0.000503,74.125.24.0-255,5738,81989,77,354204
33184,0.000505,172.31.40.0-255,66,82055,77,354204
33185,0.000529,74.125.24.0-255,7156,89211,77,354204
33186,0.000532,172.31.40.0-255,66,89277,77,354204
33187,0.000539,74.125.24.0-255,8574,97851,77,354204
33188,0.000541,172.31.40.0-255,66,97917,77,354204
33189,0.000557,74.125.24.0-255,1484,99401,77,354204
33190,0.000567,74.125.24.0-255,766,100167,77,354204
33191,0.000569,172.31.40.0-255,66,100233,77,354204
33192,0.000585,74.125.24.0-255,2902,103135,77,354204
33193,0.000587,172.31.40.0-255,66,103201,77,354204
33194,0.000604,74.125.24.0-255,7156,110357,77,354204
33195,0.000607,172.31.40.0-255,66,110423,77,354204
33196,0.000611,74.125.24.0-255,2902,113325,77,354204
33197,0.000612,172.31.40.0-255,66,113391,77,354204
33198,0.000636,74.125.24.0-255,2902,116293,77,354204
33199,0.000638,172.31.40.0-255,66,116359,77,354204
33200,0.000641,74.125.24.0-255,2902,119261,77,354204
33201,0.000643,172.31.40.0-255,66,119327,77,354204
33202,0.000673,74.125.24.0-255,11920,131247,77,354204
33203,0.000676,172.31.40.0-255,66,131313,77,354204
33204,0.000683,74.125.24.0-255,8574,139887,77,354204
33205,0.000685,172.31.40.0-255,66,139953,77,354204
33206,0.000714,74.125.24.0-255,7156,147109,77,354204
33207,0.000717,172.31.40.0-255,66,147175,77,354204
33208,0.000719,74.125.24.0-255,1484,148659,77,354204
33209,0.000738,74.125.24.0-255,2184,150843,77,354204
33210,0.000739,172.31.40.0-255,66,150909,77,354204
33211,0.000761,74.125.24.0-255,4320,155229,77,354204
33212,0.000765,172.31.40.0-255,66,155295,77,354204
33213,0.000784,74.125.24.0-255,7156,162451,77,354204
33214,0.000786,172.31.40.0-255,66,162517,77,354204
33215,0.000792,74.125.24.0-255,5738,168255,77,354204
33216,0.000794,172.31.40.0-255,66,168321,77,354204
33217,0.000824,74.125.24.0-255,7156,175477,77,354204
33218,0.000827,172.31.40.0-255,66,175543,77,354204
33219,0.000835,74.125.24.0-255,9274,184817,77,354204
33220,0.000836,172.31.40.0-255,66,184883,77,354204
33221,0.000869,74.125.24.0-255,7156,192039,77,354204
33222,0.000871,172.31.40.0-255,66,192105,77,354204
33223,0.00089,74.125.24.0-255,2902,195007,77,354204
33224,0.000893,172.31.40.0-255,66,195073,77,354204
33225,0.000916,74.125.24.0-255,9992,205065,77,354204
33226,0.000918,172.31.40.0-255,66,205131,77,354204
33227,0.000931,74.125.24.0-255,1125,206256,77,354204
33228,0.000938,74.125.24.0-255,5738,211994,77,354204
33229,0.00094,172.31.40.0-255,66,212060,77,354204
33230,0.000992,172.31.40.0-255,66,212126,77,354204
33231,0.000998,74.125.24.0-255,5020,217146,77,354204
33232,0.001,172.31.40.0-255,66,217212,77,354204
33233,0.001077,74.125.24.0-255,1484,218696,77,354204
33234,0.001094,74.125.24.0-255,2902,221598,77,354204
33235,0.001097,172.31.40.0-255,66,221664,77,354204
33236,0.001122,74.125.24.0-255,5738,227402,77,354204
33237,0.001125,172.31.40.0-255,66,227468,77,354204
33238,0.001147,74.125.24.0-255,8574,236042,77,354204
33239,0.00115,172.31.40.0-255,66,236108,77,354204
33240,0.001156,74.125.24.0-255,4320,240428,77,354204
33241,0.001158,172.31.40.0-255,66,240494,77,354204
33242,0.001185,74.125.24.0-255,5738,246232,77,354204
33243,0.001188,172.31.40.0-255,66,246298,77,354204
33244,0.001195,74.125.24.0-255,5020,251318,77,354204
33245,0.001218,172.31.40.0-255,66,251384,77,354204
33246,0.001326,74.125.24.0-255,1484,252868,77,354204
33247,0.001332,74.125.24.0-255,2902,255770,77,354204
33248,0.001346,74.125.24.0-255,2902,258672,77,354204
33249,0.001353,172.31.40.0-255,66,258738,77,354204
33250,0.001367,74.125.24.0-255,2902,261640,77,354204
33251,0.00137,172.31.40.0-255,66,261706,77,354204
33252,0.001377,74.125.24.0-255,7156,268862,77,354204
33253,0.00138,172.31.40.0-255,66,268928,77,354204
33254,0.001412,74.125.24.0-255,5738,274666,77,354204
33255,0.001422,74.125.24.0-255,10692,285358,77,354204
33256,0.001434,172.31.40.0-255,66,285424,77,354204
33257,0.001437,74.125.24.0-255,1484,286908,77,354204
33258,0.00146,74.125.24.0-255,2902,289810,77,354204
33259,0.001467,74.125.24.0-255,5738,295548,77,354204
33260,0.00148,172.31.40.0-255,66,295614,77,354204
33261,0.00149,74.125.24.0-255,5738,301352,77,354204
33262,0.001495,172.31.40.0-255,66,301418,77,354204
33263,0.001511,74.125.24.0-255,7156,308574,77,354204
33264,0.001527,172.31.40.0-255,66,308640,77,354204
33265,0.001544,74.125.24.0-255,13528,322168,77,354204
33266,0.001556,74.125.24.0-255,12828,334996,77,354204
33267,0.001562,172.31.40.0-255,66,335062,77,354204
33268,0.00157,74.125.24.0-255,1484,336546,77,354204
33269,0.001607,74.125.24.0-255,7156,343702,77,354204
33270,0.001639,172.31.40.0-255,66,343768,77,354204
33271,0.001651,74.125.24.0-255,2184,345952,77,354204
33272,0.001686,74.125.24.0-255,5020,350972,77,354204
33273,0.001691,74.125.24.0-255,2890,353862,77,354204
33274,0.001711,74.125.24.0-255,105,353967,77,354204
33275,0.001718,172.31.40.0-255,66,354033,77,354204
33276,0.008637,172.31.40.0-255,105,354138,77,354204
33277,0.011148,74.125.24.0-255,66,354204,77,354204
33278,0.0,74.125.24.0-255,296,296,77,358650
33279,2.1e-05,172.31.40.0-255,66,362,77,358650
33280,2.7e-05,74.125.24.0-255,1484,1846,77,358650
33281,3.2e-05,172.31.40.0-255,66,1912,77,358650
33282,3.7e-05,74.125.24.0-255,2902,4814,77,358650
33283,4.1e-05,172.31.40.0-255,66,4880,77,358650
33284,4.7e-05,74.125.24.0-255,4320,9200,77,358650
33285,5e-05,172.31.40.0-255,66,9266,77,358650
33286,5.3e-05,74.125.24.0-255,1484,10750,77,358650
33287,5.6e-05,172.31.40.0-255,66,10816,77,358650
33288,8.4e-05,74.125.24.0-255,7512,18328,77,358650
33289,8.8e-05,172.31.40.0-255,66,18394,77,358650
33290,9.2e-05,74.125.24.0-255,2902,21296,77,358650
33291,9.4e-05,172.31.40.0-255,66,21362,77,358650
33292,0.000131,74.125.24.0-255,12828,34190,77,358650
33293,0.000134,172.31.40.0-255,66,34256,77,358650
33294,0.000154,74.125.24.0-255,2902,37158,77,358650
33295,0.000156,172.31.40.0-255,66,37224,77,358650
33296,0.000185,74.125.24.0-255,10692,47916,77,358650
33297,0.000188,172.31.40.0-255,66,47982,77,358650
33298,0.000282,74.125.24.0-255,1484,49466,77,358650
33299,0.000286,172.31.40.0-255,66,49532,77,358650
33300,0.000292,74.125.24.0-255,2902,52434,77,358650
33301,0.000294,172.31.40.0-255,66,52500,77,358650
33302,0.00032,74.125.24.0-255,5738,58238,77,358650
33303,0.000323,172.31.40.0-255,66,58304,77,358650
33304,0.000327,74.125.24.0-255,2902,61206,77,358650
33305,0.000329,172.31.40.0-255,66,61272,77,358650
33306,0.000345,74.125.24.0-255,4290,65562,77,358650
33307,0.000347,172.31.40.0-255,66,65628,77,358650
33308,0.000459,74.125.24.0-255,1484,67112,77,358650
33309,0.000464,172.31.40.0-255,66,67178,77,358650
33310,0.000482,74.125.24.0-255,2902,70080,77,358650
33311,0.000485,172.31.40.0-255,66,70146,77,358650
33312,0.000491,74.125.24.0-255,5738,75884,77,358650
33313,0.000494,172.31.40.0-255,66,75950,77,358650
33314,0.000527,74.125.24.0-255,1484,77434,77,358650
33315,0.00055,74.125.24.0-255,8574,86008,77,358650
33316,0.000553,172.31.40.0-255,66,86074,77,358650
33317,0.000568,74.125.24.0-255,1484,87558,77,358650
33318,0.000578,74.125.24.0-255,9992,97550,77,358650
33319,0.00058,172.31.40.0-255,66,97616,77,358650
33320,0.000601,74.125.24.0-255,2184,99800,77,358650
33321,0.000604,172.31.40.0-255,66,99866,77,358650
33322,0.000607,74.125.24.0-255,1484,101350,77,358650
33323,0.000611,74.125.24.0-255,2902,104252,77,358650
33324,0.000614,172.31.40.0-255,66,104318,77,358650
33325,0.00063,74.125.24.0-255,7156,111474,77,358650
33326,0.000632,172.31.40.0-255,66,111540,77,358650
33327,0.000648,74.125.24.0-255,5738,117278,77,358650
33328,0.000651,172.31.40.0-255,66,117344,77,358650
33329,0.000655,74.125.24.0-255,2902,120246,77,358650
33330,0.000657,172.31.40.0-255,66,120312,77,358650
33331,0.000697,74.125.24.0-255,13230,133542,77,358650
33332,0.000701,172.31.40.0-255,66,133608,77,358650
33333,0.000823,74.125.24.0-255,1484,135092,77,358650
33334,0.000829,74.125.24.0-255,2902,137994,77,358650
33335,0.000834,172.31.40.0-255,66,138060,77,358650
33336,0.00086,74.125.24.0-255,5738,143798,77,358650
33337,0.000862,74.125.24.0-255,1484,145282,77,358650
33338,0.000866,172.31.40.0-255,66,145348,77,358650
33339,0.000893,74.125.24.0-255,11410,156758,77,358650
33340,0.000896,172.31.40.0-255,66,156824,77,358650
33341,0.000902,74.125.24.0-255,5738,162562,77,358650
33342,0.000905,172.31.40.0-255,66,162628,77,358650
33343,0.00094,74.125.24.0-255,5020,167648,77,358650
33344,0.000944,172.31.40.0-255,66,167714,77,358650
33345,0.001051,74.125.24.0-255,1484,169198,77,358650
33346,0.001069,74.125.24.0-255,2902,172100,77,358650
33347,0.001072,172.31.40.0-255,66,172166,77,358650
33348,0.001078,74.125.24.0-255,4320,176486,77,358650
33349,0.00108,172.31.40.0-255,66,176552,77,358650
33350,0.001099,74.125.24.0-255,1484,178036,77,358650
33351,0.001106,74.125.24.0-255,7156,185192,77,358650
33352,0.001109,172.31.40.0-255,66,185258,77,358650
33353,0.001115,74.125.24.0-255,5738,190996,77,358650
33354,0.001117,172.31.40.0-255,66,191062,77,358650
33355,0.001134,74.125.24.0-255,8574,199636,77,358650
33356,0.001137,74.125.24.0-255,2184,201820,77,358650
33357,0.001141,172.31.40.0-255,66,201886,77,358650
33358,0.001144,172.31.40.0-255,66,201952,77,358650
33359,0.001157,74.125.24.0-255,1484,203436,77,358650
33360,0.001172,74.125.24.0-255,1484,204920,77,358650
33361,0.001175,172.31.40.0-255,66,204986,77,358650
33362,0.001181,74.125.24.0-255,5738,210724,77,358650
33363,0.001183,172.31.40.0-255,66,210790,77,358650
33364,0.001194,74.125.24.0-255,1484,212274,77,358650
33365,0.001202,74.125.24.0-255,7156,219430,77,358650
33366,0.001205,172.31.40.0-255,66,219496,77,358650
33367,0.00122,74.125.24.0-255,2902,222398,77,358650
33368,0.001223,172.31.40.0-255,66,222464,77,358650
33369,0.001285,74.125.24.0-255,13528,235992,77,358650
33370,0.001289,172.31.40.0-255,66,236058,77,358650
33371,0.001627,74.125.24.0-255,1484,237542,77,358650
33372,0.001641,74.125.24.0-255,2902,240444,77,358650
33373,0.001646,172.31.40.0-255,66,240510,77,358650
33374,0.001674,74.125.24.0-255,1484,241994,77,358650
33375,0.001697,74.125.24.0-255,1484,243478,77,358650
33376,0.0017,172.31.40.0-255,66,243544,77,358650
33377,0.001705,74.125.24.0-255,4320,247864,77,358650
33378,0.001707,172.31.40.0-255,66,247930,77,358650
33379,0.001718,74.125.24.0-255,8574,256504,77,358650
33380,0.00172,172.31.40.0-255,66,256570,77,358650
33381,0.001726,74.125.24.0-255,5738,262308,77,358650
33382,0.001728,172.31.40.0-255,66,262374,77,358650
33383,0.001745,74.125.24.0-255,1484,263858,77,358650
33384,0.001757,74.125.24.0-255,4320,268178,77,358650
33385,0.001759,172.31.40.0-255,66,268244,77,358650
33386,0.001777,74.125.24.0-255,2184,270428,77,358650
33387,0.001779,172.31.40.0-255,66,270494,77,358650
33388,0.001888,74.125.24.0-255,1484,271978,77,358650
33389,0.001892,74.125.24.0-255,1484,273462,77,358650
33390,0.001894,172.31.40.0-255,66,273528,77,358650
33391,0.001916,74.125.24.0-255,1484,275012,77,358650
33392,0.001922,74.125.24.0-255,5738,280750,77,358650
33393,0.001924,172.31.40.0-255,66,280816,77,358650
33394,0.001927,74.125.24.0-255,1484,282300,77,358650
33395,0.001948,74.125.24.0-255,9992,292292,77,358650
33396,0.00195,172.31.40.0-255,66,292358,77,358650
33397,0.001964,74.125.24.0-255,1484,293842,77,358650
33398,0.001973,74.125.24.0-255,10692,304534,77,358650
33399,0.001976,172.31.40.0-255,66,304600,77,358650
33400,0.002058,74.125.24.0-255,1484,306084,77,358650
33401,0.002074,74.125.24.0-255,2902,308986,77,358650
33402,0.002077,172.31.40.0-255,66,309052,77,358650
33403,0.002095,74.125.24.0-255,4320,313372,77,358650
33404,0.002097,172.31.40.0-255,66,313438,77,358650
33405,0.004197,74.125.24.0-255,2902,316340,77,358650
33406,0.004204,172.31.40.0-255,66,316406,77,358650
33407,0.004222,74.125.24.0-255,2902,319308,77,358650
33408,0.004224,172.31.40.0-255,66,319374,77,358650
33409,0.006297,74.125.24.0-255,5738,325112,77,358650
33410,0.006301,172.31.40.0-255,66,325178,77,358650
33411,0.008466,74.125.24.0-255,4320,329498,77,358650
33412,0.008472,172.31.40.0-255,66,329564,77,358650
33413,0.008483,74.125.24.0-255,1484,331048,77,358650
33414,0.010594,74.125.24.0-255,4320,335368,77,358650
33415,0.010602,172.31.40.0-255,66,335434,77,358650
33416,0.012699,74.125.24.0-255,5738,341172,77,358650
33417,0.012707,172.31.40.0-255,66,341238,77,358650
33418,0.014819,74.125.24.0-255,5738,346976,77,358650
33419,0.014827,172.31.40.0-255,66,347042,77,358650
33420,0.016904,74.125.24.0-255,5738,352780,77,358650
33421,0.016912,172.31.40.0-255,66,352846,77,358650
33422,0.018988,74.125.24.0-255,5738,358584,77,358650
33423,0.018995,172.31.40.0-255,66,358650,77,358650
33424,0.0,74.125.68.0-255,150,150,77,173894
33425,1.6e-05,172.31.40.0-255,66,216,77,173894
33426,2.2e-05,74.125.68.0-255,1484,1700,77,173894
33427,2.7e-05,172.31.40.0-255,66,1766,77,173894
33428,3e-05,74.125.68.0-255,1484,3250,77,173894
33429,4e-05,172.31.40.0-255,66,3316,77,173894
33430,4.6e-05,74.125.68.0-255,2902,6218,77,173894
33431,5e-05,172.31.40.0-255,66,6284,77,173894
33432,8.6e-05,74.125.68.0-255,5738,12022,77,173894
33433,8.9e-05,172.31.40.0-255,66,12088,77,173894
33434,9.3e-05,74.125.68.0-255,2012,14100,77,173894
33435,9.5e-05,172.31.40.0-255,66,14166,77,173894
33436,0.0001,74.125.68.0-255,2902,17068,77,173894
33437,0.000102,172.31.40.0-255,66,17134,77,173894
33438,0.000146,74.125.68.0-255,7156,24290,77,173894
33439,0.000149,172.31.40.0-255,66,24356,77,173894
33440,0.000153,74.125.68.0-255,2902,27258,77,173894
33441,0.000155,172.31.40.0-255,66,27324,77,173894
33442,0.00016,74.125.68.0-255,3961,31285,77,173894
33443,0.000163,172.31.40.0-255,66,31351,77,173894
33444,0.000411,74.125.68.0-255,1484,32835,77,173894
33445,0.000417,172.31.40.0-255,66,32901,77,173894
33446,0.000423,74.125.68.0-255,2902,35803,77,173894
33447,0.000426,172.31.40.0-255,66,35869,77,173894
33448,0.000456,74.125.68.0-255,5738,41607,77,173894
33449,0.000459,172.31.40.0-255,66,41673,77,173894
33450,0.000466,74.125.68.0-255,6797,48470,77,173894
33451,0.000468,172.31.40.0-255,66,48536,77,173894
33452,0.000493,74.125.68.0-255,1484,50020,77,173894
33453,0.000496,172.31.40.0-255,66,50086,77,173894
33454,0.000528,74.125.68.0-255,9992,60078,77,173894
33455,0.000531,172.31.40.0-255,66,60144,77,173894
33456,0.000535,74.125.68.0-255,2902,63046,77,173894
33457,0.000537,172.31.40.0-255,66,63112,77,173894
33458,0.000573,74.125.68.0-255,2543,65655,77,173894
33459,0.000576,172.31.40.0-255,66,65721,77,173894
33460,0.000579,74.125.68.0-255,411,66132,77,173894
33461,0.000736,74.125.68.0-255,333,66465,77,173894
33462,0.000876,74.125.68.0-255,1484,67949,77,173894
33463,0.00088,172.31.40.0-255,66,68015,77,173894
33464,0.000885,74.125.68.0-255,1484,69499,77,173894
33465,0.000907,74.125.68.0-255,1484,70983,77,173894
33466,0.000909,172.31.40.0-255,66,71049,77,173894
33467,0.000915,74.125.68.0-255,4320,75369,77,173894
33468,0.000916,172.31.40.0-255,66,75435,77,173894
33469,0.000939,74.125.68.0-255,1484,76919,77,173894
33470,0.000944,74.125.68.0-255,4320,81239,77,173894
33471,0.000946,172.31.40.0-255,66,81305,77,173894
33472,0.000975,74.125.68.0-255,2543,83848,77,173894
33473,0.000978,172.31.40.0-255,66,83914,77,173894
33474,0.000996,74.125.68.0-255,4320,88234,77,173894
33475,0.000998,172.31.40.0-255,66,88300,77,173894
33476,0.001024,74.125.68.0-255,5738,94038,77,173894
33477,0.001027,172.31.40.0-255,66,94104,77,173894
33478,0.001051,74.125.68.0-255,2902,97006,77,173894
33479,0.001053,172.31.40.0-255,66,97072,77,173894
33480,0.001082,74.125.68.0-255,2902,99974,77,173894
33481,0.001084,172.31.40.0-255,66,100040,77,173894
33482,0.001087,74.125.68.0-255,1125,101165,77,173894
33483,0.001512,172.31.40.0-255,66,101231,77,173894
33484,0.002045,74.125.68.0-255,1484,102715,77,173894
33485,0.002055,74.125.68.0-255,1484,104199,77,173894
33486,0.002059,172.31.40.0-255,66,104265,77,173894
33487,0.002065,74.125.68.0-255,1484,105749,77,173894
33488,0.002085,74.125.68.0-255,1484,107233,77,173894
33489,0.002087,172.31.40.0-255,66,107299,77,173894
33490,0.002092,74.125.68.0-255,2902,110201,77,173894
33491,0.002094,172.31.40.0-255,66,110267,77,173894
33492,0.002123,74.125.68.0-255,2902,113169,77,173894
33493,0.002125,172.31.40.0-255,66,113235,77,173894
33494,0.002129,74.125.68.0-255,2902,116137,77,173894
33495,0.002131,172.31.40.0-255,66,116203,77,173894
33496,0.002137,74.125.68.0-255,4320,120523,77,173894
33497,0.002139,172.31.40.0-255,66,120589,77,173894
33498,0.002143,74.125.68.0-255,2902,123491,77,173894
33499,0.002145,172.31.40.0-255,66,123557,77,173894
33500,0.002178,74.125.68.0-255,5738,129295,77,173894
33501,0.00218,172.31.40.0-255,66,129361,77,173894
33502,0.002187,74.125.68.0-255,5738,135099,77,173894
33503,0.002189,172.31.40.0-255,66,135165,77,173894
33504,0.002192,74.125.68.0-255,766,135931,77,173894
33505,0.004484,74.125.68.0-255,4320,140251,77,173894
33506,0.004495,172.31.40.0-255,66,140317,77,173894
33507,0.006787,74.125.68.0-255,4320,144637,77,173894
33508,0.006792,172.31.40.0-255,66,144703,77,173894
33509,0.006816,74.125.68.0-255,1484,146187,77,173894
33510,0.007537,172.31.40.0-255,105,146292,77,173894
33511,0.00909,74.125.68.0-255,4320,150612,77,173894
33512,0.009104,172.31.40.0-255,66,150678,77,173894
33513,0.011406,74.125.68.0-255,5738,156416,77,173894
33514,0.011417,172.31.40.0-255,66,156482,77,173894
33515,0.013715,74.125.68.0-255,5738,162220,77,173894
33516,0.013723,172.31.40.0-255,66,162286,77,173894
33517,0.016043,74.125.68.0-255,5738,168024,77,173894
33518,0.016052,172.31.40.0-255,66,168090,77,173894
33519,0.018347,74.125.68.0-255,5738,173828,77,173894
33520,0.018356,172.31.40.0-255,66,173894,77,173894
33521,0.0,74.125.130.0-255,156,156,77,249916
33522,2.5e-05,172.31.40.0-255,66,222,77,249916
33523,3.2e-05,74.125.130.0-255,1484,1706,77,249916
33524,3.7e-05,172.31.40.0-255,66,1772,77,249916
33525,4.3e-05,74.125.130.0-255,2902,4674,77,249916
33526,4.8e-05,172.31.40.0-255,66,4740,77,249916
33527,6.3e-05,74.125.130.0-255,7156,11896,77,249916
33528,6.7e-05,172.31.40.0-255,66,11962,77,249916
33529,7.1e-05,74.125.130.0-255,2074,14036,77,249916
33530,7.4e-05,172.31.40.0-255,66,14102,77,249916
33531,0.000324,74.125.130.0-255,1484,15586,77,249916
33532,0.00033,172.31.40.0-255,66,15652,77,249916
33533,0.000337,74.125.130.0-255,2902,18554,77,249916
33534,0.00034,172.31.40.0-255,66,18620,77,249916
33535,0.000345,74.125.130.0-255,4320,22940,77,249916
33536,0.000353,172.31.40.0-255,66,23006,77,249916
33537,0.000377,74.125.130.0-255,1484,24490,77,249916
33538,0.00038,172.31.40.0-255,66,24556,77,249916
33539,0.000409,74.125.130.0-255,6797,31353,77,249916
33540,0.000411,172.31.40.0-255,66,31419,77,249916
33541,0.000417,74.125.130.0-255,4320,35739,77,249916
33542,0.000419,172.31.40.0-255,66,35805,77,249916
33543,0.000445,74.125.130.0-255,2902,38707,77,249916
33544,0.000448,172.31.40.0-255,66,38773,77,249916
33545,0.000491,74.125.130.0-255,4320,43093,77,249916
33546,0.000494,172.31.40.0-255,66,43159,77,249916
33547,0.000522,74.125.130.0-255,5379,48538,77,249916
33548,0.000525,172.31.40.0-255,66,48604,77,249916
33549,0.000528,74.125.130.0-255,1484,50088,77,249916
33550,0.00053,172.31.40.0-255,66,50154,77,249916
33551,0.000534,74.125.130.0-255,2902,53056,77,249916
33552,0.000537,172.31.40.0-255,66,53122,77,249916
33553,0.000574,74.125.130.0-255,5738,58860,77,249916
33554,0.000578,172.31.40.0-255,66,58926,77,249916
33555,0.000583,74.125.130.0-255,2902,61828,77,249916
33556,0.000585,172.31.40.0-255,66,61894,77,249916
33557,0.00059,74.125.130.0-255,3961,65855,77,249916
33558,0.000592,172.31.40.0-255,66,65921,77,249916
33559,0.000595,74.125.130.0-255,677,66598,77,249916
33560,0.000757,74.125.130.0-255,1484,68082,77,249916
33561,0.000761,172.31.40.0-255,66,68148,77,249916
33562,0.000767,74.125.130.0-255,2902,71050,77,249916
33563,0.00077,172.31.40.0-255,66,71116,77,249916
33564,0.000773,74.125.130.0-255,1484,72600,77,249916
33565,0.000792,74.125.130.0-255,4320,76920,77,249916
33566,0.000799,172.31.40.0-255,66,76986,77,249916
33567,0.000836,74.125.130.0-255,6797,83783,77,249916
33568,0.000839,172.31.40.0-255,66,83849,77,249916
33569,0.000847,74.125.130.0-255,7156,91005,77,249916
33570,0.000849,172.31.40.0-255,66,91071,77,249916
33571,0.000894,74.125.130.0-255,5738,96809,77,249916
33572,0.000898,172.31.40.0-255,66,96875,77,249916
33573,0.000924,74.125.130.0-255,3961,100836,77,249916
33574,0.000928,172.31.40.0-255,66,100902,77,249916
33575,0.001128,74.125.130.0-255,1484,102386,77,249916
33576,0.001146,74.125.130.0-255,2902,105288,77,249916
33577,0.001149,172.31.40.0-255,66,105354,77,249916
33578,0.001157,74.125.130.0-255,5738,111092,77,249916
33579,0.001159,172.31.40.0-255,66,111158,77,249916
33580,0.001195,74.125.130.0-255,9992,121150,77,249916
33581,0.001198,172.31.40.0-255,66,121216,77,249916
33582,0.001233,74.125.130.0-255,1484,122700,77,249916
33583,0.001259,74.125.130.0-255,9992,132692,77,249916
33584,0.001264,172.31.40.0-255,66,132758,77,249916
33585,0.001301,74.125.130.0-255,2184,134942,77,249916
33586,0.001303,74.125.130.0-255,1484,136426,77,249916
33587,0.001307,172.31.40.0-255,66,136492,77,249916
33588,0.001316,74.125.130.0-255,1484,137976,77,249916
33589,0.001318,172.31.40.0-255,66,138042,77,249916
33590,0.001322,74.125.130.0-255,1484,139526,77,249916
33591,0.001351,74.125.130.0-255,5738,145264,77,249916
33592,0.001354,172.31.40.0-255,66,145330,77,249916
33593,0.001359,74.125.130.0-255,2902,148232,77,249916
33594,0.001361,172.31.40.0-255,66,148298,77,249916
33595,0.001388,74.125.130.0-255,1484,149782,77,249916
33596,0.001396,74.125.130.0-255,5738,155520,77,249916
33597,0.001398,172.31.40.0-255,66,155586,77,249916
33598,0.001435,74.125.130.0-255,7156,162742,77,249916
33599,0.001439,172.31.40.0-255,66,162808,77,249916
33600,0.001469,74.125.130.0-255,4320,167128,77,249916
33601,0.001472,172.31.40.0-255,66,167194,77,249916
33602,0.001498,74.125.130.0-255,2184,169378,77,249916
33603,0.001501,172.31.40.0-255,66,169444,77,249916
33604,0.001528,74.125.130.0-255,2902,172346,77,249916
33605,0.001531,172.31.40.0-255,66,172412,77,249916
33606,0.001558,74.125.130.0-255,4320,176732,77,249916
33607,0.001562,172.31.40.0-255,66,176798,77,249916
33608,0.001571,74.125.130.0-255,8574,185372,77,249916
33609,0.001573,172.31.40.0-255,66,185438,77,249916
33610,0.001632,74.125.130.0-255,7156,192594,77,249916
33611,0.001635,172.31.40.0-255,66,192660,77,249916
33612,0.001649,74.125.130.0-255,10692,203352,77,249916
33613,0.001653,172.31.40.0-255,66,203418,77,249916
33614,0.003692,74.125.130.0-255,5738,209156,77,249916
33615,0.003698,172.31.40.0-255,66,209222,77,249916
33616,0.005743,74.125.130.0-255,5738,214960,77,249916
33617,0.00575,172.31.40.0-255,66,215026,77,249916
33618,0.007791,74.125.130.0-255,1484,216510,77,249916
33619,0.007815,74.125.130.0-255,4320,220830,77,249916
33620,0.007818,172.31.40.0-255,66,220896,77,249916
33621,0.009898,74.125.130.0-255,5738,226634,77,249916
33622,0.009902,172.31.40.0-255,66,226700,77,249916
33623,0.011946,74.125.130.0-255,5738,232438,77,249916
33624,0.011953,172.31.40.0-255,66,232504,77,249916
33625,0.01401,74.125.130.0-255,5738,238242,77,249916
33626,0.014017,172.31.40.0-255,66,238308,77,249916
33627,0.016068,74.125.130.0-255,5738,244046,77,249916
33628,0.016077,172.31.40.0-255,66,244112,77,249916
33629,0.018128,74.125.130.0-255,5738,249850,77,249916
33630,0.018136,172.31.40.0-255,66,249916,77,249916
33631,0.0,172.31.40.0-255,66,66,77,66
33632,0.0,74.125.24.0-255,152,152,77,141520
33633,2.3e-05,172.31.40.0-255,66,218,77,141520
33634,3e-05,74.125.24.0-255,1484,1702,77,141520
33635,3.5e-05,172.31.40.0-255,66,1768,77,141520
33636,4.2e-05,74.125.24.0-255,2902,4670,77,141520
33637,4.5e-05,172.31.40.0-255,66,4736,77,141520
33638,5.1e-05,74.125.24.0-255,4320,9056,77,141520
33639,5.4e-05,172.31.40.0-255,66,9122,77,141520
33640,5.8e-05,74.125.24.0-255,1484,10606,77,141520
33641,6.1e-05,172.31.40.0-255,66,10672,77,141520
33642,8.7e-05,74.125.24.0-255,3419,14091,77,141520
33643,9e-05,172.31.40.0-255,66,14157,77,141520
33644,0.00042,74.125.24.0-255,1484,15641,77,141520
33645,0.000425,172.31.40.0-255,66,15707,77,141520
33646,0.000431,74.125.24.0-255,2902,18609,77,141520
33647,0.000433,172.31.40.0-255,66,18675,77,141520
33648,0.000451,74.125.24.0-255,5738,24413,77,141520
33649,0.000454,172.31.40.0-255,66,24479,77,141520
33650,0.000489,74.125.24.0-255,2902,27381,77,141520
33651,0.000493,172.31.40.0-255,66,27447,77,141520
33652,0.000506,74.125.24.0-255,3961,31408,77,141520
33653,0.000508,172.31.40.0-255,66,31474,77,141520
33654,0.00068,74.125.24.0-255,1484,32958,77,141520
33655,0.000685,172.31.40.0-255,66,33024,77,141520
33656,0.000699,74.125.24.0-255,2902,35926,77,141520
33657,0.000703,172.31.40.0-255,66,35992,77,141520
33658,0.00073,74.125.24.0-255,5738,41730,77,141520
33659,0.000733,172.31.40.0-255,66,41796,77,141520
33660,0.000761,74.125.24.0-255,6797,48593,77,141520
33661,0.000764,172.31.40.0-255,66,48659,77,141520
33662,0.000881,74.125.24.0-255,1484,50143,77,141520
33663,0.000885,172.31.40.0-255,66,50209,77,141520
33664,0.000889,74.125.24.0-255,2902,53111,77,141520
33665,0.000891,172.31.40.0-255,66,53177,77,141520
33666,0.000895,74.125.24.0-255,1484,54661,77,141520
33667,0.000922,74.125.24.0-255,2902,57563,77,141520
33668,0.000925,172.31.40.0-255,66,57629,77,141520
33669,0.000932,74.125.24.0-255,5738,63367,77,141520
33670,0.000935,172.31.40.0-255,66,63433,77,141520
33671,0.000954,74.125.24.0-255,2890,66323,77,141520
33672,0.000956,172.31.40.0-255,66,66389,77,141520
33673,0.001189,74.125.24.0-255,331,66720,77,141520
33674,0.001685,74.125.24.0-255,1484,68204,77,141520
33675,0.001692,172.31.40.0-255,66,68270,77,141520
33676,0.0017,74.125.24.0-255,2902,71172,77,141520
33677,0.001702,172.31.40.0-255,66,71238,77,141520
33678,0.001709,74.125.24.0-255,5738,76976,77,141520
33679,0.001711,172.31.40.0-255,66,77042,77,141520
33680,0.001717,74.125.24.0-255,4320,81362,77,141520
33681,0.001719,172.31.40.0-255,66,81428,77,141520
33682,0.001745,74.125.24.0-255,1484,82912,77,141520
33683,0.001757,74.125.24.0-255,12828,95740,77,141520
33684,0.00176,172.31.40.0-255,66,95806,77,141520
33685,0.001766,74.125.24.0-255,5020,100826,77,141520
33686,0.001768,172.31.40.0-255,66,100892,77,141520
33687,0.004084,74.125.24.0-255,5738,106630,77,141520
33688,0.00409,172.31.40.0-255,66,106696,77,141520
33689,0.006479,74.125.24.0-255,5738,112434,77,141520
33690,0.006501,172.31.40.0-255,66,112500,77,141520
33691,0.008828,74.125.24.0-255,5738,118238,77,141520
33692,0.008848,172.31.40.0-255,66,118304,77,141520
33693,0.011171,74.125.24.0-255,5738,124042,77,141520
33694,0.011189,172.31.40.0-255,66,124108,77,141520
33695,0.013587,74.125.24.0-255,5738,129846,77,141520
33696,0.013594,172.31.40.0-255,66,129912,77,141520
33697,0.015922,74.125.24.0-255,5738,135650,77,141520
33698,0.015929,172.31.40.0-255,66,135716,77,141520
33699,0.018251,74.125.24.0-255,5738,141454,77,141520
33700,0.01826,172.31.40.0-255,66,141520,77,141520
33701,0.0,74.125.130.0-255,152,152,77,318458
33702,2.1e-05,172.31.40.0-255,66,218,77,318458
33703,2.9e-05,74.125.130.0-255,1484,1702,77,318458
33704,3.3e-05,172.31.40.0-255,66,1768,77,318458
33705,3.9e-05,74.125.130.0-255,2902,4670,77,318458
33706,5e-05,172.31.40.0-255,66,4736,77,318458
33707,5.8e-05,74.125.130.0-255,7156,11892,77,318458
33708,6.1e-05,172.31.40.0-255,66,11958,77,318458
33709,0.000103,74.125.130.0-255,2902,14860,77,318458
33710,0.000105,172.31.40.0-255,66,14926,77,318458
33711,0.000142,74.125.130.0-255,4818,19744,77,318458
33712,0.000145,172.31.40.0-255,66,19810,77,318458
33713,0.000154,74.125.130.0-255,8574,28384,77,318458
33714,0.000156,172.31.40.0-255,66,28450,77,318458
33715,0.00016,74.125.130.0-255,2543,30993,77,318458
33716,0.000167,172.31.40.0-255,66,31059,77,318458
33717,0.000248,74.125.130.0-255,1484,32543,77,318458
33718,0.000251,172.31.40.0-255,66,32609,77,318458
33719,0.000255,74.125.130.0-255,1484,34093,77,318458
33720,0.000258,172.31.40.0-255,66,34159,77,318458
33721,0.00028,74.125.130.0-255,1484,35643,77,318458
33722,0.000282,172.31.40.0-255,66,35709,77,318458
33723,0.000317,74.125.130.0-255,5738,41447,77,318458
33724,0.000324,172.31.40.0-255,66,41513,77,318458
33725,0.000333,74.125.130.0-255,8574,50087,77,318458
33726,0.000335,172.31.40.0-255,66,50153,77,318458
33727,0.000342,74.125.130.0-255,5738,55891,77,318458
33728,0.000344,172.31.40.0-255,66,55957,77,318458
33729,0.000373,74.125.130.0-255,4320,60277,77,318458
33730,0.00038,172.31.40.0-255,66,60343,77,318458
33731,0.000387,74.125.130.0-255,5020,65363,77,318458
33732,0.000389,172.31.40.0-255,66,65429,77,318458
33733,0.000392,74.125.130.0-255,379,65808,77,318458
33734,0.000414,74.125.130.0-255,394,66202,77,318458
33735,0.000706,74.125.130.0-255,1484,67686,77,318458
33736,0.000719,172.31.40.0-255,66,67752,77,318458
33737,0.000742,74.125.130.0-255,2902,70654,77,318458
33738,0.000745,172.31.40.0-255,66,70720,77,318458
33739,0.000752,74.125.130.0-255,5738,76458,77,318458
33740,0.000754,172.31.40.0-255,66,76524,77,318458
33741,0.000759,74.125.130.0-255,2902,79426,77,318458
33742,0.000762,172.31.40.0-255,66,79492,77,318458
33743,0.000798,74.125.130.0-255,5738,85230,77,318458
33744,0.000801,172.31.40.0-255,66,85296,77,318458
33745,0.000811,74.125.130.0-255,9992,95288,77,318458
33746,0.000813,172.31.40.0-255,66,95354,77,318458
33747,0.000824,74.125.130.0-255,5020,100374,77,318458
33748,0.000827,172.31.40.0-255,66,100440,77,318458
33749,0.000919,74.125.130.0-255,1484,101924,77,318458
33750,0.000934,74.125.130.0-255,2902,104826,77,318458
33751,0.000938,172.31.40.0-255,66,104892,77,318458
33752,0.000967,74.125.130.0-255,5738,110630,77,318458
33753,0.00097,172.31.40.0-255,66,110696,77,318458
33754,0.000974,74.125.130.0-255,2902,113598,77,318458
33755,0.000976,172.31.40.0-255,66,113664,77,318458
33756,0.000982,74.125.130.0-255,4320,117984,77,318458
33757,0.000984,172.31.40.0-255,66,118050,77,318458
33758,0.001046,74.125.130.0-255,8574,126624,77,318458
33759,0.001049,172.31.40.0-255,66,126690,77,318458
33760,0.001055,74.125.130.0-255,5738,132428,77,318458
33761,0.001057,172.31.40.0-255,66,132494,77,318458
33762,0.00106,74.125.130.0-255,1484,133978,77,318458
33763,0.001083,74.125.130.0-255,766,134744,77,318458
33764,0.001086,172.31.40.0-255,66,134810,77,318458
33765,0.001221,74.125.130.0-255,1484,136294,77,318458
33766,0.001246,74.125.130.0-255,2902,139196,77,318458
33767,0.00125,172.31.40.0-255,66,139262,77,318458
33768,0.001256,74.125.130.0-255,4320,143582,77,318458
33769,0.001258,172.31.40.0-255,66,143648,77,318458
33770,0.001283,74.125.130.0-255,1484,145132,77,318458
33771,0.001287,74.125.130.0-255,2902,148034,77,318458
33772,0.001289,172.31.40.0-255,66,148100,77,318458
33773,0.0013,74.125.130.0-255,4320,152420,77,318458
33774,0.001302,172.31.40.0-255,66,152486,77,318458
33775,0.00131,74.125.130.0-255,8574,161060,77,318458
33776,0.001312,172.31.40.0-255,66,161126,77,318458
33777,0.001318,74.125.130.0-255,5738,166864,77,318458
33778,0.00132,172.31.40.0-255,66,166930,77,318458
33779,0.001369,74.125.130.0-255,2184,169114,77,318458
33780,0.001373,172.31.40.0-255,66,169180,77,318458
33781,0.001418,74.125.130.0-255,2902,172082,77,318458
33782,0.001421,172.31.40.0-255,66,172148,77,318458
33783,0.001453,74.125.130.0-255,4320,176468,77,318458
33784,0.001457,172.31.40.0-255,66,176534,77,318458
33785,0.001466,74.125.130.0-255,8574,185108,77,318458
33786,0.001469,172.31.40.0-255,66,185174,77,318458
33787,0.00148,74.125.130.0-255,5738,190912,77,318458
33788,0.001482,172.31.40.0-255,66,190978,77,318458
33789,0.001518,74.125.130.0-255,7156,198134,77,318458
33790,0.001522,172.31.40.0-255,66,198200,77,318458
33791,0.001528,74.125.130.0-255,5020,203220,77,318458
33792,0.00153,172.31.40.0-255,66,203286,77,318458
33793,0.001591,74.125.130.0-255,1484,204770,77,318458
33794,0.001596,74.125.130.0-255,2902,207672,77,318458
33795,0.001599,172.31.40.0-255,66,207738,77,318458
33796,0.001602,74.125.130.0-255,1484,209222,77,318458
33797,0.00163,74.125.130.0-255,4320,213542,77,318458
33798,0.001633,172.31.40.0-255,66,213608,77,318458
33799,0.001638,74.125.130.0-255,2902,216510,77,318458
33800,0.00164,172.31.40.0-255,66,216576,77,318458
33801,0.001645,74.125.130.0-255,4320,220896,77,318458
33802,0.001647,172.31.40.0-255,66,220962,77,318458
33803,0.001657,74.125.130.0-255,2902,223864,77,318458
33804,0.001659,172.31.40.0-255,66,223930,77,318458
33805,0.0017,74.125.130.0-255,5738,229668,77,318458
33806,0.001703,172.31.40.0-255,66,229734,77,318458
33807,0.00171,74.125.130.0-255,7156,236890,77,318458
33808,0.001712,172.31.40.0-255,66,236956,77,318458
33809,0.001714,74.125.130.0-255,766,237722,77,318458
33810,0.001962,74.125.130.0-255,1484,239206,77,318458
33811,0.001967,172.31.40.0-255,66,239272,77,318458
33812,0.001987,74.125.130.0-255,2902,242174,77,318458
33813,0.00199,172.31.40.0-255,66,242240,77,318458
33814,0.001994,74.125.130.0-255,2902,245142,77,318458
33815,0.001996,172.31.40.0-255,66,245208,77,318458
33816,0.002017,74.125.130.0-255,2902,248110,77,318458
33817,0.002023,172.31.40.0-255,66,248176,77,318458
33818,0.002026,74.125.130.0-255,1484,249660,77,318458
33819,0.00206,74.125.130.0-255,11410,261070,77,318458
33820,0.002063,172.31.40.0-255,66,261136,77,318458
33821,0.002083,74.125.130.0-255,2902,264038,77,318458
33822,0.002085,172.31.40.0-255,66,264104,77,318458
33823,0.002105,74.125.130.0-255,7856,271960,77,318458
33824,0.002108,172.31.40.0-255,66,272026,77,318458
33825,0.004174,74.125.130.0-255,5738,277764,77,318458
33826,0.004181,172.31.40.0-255,66,277830,77,318458
33827,0.006256,74.125.130.0-255,5738,283568,77,318458
33828,0.006264,172.31.40.0-255,66,283634,77,318458
33829,0.008333,74.125.130.0-255,5738,289372,77,318458
33830,0.008338,172.31.40.0-255,66,289438,77,318458
33831,0.010414,74.125.130.0-255,5738,295176,77,318458
33832,0.010421,172.31.40.0-255,66,295242,77,318458
33833,0.012486,74.125.130.0-255,5738,300980,77,318458
33834,0.012493,172.31.40.0-255,66,301046,77,318458
33835,0.014606,74.125.130.0-255,5738,306784,77,318458
33836,0.014615,172.31.40.0-255,66,306850,77,318458
33837,0.016685,74.125.130.0-255,5738,312588,77,318458
33838,0.016696,172.31.40.0-255,66,312654,77,318458
33839,0.018782,74.125.130.0-255,5738,318392,77,318458
33840,0.01879,172.31.40.0-255,66,318458,77,318458
33841,0.0,172.217.24.0-255,153,153,77,164147
33842,2.2e-05,172.31.40.0-255,66,219,77,164147
33843,2.9e-05,172.217.24.0-255,1484,1703,77,164147
33844,3.5e-05,172.31.40.0-255,66,1769,77,164147
33845,4e-05,172.217.24.0-255,2902,4671,77,164147
33846,4.3e-05,172.31.40.0-255,66,4737,77,164147
33847,5e-05,172.217.24.0-255,7156,11893,77,164147
33848,5.3e-05,172.31.40.0-255,66,11959,77,164147
33849,5.7e-05,172.217.24.0-255,2072,14031,77,164147
33850,6e-05,172.31.40.0-255,66,14097,77,164147
33851,6.5e-05,172.217.24.0-255,2902,16999,77,164147
33852,6.8e-05,172.31.40.0-255,66,17065,77,164147
33853,7.5e-05,172.217.24.0-255,7156,24221,77,164147
33854,7.8e-05,172.31.40.0-255,66,24287,77,164147
33855,0.000112,172.217.24.0-255,6797,31084,77,164147
33856,0.000115,172.31.40.0-255,66,31150,77,164147
33857,0.000253,172.217.24.0-255,1484,32634,77,164147
33858,0.000257,172.31.40.0-255,66,32700,77,164147
33859,0.000262,172.217.24.0-255,2902,35602,77,164147
33860,0.000264,172.31.40.0-255,66,35668,77,164147
33861,0.00027,172.217.24.0-255,4320,39988,77,164147
33862,0.000272,172.31.40.0-255,66,40054,77,164147
33863,0.000299,172.217.24.0-255,1484,41538,77,164147
33864,0.000302,172.31.40.0-255,66,41604,77,164147
33865,0.000309,172.217.24.0-255,5738,47342,77,164147
33866,0.000312,172.31.40.0-255,66,47408,77,164147
33867,0.000334,172.217.24.0-255,1125,48533,77,164147
33868,0.000336,172.31.40.0-255,66,48599,77,164147
33869,0.00047,172.217.24.0-255,1484,50083,77,164147
33870,0.000474,172.31.40.0-255,66,50149,77,164147
33871,0.000497,172.217.24.0-255,2902,53051,77,164147
33872,0.000501,172.31.40.0-255,66,53117,77,164147
33873,0.000506,172.217.24.0-255,4320,57437,77,164147
33874,0.000509,172.31.40.0-255,66,57503,77,164147
33875,0.000555,172.217.24.0-255,8545,66048,77,164147
33876,0.000559,172.31.40.0-255,66,66114,77,164147
33877,0.001198,172.217.24.0-255,115,66229,77,164147
33878,0.00135,172.217.24.0-255,1484,67713,77,164147
33879,0.001355,172.31.40.0-255,66,67779,77,164147
33880,0.001363,172.217.24.0-255,2902,70681,77,164147
33881,0.001365,172.31.40.0-255,66,70747,77,164147
33882,0.00141,172.217.24.0-255,2902,73649,77,164147
33883,0.001413,172.31.40.0-255,66,73715,77,164147
33884,0.001432,172.217.24.0-255,2902,76617,77,164147
33885,0.001434,172.31.40.0-255,66,76683,77,164147
33886,0.001441,172.217.24.0-255,6797,83480,77,164147
33887,0.001443,172.31.40.0-255,66,83546,77,164147
33888,0.001462,172.217.24.0-255,1484,85030,77,164147
33889,0.001484,172.217.24.0-255,2902,87932,77,164147
33890,0.001486,172.31.40.0-255,66,87998,77,164147
33891,0.001493,172.217.24.0-255,5738,93736,77,164147
33892,0.001495,172.31.40.0-255,66,93802,77,164147
33893,0.001498,172.217.24.0-255,1484,95286,77,164147
33894,0.001515,172.217.24.0-255,1484,96770,77,164147
33895,0.001517,172.31.40.0-255,66,96836,77,164147
33896,0.001534,172.217.24.0-255,1484,98320,77,164147
33897,0.001548,172.217.24.0-255,2543,100863,77,164147
33898,0.001551,172.31.40.0-255,66,100929,77,164147
33899,0.001891,172.217.24.0-255,1484,102413,77,164147
33900,0.0019,172.217.24.0-255,2902,105315,77,164147
33901,0.001904,172.31.40.0-255,66,105381,77,164147
33902,0.001911,172.217.24.0-255,4320,109701,77,164147
33903,0.001913,172.31.40.0-255,66,109767,77,164147
33904,0.001935,172.217.24.0-255,2902,112669,77,164147
33905,0.001937,172.31.40.0-255,66,112735,77,164147
33906,0.003822,172.217.24.0-255,2902,115637,77,164147
33907,0.003826,172.31.40.0-255,66,115703,77,164147
33908,0.003847,172.217.24.0-255,2902,118605,77,164147
33909,0.003849,172.31.40.0-255,66,118671,77,164147
33910,0.005759,172.217.24.0-255,2902,121573,77,164147
33911,0.005761,172.31.40.0-255,66,121639,77,164147
33912,0.005781,172.217.24.0-255,2902,124541,77,164147
33913,0.005783,172.31.40.0-255,66,124607,77,164147
33914,0.007682,172.217.24.0-255,2902,127509,77,164147
33915,0.007689,172.31.40.0-255,66,127575,77,164147
33916,0.00771,172.217.24.0-255,2902,130477,77,164147
33917,0.007713,172.31.40.0-255,66,130543,77,164147
33918,0.00962,172.217.24.0-255,2902,133445,77,164147
33919,0.009627,172.31.40.0-255,66,133511,77,164147
33920,0.009648,172.217.24.0-255,2902,136413,77,164147
33921,0.009651,172.31.40.0-255,66,136479,77,164147
33922,0.01155,172.217.24.0-255,4320,140799,77,164147
33923,0.011558,172.31.40.0-255,66,140865,77,164147
33924,0.011574,172.217.24.0-255,1484,142349,77,164147
33925,0.01351,172.217.24.0-255,4320,146669,77,164147
33926,0.013518,172.31.40.0-255,66,146735,77,164147
33927,0.015471,172.217.24.0-255,5738,152473,77,164147
33928,0.015489,172.31.40.0-255,66,152539,77,164147
33929,0.017425,172.217.24.0-255,5738,158277,77,164147
33930,0.017442,172.31.40.0-255,66,158343,77,164147
33931,0.019373,172.217.24.0-255,5738,164081,77,164147
33932,0.01938,172.31.40.0-255,66,164147,77,164147
33933,0.0,172.217.194.0-255,297,297,77,397066
33934,2.3e-05,172.31.40.0-255,66,363,77,397066
33935,3e-05,172.217.194.0-255,1484,1847,77,397066
33936,3.5e-05,172.31.40.0-255,66,1913,77,397066
33937,4.3e-05,172.217.194.0-255,4320,6233,77,397066
33938,4.6e-05,172.31.40.0-255,66,6299,77,397066
33939,8.3e-05,172.217.194.0-255,9056,15355,77,397066
33940,8.6e-05,172.31.40.0-255,66,15421,77,397066
33941,9.4e-05,172.217.194.0-255,8574,23995,77,397066
33942,9.7e-05,172.31.40.0-255,66,24061,77,397066
33943,0.000133,172.217.194.0-255,2902,26963,77,397066
33944,0.000136,172.31.40.0-255,66,27029,77,397066
33945,0.000156,172.217.194.0-255,3961,30990,77,397066
33946,0.000159,172.31.40.0-255,66,31056,77,397066
33947,0.000195,172.217.194.0-255,1484,32540,77,397066
33948,0.000198,172.31.40.0-255,66,32606,77,397066
33949,0.000202,172.217.194.0-255,1484,34090,77,397066
33950,0.000204,172.31.40.0-255,66,34156,77,397066
33951,0.000217,172.217.194.0-255,1484,35640,77,397066
33952,0.000221,172.217.194.0-255,2902,38542,77,397066
33953,0.000225,172.31.40.0-255,66,38608,77,397066
33954,0.000229,172.31.40.0-255,66,38674,77,397066
33955,0.000239,172.217.194.0-255,2902,41576,77,397066
33956,0.000241,172.31.40.0-255,66,41642,77,397066
33957,0.000246,172.217.194.0-255,4320,45962,77,397066
33958,0.000249,172.31.40.0-255,66,46028,77,397066
33959,0.00027,172.217.194.0-255,6797,52825,77,397066
33960,0.000273,172.31.40.0-255,66,52891,77,397066
33961,0.000275,172.217.194.0-255,1484,54375,77,397066
33962,0.000277,172.31.40.0-255,66,54441,77,397066
33963,0.000292,172.217.194.0-255,4320,58761,77,397066
33964,0.000294,172.31.40.0-255,66,58827,77,397066
33965,0.000323,172.217.194.0-255,7048,65875,77,397066
33966,0.000326,172.31.40.0-255,66,65941,77,397066
33967,0.000329,172.217.194.0-255,123,66064,77,397066
33968,0.000333,172.217.194.0-255,379,66443,77,397066
33969,0.000471,172.217.194.0-255,1484,67927,77,397066
33970,0.000476,172.31.40.0-255,66,67993,77,397066
33971,0.000495,172.217.194.0-255,2902,70895,77,397066
33972,0.000498,172.31.40.0-255,66,70961,77,397066
33973,0.000505,172.217.194.0-255,5738,76699,77,397066
33974,0.000507,172.31.40.0-255,66,76765,77,397066
33975,0.000543,172.217.194.0-255,6797,83562,77,397066
33976,0.000546,172.31.40.0-255,66,83628,77,397066
33977,0.000581,172.217.194.0-255,5738,89366,77,397066
33978,0.000584,172.31.40.0-255,66,89432,77,397066
33979,0.000588,172.217.194.0-255,2902,92334,77,397066
33980,0.000591,172.31.40.0-255,66,92400,77,397066
33981,0.000607,172.217.194.0-255,4320,96720,77,397066
33982,0.00061,172.31.40.0-255,66,96786,77,397066
33983,0.000639,172.217.194.0-255,3961,100747,77,397066
33984,0.000642,172.31.40.0-255,66,100813,77,397066
33985,0.001337,172.217.194.0-255,1484,102297,77,397066
33986,0.001344,172.217.194.0-255,2902,105199,77,397066
33987,0.001348,172.31.40.0-255,66,105265,77,397066
33988,0.001356,172.217.194.0-255,5738,111003,77,397066
33989,0.001358,172.31.40.0-255,66,111069,77,397066
33990,0.001374,172.217.194.0-255,4320,115389,77,397066
33991,0.001376,172.31.40.0-255,66,115455,77,397066
33992,0.001412,172.217.194.0-255,8574,124029,77,397066
33993,0.001421,172.217.194.0-255,9992,134021,77,397066
33994,0.001425,172.31.40.0-255,66,134087,77,397066
33995,0.001428,172.31.40.0-255,66,134153,77,397066
33996,0.001448,172.217.194.0-255,4320,138473,77,397066
33997,0.00145,172.31.40.0-255,66,138539,77,397066
33998,0.00147,172.217.194.0-255,766,139305,77,397066
33999,0.001477,172.217.194.0-255,5738,145043,77,397066
34000,0.00148,172.31.40.0-255,66,145109,77,397066
34001,0.001492,172.217.194.0-255,12828,157937,77,397066
34002,0.001494,172.31.40.0-255,66,158003,77,397066
34003,0.0015,172.217.194.0-255,7156,165159,77,397066
34004,0.001502,172.31.40.0-255,66,165225,77,397066
34005,0.001538,172.217.194.0-255,2902,168127,77,397066
34006,0.001541,172.31.40.0-255,66,168193,77,397066
34007,0.001568,172.217.194.0-255,6438,174631,77,397066
34008,0.001571,172.31.40.0-255,66,174697,77,397066
34009,0.00158,172.217.194.0-255,9992,184689,77,397066
34010,0.001582,172.31.40.0-255,66,184755,77,397066
34011,0.001603,172.217.194.0-255,9992,194747,77,397066
34012,0.001606,172.31.40.0-255,66,194813,77,397066
34013,0.001624,172.217.194.0-255,7856,202669,77,397066
34014,0.001628,172.31.40.0-255,66,202735,77,397066
34015,0.001636,172.217.194.0-255,1484,204219,77,397066
34016,0.001665,172.217.194.0-255,2902,207121,77,397066
34017,0.001668,172.31.40.0-255,66,207187,77,397066
34018,0.001674,172.217.194.0-255,5738,212925,77,397066
34019,0.001676,172.31.40.0-255,66,212991,77,397066
34020,0.001712,172.217.194.0-255,2902,215893,77,397066
34021,0.001714,172.31.40.0-255,66,215959,77,397066
34022,0.001745,172.217.194.0-255,9992,225951,77,397066
34023,0.001755,172.217.194.0-255,10692,236643,77,397066
34024,0.00176,172.217.194.0-255,4320,240963,77,397066
34025,0.001764,172.217.194.0-255,5738,246701,77,397066
34026,0.001768,172.217.194.0-255,2902,249603,77,397066
34027,0.001773,172.31.40.0-255,66,249669,77,397066
34028,0.001781,172.31.40.0-255,66,249735,77,397066
34029,0.001783,172.31.40.0-255,66,249801,77,397066
34030,0.001786,172.31.40.0-255,66,249867,77,397066
34031,0.001789,172.31.40.0-255,66,249933,77,397066
34032,0.001801,172.217.194.0-255,8574,258507,77,397066
34033,0.001804,172.31.40.0-255,66,258573,77,397066
34034,0.001807,172.217.194.0-255,1484,260057,77,397066
34035,0.001843,172.217.194.0-255,10692,270749,77,397066
34036,0.001846,172.31.40.0-255,66,270815,77,397066
34037,0.001851,172.217.194.0-255,4320,275135,77,397066
34038,0.001853,172.31.40.0-255,66,275201,77,397066
34039,0.001857,172.217.194.0-255,2902,278103,77,397066
34040,0.001859,172.31.40.0-255,66,278169,77,397066
34041,0.001889,172.217.194.0-255,2902,281071,77,397066
34042,0.001892,172.31.40.0-255,66,281137,77,397066
34043,0.001902,172.217.194.0-255,11410,292547,77,397066
34044,0.001905,172.31.40.0-255,66,292613,77,397066
34045,0.001911,172.217.194.0-255,5738,298351,77,397066
34046,0.001913,172.31.40.0-255,66,298417,77,397066
34047,0.001938,172.217.194.0-255,6438,304855,77,397066
34048,0.001941,172.31.40.0-255,66,304921,77,397066
34049,0.001946,172.217.194.0-255,4320,309241,77,397066
34050,0.001948,172.31.40.0-255,66,309307,77,397066
34051,0.001982,172.217.194.0-255,8574,317881,77,397066
34052,0.001985,172.31.40.0-255,66,317947,77,397066
34053,0.001994,172.217.194.0-255,9992,327939,77,397066
34054,0.001996,172.31.40.0-255,66,328005,77,397066
34055,0.002034,172.217.194.0-255,13528,341533,77,397066
34056,0.002037,172.31.40.0-255,66,341599,77,397066
34057,0.002046,172.217.194.0-255,9992,351591,77,397066
34058,0.002049,172.31.40.0-255,66,351657,77,397066
34059,0.002069,172.217.194.0-255,4320,355977,77,397066
34060,0.002071,172.31.40.0-255,66,356043,77,397066
34061,0.002088,172.31.40.0-255,66,356109,77,397066
34062,0.00212,172.217.194.0-255,5738,361847,77,397066
34063,0.002122,172.31.40.0-255,66,361913,77,397066
34064,0.00214,172.217.194.0-255,1484,363397,77,397066
34065,0.002149,172.217.194.0-255,8574,371971,77,397066
34066,0.002151,172.31.40.0-255,66,372037,77,397066
34067,0.002158,172.217.194.0-255,5738,377775,77,397066
34068,0.00216,172.31.40.0-255,66,377841,77,397066
34069,0.002182,172.217.194.0-255,11410,389251,77,397066
34070,0.002185,172.31.40.0-255,66,389317,77,397066
34071,0.002188,172.217.194.0-255,766,390083,77,397066
34072,0.002236,172.217.194.0-255,6575,396658,77,397066
34073,0.002239,172.31.40.0-255,66,396724,77,397066
34074,0.002257,172.217.194.0-255,105,396829,77,397066
34075,0.009901,172.31.40.0-255,66,396895,77,397066
34076,0.009951,172.31.40.0-255,105,397000,77,397066
34077,0.012288,172.217.194.0-255,66,397066,77,397066
34078,0.0,74.125.24.0-255,154,154,77,176017
34079,1.5e-05,172.31.40.0-255,66,220,77,176017
34080,4.8e-05,74.125.24.0-255,1484,1704,77,176017
34081,5.2e-05,172.31.40.0-255,66,1770,77,176017
34082,5.8e-05,74.125.24.0-255,2902,4672,77,176017
34083,6e-05,172.31.40.0-255,66,4738,77,176017
34084,7.3e-05,74.125.24.0-255,7156,11894,77,176017
34085,7.6e-05,172.31.40.0-255,66,11960,77,176017
34086,0.000104,74.125.24.0-255,7709,19669,77,176017
34087,0.000106,172.31.40.0-255,66,19735,77,176017
34088,0.000133,74.125.24.0-255,7156,26891,77,176017
34089,0.000136,172.31.40.0-255,66,26957,77,176017
34090,0.000156,74.125.24.0-255,2902,29859,77,176017
34091,0.000158,172.31.40.0-255,66,29925,77,176017
34092,0.000161,74.125.24.0-255,1125,31050,77,176017
34093,0.000163,172.31.40.0-255,66,31116,77,176017
34094,0.00024,74.125.24.0-255,1484,32600,77,176017
34095,0.000243,172.31.40.0-255,66,32666,77,176017
34096,0.000247,74.125.24.0-255,1484,34150,77,176017
34097,0.000249,172.31.40.0-255,66,34216,77,176017
34098,0.000269,74.125.24.0-255,1484,35700,77,176017
34099,0.000272,172.31.40.0-255,66,35766,77,176017
34100,0.000301,74.125.24.0-255,5738,41504,77,176017
34101,0.000304,172.31.40.0-255,66,41570,77,176017
34102,0.000344,74.125.24.0-255,13887,55457,77,176017
34103,0.000347,172.31.40.0-255,66,55523,77,176017
34104,0.000351,74.125.24.0-255,2902,58425,77,176017
34105,0.000354,172.31.40.0-255,66,58491,77,176017
34106,0.000385,74.125.24.0-255,7072,65563,77,176017
34107,0.000388,172.31.40.0-255,66,65629,77,176017
34108,0.000487,74.125.24.0-255,130,65759,77,176017
34109,0.000491,172.31.40.0-255,66,65825,77,176017
34110,0.00069,74.125.24.0-255,1484,67309,77,176017
34111,0.000697,74.125.24.0-255,2902,70211,77,176017
34112,0.000705,172.31.40.0-255,66,70277,77,176017
34113,0.000746,74.125.24.0-255,4320,74597,77,176017
34114,0.000773,74.125.24.0-255,5738,80335,77,176017
34115,0.000783,172.31.40.0-255,66,80401,77,176017
34116,0.000805,74.125.24.0-255,8215,88616,77,176017
34117,0.000822,74.125.24.0-255,5738,94354,77,176017
34118,0.000835,74.125.24.0-255,2902,97256,77,176017
34119,0.000839,74.125.24.0-255,2543,99799,77,176017
34120,0.000868,172.31.40.0-255,66,99865,77,176017
34121,0.001814,74.125.24.0-255,1484,101349,77,176017
34122,0.001824,74.125.24.0-255,2902,104251,77,176017
34123,0.001829,172.31.40.0-255,66,104317,77,176017
34124,0.001836,74.125.24.0-255,5738,110055,77,176017
34125,0.001862,74.125.24.0-255,9992,120047,77,176017
34126,0.001882,74.125.24.0-255,2902,122949,77,176017
34127,0.00189,74.125.24.0-255,7156,130105,77,176017
34128,0.001942,74.125.24.0-255,3602,133707,77,176017
34129,0.002045,74.125.24.0-255,1484,135191,77,176017
34130,0.002049,74.125.24.0-255,1484,136675,77,176017
34131,0.002063,74.125.24.0-255,1484,138159,77,176017
34132,0.002086,74.125.24.0-255,1484,139643,77,176017
34133,0.00209,74.125.24.0-255,2902,142545,77,176017
34134,0.003798,172.31.40.0-255,66,142611,77,176017
34135,0.00586,74.125.24.0-255,4320,146931,77,176017
34136,0.005865,172.31.40.0-255,66,146997,77,176017
34137,0.005894,74.125.24.0-255,1484,148481,77,176017
34138,0.007954,74.125.24.0-255,4320,152801,77,176017
34139,0.007961,172.31.40.0-255,66,152867,77,176017
34140,0.010016,74.125.24.0-255,5738,158605,77,176017
34141,0.011533,172.31.40.0-255,66,158671,77,176017
34142,0.013627,74.125.24.0-255,5738,164409,77,176017
34143,0.013637,172.31.40.0-255,66,164475,77,176017
34144,0.015724,74.125.24.0-255,5738,170213,77,176017
34145,0.015734,172.31.40.0-255,66,170279,77,176017
34146,0.017826,74.125.24.0-255,5738,176017,77,176017
34147,0.0,172.217.27.0-255,148,148,77,261417
34148,2.1e-05,172.31.40.0-255,66,214,77,261417
34149,2.8e-05,172.217.27.0-255,1484,1698,77,261417
34150,3.2e-05,172.31.40.0-255,66,1764,77,261417
34151,3.8e-05,172.217.27.0-255,2902,4666,77,261417
34152,4.8e-05,172.31.40.0-255,66,4732,77,261417
34153,5.3e-05,172.217.27.0-255,4320,9052,77,261417
34154,5.6e-05,172.31.40.0-255,66,9118,77,261417
34155,6.3e-05,172.217.27.0-255,4988,14106,77,261417
34156,6.6e-05,172.31.40.0-255,66,14172,77,261417
34157,8.7e-05,172.217.27.0-255,2902,17074,77,261417
34158,9.4e-05,172.31.40.0-255,66,17140,77,261417
34159,0.000116,172.217.27.0-255,7156,24296,77,261417
34160,0.00012,172.31.40.0-255,66,24362,77,261417
34161,0.00015,172.217.27.0-255,6797,31159,77,261417
34162,0.000152,172.31.40.0-255,66,31225,77,261417
34163,0.00029,172.217.27.0-255,1484,32709,77,261417
34164,0.000294,172.31.40.0-255,66,32775,77,261417
34165,0.0003,172.217.27.0-255,2902,35677,77,261417
34166,0.000303,172.31.40.0-255,66,35743,77,261417
34167,0.000328,172.217.27.0-255,5738,41481,77,261417
34168,0.000332,172.31.40.0-255,66,41547,77,261417
34169,0.000335,172.217.27.0-255,1484,43031,77,261417
34170,0.000337,172.31.40.0-255,66,43097,77,261417
34171,0.000368,172.217.27.0-255,5379,48476,77,261417
34172,0.000371,172.31.40.0-255,66,48542,77,261417
34173,0.000382,172.217.27.0-255,7156,55698,77,261417
34174,0.000384,172.31.40.0-255,66,55764,77,261417
34175,0.00039,172.217.27.0-255,4320,60084,77,261417
34176,0.000392,172.31.40.0-255,66,60150,77,261417
34177,0.000425,172.217.27.0-255,4320,64470,77,261417
34178,0.000428,172.31.40.0-255,66,64536,77,261417
34179,0.000439,172.217.27.0-255,1396,65932,77,261417
34180,0.000935,172.217.27.0-255,133,66065,77,261417
34181,0.000976,172.217.27.0-255,1484,67549,77,261417
34182,0.00098,172.31.40.0-255,66,67615,77,261417
34183,0.000986,172.217.27.0-255,2902,70517,77,261417
34184,0.000988,172.31.40.0-255,66,70583,77,261417
34185,0.000994,172.217.27.0-255,4320,74903,77,261417
34186,0.001001,172.31.40.0-255,66,74969,77,261417
34187,0.001032,172.217.27.0-255,2902,77871,77,261417
34188,0.001037,172.31.40.0-255,66,77937,77,261417
34189,0.001048,172.217.27.0-255,5379,83316,77,261417
34190,0.00105,172.31.40.0-255,66,83382,77,261417
34191,0.001129,172.217.27.0-255,1484,84866,77,261417
34192,0.001132,172.217.27.0-255,1484,86350,77,261417
34193,0.001137,172.31.40.0-255,66,86416,77,261417
34194,0.001163,172.217.27.0-255,1484,87900,77,261417
34195,0.001168,172.217.27.0-255,4320,92220,77,261417
34196,0.00117,172.31.40.0-255,66,92286,77,261417
34197,0.001177,172.217.27.0-255,5738,98024,77,261417
34198,0.001179,172.31.40.0-255,66,98090,77,261417
34199,0.001194,172.217.27.0-255,9992,108082,77,261417
34200,0.001196,172.31.40.0-255,66,108148,77,261417
34201,0.001218,172.217.27.0-255,1484,109632,77,261417
34202,0.001226,172.217.27.0-255,7856,117488,77,261417
34203,0.001229,172.31.40.0-255,66,117554,77,261417
34204,0.001242,172.217.27.0-255,8574,126128,77,261417
34205,0.001244,172.31.40.0-255,66,126194,77,261417
34206,0.00128,172.217.27.0-255,5738,131932,77,261417
34207,0.001282,172.31.40.0-255,66,131998,77,261417
34208,0.00131,172.217.27.0-255,2802,134800,77,261417
34209,0.001313,172.31.40.0-255,66,134866,77,261417
34210,0.001433,172.217.27.0-255,1484,136350,77,261417
34211,0.001439,172.217.27.0-255,2902,139252,77,261417
34212,0.001441,172.31.40.0-255,66,139318,77,261417
34213,0.00147,172.217.27.0-255,5738,145056,77,261417
34214,0.001476,172.217.27.0-255,7156,152212,77,261417
34215,0.001481,172.31.40.0-255,66,152278,77,261417
34216,0.001484,172.31.40.0-255,66,152344,77,261417
34217,0.001505,172.217.27.0-255,11410,163754,77,261417
34218,0.001508,172.31.40.0-255,66,163820,77,261417
34219,0.001536,172.217.27.0-255,2902,166722,77,261417
34220,0.001539,172.31.40.0-255,66,166788,77,261417
34221,0.001543,172.217.27.0-255,2184,168972,77,261417
34222,0.001545,172.31.40.0-255,66,169038,77,261417
34223,0.001609,172.217.27.0-255,1484,170522,77,261417
34224,0.001624,172.217.27.0-255,2902,173424,77,261417
34225,0.001628,172.31.40.0-255,66,173490,77,261417
34226,0.001632,172.217.27.0-255,2902,176392,77,261417
34227,0.001635,172.31.40.0-255,66,176458,77,261417
34228,0.001657,172.217.27.0-255,2902,179360,77,261417
34229,0.001659,172.31.40.0-255,66,179426,77,261417
34230,0.001665,172.217.27.0-255,4320,183746,77,261417
34231,0.001672,172.31.40.0-255,66,183812,77,261417
34232,0.001711,172.217.27.0-255,8574,192386,77,261417
34233,0.001714,172.31.40.0-255,66,192452,77,261417
34234,0.001724,172.217.27.0-255,10692,203144,77,261417
34235,0.001731,172.31.40.0-255,66,203210,77,261417
34236,0.002019,172.31.40.0-255,101,203311,77,261417
34237,0.003388,172.217.27.0-255,5738,209049,77,261417
34238,0.003395,172.31.40.0-255,66,209115,77,261417
34239,0.003634,172.217.27.0-255,66,209181,77,261417
34240,0.005074,172.217.27.0-255,5738,214919,77,261417
34241,0.005078,172.31.40.0-255,66,214985,77,261417
34242,0.006751,172.217.27.0-255,5738,220723,77,261417
34243,0.006757,172.31.40.0-255,66,220789,77,261417
34244,0.008415,172.217.27.0-255,5738,226527,77,261417
34245,0.00842,172.31.40.0-255,66,226593,77,261417
34246,0.010079,172.217.27.0-255,5738,232331,77,261417
34247,0.010086,172.31.40.0-255,66,232397,77,261417
34248,0.011753,172.217.27.0-255,5738,238135,77,261417
34249,0.011761,172.31.40.0-255,66,238201,77,261417
34250,0.013424,172.217.27.0-255,5738,243939,77,261417
34251,0.013439,172.31.40.0-255,66,244005,77,261417
34252,0.015098,172.217.27.0-255,5738,249743,77,261417
34253,0.015106,172.31.40.0-255,66,249809,77,261417
34254,0.016869,172.217.27.0-255,5738,255547,77,261417
34255,0.016875,172.31.40.0-255,66,255613,77,261417
34256,0.018548,172.217.27.0-255,5738,261351,77,261417
34257,0.018562,172.31.40.0-255,66,261417,77,261417
34258,0.0,172.217.194.0-255,153,153,77,165858
34259,2.4e-05,172.31.40.0-255,66,219,77,165858
34260,3.1e-05,172.217.194.0-255,1484,1703,77,165858
34261,3.5e-05,172.31.40.0-255,66,1769,77,165858
34262,4.1e-05,172.217.194.0-255,2902,4671,77,165858
34263,4.4e-05,172.31.40.0-255,66,4737,77,165858
34264,0.000102,172.217.194.0-255,2902,7639,77,165858
34265,0.000105,172.31.40.0-255,66,7705,77,165858
34266,0.000119,172.217.194.0-255,4320,12025,77,165858
34267,0.000122,172.31.40.0-255,66,12091,77,165858
34268,0.000269,172.217.194.0-255,2037,14128,77,165858
34269,0.000274,172.31.40.0-255,66,14194,77,165858
34270,0.000336,172.217.194.0-255,7156,21350,77,165858
34271,0.000339,172.31.40.0-255,66,21416,77,165858
34272,0.000353,172.217.194.0-255,4320,25736,77,165858
34273,0.000355,172.31.40.0-255,66,25802,77,165858
34274,0.000617,172.217.194.0-255,7156,32958,77,165858
34275,0.000622,172.31.40.0-255,66,33024,77,165858
34276,0.000648,172.217.194.0-255,12828,45852,77,165858
34277,0.000651,172.31.40.0-255,66,45918,77,165858
34278,0.000668,172.217.194.0-255,2184,48102,77,165858
34279,0.00067,172.31.40.0-255,66,48168,77,165858
34280,0.00118,172.217.194.0-255,11410,59578,77,165858
34281,0.001188,172.31.40.0-255,66,59644,77,165858
34282,0.001211,172.217.194.0-255,5657,65301,77,165858
34283,0.001215,172.31.40.0-255,66,65367,77,165858
34284,0.001595,172.217.194.0-255,2902,68269,77,165858
34285,0.001598,172.31.40.0-255,66,68335,77,165858
34286,0.001619,172.217.194.0-255,11410,79745,77,165858
34287,0.001622,172.31.40.0-255,66,79811,77,165858
34288,0.001661,172.31.40.0-255,66,79877,77,165858
34289,0.001683,172.217.194.0-255,5385,85262,77,165858
34290,0.002447,172.217.194.0-255,4320,89582,77,165858
34291,0.003163,172.217.194.0-255,12828,102410,77,165858
34292,0.003898,172.217.194.0-255,4320,106730,77,165858
34293,0.003927,172.217.194.0-255,12828,119558,77,165858
34294,0.003947,172.217.194.0-255,8574,128132,77,165858
34295,0.003974,172.217.194.0-255,8574,136706,77,165858
34296,0.00488,172.31.40.0-255,66,136772,77,165858
34297,0.007243,172.217.194.0-255,1484,138256,77,165858
34298,0.007265,172.217.194.0-255,4320,142576,77,165858
34299,0.00727,172.31.40.0-255,66,142642,77,165858
34300,0.009644,172.217.194.0-255,5738,148380,77,165858
34301,0.009653,172.31.40.0-255,66,148446,77,165858
34302,0.012036,172.217.194.0-255,5738,154184,77,165858
34303,0.012045,172.31.40.0-255,66,154250,77,165858
34304,0.01444,172.217.194.0-255,5738,159988,77,165858
34305,0.015909,172.31.40.0-255,66,160054,77,165858
34306,0.018283,172.217.194.0-255,5738,165792,77,165858
34307,0.018291,172.31.40.0-255,66,165858,77,165858
34308,0.0,74.125.68.0-255,147,147,77,273658
34309,1.4e-05,172.31.40.0-255,66,213,77,273658
34310,3.8e-05,74.125.68.0-255,1484,1697,77,273658
34311,4.3e-05,172.31.40.0-255,66,1763,77,273658
34312,6.2e-05,74.125.68.0-255,2902,4665,77,273658
34313,7.5e-05,172.31.40.0-255,66,4731,77,273658
34314,8e-05,74.125.68.0-255,4320,9051,77,273658
34315,8.5e-05,172.31.40.0-255,66,9117,77,273658
34316,0.000121,74.125.68.0-255,2902,12019,77,273658
34317,0.000124,172.31.40.0-255,66,12085,77,273658
34318,0.00014,74.125.68.0-255,2011,14096,77,273658
34319,0.000143,172.31.40.0-255,66,14162,77,273658
34320,0.000196,74.125.68.0-255,1484,15646,77,273658
34321,0.000199,172.31.40.0-255,66,15712,77,273658
34322,0.000216,74.125.68.0-255,1484,17196,77,273658
34323,0.000218,172.31.40.0-255,66,17262,77,273658
34324,0.000223,74.125.68.0-255,2902,20164,77,273658
34325,0.000226,172.31.40.0-255,66,20230,77,273658
34326,0.000255,74.125.68.0-255,5738,25968,77,273658
34327,0.000258,172.31.40.0-255,66,26034,77,273658
34328,0.000264,74.125.68.0-255,5379,31413,77,273658
34329,0.000266,172.31.40.0-255,66,31479,77,273658
34330,0.000311,74.125.68.0-255,5738,37217,77,273658
34331,0.000315,172.31.40.0-255,66,37283,77,273658
34332,0.000321,74.125.68.0-255,5738,43021,77,273658
34333,0.000323,172.31.40.0-255,66,43087,77,273658
34334,0.000362,74.125.68.0-255,2902,45989,77,273658
34335,0.000365,172.31.40.0-255,66,46055,77,273658
34336,0.000378,74.125.68.0-255,2543,48598,77,273658
34337,0.000381,172.31.40.0-255,66,48664,77,273658
34338,0.000656,74.125.68.0-255,1484,50148,77,273658
34339,0.000661,172.31.40.0-255,66,50214,77,273658
34340,0.000666,74.125.68.0-255,2902,53116,77,273658
34341,0.000669,172.31.40.0-255,66,53182,77,273658
34342,0.000673,74.125.68.0-255,2902,56084,77,273658
34343,0.000675,172.31.40.0-255,66,56150,77,273658
34344,0.000696,74.125.68.0-255,1484,57634,77,273658
34345,0.000734,74.125.68.0-255,4320,61954,77,273658
34346,0.000738,172.31.40.0-255,66,62020,77,273658
34347,0.000759,74.125.68.0-255,3961,65981,77,273658
34348,0.000762,172.31.40.0-255,66,66047,77,273658
34349,0.000765,74.125.68.0-255,1484,67531,77,273658
34350,0.000782,74.125.68.0-255,2902,70433,77,273658
34351,0.000785,172.31.40.0-255,66,70499,77,273658
34352,0.000788,74.125.68.0-255,1484,71983,77,273658
34353,0.000807,74.125.68.0-255,4320,76303,77,273658
34354,0.000809,172.31.40.0-255,66,76369,77,273658
34355,0.000825,74.125.68.0-255,2902,79271,77,273658
34356,0.000827,172.31.40.0-255,66,79337,77,273658
34357,0.000848,74.125.68.0-255,2902,82239,77,273658
34358,0.000851,172.31.40.0-255,66,82305,77,273658
34359,0.000896,74.125.68.0-255,1706,84011,77,273658
34360,0.000899,172.31.40.0-255,66,84077,77,273658
34361,0.000904,74.125.68.0-255,2902,86979,77,273658
34362,0.000906,172.31.40.0-255,66,87045,77,273658
34363,0.000929,74.125.68.0-255,2902,89947,77,273658
34364,0.000932,172.31.40.0-255,66,90013,77,273658
34365,0.000935,74.125.68.0-255,1484,91497,77,273658
34366,0.000952,74.125.68.0-255,2902,94399,77,273658
34367,0.000955,172.31.40.0-255,66,94465,77,273658
34368,0.000972,74.125.68.0-255,6797,101262,77,273658
34369,0.000975,172.31.40.0-255,66,101328,77,273658
34370,0.00107,74.125.68.0-255,1484,102812,77,273658
34371,0.001083,74.125.68.0-255,1484,104296,77,273658
34372,0.001086,172.31.40.0-255,66,104362,77,273658
34373,0.001108,74.125.68.0-255,1484,105846,77,273658
34374,0.001114,74.125.68.0-255,5738,111584,77,273658
34375,0.001117,172.31.40.0-255,66,111650,77,273658
34376,0.001132,74.125.68.0-255,2902,114552,77,273658
34377,0.001134,172.31.40.0-255,66,114618,77,273658
34378,0.001149,74.125.68.0-255,1484,116102,77,273658
34379,0.001155,74.125.68.0-255,5738,121840,77,273658
34380,0.001158,172.31.40.0-255,66,121906,77,273658
34381,0.001181,74.125.68.0-255,1484,123390,77,273658
34382,0.001193,74.125.68.0-255,4320,127710,77,273658
34383,0.001196,172.31.40.0-255,66,127776,77,273658
34384,0.001219,74.125.68.0-255,5738,133514,77,273658
34385,0.001221,172.31.40.0-255,66,133580,77,273658
34386,0.001251,74.125.68.0-255,2184,135764,77,273658
34387,0.001253,172.31.40.0-255,66,135830,77,273658
34388,0.001678,74.125.68.0-255,1484,137314,77,273658
34389,0.001707,74.125.68.0-255,2902,140216,77,273658
34390,0.001712,172.31.40.0-255,66,140282,77,273658
34391,0.001729,74.125.68.0-255,5738,146020,77,273658
34392,0.001732,172.31.40.0-255,66,146086,77,273658
34393,0.001736,74.125.68.0-255,2902,148988,77,273658
34394,0.001738,172.31.40.0-255,66,149054,77,273658
34395,0.001743,74.125.68.0-255,2902,151956,77,273658
34396,0.001745,172.31.40.0-255,66,152022,77,273658
34397,0.00177,74.125.68.0-255,1484,153506,77,273658
34398,0.001778,74.125.68.0-255,8574,162080,77,273658
34399,0.001781,172.31.40.0-255,66,162146,77,273658
34400,0.001807,74.125.68.0-255,7156,169302,77,273658
34401,0.001809,172.31.40.0-255,66,169368,77,273658
34402,0.001825,74.125.68.0-255,766,170134,77,273658
34403,0.001952,74.125.68.0-255,1484,171618,77,273658
34404,0.001955,172.31.40.0-255,66,171684,77,273658
34405,0.001992,74.125.68.0-255,2902,174586,77,273658
34406,0.001994,172.31.40.0-255,66,174652,77,273658
34407,0.002,74.125.68.0-255,4320,178972,77,273658
34408,0.002002,172.31.40.0-255,66,179038,77,273658
34409,0.002022,74.125.68.0-255,5738,184776,77,273658
34410,0.002025,172.31.40.0-255,66,184842,77,273658
34411,0.002051,74.125.68.0-255,2902,187744,77,273658
34412,0.002054,172.31.40.0-255,66,187810,77,273658
34413,0.00206,74.125.68.0-255,5738,193548,77,273658
34414,0.002062,172.31.40.0-255,66,193614,77,273658
34415,0.002068,74.125.68.0-255,5738,199352,77,273658
34416,0.00207,172.31.40.0-255,66,199418,77,273658
34417,0.002096,74.125.68.0-255,1484,200902,77,273658
34418,0.002101,74.125.68.0-255,2902,203804,77,273658
34419,0.002103,172.31.40.0-255,66,203870,77,273658
34420,0.002119,74.125.68.0-255,766,204636,77,273658
34421,0.002227,74.125.68.0-255,1484,206120,77,273658
34422,0.002231,172.31.40.0-255,66,206186,77,273658
34423,0.002236,74.125.68.0-255,2902,209088,77,273658
34424,0.002238,172.31.40.0-255,66,209154,77,273658
34425,0.002242,74.125.68.0-255,1484,210638,77,273658
34426,0.002266,74.125.68.0-255,2902,213540,77,273658
34427,0.002268,172.31.40.0-255,66,213606,77,273658
34428,0.002301,74.125.68.0-255,8574,222180,77,273658
34429,0.002303,172.31.40.0-255,66,222246,77,273658
34430,0.002307,74.125.68.0-255,1484,223730,77,273658
34431,0.002312,74.125.68.0-255,2902,226632,77,273658
34432,0.002313,172.31.40.0-255,66,226698,77,273658
34433,0.002327,74.125.68.0-255,2902,229600,77,273658
34434,0.002329,172.31.40.0-255,66,229666,77,273658
34435,0.002342,74.125.68.0-255,2902,232568,77,273658
34436,0.002344,172.31.40.0-255,66,232634,77,273658
34437,0.004626,74.125.68.0-255,2902,235536,77,273658
34438,0.004633,172.31.40.0-255,66,235602,77,273658
34439,0.004654,74.125.68.0-255,2902,238504,77,273658
34440,0.004657,172.31.40.0-255,66,238570,77,273658
34441,0.00693,74.125.68.0-255,2902,241472,77,273658
34442,0.006934,172.31.40.0-255,66,241538,77,273658
34443,0.00697,74.125.68.0-255,2902,244440,77,273658
34444,0.006972,172.31.40.0-255,66,244506,77,273658
34445,0.00925,74.125.68.0-255,2902,247408,77,273658
34446,0.009257,172.31.40.0-255,66,247474,77,273658
34447,0.009282,74.125.68.0-255,2902,250376,77,273658
34448,0.009285,172.31.40.0-255,66,250442,77,273658
34449,0.011591,74.125.68.0-255,5738,256180,77,273658
34450,0.011627,172.31.40.0-255,66,256246,77,273658
34451,0.013977,74.125.68.0-255,5738,261984,77,273658
34452,0.013992,172.31.40.0-255,66,262050,77,273658
34453,0.016349,74.125.68.0-255,5738,267788,77,273658
34454,0.016365,172.31.40.0-255,66,267854,77,273658
34455,0.018678,74.125.68.0-255,5738,273592,77,273658
34456,0.018688,172.31.40.0-255,66,273658,77,273658
34457,0.0,104.244.42.0-255,66,66,77,66
34458,0.0,74.125.24.0-255,291,291,77,209209
34459,2.2e-05,172.31.40.0-255,66,357,77,209209
34460,2.9e-05,74.125.24.0-255,1484,1841,77,209209
34461,3.3e-05,172.31.40.0-255,66,1907,77,209209
34462,4.1e-05,74.125.24.0-255,4320,6227,77,209209
34463,4.4e-05,172.31.40.0-255,66,6293,77,209209
34464,5e-05,74.125.24.0-255,5738,12031,77,209209
34465,5.3e-05,172.31.40.0-255,66,12097,77,209209
34466,7e-05,74.125.24.0-255,1801,13898,77,209209
34467,7.3e-05,172.31.40.0-255,66,13964,77,209209
34468,0.000111,74.125.24.0-255,2902,16866,77,209209
34469,0.000114,172.31.40.0-255,66,16932,77,209209
34470,0.000138,74.125.24.0-255,7156,24088,77,209209
34471,0.000141,172.31.40.0-255,66,24154,77,209209
34472,0.000182,74.125.24.0-255,1484,25638,77,209209
34473,0.000185,172.31.40.0-255,66,25704,77,209209
34474,0.000207,74.125.24.0-255,5379,31083,77,209209
34475,0.00021,172.31.40.0-255,66,31149,77,209209
34476,0.000476,74.125.24.0-255,1484,32633,77,209209
34477,0.000481,172.31.40.0-255,66,32699,77,209209
34478,0.000487,74.125.24.0-255,2902,35601,77,209209
34479,0.000489,172.31.40.0-255,66,35667,77,209209
34480,0.000495,74.125.24.0-255,5738,41405,77,209209
34481,0.000498,172.31.40.0-255,66,41471,77,209209
34482,0.000524,74.125.24.0-255,9633,51104,77,209209
34483,0.000527,172.31.40.0-255,66,51170,77,209209
34484,0.000531,74.125.24.0-255,1484,52654,77,209209
34485,0.000533,172.31.40.0-255,66,52720,77,209209
34486,0.00056,74.125.24.0-255,8574,61294,77,209209
34487,0.000563,172.31.40.0-255,66,61360,77,209209
34488,0.000569,74.125.24.0-255,4295,65655,77,209209
34489,0.000571,172.31.40.0-255,66,65721,77,209209
34490,0.001019,74.125.24.0-255,344,66065,77,209209
34491,0.001069,172.31.40.0-255,66,66131,77,209209
34492,0.001126,74.125.24.0-255,1484,67615,77,209209
34493,0.001152,74.125.24.0-255,2902,70517,77,209209
34494,0.001155,172.31.40.0-255,66,70583,77,209209
34495,0.001163,74.125.24.0-255,5738,76321,77,209209
34496,0.001165,172.31.40.0-255,66,76387,77,209209
34497,0.001202,74.125.24.0-255,4320,80707,77,209209
34498,0.001204,172.31.40.0-255,66,80773,77,209209
34499,0.001227,74.125.24.0-255,2543,83316,77,209209
34500,0.001229,172.31.40.0-255,66,83382,77,209209
34501,0.001236,74.125.24.0-255,7156,90538,77,209209
34502,0.001238,172.31.40.0-255,66,90604,77,209209
34503,0.001251,74.125.24.0-255,1484,92088,77,209209
34504,0.001296,74.125.24.0-255,8215,100303,77,209209
34505,0.0013,172.31.40.0-255,66,100369,77,209209
34506,0.002144,74.125.24.0-255,1484,101853,77,209209
34507,0.002153,74.125.24.0-255,2902,104755,77,209209
34508,0.002158,172.31.40.0-255,66,104821,77,209209
34509,0.002181,74.125.24.0-255,1484,106305,77,209209
34510,0.002206,74.125.24.0-255,4320,110625,77,209209
34511,0.002208,172.31.40.0-255,66,110691,77,209209
34512,0.00222,74.125.24.0-255,12828,123519,77,209209
34513,0.002222,172.31.40.0-255,66,123585,77,209209
34514,0.002231,74.125.24.0-255,8574,132159,77,209209
34515,0.002233,172.31.40.0-255,66,132225,77,209209
34516,0.002253,74.125.24.0-255,2184,134409,77,209209
34517,0.002255,172.31.40.0-255,66,134475,77,209209
34518,0.002259,74.125.24.0-255,1484,135959,77,209209
34519,0.002263,74.125.24.0-255,2902,138861,77,209209
34520,0.002265,172.31.40.0-255,66,138927,77,209209
34521,0.002293,74.125.24.0-255,5738,144665,77,209209
34522,0.002295,172.31.40.0-255,66,144731,77,209209
34523,0.002299,74.125.24.0-255,1484,146215,77,209209
34524,0.002336,74.125.24.0-255,11410,157625,77,209209
34525,0.002339,172.31.40.0-255,66,157691,77,209209
34526,0.002345,74.125.24.0-255,5738,163429,77,209209
34527,0.002347,172.31.40.0-255,66,163495,77,209209
34528,0.002353,74.125.24.0-255,5020,168515,77,209209
34529,0.002355,172.31.40.0-255,66,168581,77,209209
34530,0.004627,74.125.24.0-255,5738,174319,77,209209
34531,0.004637,172.31.40.0-255,66,174385,77,209209
34532,0.006932,74.125.24.0-255,5738,180123,77,209209
34533,0.006936,172.31.40.0-255,66,180189,77,209209
34534,0.009214,74.125.24.0-255,5738,185927,77,209209
34535,0.009221,172.31.40.0-255,66,185993,77,209209
34536,0.011511,74.125.24.0-255,5738,191731,77,209209
34537,0.01152,172.31.40.0-255,66,191797,77,209209
34538,0.013855,74.125.24.0-255,5738,197535,77,209209
34539,0.013864,172.31.40.0-255,66,197601,77,209209
34540,0.01615,74.125.24.0-255,5738,203339,77,209209
34541,0.016158,172.31.40.0-255,66,203405,77,209209
34542,0.01846,74.125.24.0-255,5738,209143,77,209209
34543,0.018469,172.31.40.0-255,66,209209,77,209209
34544,0.0,74.125.24.0-255,152,152,77,192275
34545,2.2e-05,172.31.40.0-255,66,218,77,192275
34546,2.8e-05,74.125.24.0-255,1484,1702,77,192275
34547,3.3e-05,172.31.40.0-255,66,1768,77,192275
34548,3.8e-05,74.125.24.0-255,2902,4670,77,192275
34549,4.7e-05,172.31.40.0-255,66,4736,77,192275
34550,5.5e-05,74.125.24.0-255,7156,11892,77,192275
34551,5.8e-05,172.31.40.0-255,66,11958,77,192275
34552,6.5e-05,74.125.24.0-255,7709,19667,77,192275
34553,6.8e-05,172.31.40.0-255,66,19733,77,192275
34554,0.000113,74.125.24.0-255,4320,24053,77,192275
34555,0.000116,172.31.40.0-255,66,24119,77,192275
34556,0.000133,74.125.24.0-255,1484,25603,77,192275
34557,0.000135,172.31.40.0-255,66,25669,77,192275
34558,0.000165,74.125.24.0-255,5379,31048,77,192275
34559,0.000167,172.31.40.0-255,66,31114,77,192275
34560,0.000213,74.125.24.0-255,1484,32598,77,192275
34561,0.000216,172.31.40.0-255,66,32664,77,192275
34562,0.000259,74.125.24.0-255,2902,35566,77,192275
34563,0.000262,172.31.40.0-255,66,35632,77,192275
34564,0.000268,74.125.24.0-255,5738,41370,77,192275
34565,0.00027,172.31.40.0-255,66,41436,77,192275
34566,0.000276,74.125.24.0-255,6797,48233,77,192275
34567,0.000278,172.31.40.0-255,66,48299,77,192275
34568,0.000285,74.125.24.0-255,7156,55455,77,192275
34569,0.000287,172.31.40.0-255,66,55521,77,192275
34570,0.000327,74.125.24.0-255,7156,62677,77,192275
34571,0.00033,172.31.40.0-255,66,62743,77,192275
34572,0.000334,74.125.24.0-255,2817,65560,77,192275
34573,0.000336,172.31.40.0-255,66,65626,77,192275
34574,0.000361,74.125.24.0-255,131,65757,77,192275
34575,0.000367,172.31.40.0-255,66,65823,77,192275
34576,0.00046,74.125.24.0-255,1484,67307,77,192275
34577,0.000465,74.125.24.0-255,1484,68791,77,192275
34578,0.000467,172.31.40.0-255,66,68857,77,192275
34579,0.000489,74.125.24.0-255,1484,70341,77,192275
34580,0.000499,74.125.24.0-255,5738,76079,77,192275
34581,0.000501,172.31.40.0-255,66,76145,77,192275
34582,0.000507,74.125.24.0-255,6498,82643,77,192275
34583,0.000509,172.31.40.0-255,66,82709,77,192275
34584,0.000542,74.125.24.0-255,1484,84193,77,192275
34585,0.000561,74.125.24.0-255,5738,89931,77,192275
34586,0.000564,172.31.40.0-255,66,89997,77,192275
34587,0.000581,74.125.24.0-255,7156,97153,77,192275
34588,0.000586,172.31.40.0-255,66,97219,77,192275
34589,0.00059,74.125.24.0-255,2543,99762,77,192275
34590,0.000592,172.31.40.0-255,66,99828,77,192275
34591,0.000892,74.125.24.0-255,1484,101312,77,192275
34592,0.000897,74.125.24.0-255,1484,102796,77,192275
34593,0.0009,172.31.40.0-255,66,102862,77,192275
34594,0.000927,74.125.24.0-255,1484,104346,77,192275
34595,0.000933,74.125.24.0-255,5738,110084,77,192275
34596,0.000941,74.125.24.0-255,8574,118658,77,192275
34597,0.000944,172.31.40.0-255,66,118724,77,192275
34598,0.000947,172.31.40.0-255,66,118790,77,192275
34599,0.000978,74.125.24.0-255,4320,123110,77,192275
34600,0.000981,172.31.40.0-255,66,123176,77,192275
34601,0.000989,74.125.24.0-255,9992,133168,77,192275
34602,0.000991,172.31.40.0-255,66,133234,77,192275
34603,0.000994,74.125.24.0-255,766,134000,77,192275
34604,0.001577,172.31.40.0-255,66,134066,77,192275
34605,0.002244,74.125.24.0-255,1484,135550,77,192275
34606,0.002253,74.125.24.0-255,2902,138452,77,192275
34607,0.002258,172.31.40.0-255,66,138518,77,192275
34608,0.002263,74.125.24.0-255,1484,140002,77,192275
34609,0.002291,74.125.24.0-255,4320,144322,77,192275
34610,0.002293,172.31.40.0-255,66,144388,77,192275
34611,0.002301,74.125.24.0-255,6797,151185,77,192275
34612,0.002303,172.31.40.0-255,66,151251,77,192275
34613,0.00455,74.125.24.0-255,5738,156989,77,192275
34614,0.004555,172.31.40.0-255,66,157055,77,192275
34615,0.00682,74.125.24.0-255,2902,159957,77,192275
34616,0.006825,172.31.40.0-255,66,160023,77,192275
34617,0.00686,74.125.24.0-255,2902,162925,77,192275
34618,0.006862,172.31.40.0-255,66,162991,77,192275
34619,0.009137,74.125.24.0-255,2902,165893,77,192275
34620,0.009146,172.31.40.0-255,66,165959,77,192275
34621,0.009185,74.125.24.0-255,2902,168861,77,192275
34622,0.009189,172.31.40.0-255,66,168927,77,192275
34623,0.011432,74.125.24.0-255,2902,171829,77,192275
34624,0.01144,172.31.40.0-255,66,171895,77,192275
34625,0.011468,74.125.24.0-255,2902,174797,77,192275
34626,0.01147,172.31.40.0-255,66,174863,77,192275
34627,0.013719,74.125.24.0-255,5738,180601,77,192275
34628,0.013728,172.31.40.0-255,66,180667,77,192275
34629,0.016007,74.125.24.0-255,5738,186405,77,192275
34630,0.016016,172.31.40.0-255,66,186471,77,192275
34631,0.018297,74.125.24.0-255,5738,192209,77,192275
34632,0.018304,172.31.40.0-255,66,192275,77,192275
34633,0.0,74.125.130.0-255,298,298,77,244882
34634,2.2e-05,172.31.40.0-255,66,364,77,244882
34635,2.8e-05,74.125.130.0-255,1484,1848,77,244882
34636,3.2e-05,172.31.40.0-255,66,1914,77,244882
34637,3.8e-05,74.125.130.0-255,4320,6234,77,244882
34638,4.6e-05,172.31.40.0-255,66,6300,77,244882
34639,5.1e-05,74.125.130.0-255,4320,10620,77,244882
34640,5.3e-05,172.31.40.0-255,66,10686,77,244882
34641,8.1e-05,74.125.130.0-255,3284,13970,77,244882
34642,8.3e-05,172.31.40.0-255,66,14036,77,244882
34643,0.000141,74.125.130.0-255,1484,15520,77,244882
34644,0.000146,172.31.40.0-255,66,15586,77,244882
34645,0.000156,74.125.130.0-255,2902,18488,77,244882
34646,0.000162,172.31.40.0-255,66,18554,77,244882
34647,0.000191,74.125.130.0-255,5738,24292,77,244882
34648,0.000193,172.31.40.0-255,66,24358,77,244882
34649,0.000199,74.125.130.0-255,4320,28678,77,244882
34650,0.0002,172.31.40.0-255,66,28744,77,244882
34651,0.000224,74.125.130.0-255,2543,31287,77,244882
34652,0.000227,172.31.40.0-255,66,31353,77,244882
34653,0.000388,74.125.130.0-255,1484,32837,77,244882
34654,0.000393,172.31.40.0-255,66,32903,77,244882
34655,0.000398,74.125.130.0-255,2902,35805,77,244882
34656,0.000401,172.31.40.0-255,66,35871,77,244882
34657,0.000411,74.125.130.0-255,4320,40191,77,244882
34658,0.000413,172.31.40.0-255,66,40257,77,244882
34659,0.00046,74.125.130.0-255,9633,49890,77,244882
34660,0.000463,172.31.40.0-255,66,49956,77,244882
34661,0.000468,74.125.130.0-255,4320,54276,77,244882
34662,0.00047,172.31.40.0-255,66,54342,77,244882
34663,0.00052,74.125.130.0-255,2902,57244,77,244882
34664,0.000523,172.31.40.0-255,66,57310,77,244882
34665,0.000547,74.125.130.0-255,8472,65782,77,244882
34666,0.000549,172.31.40.0-255,66,65848,77,244882
34667,0.000573,74.125.130.0-255,398,66246,77,244882
34668,0.000728,74.125.130.0-255,1484,67730,77,244882
34669,0.000735,172.31.40.0-255,66,67796,77,244882
34670,0.000744,74.125.130.0-255,2902,70698,77,244882
34671,0.000751,172.31.40.0-255,66,70764,77,244882
34672,0.000758,74.125.130.0-255,5738,76502,77,244882
34673,0.000761,172.31.40.0-255,66,76568,77,244882
34674,0.000763,74.125.130.0-255,1484,78052,77,244882
34675,0.000795,74.125.130.0-255,2902,80954,77,244882
34676,0.000798,172.31.40.0-255,66,81020,77,244882
34677,0.000806,74.125.130.0-255,6797,87817,77,244882
34678,0.000808,172.31.40.0-255,66,87883,77,244882
34679,0.000841,74.125.130.0-255,1484,89367,77,244882
34680,0.000869,74.125.130.0-255,5738,95105,77,244882
34681,0.000872,172.31.40.0-255,66,95171,77,244882
34682,0.000878,74.125.130.0-255,5379,100550,77,244882
34683,0.00088,172.31.40.0-255,66,100616,77,244882
34684,0.001344,74.125.130.0-255,1484,102100,77,244882
34685,0.00135,74.125.130.0-255,2902,105002,77,244882
34686,0.001353,172.31.40.0-255,66,105068,77,244882
34687,0.001383,74.125.130.0-255,2902,107970,77,244882
34688,0.001385,172.31.40.0-255,66,108036,77,244882
34689,0.001391,74.125.130.0-255,4320,112356,77,244882
34690,0.001393,172.31.40.0-255,66,112422,77,244882
34691,0.001417,74.125.130.0-255,8574,120996,77,244882
34692,0.001424,172.31.40.0-255,66,121062,77,244882
34693,0.001428,74.125.130.0-255,2902,123964,77,244882
34694,0.00143,172.31.40.0-255,66,124030,77,244882
34695,0.001435,74.125.130.0-255,4320,128350,77,244882
34696,0.001437,172.31.40.0-255,66,128416,77,244882
34697,0.001482,74.125.130.0-255,6438,134854,77,244882
34698,0.001485,172.31.40.0-255,66,134920,77,244882
34699,0.001575,74.125.130.0-255,1484,136404,77,244882
34700,0.001589,74.125.130.0-255,2902,139306,77,244882
34701,0.001592,172.31.40.0-255,66,139372,77,244882
34702,0.001608,74.125.130.0-255,2902,142274,77,244882
34703,0.001611,172.31.40.0-255,66,142340,77,244882
34704,0.001635,74.125.130.0-255,2902,145242,77,244882
34705,0.001637,172.31.40.0-255,66,145308,77,244882
34706,0.001644,74.125.130.0-255,5738,151046,77,244882
34707,0.001646,172.31.40.0-255,66,151112,77,244882
34708,0.001657,74.125.130.0-255,7156,158268,77,244882
34709,0.00166,172.31.40.0-255,66,158334,77,244882
34710,0.001687,74.125.130.0-255,7156,165490,77,244882
34711,0.001689,172.31.40.0-255,66,165556,77,244882
34712,0.001729,74.125.130.0-255,3602,169158,77,244882
34713,0.001731,172.31.40.0-255,66,169224,77,244882
34714,0.001838,74.125.130.0-255,1484,170708,77,244882
34715,0.001842,74.125.130.0-255,1484,172192,77,244882
34716,0.001845,172.31.40.0-255,66,172258,77,244882
34717,0.00187,74.125.130.0-255,1484,173742,77,244882
34718,0.001878,74.125.130.0-255,5738,179480,77,244882
34719,0.00188,172.31.40.0-255,66,179546,77,244882
34720,0.001885,74.125.130.0-255,2902,182448,77,244882
34721,0.001887,172.31.40.0-255,66,182514,77,244882
34722,0.001897,74.125.130.0-255,4320,186834,77,244882
34723,0.0019,172.31.40.0-255,66,186900,77,244882
34724,0.001903,74.125.130.0-255,1484,188384,77,244882
34725,0.001944,74.125.130.0-255,7156,195540,77,244882
34726,0.001948,172.31.40.0-255,66,195606,77,244882
34727,0.001954,74.125.130.0-255,5738,201344,77,244882
34728,0.001956,172.31.40.0-255,66,201410,77,244882
34729,0.001981,74.125.130.0-255,2184,203594,77,244882
34730,0.001983,172.31.40.0-255,66,203660,77,244882
34731,0.004216,74.125.130.0-255,2902,206562,77,244882
34732,0.004223,172.31.40.0-255,66,206628,77,244882
34733,0.004253,74.125.130.0-255,2902,209530,77,244882
34734,0.004256,172.31.40.0-255,66,209596,77,244882
34735,0.006472,74.125.130.0-255,2902,212498,77,244882
34736,0.006477,172.31.40.0-255,66,212564,77,244882
34737,0.00651,74.125.130.0-255,2902,215466,77,244882
34738,0.006513,172.31.40.0-255,66,215532,77,244882
34739,0.008744,74.125.130.0-255,2902,218434,77,244882
34740,0.00875,172.31.40.0-255,66,218500,77,244882
34741,0.008776,74.125.130.0-255,2902,221402,77,244882
34742,0.008779,172.31.40.0-255,66,221468,77,244882
34743,0.011016,74.125.130.0-255,2902,224370,77,244882
34744,0.011031,172.31.40.0-255,66,224436,77,244882
34745,0.011059,74.125.130.0-255,2902,227338,77,244882
34746,0.011062,172.31.40.0-255,66,227404,77,244882
34747,0.013304,74.125.130.0-255,5738,233142,77,244882
34748,0.013316,172.31.40.0-255,66,233208,77,244882
34749,0.01558,74.125.130.0-255,5738,238946,77,244882
34750,0.015594,172.31.40.0-255,66,239012,77,244882
34751,0.017851,74.125.130.0-255,4320,243332,77,244882
34752,0.017858,172.31.40.0-255,66,243398,77,244882
34753,0.017889,74.125.130.0-255,1484,244882,77,244882
34754,0.0,172.217.194.0-255,153,153,77,152702
34755,2.2e-05,172.31.40.0-255,66,219,77,152702
34756,2.9e-05,172.217.194.0-255,1484,1703,77,152702
34757,3.4e-05,172.31.40.0-255,66,1769,77,152702
34758,4.1e-05,172.217.194.0-255,2902,4671,77,152702
34759,4.4e-05,172.31.40.0-255,66,4737,77,152702
34760,5.2e-05,172.217.194.0-255,7156,11893,77,152702
34761,5.5e-05,172.31.40.0-255,66,11959,77,152702
34762,8.1e-05,172.217.194.0-255,2068,14027,77,152702
34763,8.3e-05,172.31.40.0-255,66,14093,77,152702
34764,0.000192,172.217.194.0-255,1484,15577,77,152702
34765,0.000195,172.31.40.0-255,66,15643,77,152702
34766,0.000219,172.217.194.0-255,2902,18545,77,152702
34767,0.000222,172.31.40.0-255,66,18611,77,152702
34768,0.000228,172.217.194.0-255,5738,24349,77,152702
34769,0.00023,172.31.40.0-255,66,24415,77,152702
34770,0.000275,172.217.194.0-255,2902,27317,77,152702
34771,0.000277,172.31.40.0-255,66,27383,77,152702
34772,0.000303,172.217.194.0-255,6797,34180,77,152702
34773,0.000306,172.31.40.0-255,66,34246,77,152702
34774,0.000317,172.217.194.0-255,9992,44238,77,152702
34775,0.000319,172.31.40.0-255,66,44304,77,152702
34776,0.000325,172.217.194.0-255,3961,48265,77,152702
34777,0.000327,172.31.40.0-255,66,48331,77,152702
34778,0.000577,172.217.194.0-255,1484,49815,77,152702
34779,0.000583,172.31.40.0-255,66,49881,77,152702
34780,0.000589,172.217.194.0-255,2902,52783,77,152702
34781,0.000592,172.31.40.0-255,66,52849,77,152702
34782,0.000595,172.217.194.0-255,1484,54333,77,152702
34783,0.000599,172.31.40.0-255,66,54399,77,152702
34784,0.000625,172.217.194.0-255,4320,58719,77,152702
34785,0.000629,172.31.40.0-255,66,58785,77,152702
34786,0.000638,172.217.194.0-255,7377,66162,77,152702
34787,0.00064,172.31.40.0-255,66,66228,77,152702
34788,0.000775,172.217.194.0-255,1484,67712,77,152702
34789,0.000782,172.217.194.0-255,2902,70614,77,152702
34790,0.000785,172.31.40.0-255,66,70680,77,152702
34791,0.000792,172.217.194.0-255,5738,76418,77,152702
34792,0.000794,172.31.40.0-255,66,76484,77,152702
34793,0.000832,172.217.194.0-255,11410,87894,77,152702
34794,0.000836,172.31.40.0-255,66,87960,77,152702
34795,0.000858,172.217.194.0-255,2543,90503,77,152702
34796,0.000861,172.31.40.0-255,66,90569,77,152702
34797,0.000867,172.217.194.0-255,5738,96307,77,152702
34798,0.000869,172.31.40.0-255,66,96373,77,152702
34799,0.000872,172.217.194.0-255,1484,97857,77,152702
34800,0.000891,172.217.194.0-255,2543,100400,77,152702
34801,0.000893,172.31.40.0-255,66,100466,77,152702
34802,0.002865,172.217.194.0-255,5738,106204,77,152702
34803,0.002872,172.31.40.0-255,66,106270,77,152702
34804,0.004858,172.217.194.0-255,5738,112008,77,152702
34805,0.004863,172.31.40.0-255,66,112074,77,152702
34806,0.006891,172.217.194.0-255,5738,117812,77,152702
34807,0.006897,172.31.40.0-255,66,117878,77,152702
34808,0.008889,172.217.194.0-255,5738,123616,77,152702
34809,0.008896,172.31.40.0-255,66,123682,77,152702
34810,0.01092,172.217.194.0-255,5738,129420,77,152702
34811,0.01093,172.31.40.0-255,66,129486,77,152702
34812,0.012926,172.217.194.0-255,5738,135224,77,152702
34813,0.012935,172.31.40.0-255,66,135290,77,152702
34814,0.014989,172.217.194.0-255,5738,141028,77,152702
34815,0.014996,172.31.40.0-255,66,141094,77,152702
34816,0.01698,172.217.194.0-255,5738,146832,77,152702
34817,0.016986,172.31.40.0-255,66,146898,77,152702
34818,0.019005,172.217.194.0-255,5738,152636,77,152702
34819,0.019016,172.31.40.0-255,66,152702,77,152702
34820,0.0,172.217.194.0-255,153,153,77,395031
34821,1.6e-05,172.31.40.0-255,66,219,77,395031
34822,2.3e-05,172.217.194.0-255,1484,1703,77,395031
34823,2.8e-05,172.31.40.0-255,66,1769,77,395031
34824,3.4e-05,172.217.194.0-255,2902,4671,77,395031
34825,3.7e-05,172.31.40.0-255,66,4737,77,395031
34826,4.1e-05,172.217.194.0-255,2902,7639,77,395031
34827,4.4e-05,172.31.40.0-255,66,7705,77,395031
34828,5.3e-05,172.217.194.0-255,7772,15477,77,395031
34829,5.7e-05,172.31.40.0-255,66,15543,77,395031
34830,9.4e-05,172.217.194.0-255,7156,22699,77,395031
34831,9.7e-05,172.31.40.0-255,66,22765,77,395031
34832,0.000123,172.217.194.0-255,8215,30980,77,395031
34833,0.000125,172.31.40.0-255,66,31046,77,395031
34834,0.000131,172.217.194.0-255,5738,36784,77,395031
34835,0.000133,172.31.40.0-255,66,36850,77,395031
34836,0.000157,172.217.194.0-255,5738,42588,77,395031
34837,0.000159,172.31.40.0-255,66,42654,77,395031
34838,0.000183,172.217.194.0-255,5379,48033,77,395031
34839,0.000185,172.31.40.0-255,66,48099,77,395031
34840,0.00061,172.217.194.0-255,1484,49583,77,395031
34841,0.000616,172.31.40.0-255,66,49649,77,395031
34842,0.000621,172.217.194.0-255,2902,52551,77,395031
34843,0.000623,172.31.40.0-255,66,52617,77,395031
34844,0.000653,172.217.194.0-255,5738,58355,77,395031
34845,0.000656,172.31.40.0-255,66,58421,77,395031
34846,0.000662,172.217.194.0-255,5738,64159,77,395031
34847,0.000664,172.31.40.0-255,66,64225,77,395031
34848,0.000681,172.217.194.0-255,8215,72440,77,395031
34849,0.000683,172.31.40.0-255,66,72506,77,395031
34850,0.000688,172.217.194.0-255,2902,75408,77,395031
34851,0.00069,172.31.40.0-255,66,75474,77,395031
34852,0.000736,172.217.194.0-255,5738,81212,77,395031
34853,0.000739,172.31.40.0-255,66,81278,77,395031
34854,0.000769,172.217.194.0-255,12469,93747,77,395031
34855,0.000772,172.31.40.0-255,66,93813,77,395031
34856,0.000792,172.217.194.0-255,4320,98133,77,395031
34857,0.000795,172.31.40.0-255,66,98199,77,395031
34858,0.000816,172.217.194.0-255,1125,99324,77,395031
34859,0.000862,172.217.194.0-255,1484,100808,77,395031
34860,0.000865,172.31.40.0-255,66,100874,77,395031
34861,0.00087,172.217.194.0-255,2902,103776,77,395031
34862,0.000873,172.31.40.0-255,66,103842,77,395031
34863,0.000897,172.217.194.0-255,5738,109580,77,395031
34864,0.000899,172.31.40.0-255,66,109646,77,395031
34865,0.000939,172.217.194.0-255,8574,118220,77,395031
34866,0.000942,172.31.40.0-255,66,118286,77,395031
34867,0.000968,172.217.194.0-255,4320,122606,77,395031
34868,0.000971,172.31.40.0-255,66,122672,77,395031
34869,0.000981,172.217.194.0-255,10692,133364,77,395031
34870,0.000983,172.31.40.0-255,66,133430,77,395031
34871,0.001031,172.217.194.0-255,1484,134914,77,395031
34872,0.001048,172.217.194.0-255,2902,137816,77,395031
34873,0.00105,172.31.40.0-255,66,137882,77,395031
34874,0.001057,172.217.194.0-255,5738,143620,77,395031
34875,0.001059,172.31.40.0-255,66,143686,77,395031
34876,0.001075,172.217.194.0-255,2902,146588,77,395031
34877,0.001078,172.31.40.0-255,66,146654,77,395031
34878,0.001114,172.217.194.0-255,9992,156646,77,395031
34879,0.001116,172.31.40.0-255,66,156712,77,395031
34880,0.001135,172.217.194.0-255,9992,166704,77,395031
34881,0.001138,172.31.40.0-255,66,166770,77,395031
34882,0.001141,172.217.194.0-255,766,167536,77,395031
34883,0.00136,172.217.194.0-255,1484,169020,77,395031
34884,0.001365,172.31.40.0-255,66,169086,77,395031
34885,0.001387,172.217.194.0-255,2902,171988,77,395031
34886,0.001389,172.31.40.0-255,66,172054,77,395031
34887,0.001433,172.217.194.0-255,5738,177792,77,395031
34888,0.001436,172.31.40.0-255,66,177858,77,395031
34889,0.001444,172.217.194.0-255,7156,185014,77,395031
34890,0.001445,172.31.40.0-255,66,185080,77,395031
34891,0.001466,172.217.194.0-255,2902,187982,77,395031
34892,0.001468,172.31.40.0-255,66,188048,77,395031
34893,0.001476,172.217.194.0-255,8574,196622,77,395031
34894,0.001479,172.31.40.0-255,66,196688,77,395031
34895,0.001502,172.217.194.0-255,1484,198172,77,395031
34896,0.00152,172.217.194.0-255,3602,201774,77,395031
34897,0.001523,172.31.40.0-255,66,201840,77,395031
34898,0.00154,172.217.194.0-255,4320,206160,77,395031
34899,0.001542,172.31.40.0-255,66,206226,77,395031
34900,0.00156,172.217.194.0-255,1484,207710,77,395031
34901,0.001572,172.217.194.0-255,1484,209194,77,395031
34902,0.001574,172.31.40.0-255,66,209260,77,395031
34903,0.001602,172.217.194.0-255,11410,220670,77,395031
34904,0.001605,172.31.40.0-255,66,220736,77,395031
34905,0.001609,172.217.194.0-255,2902,223638,77,395031
34906,0.001611,172.31.40.0-255,66,223704,77,395031
34907,0.001617,172.217.194.0-255,4320,228024,77,395031
34908,0.00162,172.31.40.0-255,66,228090,77,395031
34909,0.001643,172.217.194.0-255,7856,235946,77,395031
34910,0.001646,172.31.40.0-255,66,236012,77,395031
34911,0.00169,172.217.194.0-255,5738,241750,77,395031
34912,0.001696,172.31.40.0-255,66,241816,77,395031
34913,0.001708,172.217.194.0-255,7156,248972,77,395031
34914,0.00171,172.31.40.0-255,66,249038,77,395031
34915,0.001713,172.217.194.0-255,1484,250522,77,395031
34916,0.00174,172.217.194.0-255,4320,254842,77,395031
34917,0.001742,172.31.40.0-255,66,254908,77,395031
34918,0.001763,172.217.194.0-255,8574,263482,77,395031
34919,0.001767,172.31.40.0-255,66,263548,77,395031
34920,0.001795,172.217.194.0-255,6438,269986,77,395031
34921,0.001798,172.31.40.0-255,66,270052,77,395031
34922,0.001919,172.217.194.0-255,1484,271536,77,395031
34923,0.001925,172.217.194.0-255,2902,274438,77,395031
34924,0.001928,172.31.40.0-255,66,274504,77,395031
34925,0.001945,172.217.194.0-255,1484,275988,77,395031
34926,0.001963,172.217.194.0-255,4320,280308,77,395031
34927,0.001966,172.31.40.0-255,66,280374,77,395031
34928,0.001997,172.217.194.0-255,12828,293202,77,395031
34929,0.002,172.31.40.0-255,66,293268,77,395031
34930,0.002003,172.217.194.0-255,1484,294752,77,395031
34931,0.002035,172.217.194.0-255,4320,299072,77,395031
34932,0.002039,172.31.40.0-255,66,299138,77,395031
34933,0.002069,172.217.194.0-255,12110,311248,77,395031
34934,0.002072,172.31.40.0-255,66,311314,77,395031
34935,0.002113,172.217.194.0-255,7156,318470,77,395031
34936,0.002116,172.31.40.0-255,66,318536,77,395031
34937,0.002144,172.217.194.0-255,9992,328528,77,395031
34938,0.002147,172.31.40.0-255,66,328594,77,395031
34939,0.002151,172.217.194.0-255,4320,332914,77,395031
34940,0.002153,172.31.40.0-255,66,332980,77,395031
34941,0.00216,172.217.194.0-255,5738,338718,77,395031
34942,0.002162,172.31.40.0-255,66,338784,77,395031
34943,0.002201,172.217.194.0-255,13528,352312,77,395031
34944,0.002204,172.31.40.0-255,66,352378,77,395031
34945,0.002207,172.217.194.0-255,1484,353862,77,395031
34946,0.002262,172.31.40.0-255,66,353928,77,395031
34947,0.002287,172.217.194.0-255,766,354694,77,395031
34948,0.002296,172.217.194.0-255,9992,364686,77,395031
34949,0.002306,172.217.194.0-255,11410,376096,77,395031
34950,0.002313,172.217.194.0-255,5738,381834,77,395031
34951,0.002318,172.217.194.0-255,4320,386154,77,395031
34952,0.002335,172.31.40.0-255,66,386220,77,395031
34953,0.004642,172.217.194.0-255,5738,391958,77,395031
34954,0.00465,172.31.40.0-255,66,392024,77,395031
34955,0.00692,172.217.194.0-255,2770,394794,77,395031
34956,0.006927,172.31.40.0-255,66,394860,77,395031
34957,0.008576,172.31.40.0-255,105,394965,77,395031
34958,0.010855,172.217.194.0-255,66,395031,77,395031
34959,0.0,172.217.194.0-255,153,153,77,360908
34960,2.4e-05,172.31.40.0-255,66,219,77,360908
34961,3.2e-05,172.217.194.0-255,1484,1703,77,360908
34962,3.6e-05,172.31.40.0-255,66,1769,77,360908
34963,4.2e-05,172.217.194.0-255,2902,4671,77,360908
34964,5.3e-05,172.31.40.0-255,66,4737,77,360908
34965,6e-05,172.217.194.0-255,7156,11893,77,360908
34966,6.3e-05,172.31.40.0-255,66,11959,77,360908
34967,7.3e-05,172.217.194.0-255,11960,23919,77,360908
34968,7.6e-05,172.31.40.0-255,66,23985,77,360908
34969,0.000112,172.217.194.0-255,6797,30782,77,360908
34970,0.000115,172.31.40.0-255,66,30848,77,360908
34971,0.000121,172.217.194.0-255,4320,35168,77,360908
34972,0.000123,172.31.40.0-255,66,35234,77,360908
34973,0.000148,172.217.194.0-255,2902,38136,77,360908
34974,0.00015,172.31.40.0-255,66,38202,77,360908
34975,0.000164,172.217.194.0-255,9633,47835,77,360908
34976,0.000167,172.31.40.0-255,66,47901,77,360908
34977,0.000191,172.217.194.0-255,1484,49385,77,360908
34978,0.000193,172.31.40.0-255,66,49451,77,360908
34979,0.000197,172.217.194.0-255,2902,52353,77,360908
34980,0.0002,172.31.40.0-255,66,52419,77,360908
34981,0.000206,172.217.194.0-255,5738,58157,77,360908
34982,0.000213,172.31.40.0-255,66,58223,77,360908
34983,0.000245,172.217.194.0-255,7075,65298,77,360908
34984,0.000248,172.31.40.0-255,66,65364,77,360908
34985,0.00025,172.217.194.0-255,119,65483,77,360908
34986,0.000252,172.31.40.0-255,66,65549,77,360908
34987,0.000291,172.217.194.0-255,1484,67033,77,360908
34988,0.000294,172.31.40.0-255,66,67099,77,360908
34989,0.000298,172.217.194.0-255,1484,68583,77,360908
34990,0.0003,172.31.40.0-255,66,68649,77,360908
34991,0.000329,172.217.194.0-255,1484,70133,77,360908
34992,0.000337,172.217.194.0-255,7156,77289,77,360908
34993,0.00034,172.31.40.0-255,66,77355,77,360908
34994,0.000364,172.217.194.0-255,1484,78839,77,360908
34995,0.000388,172.217.194.0-255,4271,83110,77,360908
34996,0.000391,172.31.40.0-255,66,83176,77,360908
34997,0.000413,172.217.194.0-255,1484,84660,77,360908
34998,0.00043,172.217.194.0-255,5738,90398,77,360908
34999,0.000433,172.31.40.0-255,66,90464,77,360908
35000,0.000464,172.217.194.0-255,7156,97620,77,360908
35001,0.000467,172.31.40.0-255,66,97686,77,360908
35002,0.000494,172.217.194.0-255,2543,100229,77,360908
35003,0.000497,172.31.40.0-255,66,100295,77,360908
35004,0.000839,172.217.194.0-255,1484,101779,77,360908
35005,0.000846,172.217.194.0-255,2902,104681,77,360908
35006,0.000853,172.31.40.0-255,66,104747,77,360908
35007,0.000867,172.217.194.0-255,5738,110485,77,360908
35008,0.000877,172.217.194.0-255,4320,114805,77,360908
35009,0.000886,172.217.194.0-255,9992,124797,77,360908
35010,0.000891,172.31.40.0-255,66,124863,77,360908
35011,0.000899,172.31.40.0-255,66,124929,77,360908
35012,0.000902,172.31.40.0-255,66,124995,77,360908
35013,0.000912,172.217.194.0-255,5738,130733,77,360908
35014,0.000914,172.31.40.0-255,66,130799,77,360908
35015,0.00092,172.217.194.0-255,3054,133853,77,360908
35016,0.000922,172.31.40.0-255,66,133919,77,360908
35017,0.000957,172.217.194.0-255,8574,142493,77,360908
35018,0.00096,172.31.40.0-255,66,142559,77,360908
35019,0.000995,172.217.194.0-255,12828,155387,77,360908
35020,0.000998,172.31.40.0-255,66,155453,77,360908
35021,0.001047,172.217.194.0-255,11410,166863,77,360908
35022,0.001049,172.31.40.0-255,66,166929,77,360908
35023,0.001059,172.217.194.0-255,766,167695,77,360908
35024,0.00164,172.31.40.0-255,101,167796,77,360908
35025,0.001672,172.217.194.0-255,1484,169280,77,360908
35026,0.001678,172.217.194.0-255,2902,172182,77,360908
35027,0.001681,172.31.40.0-255,66,172248,77,360908
35028,0.001708,172.217.194.0-255,5738,177986,77,360908
35029,0.001711,172.31.40.0-255,66,178052,77,360908
35030,0.001721,172.217.194.0-255,8574,186626,77,360908
35031,0.001723,172.31.40.0-255,66,186692,77,360908
35032,0.00175,172.217.194.0-255,1484,188176,77,360908
35033,0.001788,172.217.194.0-255,13528,201704,77,360908
35034,0.001791,172.31.40.0-255,66,201770,77,360908
35035,0.00181,172.217.194.0-255,4320,206090,77,360908
35036,0.001812,172.31.40.0-255,66,206156,77,360908
35037,0.001848,172.217.194.0-255,9992,216148,77,360908
35038,0.001851,172.31.40.0-255,66,216214,77,360908
35039,0.001861,172.217.194.0-255,11410,227624,77,360908
35040,0.001869,172.31.40.0-255,66,227690,77,360908
35041,0.001878,172.217.194.0-255,7856,235546,77,360908
35042,0.001882,172.31.40.0-255,66,235612,77,360908
35043,0.001923,172.217.194.0-255,8574,244186,77,360908
35044,0.001927,172.31.40.0-255,66,244252,77,360908
35045,0.001955,172.31.40.0-255,66,244318,77,360908
35046,0.001982,172.217.194.0-255,4320,248638,77,360908
35047,0.001984,172.217.194.0-255,1484,250122,77,360908
35048,0.001989,172.217.194.0-255,5020,255142,77,360908
35049,0.001993,172.31.40.0-255,66,255208,77,360908
35050,0.001998,172.31.40.0-255,66,255274,77,360908
35051,0.002145,172.217.194.0-255,1484,256758,77,360908
35052,0.002151,172.217.194.0-255,2902,259660,77,360908
35053,0.002154,172.31.40.0-255,66,259726,77,360908
35054,0.002183,172.217.194.0-255,5738,265464,77,360908
35055,0.002185,172.31.40.0-255,66,265530,77,360908
35056,0.002192,172.217.194.0-255,5738,271268,77,360908
35057,0.002194,172.31.40.0-255,66,271334,77,360908
35058,0.002209,172.217.194.0-255,12828,284162,77,360908
35059,0.002211,172.31.40.0-255,66,284228,77,360908
35060,0.002251,172.217.194.0-255,5020,289248,77,360908
35061,0.002256,172.31.40.0-255,66,289314,77,360908
35062,0.002283,172.217.194.0-255,1484,290798,77,360908
35063,0.0023,172.217.194.0-255,2902,293700,77,360908
35064,0.002304,172.31.40.0-255,66,293766,77,360908
35065,0.002311,172.217.194.0-255,5738,299504,77,360908
35066,0.002314,172.31.40.0-255,66,299570,77,360908
35067,0.002345,172.217.194.0-255,4320,303890,77,360908
35068,0.002363,172.31.40.0-255,66,303956,77,360908
35069,0.002371,172.217.194.0-255,7156,311112,77,360908
35070,0.002375,172.31.40.0-255,66,311178,77,360908
35071,0.002407,172.217.194.0-255,8574,319752,77,360908
35072,0.002411,172.31.40.0-255,66,319818,77,360908
35073,0.003951,172.217.194.0-255,66,319884,77,360908
35074,0.004735,172.217.194.0-255,5738,325622,77,360908
35075,0.004743,172.31.40.0-255,66,325688,77,360908
35076,0.007052,172.217.194.0-255,2902,328590,77,360908
35077,0.007056,172.31.40.0-255,66,328656,77,360908
35078,0.007085,172.217.194.0-255,2902,331558,77,360908
35079,0.007088,172.31.40.0-255,66,331624,77,360908
35080,0.009397,172.217.194.0-255,2902,334526,77,360908
35081,0.009406,172.31.40.0-255,66,334592,77,360908
35082,0.009425,172.217.194.0-255,2902,337494,77,360908
35083,0.009428,172.31.40.0-255,66,337560,77,360908
35084,0.011725,172.217.194.0-255,2902,340462,77,360908
35085,0.011734,172.31.40.0-255,66,340528,77,360908
35086,0.011762,172.217.194.0-255,2902,343430,77,360908
35087,0.011765,172.31.40.0-255,66,343496,77,360908
35088,0.014079,172.217.194.0-255,5738,349234,77,360908
35089,0.014092,172.31.40.0-255,66,349300,77,360908
35090,0.016435,172.217.194.0-255,5738,355038,77,360908
35091,0.016451,172.31.40.0-255,66,355104,77,360908
35092,0.018792,172.217.194.0-255,5738,360842,77,360908
35093,0.018808,172.31.40.0-255,66,360908,77,360908
35094,0.0,74.125.200.0-255,153,153,77,245140
35095,1.9e-05,172.31.40.0-255,66,219,77,245140
35096,2.6e-05,74.125.200.0-255,1484,1703,77,245140
35097,3.1e-05,172.31.40.0-255,66,1769,77,245140
35098,4.4e-05,74.125.200.0-255,2902,4671,77,245140
35099,4.8e-05,172.31.40.0-255,66,4737,77,245140
35100,5.2e-05,74.125.200.0-255,1484,6221,77,245140
35101,5.4e-05,172.31.40.0-255,66,6287,77,245140
35102,6e-05,74.125.200.0-255,2902,9189,77,245140
35103,6.3e-05,172.31.40.0-255,66,9255,77,245140
35104,9.5e-05,74.125.200.0-255,6390,15645,77,245140
35105,9.8e-05,172.31.40.0-255,66,15711,77,245140
35106,0.000102,74.125.200.0-255,2902,18613,77,245140
35107,0.000105,172.31.40.0-255,66,18679,77,245140
35108,0.00011,74.125.200.0-255,4320,22999,77,245140
35109,0.000113,172.31.40.0-255,66,23065,77,245140
35110,0.000142,74.125.200.0-255,2902,25967,77,245140
35111,0.000144,172.31.40.0-255,66,26033,77,245140
35112,0.000173,74.125.200.0-255,5379,31412,77,245140
35113,0.000176,172.31.40.0-255,66,31478,77,245140
35114,0.000229,74.125.200.0-255,1484,32962,77,245140
35115,0.000231,172.31.40.0-255,66,33028,77,245140
35116,0.00026,74.125.200.0-255,2902,35930,77,245140
35117,0.000262,172.31.40.0-255,66,35996,77,245140
35118,0.000268,74.125.200.0-255,5738,41734,77,245140
35119,0.000271,172.31.40.0-255,66,41800,77,245140
35120,0.000298,74.125.200.0-255,5738,47538,77,245140
35121,0.000301,172.31.40.0-255,66,47604,77,245140
35122,0.000323,74.125.200.0-255,7156,54760,77,245140
35123,0.000325,172.31.40.0-255,66,54826,77,245140
35124,0.000359,74.125.200.0-255,10987,65813,77,245140
35125,0.000362,172.31.40.0-255,66,65879,77,245140
35126,0.000446,74.125.200.0-255,131,66010,77,245140
35127,0.000629,74.125.200.0-255,1484,67494,77,245140
35128,0.000633,74.125.200.0-255,1484,68978,77,245140
35129,0.000644,172.31.40.0-255,66,69044,77,245140
35130,0.000649,74.125.200.0-255,1484,70528,77,245140
35131,0.000651,172.31.40.0-255,66,70594,77,245140
35132,0.000657,74.125.200.0-255,2902,73496,77,245140
35133,0.000665,172.31.40.0-255,66,73562,77,245140
35134,0.00069,74.125.200.0-255,1484,75046,77,245140
35135,0.000699,74.125.200.0-255,8574,83620,77,245140
35136,0.000702,172.31.40.0-255,66,83686,77,245140
35137,0.000706,74.125.200.0-255,2902,86588,77,245140
35138,0.000708,172.31.40.0-255,66,86654,77,245140
35139,0.000746,74.125.200.0-255,2902,89556,77,245140
35140,0.000749,172.31.40.0-255,66,89622,77,245140
35141,0.000784,74.125.200.0-255,9992,99614,77,245140
35142,0.000787,74.125.200.0-255,468,100082,77,245140
35143,0.000791,172.31.40.0-255,66,100148,77,245140
35144,0.000902,74.125.200.0-255,1484,101632,77,245140
35145,0.000907,172.31.40.0-255,66,101698,77,245140
35146,0.000912,74.125.200.0-255,2902,104600,77,245140
35147,0.000914,172.31.40.0-255,66,104666,77,245140
35148,0.000918,74.125.200.0-255,1484,106150,77,245140
35149,0.000948,74.125.200.0-255,4320,110470,77,245140
35150,0.000951,172.31.40.0-255,66,110536,77,245140
35151,0.000961,74.125.200.0-255,9992,120528,77,245140
35152,0.000963,172.31.40.0-255,66,120594,77,245140
35153,0.000995,74.125.200.0-255,11410,132004,77,245140
35154,0.000998,74.125.200.0-255,2184,134188,77,245140
35155,0.001004,172.31.40.0-255,66,134254,77,245140
35156,0.001018,172.31.40.0-255,66,134320,77,245140
35157,0.00161,74.125.200.0-255,1484,135804,77,245140
35158,0.001634,74.125.200.0-255,2902,138706,77,245140
35159,0.001638,172.31.40.0-255,66,138772,77,245140
35160,0.001643,74.125.200.0-255,2902,141674,77,245140
35161,0.001645,172.31.40.0-255,66,141740,77,245140
35162,0.001678,74.125.200.0-255,2902,144642,77,245140
35163,0.001681,172.31.40.0-255,66,144708,77,245140
35164,0.001684,74.125.200.0-255,1484,146192,77,245140
35165,0.001689,74.125.200.0-255,2902,149094,77,245140
35166,0.001691,172.31.40.0-255,66,149160,77,245140
35167,0.001697,74.125.200.0-255,5738,154898,77,245140
35168,0.001699,172.31.40.0-255,66,154964,77,245140
35169,0.001702,74.125.200.0-255,1484,156448,77,245140
35170,0.001726,74.125.200.0-255,2902,159350,77,245140
35171,0.001729,172.31.40.0-255,66,159416,77,245140
35172,0.001751,74.125.200.0-255,4320,163736,77,245140
35173,0.001754,172.31.40.0-255,66,163802,77,245140
35174,0.001777,74.125.200.0-255,1484,165286,77,245140
35175,0.001782,74.125.200.0-255,2902,168188,77,245140
35176,0.001785,172.31.40.0-255,66,168254,77,245140
35177,0.001788,74.125.200.0-255,766,169020,77,245140
35178,0.001895,74.125.200.0-255,1484,170504,77,245140
35179,0.001899,172.31.40.0-255,66,170570,77,245140
35180,0.001902,74.125.200.0-255,1484,172054,77,245140
35181,0.001926,74.125.200.0-255,2902,174956,77,245140
35182,0.001928,172.31.40.0-255,66,175022,77,245140
35183,0.001965,74.125.200.0-255,5738,180760,77,245140
35184,0.001968,172.31.40.0-255,66,180826,77,245140
35185,0.001971,74.125.200.0-255,1484,182310,77,245140
35186,0.002011,74.125.200.0-255,8574,190884,77,245140
35187,0.002014,172.31.40.0-255,66,190950,77,245140
35188,0.002019,74.125.200.0-255,2902,193852,77,245140
35189,0.002021,172.31.40.0-255,66,193918,77,245140
35190,0.002024,74.125.200.0-255,1484,195402,77,245140
35191,0.002043,74.125.200.0-255,2902,198304,77,245140
35192,0.002052,172.31.40.0-255,66,198370,77,245140
35193,0.00206,74.125.200.0-255,2902,201272,77,245140
35194,0.002063,172.31.40.0-255,66,201338,77,245140
35195,0.002082,74.125.200.0-255,2184,203522,77,245140
35196,0.002084,172.31.40.0-255,66,203588,77,245140
35197,0.00431,74.125.200.0-255,2902,206490,77,245140
35198,0.004318,172.31.40.0-255,66,206556,77,245140
35199,0.004345,74.125.200.0-255,2902,209458,77,245140
35200,0.004348,172.31.40.0-255,66,209524,77,245140
35201,0.006565,74.125.200.0-255,2902,212426,77,245140
35202,0.00657,172.31.40.0-255,66,212492,77,245140
35203,0.006597,74.125.200.0-255,2902,215394,77,245140
35204,0.006599,172.31.40.0-255,66,215460,77,245140
35205,0.008822,74.125.200.0-255,2902,218362,77,245140
35206,0.008828,172.31.40.0-255,66,218428,77,245140
35207,0.008856,74.125.200.0-255,2902,221330,77,245140
35208,0.008858,172.31.40.0-255,66,221396,77,245140
35209,0.01108,74.125.200.0-255,2902,224298,77,245140
35210,0.011088,172.31.40.0-255,66,224364,77,245140
35211,0.011118,74.125.200.0-255,2902,227266,77,245140
35212,0.011121,172.31.40.0-255,66,227332,77,245140
35213,0.013333,74.125.200.0-255,2902,230234,77,245140
35214,0.013341,172.31.40.0-255,66,230300,77,245140
35215,0.013376,74.125.200.0-255,2902,233202,77,245140
35216,0.013379,172.31.40.0-255,66,233268,77,245140
35217,0.015599,74.125.200.0-255,2902,236170,77,245140
35218,0.01561,172.31.40.0-255,66,236236,77,245140
35219,0.015646,74.125.200.0-255,2902,239138,77,245140
35220,0.015649,172.31.40.0-255,66,239204,77,245140
35221,0.017875,74.125.200.0-255,2902,242106,77,245140
35222,0.017884,172.31.40.0-255,66,242172,77,245140
35223,0.017914,74.125.200.0-255,2902,245074,77,245140
35224,0.017917,172.31.40.0-255,66,245140,77,245140
35225,0.0,172.217.194.0-255,150,150,77,345681
35226,2.5e-05,172.31.40.0-255,66,216,77,345681
35227,3.2e-05,172.217.194.0-255,1484,1700,77,345681
35228,3.6e-05,172.31.40.0-255,66,1766,77,345681
35229,5e-05,172.217.194.0-255,2902,4668,77,345681
35230,5.4e-05,172.31.40.0-255,66,4734,77,345681
35231,6.2e-05,172.217.194.0-255,7156,11890,77,345681
35232,6.5e-05,172.31.40.0-255,66,11956,77,345681
35233,7.7e-05,172.217.194.0-255,11948,23904,77,345681
35234,8.1e-05,172.31.40.0-255,66,23970,77,345681
35235,8.6e-05,172.217.194.0-255,4320,28290,77,345681
35236,8.9e-05,172.31.40.0-255,66,28356,77,345681
35237,0.000112,172.217.194.0-255,2543,30899,77,345681
35238,0.000119,172.31.40.0-255,66,30965,77,345681
35239,0.000139,172.217.194.0-255,1484,32449,77,345681
35240,0.000142,172.31.40.0-255,66,32515,77,345681
35241,0.000147,172.217.194.0-255,2902,35417,77,345681
35242,0.00015,172.31.40.0-255,66,35483,77,345681
35243,0.000183,172.217.194.0-255,5738,41221,77,345681
35244,0.000186,172.31.40.0-255,66,41287,77,345681
35245,0.000194,172.217.194.0-255,6797,48084,77,345681
35246,0.000196,172.31.40.0-255,66,48150,77,345681
35247,0.000757,172.217.194.0-255,1484,49634,77,345681
35248,0.000763,172.31.40.0-255,66,49700,77,345681
35249,0.00077,172.217.194.0-255,2902,52602,77,345681
35250,0.000772,172.31.40.0-255,66,52668,77,345681
35251,0.000785,172.217.194.0-255,5738,58406,77,345681
35252,0.000788,172.31.40.0-255,66,58472,77,345681
35253,0.000796,172.217.194.0-255,6797,65269,77,345681
35254,0.000798,172.31.40.0-255,66,65335,77,345681
35255,0.000913,172.217.194.0-255,1484,66819,77,345681
35256,0.000917,172.31.40.0-255,66,66885,77,345681
35257,0.000923,172.217.194.0-255,2902,69787,77,345681
35258,0.000925,172.31.40.0-255,66,69853,77,345681
35259,0.000934,172.217.194.0-255,1484,71337,77,345681
35260,0.000955,172.217.194.0-255,4320,75657,77,345681
35261,0.000958,172.31.40.0-255,66,75723,77,345681
35262,0.000964,172.217.194.0-255,4320,80043,77,345681
35263,0.000966,172.31.40.0-255,66,80109,77,345681
35264,0.000995,172.217.194.0-255,4320,84429,77,345681
35265,0.000997,172.31.40.0-255,66,84495,77,345681
35266,0.001035,172.217.194.0-255,8215,92710,77,345681
35267,0.001038,172.31.40.0-255,66,92776,77,345681
35268,0.001041,172.217.194.0-255,1484,94260,77,345681
35269,0.001048,172.217.194.0-255,5379,99639,77,345681
35270,0.001055,172.31.40.0-255,66,99705,77,345681
35271,0.001174,172.217.194.0-255,646,100351,77,345681
35272,0.001362,172.217.194.0-255,1484,101835,77,345681
35273,0.001367,172.31.40.0-255,66,101901,77,345681
35274,0.001371,172.217.194.0-255,1484,103385,77,345681
35275,0.001394,172.217.194.0-255,1484,104869,77,345681
35276,0.001397,172.31.40.0-255,66,104935,77,345681
35277,0.001404,172.217.194.0-255,5738,110673,77,345681
35278,0.001406,172.31.40.0-255,66,110739,77,345681
35279,0.001415,172.217.194.0-255,2902,113641,77,345681
35280,0.001417,172.31.40.0-255,66,113707,77,345681
35281,0.001446,172.217.194.0-255,7156,120863,77,345681
35282,0.001448,172.31.40.0-255,66,120929,77,345681
35283,0.001483,172.217.194.0-255,2902,123831,77,345681
35284,0.001486,172.31.40.0-255,66,123897,77,345681
35285,0.001503,172.217.194.0-255,10692,134589,77,345681
35286,0.001506,172.31.40.0-255,66,134655,77,345681
35287,0.00177,172.217.194.0-255,1484,136139,77,345681
35288,0.001777,172.217.194.0-255,2902,139041,77,345681
35289,0.00178,172.31.40.0-255,66,139107,77,345681
35290,0.001785,172.217.194.0-255,2902,142009,77,345681
35291,0.001787,172.31.40.0-255,66,142075,77,345681
35292,0.001806,172.217.194.0-255,2902,144977,77,345681
35293,0.001808,172.31.40.0-255,66,145043,77,345681
35294,0.00182,172.217.194.0-255,7156,152199,77,345681
35295,0.001822,172.31.40.0-255,66,152265,77,345681
35296,0.001852,172.217.194.0-255,5738,158003,77,345681
35297,0.001855,172.31.40.0-255,66,158069,77,345681
35298,0.001862,172.217.194.0-255,5738,163807,77,345681
35299,0.001864,172.31.40.0-255,66,163873,77,345681
35300,0.001893,172.217.194.0-255,5020,168893,77,345681
35301,0.001908,172.217.194.0-255,11410,180303,77,345681
35302,0.001912,172.217.194.0-255,4320,184623,77,345681
35303,0.001916,172.31.40.0-255,66,184689,77,345681
35304,0.001924,172.31.40.0-255,66,184755,77,345681
35305,0.001931,172.31.40.0-255,66,184821,77,345681
35306,0.001937,172.217.194.0-255,5738,190559,77,345681
35307,0.00194,172.31.40.0-255,66,190625,77,345681
35308,0.001962,172.217.194.0-255,1484,192109,77,345681
35309,0.001998,172.217.194.0-255,10692,202801,77,345681
35310,0.002002,172.31.40.0-255,66,202867,77,345681
35311,0.002005,172.217.194.0-255,1484,204351,77,345681
35312,0.002035,172.217.194.0-255,7156,211507,77,345681
35313,0.002038,172.31.40.0-255,66,211573,77,345681
35314,0.002048,172.217.194.0-255,9992,221565,77,345681
35315,0.002054,172.31.40.0-255,66,221631,77,345681
35316,0.002057,172.217.194.0-255,1484,223115,77,345681
35317,0.002082,172.217.194.0-255,5738,228853,77,345681
35318,0.002085,172.31.40.0-255,66,228919,77,345681
35319,0.002118,172.217.194.0-255,7856,236775,77,345681
35320,0.002121,172.31.40.0-255,66,236841,77,345681
35321,0.002144,172.217.194.0-255,1484,238325,77,345681
35322,0.002157,172.217.194.0-255,2902,241227,77,345681
35323,0.00216,172.31.40.0-255,66,241293,77,345681
35324,0.002164,172.217.194.0-255,2902,244195,77,345681
35325,0.002166,172.31.40.0-255,66,244261,77,345681
35326,0.002191,172.217.194.0-255,2902,247163,77,345681
35327,0.002195,172.217.194.0-255,2902,250065,77,345681
35328,0.002199,172.31.40.0-255,66,250131,77,345681
35329,0.002201,172.31.40.0-255,66,250197,77,345681
35330,0.002241,172.217.194.0-255,9992,260189,77,345681
35331,0.002245,172.31.40.0-255,66,260255,77,345681
35332,0.002255,172.217.194.0-255,10692,270947,77,345681
35333,0.002258,172.31.40.0-255,66,271013,77,345681
35334,0.002312,172.217.194.0-255,1484,272497,77,345681
35335,0.002317,172.217.194.0-255,2902,275399,77,345681
35336,0.00232,172.31.40.0-255,66,275465,77,345681
35337,0.002328,172.217.194.0-255,5738,281203,77,345681
35338,0.002331,172.31.40.0-255,66,281269,77,345681
35339,0.002395,172.217.194.0-255,7156,288425,77,345681
35340,0.002398,172.31.40.0-255,66,288491,77,345681
35341,0.002424,172.217.194.0-255,5738,294229,77,345681
35342,0.002427,172.31.40.0-255,66,294295,77,345681
35343,0.002442,172.217.194.0-255,10692,304987,77,345681
35344,0.002444,172.31.40.0-255,66,305053,77,345681
35345,0.004792,172.217.194.0-255,5738,310791,77,345681
35346,0.0048,172.31.40.0-255,66,310857,77,345681
35347,0.007127,172.217.194.0-255,5738,316595,77,345681
35348,0.007132,172.31.40.0-255,66,316661,77,345681
35349,0.009503,172.217.194.0-255,5738,322399,77,345681
35350,0.009524,172.31.40.0-255,66,322465,77,345681
35351,0.011893,172.217.194.0-255,5738,328203,77,345681
35352,0.011903,172.31.40.0-255,66,328269,77,345681
35353,0.01427,172.217.194.0-255,5738,334007,77,345681
35354,0.014282,172.31.40.0-255,66,334073,77,345681
35355,0.016618,172.217.194.0-255,5738,339811,77,345681
35356,0.01663,172.31.40.0-255,66,339877,77,345681
35357,0.018997,172.217.194.0-255,5738,345615,77,345681
35358,0.019011,172.31.40.0-255,66,345681,77,345681
35359,0.0,172.31.40.0-255,105,105,77,459
35360,0.000264,172.31.40.0-255,90,195,77,459
35361,0.000275,172.31.40.0-255,66,261,77,459
35362,0.002287,172.217.194.0-255,66,327,77,459
35363,0.002301,172.217.194.0-255,66,393,77,459
35364,0.002307,172.31.40.0-255,66,459,77,459
35365,0.0,172.31.40.0-255,105,105,77,105
35366,0.0,74.125.200.0-255,153,153,77,187677
35367,1.7e-05,172.31.40.0-255,66,219,77,187677
35368,2.3e-05,74.125.200.0-255,1484,1703,77,187677
35369,2.8e-05,172.31.40.0-255,66,1769,77,187677
35370,4e-05,74.125.200.0-255,2902,4671,77,187677
35371,4.3e-05,172.31.40.0-255,66,4737,77,187677
35372,4.6e-05,74.125.200.0-255,1484,6221,77,187677
35373,4.8e-05,172.31.40.0-255,66,6287,77,187677
35374,7.3e-05,74.125.200.0-255,4320,10607,77,187677
35375,8.1e-05,172.31.40.0-255,66,10673,77,187677
35376,8.8e-05,74.125.200.0-255,6248,16921,77,187677
35377,9.1e-05,172.31.40.0-255,66,16987,77,187677
35378,0.000129,74.125.200.0-255,9992,26979,77,187677
35379,0.000133,172.31.40.0-255,66,27045,77,187677
35380,0.000161,74.125.200.0-255,3961,31006,77,187677
35381,0.000163,172.31.40.0-255,66,31072,77,187677
35382,0.00023,74.125.200.0-255,1484,32556,77,187677
35383,0.000233,172.31.40.0-255,66,32622,77,187677
35384,0.000263,74.125.200.0-255,2902,35524,77,187677
35385,0.000265,172.31.40.0-255,66,35590,77,187677
35386,0.00029,74.125.200.0-255,4320,39910,77,187677
35387,0.000292,172.31.40.0-255,66,39976,77,187677
35388,0.000319,74.125.200.0-255,1484,41460,77,187677
35389,0.000321,172.31.40.0-255,66,41526,77,187677
35390,0.000326,74.125.200.0-255,2902,44428,77,187677
35391,0.000328,172.31.40.0-255,66,44494,77,187677
35392,0.000347,74.125.200.0-255,1484,45978,77,187677
35393,0.000352,172.31.40.0-255,66,46044,77,187677
35394,0.00039,74.125.200.0-255,5379,51423,77,187677
35395,0.000393,172.31.40.0-255,66,51489,77,187677
35396,0.0004,74.125.200.0-255,7156,58645,77,187677
35397,0.000403,172.31.40.0-255,66,58711,77,187677
35398,0.000415,74.125.200.0-255,7102,65813,77,187677
35399,0.000418,172.31.40.0-255,66,65879,77,187677
35400,0.000421,74.125.200.0-255,114,65993,77,187677
35401,0.000489,74.125.200.0-255,332,66325,77,187677
35402,0.000767,74.125.200.0-255,1484,67809,77,187677
35403,0.000771,172.31.40.0-255,66,67875,77,187677
35404,0.000793,74.125.200.0-255,2902,70777,77,187677
35405,0.000796,172.31.40.0-255,66,70843,77,187677
35406,0.000799,74.125.200.0-255,1484,72327,77,187677
35407,0.000824,74.125.200.0-255,1484,73811,77,187677
35408,0.000826,172.31.40.0-255,66,73877,77,187677
35409,0.000832,74.125.200.0-255,4320,78197,77,187677
35410,0.000834,172.31.40.0-255,66,78263,77,187677
35411,0.00087,74.125.200.0-255,8574,86837,77,187677
35412,0.000873,172.31.40.0-255,66,86903,77,187677
35413,0.000879,74.125.200.0-255,4320,91223,77,187677
35414,0.000881,172.31.40.0-255,66,91289,77,187677
35415,0.000913,74.125.200.0-255,5738,97027,77,187677
35416,0.000916,172.31.40.0-255,66,97093,77,187677
35417,0.000921,74.125.200.0-255,3054,100147,77,187677
35418,0.000923,172.31.40.0-255,66,100213,77,187677
35419,0.001098,74.125.200.0-255,1484,101697,77,187677
35420,0.001112,74.125.200.0-255,2902,104599,77,187677
35421,0.001115,172.31.40.0-255,66,104665,77,187677
35422,0.001135,74.125.200.0-255,5738,110403,77,187677
35423,0.001139,172.31.40.0-255,66,110469,77,187677
35424,0.001176,74.125.200.0-255,12828,123297,77,187677
35425,0.001179,172.31.40.0-255,66,123363,77,187677
35426,0.001233,74.125.200.0-255,8574,131937,77,187677
35427,0.001237,172.31.40.0-255,66,132003,77,187677
35428,0.001261,74.125.200.0-255,2184,134187,77,187677
35429,0.001263,172.31.40.0-255,66,134253,77,187677
35430,0.003129,74.125.200.0-255,2902,137155,77,187677
35431,0.003136,172.31.40.0-255,66,137221,77,187677
35432,0.003164,74.125.200.0-255,2902,140123,77,187677
35433,0.003166,172.31.40.0-255,66,140189,77,187677
35434,0.005045,74.125.200.0-255,2902,143091,77,187677
35435,0.005048,172.31.40.0-255,66,143157,77,187677
35436,0.005067,74.125.200.0-255,2902,146059,77,187677
35437,0.005069,172.31.40.0-255,66,146125,77,187677
35438,0.006954,74.125.200.0-255,2902,149027,77,187677
35439,0.00696,172.31.40.0-255,66,149093,77,187677
35440,0.00699,74.125.200.0-255,2902,151995,77,187677
35441,0.006993,172.31.40.0-255,66,152061,77,187677
35442,0.008872,74.125.200.0-255,2902,154963,77,187677
35443,0.00888,172.31.40.0-255,66,155029,77,187677
35444,0.008912,74.125.200.0-255,2902,157931,77,187677
35445,0.008915,172.31.40.0-255,66,157997,77,187677
35446,0.010792,74.125.200.0-255,2902,160899,77,187677
35447,0.0108,172.31.40.0-255,66,160965,77,187677
35448,0.010833,74.125.200.0-255,2902,163867,77,187677
35449,0.010837,172.31.40.0-255,66,163933,77,187677
35450,0.012714,74.125.200.0-255,2902,166835,77,187677
35451,0.01272,172.31.40.0-255,66,166901,77,187677
35452,0.012752,74.125.200.0-255,2902,169803,77,187677
35453,0.012754,172.31.40.0-255,66,169869,77,187677
35454,0.014625,74.125.200.0-255,2902,172771,77,187677
35455,0.014635,172.31.40.0-255,66,172837,77,187677
35456,0.014668,74.125.200.0-255,2902,175739,77,187677
35457,0.01467,172.31.40.0-255,66,175805,77,187677
35458,0.016537,74.125.200.0-255,2902,178707,77,187677
35459,0.016544,172.31.40.0-255,66,178773,77,187677
35460,0.016576,74.125.200.0-255,2902,181675,77,187677
35461,0.016578,172.31.40.0-255,66,181741,77,187677
35462,0.018449,74.125.200.0-255,2902,184643,77,187677
35463,0.018455,172.31.40.0-255,66,184709,77,187677
35464,0.018482,74.125.200.0-255,2902,187611,77,187677
35465,0.018484,172.31.40.0-255,66,187677,77,187677
35466,0.0,172.217.194.0-255,292,292,77,141700
35467,2.5e-05,172.31.40.0-255,66,358,77,141700
35468,3.3e-05,172.217.194.0-255,1484,1842,77,141700
35469,3.8e-05,172.31.40.0-255,66,1908,77,141700
35470,4.2e-05,172.217.194.0-255,1484,3392,77,141700
35471,5.3e-05,172.31.40.0-255,66,3458,77,141700
35472,6.1e-05,172.217.194.0-255,4320,7778,77,141700
35473,6.5e-05,172.31.40.0-255,66,7844,77,141700
35474,7.2e-05,172.217.194.0-255,6194,14038,77,141700
35475,7.5e-05,172.31.40.0-255,66,14104,77,141700
35476,0.000177,172.217.194.0-255,1484,15588,77,141700
35477,0.000181,172.31.40.0-255,66,15654,77,141700
35478,0.000187,172.217.194.0-255,2902,18556,77,141700
35479,0.000189,172.31.40.0-255,66,18622,77,141700
35480,0.000216,172.217.194.0-255,2902,21524,77,141700
35481,0.000219,172.31.40.0-255,66,21590,77,141700
35482,0.000224,172.217.194.0-255,4320,25910,77,141700
35483,0.000227,172.31.40.0-255,66,25976,77,141700
35484,0.000254,172.217.194.0-255,2902,28878,77,141700
35485,0.000258,172.31.40.0-255,66,28944,77,141700
35486,0.000262,172.217.194.0-255,2543,31487,77,141700
35487,0.000264,172.31.40.0-255,66,31553,77,141700
35488,0.001048,172.217.194.0-255,1484,33037,77,141700
35489,0.001055,172.31.40.0-255,66,33103,77,141700
35490,0.001063,172.217.194.0-255,2902,36005,77,141700
35491,0.001065,172.31.40.0-255,66,36071,77,141700
35492,0.001079,172.217.194.0-255,5738,41809,77,141700
35493,0.001081,172.31.40.0-255,66,41875,77,141700
35494,0.001132,172.217.194.0-255,2902,44777,77,141700
35495,0.001134,172.31.40.0-255,66,44843,77,141700
35496,0.001168,172.217.194.0-255,3961,48804,77,141700
35497,0.001171,172.31.40.0-255,66,48870,77,141700
35498,0.001174,172.217.194.0-255,1484,50354,77,141700
35499,0.00118,172.217.194.0-255,2902,53256,77,141700
35500,0.001183,172.31.40.0-255,66,53322,77,141700
35501,0.001195,172.217.194.0-255,5738,59060,77,141700
35502,0.001197,172.31.40.0-255,66,59126,77,141700
35503,0.001219,172.217.194.0-255,2902,62028,77,141700
35504,0.001222,172.31.40.0-255,66,62094,77,141700
35505,0.001254,172.217.194.0-255,3961,66055,77,141700
35506,0.001258,172.31.40.0-255,66,66121,77,141700
35507,0.00178,172.217.194.0-255,647,66768,77,141700
35508,0.001968,172.217.194.0-255,1484,68252,77,141700
35509,0.001973,172.31.40.0-255,66,68318,77,141700
35510,0.00198,172.217.194.0-255,2902,71220,77,141700
35511,0.001983,172.31.40.0-255,66,71286,77,141700
35512,0.001986,172.217.194.0-255,1484,72770,77,141700
35513,0.002016,172.217.194.0-255,4320,77090,77,141700
35514,0.002019,172.31.40.0-255,66,77156,77,141700
35515,0.002031,172.217.194.0-255,12828,89984,77,141700
35516,0.002033,172.31.40.0-255,66,90050,77,141700
35517,0.002045,172.217.194.0-255,7156,97206,77,141700
35518,0.002047,172.31.40.0-255,66,97272,77,141700
35519,0.002072,172.217.194.0-255,1484,98756,77,141700
35520,0.002083,172.217.194.0-255,2184,100940,77,141700
35521,0.002086,172.31.40.0-255,66,101006,77,141700
35522,0.004356,172.217.194.0-255,1484,102490,77,141700
35523,0.004387,172.217.194.0-255,4320,106810,77,141700
35524,0.004392,172.31.40.0-255,66,106876,77,141700
35525,0.006699,172.217.194.0-255,5738,112614,77,141700
35526,0.006704,172.31.40.0-255,66,112680,77,141700
35527,0.009041,172.217.194.0-255,5738,118418,77,141700
35528,0.00905,172.31.40.0-255,66,118484,77,141700
35529,0.011355,172.217.194.0-255,5738,124222,77,141700
35530,0.011367,172.31.40.0-255,66,124288,77,141700
35531,0.013696,172.217.194.0-255,5738,130026,77,141700
35532,0.013708,172.31.40.0-255,66,130092,77,141700
35533,0.016004,172.217.194.0-255,5738,135830,77,141700
35534,0.016016,172.31.40.0-255,66,135896,77,141700
35535,0.018332,172.217.194.0-255,5738,141634,77,141700
35536,0.018343,172.31.40.0-255,66,141700,77,141700
35537,0.0,74.125.130.0-255,153,153,77,170883
35538,2.1e-05,172.31.40.0-255,66,219,77,170883
35539,2.7e-05,74.125.130.0-255,1484,1703,77,170883
35540,3.1e-05,172.31.40.0-255,66,1769,77,170883
35541,4.9e-05,74.125.130.0-255,2902,4671,77,170883
35542,5.1e-05,172.31.40.0-255,66,4737,77,170883
35543,5.4e-05,74.125.130.0-255,1484,6221,77,170883
35544,5.5e-05,172.31.40.0-255,66,6287,77,170883
35545,8e-05,74.125.130.0-255,2902,9189,77,170883
35546,8.2e-05,172.31.40.0-255,66,9255,77,170883
35547,0.000118,74.125.130.0-255,4874,14129,77,170883
35548,0.00012,172.31.40.0-255,66,14195,77,170883
35549,0.00029,74.125.130.0-255,1484,15679,77,170883
35550,0.000295,172.31.40.0-255,66,15745,77,170883
35551,0.000299,74.125.130.0-255,1484,17229,77,170883
35552,0.0003,172.31.40.0-255,66,17295,77,170883
35553,0.000314,74.125.130.0-255,1484,18779,77,170883
35554,0.000316,172.31.40.0-255,66,18845,77,170883
35555,0.000331,74.125.130.0-255,4320,23165,77,170883
35556,0.000334,172.31.40.0-255,66,23231,77,170883
35557,0.000368,74.125.130.0-255,5738,28969,77,170883
35558,0.00037,172.31.40.0-255,66,29035,77,170883
35559,0.000382,74.125.130.0-255,2543,31578,77,170883
35560,0.000385,172.31.40.0-255,66,31644,77,170883
35561,0.000419,74.125.130.0-255,1484,33128,77,170883
35562,0.000422,172.31.40.0-255,66,33194,77,170883
35563,0.000442,74.125.130.0-255,2902,36096,77,170883
35564,0.000444,172.31.40.0-255,66,36162,77,170883
35565,0.000457,74.125.130.0-255,1484,37646,77,170883
35566,0.000459,172.31.40.0-255,66,37712,77,170883
35567,0.000472,74.125.130.0-255,2902,40614,77,170883
35568,0.000475,172.31.40.0-255,66,40680,77,170883
35569,0.000527,74.125.130.0-255,1484,42164,77,170883
35570,0.000542,74.125.130.0-255,4320,46484,77,170883
35571,0.000551,172.31.40.0-255,66,46550,77,170883
35572,0.000559,74.125.130.0-255,2543,49093,77,170883
35573,0.000563,172.31.40.0-255,66,49159,77,170883
35574,0.000609,74.125.130.0-255,1484,50643,77,170883
35575,0.000633,74.125.130.0-255,2902,53545,77,170883
35576,0.000649,172.31.40.0-255,66,53611,77,170883
35577,0.000662,74.125.130.0-255,5738,59349,77,170883
35578,0.000679,172.31.40.0-255,66,59415,77,170883
35579,0.000685,74.125.130.0-255,1484,60899,77,170883
35580,0.000698,74.125.130.0-255,2902,63801,77,170883
35581,0.0007,172.31.40.0-255,66,63867,77,170883
35582,0.000729,74.125.130.0-255,2543,66410,77,170883
35583,0.000744,172.31.40.0-255,66,66476,77,170883
35584,0.000848,74.125.130.0-255,645,67121,77,170883
35585,0.000891,74.125.130.0-255,1484,68605,77,170883
35586,0.000907,74.125.130.0-255,4320,72925,77,170883
35587,0.00091,172.31.40.0-255,66,72991,77,170883
35588,0.000917,172.31.40.0-255,66,73057,77,170883
35589,0.000931,74.125.130.0-255,4320,77377,77,170883
35590,0.000949,172.31.40.0-255,66,77443,77,170883
35591,0.000964,74.125.130.0-255,4320,81763,77,170883
35592,0.000966,172.31.40.0-255,66,81829,77,170883
35593,0.000976,74.125.130.0-255,1484,83313,77,170883
35594,0.001004,74.125.130.0-255,1125,84438,77,170883
35595,0.001014,172.31.40.0-255,66,84504,77,170883
35596,0.001025,74.125.130.0-255,1484,85988,77,170883
35597,0.001038,74.125.130.0-255,2902,88890,77,170883
35598,0.001048,74.125.130.0-255,1484,90374,77,170883
35599,0.00105,172.31.40.0-255,66,90440,77,170883
35600,0.00108,74.125.130.0-255,2902,93342,77,170883
35601,0.001089,172.31.40.0-255,66,93408,77,170883
35602,0.001102,74.125.130.0-255,7156,100564,77,170883
35603,0.001137,172.31.40.0-255,66,100630,77,170883
35604,0.001163,74.125.130.0-255,1125,101755,77,170883
35605,0.001434,172.31.40.0-255,66,101821,77,170883
35606,0.001773,74.125.130.0-255,1484,103305,77,170883
35607,0.001782,74.125.130.0-255,2902,106207,77,170883
35608,0.001786,172.31.40.0-255,66,106273,77,170883
35609,0.001791,74.125.130.0-255,2902,109175,77,170883
35610,0.001793,172.31.40.0-255,66,109241,77,170883
35611,0.001815,74.125.130.0-255,2902,112143,77,170883
35612,0.001817,172.31.40.0-255,66,112209,77,170883
35613,0.001849,74.125.130.0-255,5738,117947,77,170883
35614,0.001852,172.31.40.0-255,66,118013,77,170883
35615,0.001875,74.125.130.0-255,7156,125169,77,170883
35616,0.00196,74.125.130.0-255,5738,130907,77,170883
35617,0.002009,74.125.130.0-255,2902,133809,77,170883
35618,0.002023,74.125.130.0-255,2184,135993,77,170883
35619,0.005852,172.31.40.0-255,66,136059,77,170883
35620,0.008195,74.125.130.0-255,5738,141797,77,170883
35621,0.008201,172.31.40.0-255,66,141863,77,170883
35622,0.010541,74.125.130.0-255,5738,147601,77,170883
35623,0.010553,172.31.40.0-255,66,147667,77,170883
35624,0.012884,74.125.130.0-255,5738,153405,77,170883
35625,0.012892,172.31.40.0-255,66,153471,77,170883
35626,0.015254,74.125.130.0-255,5738,159209,77,170883
35627,0.015263,172.31.40.0-255,66,159275,77,170883
35628,0.017602,74.125.130.0-255,5738,165013,77,170883
35629,0.017612,172.31.40.0-255,66,165079,77,170883
35630,0.019939,74.125.130.0-255,5738,170817,77,170883
35631,0.019947,172.31.40.0-255,66,170883,77,170883
35632,0.0,74.125.24.0-255,152,152,77,207821
35633,2.1e-05,172.31.40.0-255,66,218,77,207821
35634,2.9e-05,74.125.24.0-255,1484,1702,77,207821
35635,3.4e-05,172.31.40.0-255,66,1768,77,207821
35636,4.7e-05,74.125.24.0-255,2902,4670,77,207821
35637,5e-05,172.31.40.0-255,66,4736,77,207821
35638,5.8e-05,74.125.24.0-255,7156,11892,77,207821
35639,6.1e-05,172.31.40.0-255,66,11958,77,207821
35640,6.5e-05,74.125.24.0-255,2002,13960,77,207821
35641,6.7e-05,172.31.40.0-255,66,14026,77,207821
35642,0.000102,74.125.24.0-255,11410,25436,77,207821
35643,0.000105,172.31.40.0-255,66,25502,77,207821
35644,0.000111,74.125.24.0-255,4320,29822,77,207821
35645,0.000113,172.31.40.0-255,66,29888,77,207821
35646,0.000145,74.125.24.0-255,1125,31013,77,207821
35647,0.000147,172.31.40.0-255,66,31079,77,207821
35648,0.00015,74.125.24.0-255,1484,32563,77,207821
35649,0.000152,172.31.40.0-255,66,32629,77,207821
35650,0.000184,74.125.24.0-255,4320,36949,77,207821
35651,0.000187,172.31.40.0-255,66,37015,77,207821
35652,0.000196,74.125.24.0-255,9992,47007,77,207821
35653,0.000199,172.31.40.0-255,66,47073,77,207821
35654,0.000206,74.125.24.0-255,1125,48198,77,207821
35655,0.000208,172.31.40.0-255,66,48264,77,207821
35656,0.0007,74.125.24.0-255,1484,49748,77,207821
35657,0.000705,172.31.40.0-255,66,49814,77,207821
35658,0.000711,74.125.24.0-255,2902,52716,77,207821
35659,0.000713,172.31.40.0-255,66,52782,77,207821
35660,0.000717,74.125.24.0-255,1484,54266,77,207821
35661,0.000724,172.31.40.0-255,66,54332,77,207821
35662,0.00075,74.125.24.0-255,4320,58652,77,207821
35663,0.000756,172.31.40.0-255,66,58718,77,207821
35664,0.000766,74.125.24.0-255,9992,68710,77,207821
35665,0.000769,172.31.40.0-255,66,68776,77,207821
35666,0.000793,74.125.24.0-255,3961,72737,77,207821
35667,0.000795,172.31.40.0-255,66,72803,77,207821
35668,0.000807,74.125.24.0-255,7156,79959,77,207821
35669,0.00081,172.31.40.0-255,66,80025,77,207821
35670,0.000818,74.125.24.0-255,9992,90017,77,207821
35671,0.00082,172.31.40.0-255,66,90083,77,207821
35672,0.000849,74.125.24.0-255,3961,94044,77,207821
35673,0.000852,172.31.40.0-255,66,94110,77,207821
35674,0.00088,74.125.24.0-255,5959,100069,77,207821
35675,0.000884,172.31.40.0-255,66,100135,77,207821
35676,0.00187,74.125.24.0-255,1484,101619,77,207821
35677,0.001882,74.125.24.0-255,2902,104521,77,207821
35678,0.001886,172.31.40.0-255,66,104587,77,207821
35679,0.001896,74.125.24.0-255,5738,110325,77,207821
35680,0.001898,172.31.40.0-255,66,110391,77,207821
35681,0.001946,74.125.24.0-255,12828,123219,77,207821
35682,0.001948,172.31.40.0-255,66,123285,77,207821
35683,0.001986,74.125.24.0-255,5738,129023,77,207821
35684,0.001988,172.31.40.0-255,66,129089,77,207821
35685,0.002017,74.125.24.0-255,5020,134109,77,207821
35686,0.002019,172.31.40.0-255,66,134175,77,207821
35687,0.002178,74.125.24.0-255,1484,135659,77,207821
35688,0.002208,74.125.24.0-255,1484,137143,77,207821
35689,0.002211,172.31.40.0-255,66,137209,77,207821
35690,0.002224,74.125.24.0-255,1484,138693,77,207821
35691,0.002236,74.125.24.0-255,4320,143013,77,207821
35692,0.002238,172.31.40.0-255,66,143079,77,207821
35693,0.002245,74.125.24.0-255,5738,148817,77,207821
35694,0.002246,172.31.40.0-255,66,148883,77,207821
35695,0.00229,74.125.24.0-255,5738,154621,77,207821
35696,0.002293,172.31.40.0-255,66,154687,77,207821
35697,0.002298,74.125.24.0-255,4320,159007,77,207821
35698,0.002301,172.31.40.0-255,66,159073,77,207821
35699,0.002328,74.125.24.0-255,2902,161975,77,207821
35700,0.002331,172.31.40.0-255,66,162041,77,207821
35701,0.002338,74.125.24.0-255,6438,168479,77,207821
35702,0.002339,172.31.40.0-255,66,168545,77,207821
35703,0.004656,74.125.24.0-255,4320,172865,77,207821
35704,0.004659,172.31.40.0-255,66,172931,77,207821
35705,0.004683,74.125.24.0-255,1484,174415,77,207821
35706,0.006976,74.125.24.0-255,4320,178735,77,207821
35707,0.006981,172.31.40.0-255,66,178801,77,207821
35708,0.009288,74.125.24.0-255,5738,184539,77,207821
35709,0.009296,172.31.40.0-255,66,184605,77,207821
35710,0.011629,74.125.24.0-255,5738,190343,77,207821
35711,0.011637,172.31.40.0-255,66,190409,77,207821
35712,0.013987,74.125.24.0-255,5738,196147,77,207821
35713,0.013994,172.31.40.0-255,66,196213,77,207821
35714,0.016321,74.125.24.0-255,5738,201951,77,207821
35715,0.016327,172.31.40.0-255,66,202017,77,207821
35716,0.018634,74.125.24.0-255,5738,207755,77,207821
35717,0.018641,172.31.40.0-255,66,207821,77,207821
35718,0.0,172.217.26.0-255,153,153,77,117644
35719,2e-05,172.31.40.0-255,66,219,77,117644
35720,2.7e-05,172.217.26.0-255,1484,1703,77,117644
35721,3.2e-05,172.31.40.0-255,66,1769,77,117644
35722,3.9e-05,172.217.26.0-255,2902,4671,77,117644
35723,5.2e-05,172.31.40.0-255,66,4737,77,117644
35724,6e-05,172.217.26.0-255,7156,11893,77,117644
35725,6.3e-05,172.31.40.0-255,66,11959,77,117644
35726,6.7e-05,172.217.26.0-255,1940,13899,77,117644
35727,7e-05,172.31.40.0-255,66,13965,77,117644
35728,8.9e-05,172.217.26.0-255,1484,15449,77,117644
35729,9.5e-05,172.31.40.0-255,66,15515,77,117644
35730,0.000101,172.217.26.0-255,2902,18417,77,117644
35731,0.000104,172.31.40.0-255,66,18483,77,117644
35732,0.00011,172.217.26.0-255,5738,24221,77,117644
35733,0.000113,172.31.40.0-255,66,24287,77,117644
35734,0.000144,172.217.26.0-255,1484,25771,77,117644
35735,0.000147,172.31.40.0-255,66,25837,77,117644
35736,0.00018,172.217.26.0-255,5379,31216,77,117644
35737,0.000183,172.31.40.0-255,66,31282,77,117644
35738,0.000373,172.217.26.0-255,1484,32766,77,117644
35739,0.000378,172.31.40.0-255,66,32832,77,117644
35740,0.000384,172.217.26.0-255,2902,35734,77,117644
35741,0.000387,172.31.40.0-255,66,35800,77,117644
35742,0.000392,172.217.26.0-255,4320,40120,77,117644
35743,0.0004,172.31.40.0-255,66,40186,77,117644
35744,0.000407,172.217.26.0-255,5738,45924,77,117644
35745,0.00041,172.31.40.0-255,66,45990,77,117644
35746,0.000445,172.217.26.0-255,12469,58459,77,117644
35747,0.000448,172.31.40.0-255,66,58525,77,117644
35748,0.00046,172.217.26.0-255,6797,65322,77,117644
35749,0.000462,172.31.40.0-255,66,65388,77,117644
35750,0.002369,172.217.26.0-255,646,66034,77,117644
35751,0.002605,172.217.26.0-255,1484,67518,77,117644
35752,0.00261,172.31.40.0-255,66,67584,77,117644
35753,0.00263,172.217.26.0-255,2902,70486,77,117644
35754,0.002633,172.31.40.0-255,66,70552,77,117644
35755,0.004539,172.217.26.0-255,2902,73454,77,117644
35756,0.004542,172.31.40.0-255,66,73520,77,117644
35757,0.004573,172.217.26.0-255,2902,76422,77,117644
35758,0.004575,172.31.40.0-255,66,76488,77,117644
35759,0.006482,172.217.26.0-255,2902,79390,77,117644
35760,0.006489,172.31.40.0-255,66,79456,77,117644
35761,0.006516,172.217.26.0-255,2902,82358,77,117644
35762,0.006519,172.31.40.0-255,66,82424,77,117644
35763,0.008426,172.217.26.0-255,2902,85326,77,117644
35764,0.008432,172.31.40.0-255,66,85392,77,117644
35765,0.008465,172.217.26.0-255,2902,88294,77,117644
35766,0.008468,172.31.40.0-255,66,88360,77,117644
35767,0.010375,172.217.26.0-255,2902,91262,77,117644
35768,0.010382,172.31.40.0-255,66,91328,77,117644
35769,0.010417,172.217.26.0-255,2902,94230,77,117644
35770,0.01042,172.31.40.0-255,66,94296,77,117644
35771,0.012327,172.217.26.0-255,2902,97198,77,117644
35772,0.012333,172.31.40.0-255,66,97264,77,117644
35773,0.012347,172.217.26.0-255,2902,100166,77,117644
35774,0.012352,172.31.40.0-255,66,100232,77,117644
35775,0.014274,172.217.26.0-255,5738,105970,77,117644
35776,0.014282,172.31.40.0-255,66,106036,77,117644
35777,0.016229,172.217.26.0-255,5738,111774,77,117644
35778,0.016236,172.31.40.0-255,66,111840,77,117644
35779,0.018175,172.217.26.0-255,5738,117578,77,117644
35780,0.018183,172.31.40.0-255,66,117644,77,117644
35781,0.0,74.125.24.0-255,152,152,77,316387
35782,2.1e-05,172.31.40.0-255,66,218,77,316387
35783,2.8e-05,74.125.24.0-255,1484,1702,77,316387
35784,3.2e-05,172.31.40.0-255,66,1768,77,316387
35785,3.7e-05,74.125.24.0-255,2902,4670,77,316387
35786,4.7e-05,172.31.40.0-255,66,4736,77,316387
35787,5.4e-05,74.125.24.0-255,5738,10474,77,316387
35788,5.6e-05,172.31.40.0-255,66,10540,77,316387
35789,8.8e-05,74.125.24.0-255,3484,14024,77,316387
35790,9e-05,172.31.40.0-255,66,14090,77,316387
35791,9.7e-05,74.125.24.0-255,4320,18410,77,316387
35792,9.9e-05,172.31.40.0-255,66,18476,77,316387
35793,0.000124,74.125.24.0-255,5738,24214,77,316387
35794,0.000126,172.31.40.0-255,66,24280,77,316387
35795,0.000169,74.125.24.0-255,5738,30018,77,316387
35796,0.000172,172.31.40.0-255,66,30084,77,316387
35797,0.000196,74.125.24.0-255,1125,31209,77,316387
35798,0.000198,172.31.40.0-255,66,31275,77,316387
35799,0.000223,74.125.24.0-255,1484,32759,77,316387
35800,0.000225,172.31.40.0-255,66,32825,77,316387
35801,0.00023,74.125.24.0-255,2902,35727,77,316387
35802,0.000232,172.31.40.0-255,66,35793,77,316387
35803,0.000238,74.125.24.0-255,4320,40113,77,316387
35804,0.00024,172.31.40.0-255,66,40179,77,316387
35805,0.000265,74.125.24.0-255,1484,41663,77,316387
35806,0.000273,74.125.24.0-255,7156,48819,77,316387
35807,0.000277,172.31.40.0-255,66,48885,77,316387
35808,0.000284,172.31.40.0-255,66,48951,77,316387
35809,0.00029,74.125.24.0-255,3961,52912,77,316387
35810,0.000293,172.31.40.0-255,66,52978,77,316387
35811,0.000307,74.125.24.0-255,11410,64388,77,316387
35812,0.000309,172.31.40.0-255,66,64454,77,316387
35813,0.000346,74.125.24.0-255,1401,65855,77,316387
35814,0.000358,74.125.24.0-255,130,65985,77,316387
35815,0.000401,74.125.24.0-255,347,66332,77,316387
35816,0.000404,172.31.40.0-255,66,66398,77,316387
35817,0.000738,74.125.24.0-255,1484,67882,77,316387
35818,0.000745,74.125.24.0-255,2902,70784,77,316387
35819,0.000749,172.31.40.0-255,66,70850,77,316387
35820,0.000803,74.125.24.0-255,1484,72334,77,316387
35821,0.000819,74.125.24.0-255,2902,75236,77,316387
35822,0.000822,172.31.40.0-255,66,75302,77,316387
35823,0.000861,74.125.24.0-255,4320,79622,77,316387
35824,0.000864,172.31.40.0-255,66,79688,77,316387
35825,0.000903,74.125.24.0-255,5738,85426,77,316387
35826,0.000906,172.31.40.0-255,66,85492,77,316387
35827,0.000912,74.125.24.0-255,4320,89812,77,316387
35828,0.000914,172.31.40.0-255,66,89878,77,316387
35829,0.000948,74.125.24.0-255,5738,95616,77,316387
35830,0.00095,172.31.40.0-255,66,95682,77,316387
35831,0.000954,74.125.24.0-255,1484,97166,77,316387
35832,0.000982,74.125.24.0-255,3602,100768,77,316387
35833,0.000985,172.31.40.0-255,66,100834,77,316387
35834,0.001333,74.125.24.0-255,1484,102318,77,316387
35835,0.00134,74.125.24.0-255,2902,105220,77,316387
35836,0.001346,172.31.40.0-255,66,105286,77,316387
35837,0.001351,74.125.24.0-255,2902,108188,77,316387
35838,0.001353,172.31.40.0-255,66,108254,77,316387
35839,0.001386,74.125.24.0-255,2902,111156,77,316387
35840,0.001389,172.31.40.0-255,66,111222,77,316387
35841,0.001396,74.125.24.0-255,7156,118378,77,316387
35842,0.001399,172.31.40.0-255,66,118444,77,316387
35843,0.001452,172.31.40.0-255,66,118510,77,316387
35844,0.001456,74.125.24.0-255,2184,120694,77,316387
35845,0.001459,172.31.40.0-255,66,120760,77,316387
35846,0.001708,74.125.24.0-255,1484,122244,77,316387
35847,0.001715,74.125.24.0-255,2902,125146,77,316387
35848,0.001719,172.31.40.0-255,66,125212,77,316387
35849,0.001747,74.125.24.0-255,5738,130950,77,316387
35850,0.00175,172.31.40.0-255,66,131016,77,316387
35851,0.001784,74.125.24.0-255,12828,143844,77,316387
35852,0.001787,172.31.40.0-255,66,143910,77,316387
35853,0.001796,74.125.24.0-255,10692,154602,77,316387
35854,0.001797,172.31.40.0-255,66,154668,77,316387
35855,0.002046,74.125.24.0-255,1484,156152,77,316387
35856,0.002064,74.125.24.0-255,2902,159054,77,316387
35857,0.002066,172.31.40.0-255,66,159120,77,316387
35858,0.002072,74.125.24.0-255,4320,163440,77,316387
35859,0.002074,172.31.40.0-255,66,163506,77,316387
35860,0.002099,74.125.24.0-255,1484,164990,77,316387
35861,0.002107,74.125.24.0-255,7156,172146,77,316387
35862,0.002109,172.31.40.0-255,66,172212,77,316387
35863,0.002113,74.125.24.0-255,2902,175114,77,316387
35864,0.002116,172.31.40.0-255,66,175180,77,316387
35865,0.002153,74.125.24.0-255,11410,186590,77,316387
35866,0.002156,172.31.40.0-255,66,186656,77,316387
35867,0.00216,74.125.24.0-255,2184,188840,77,316387
35868,0.002162,172.31.40.0-255,66,188906,77,316387
35869,0.002218,74.125.24.0-255,1484,190390,77,316387
35870,0.00223,74.125.24.0-255,1484,191874,77,316387
35871,0.002233,172.31.40.0-255,66,191940,77,316387
35872,0.00227,74.125.24.0-255,1484,193424,77,316387
35873,0.002276,74.125.24.0-255,5738,199162,77,316387
35874,0.002279,172.31.40.0-255,66,199228,77,316387
35875,0.00229,74.125.24.0-255,12828,212056,77,316387
35876,0.002304,74.125.24.0-255,10692,222748,77,316387
35877,0.002311,74.125.24.0-255,5738,228486,77,316387
35878,0.002335,74.125.24.0-255,5738,234224,77,316387
35879,0.002454,74.125.24.0-255,7156,241380,77,316387
35880,0.002484,74.125.24.0-255,10692,252072,77,316387
35881,0.002489,74.125.24.0-255,4320,256392,77,316387
35882,0.002506,74.125.24.0-255,7156,263548,77,316387
35883,0.002508,74.125.24.0-255,1484,265032,77,316387
35884,0.002539,74.125.24.0-255,11410,276442,77,316387
35885,0.002545,74.125.24.0-255,5738,282180,77,316387
35886,0.002559,74.125.24.0-255,3602,285782,77,316387
35887,0.002566,74.125.24.0-255,7156,292938,77,316387
35888,0.009722,172.31.40.0-255,66,293004,77,316387
35889,0.01025,172.31.40.0-255,101,293105,77,316387
35890,0.012263,74.125.24.0-255,5738,298843,77,316387
35891,0.012275,172.31.40.0-255,66,298909,77,316387
35892,0.012753,74.125.24.0-255,66,298975,77,316387
35893,0.014829,74.125.24.0-255,5738,304713,77,316387
35894,0.014849,172.31.40.0-255,66,304779,77,316387
35895,0.017393,74.125.24.0-255,5738,310517,77,316387
35896,0.017409,172.31.40.0-255,66,310583,77,316387
35897,0.019963,74.125.24.0-255,5738,316321,77,316387
35898,0.019973,172.31.40.0-255,66,316387,77,316387
35899,0.0,74.125.200.0-255,152,152,77,255763
35900,1.5e-05,172.31.40.0-255,66,218,77,255763
35901,2.2e-05,74.125.200.0-255,1484,1702,77,255763
35902,2.6e-05,172.31.40.0-255,66,1768,77,255763
35903,4.4e-05,74.125.200.0-255,2902,4670,77,255763
35904,4.7e-05,172.31.40.0-255,66,4736,77,255763
35905,6.5e-05,74.125.200.0-255,4320,9056,77,255763
35906,6.8e-05,172.31.40.0-255,66,9122,77,255763
35907,0.000101,74.125.200.0-255,4992,14114,77,255763
35908,0.000104,172.31.40.0-255,66,14180,77,255763
35909,0.000316,74.125.200.0-255,1484,15664,77,255763
35910,0.000321,172.31.40.0-255,66,15730,77,255763
35911,0.000325,74.125.200.0-255,1484,17214,77,255763
35912,0.000327,172.31.40.0-255,66,17280,77,255763
35913,0.000342,74.125.200.0-255,1484,18764,77,255763
35914,0.000344,172.31.40.0-255,66,18830,77,255763
35915,0.000347,74.125.200.0-255,1484,20314,77,255763
35916,0.000349,172.31.40.0-255,66,20380,77,255763
35917,0.000354,74.125.200.0-255,2902,23282,77,255763
35918,0.000357,172.31.40.0-255,66,23348,77,255763
35919,0.000383,74.125.200.0-255,5738,29086,77,255763
35920,0.000385,172.31.40.0-255,66,29152,77,255763
35921,0.000401,74.125.200.0-255,2543,31695,77,255763
35922,0.000404,172.31.40.0-255,66,31761,77,255763
35923,0.000423,74.125.200.0-255,2902,34663,77,255763
35924,0.000425,172.31.40.0-255,66,34729,77,255763
35925,0.000428,74.125.200.0-255,1484,36213,77,255763
35926,0.00043,172.31.40.0-255,66,36279,77,255763
35927,0.000455,74.125.200.0-255,5738,42017,77,255763
35928,0.000458,172.31.40.0-255,66,42083,77,255763
35929,0.000462,74.125.200.0-255,2902,44985,77,255763
35930,0.000465,172.31.40.0-255,66,45051,77,255763
35931,0.000469,74.125.200.0-255,4320,49371,77,255763
35932,0.000471,172.31.40.0-255,66,49437,77,255763
35933,0.000477,74.125.200.0-255,4320,53757,77,255763
35934,0.000479,172.31.40.0-255,66,53823,77,255763
35935,0.000505,74.125.200.0-255,4320,58143,77,255763
35936,0.000508,172.31.40.0-255,66,58209,77,255763
35937,0.000516,74.125.200.0-255,7156,65365,77,255763
35938,0.000518,172.31.40.0-255,66,65431,77,255763
35939,0.000535,74.125.200.0-255,766,66197,77,255763
35940,0.000575,74.125.200.0-255,428,66625,77,255763
35941,0.000654,74.125.200.0-255,1484,68109,77,255763
35942,0.000659,172.31.40.0-255,66,68175,77,255763
35943,0.000662,74.125.200.0-255,1484,69659,77,255763
35944,0.000667,74.125.200.0-255,2902,72561,77,255763
35945,0.00067,172.31.40.0-255,66,72627,77,255763
35946,0.000676,74.125.200.0-255,5738,78365,77,255763
35947,0.000679,172.31.40.0-255,66,78431,77,255763
35948,0.000703,74.125.200.0-255,5738,84169,77,255763
35949,0.000706,172.31.40.0-255,66,84235,77,255763
35950,0.00073,74.125.200.0-255,4320,88555,77,255763
35951,0.000732,172.31.40.0-255,66,88621,77,255763
35952,0.000742,74.125.200.0-255,11410,100031,77,255763
35953,0.000744,172.31.40.0-255,66,100097,77,255763
35954,0.000746,74.125.200.0-255,1046,101143,77,255763
35955,0.000983,74.125.200.0-255,1484,102627,77,255763
35956,0.000989,172.31.40.0-255,66,102693,77,255763
35957,0.000996,74.125.200.0-255,2902,105595,77,255763
35958,0.000998,172.31.40.0-255,66,105661,77,255763
35959,0.001001,74.125.200.0-255,1484,107145,77,255763
35960,0.001008,74.125.200.0-255,2902,110047,77,255763
35961,0.001032,74.125.200.0-255,5738,115785,77,255763
35962,0.001056,74.125.200.0-255,4320,120105,77,255763
35963,0.00108,74.125.200.0-255,7156,127261,77,255763
35964,0.0011,74.125.200.0-255,2902,130163,77,255763
35965,0.001121,74.125.200.0-255,5020,135183,77,255763
35966,0.00116,74.125.200.0-255,1484,136667,77,255763
35967,0.001179,74.125.200.0-255,2902,139569,77,255763
35968,0.001182,74.125.200.0-255,1484,141053,77,255763
35969,0.001197,74.125.200.0-255,4320,145373,77,255763
35970,0.001237,74.125.200.0-255,1484,146857,77,255763
35971,0.001256,74.125.200.0-255,2902,149759,77,255763
35972,0.001262,74.125.200.0-255,5738,155497,77,255763
35973,0.001272,74.125.200.0-255,11410,166907,77,255763
35974,0.001275,74.125.200.0-255,2184,169091,77,255763
35975,0.001286,172.31.40.0-255,66,169157,77,255763
35976,0.001294,172.31.40.0-255,66,169223,77,255763
35977,0.001752,74.125.200.0-255,1484,170707,77,255763
35978,0.001757,74.125.200.0-255,1484,172191,77,255763
35979,0.00176,172.31.40.0-255,66,172257,77,255763
35980,0.001778,74.125.200.0-255,2902,175159,77,255763
35981,0.001781,172.31.40.0-255,66,175225,77,255763
35982,0.001786,74.125.200.0-255,2902,178127,77,255763
35983,0.001793,172.31.40.0-255,66,178193,77,255763
35984,0.001806,74.125.200.0-255,2902,181095,77,255763
35985,0.001822,172.31.40.0-255,66,181161,77,255763
35986,0.001841,74.125.200.0-255,11410,192571,77,255763
35987,0.001856,172.31.40.0-255,66,192637,77,255763
35988,0.001869,74.125.200.0-255,2902,195539,77,255763
35989,0.001885,172.31.40.0-255,66,195605,77,255763
35990,0.001894,74.125.200.0-255,7856,203461,77,255763
35991,0.001899,172.31.40.0-255,66,203527,77,255763
35992,0.003829,74.125.200.0-255,5738,209265,77,255763
35993,0.003836,172.31.40.0-255,66,209331,77,255763
35994,0.005768,74.125.200.0-255,5738,215069,77,255763
35995,0.005773,172.31.40.0-255,66,215135,77,255763
35996,0.007699,74.125.200.0-255,5738,220873,77,255763
35997,0.007702,172.31.40.0-255,66,220939,77,255763
35998,0.009632,74.125.200.0-255,5738,226677,77,255763
35999,0.00964,172.31.40.0-255,66,226743,77,255763
36000,0.011568,74.125.200.0-255,5738,232481,77,255763
36001,0.011576,172.31.40.0-255,66,232547,77,255763
36002,0.013499,74.125.200.0-255,5738,238285,77,255763
36003,0.013507,172.31.40.0-255,66,238351,77,255763
36004,0.015442,74.125.200.0-255,5738,244089,77,255763
36005,0.015449,172.31.40.0-255,66,244155,77,255763
36006,0.017381,74.125.200.0-255,5738,249893,77,255763
36007,0.017389,172.31.40.0-255,66,249959,77,255763
36008,0.019327,74.125.200.0-255,5738,255697,77,255763
36009,0.019334,172.31.40.0-255,66,255763,77,255763
36010,0.0,172.217.160.0-255,149,149,77,158513
36011,2.1e-05,172.31.40.0-255,66,215,77,158513
36012,2.9e-05,172.217.160.0-255,1484,1699,77,158513
36013,3.3e-05,172.31.40.0-255,66,1765,77,158513
36014,3.9e-05,172.217.160.0-255,2902,4667,77,158513
36015,4.3e-05,172.31.40.0-255,66,4733,77,158513
36016,5.1e-05,172.217.160.0-255,7156,11889,77,158513
36017,5.5e-05,172.31.40.0-255,66,11955,77,158513
36018,5.9e-05,172.217.160.0-255,1983,13938,77,158513
36019,6.2e-05,172.31.40.0-255,66,14004,77,158513
36020,0.000368,172.217.160.0-255,1484,15488,77,158513
36021,0.000374,172.31.40.0-255,66,15554,77,158513
36022,0.00038,172.217.160.0-255,2902,18456,77,158513
36023,0.000383,172.31.40.0-255,66,18522,77,158513
36024,0.000388,172.217.160.0-255,5738,24260,77,158513
36025,0.00039,172.31.40.0-255,66,24326,77,158513
36026,0.000415,172.217.160.0-255,6797,31123,77,158513
36027,0.000418,172.31.40.0-255,66,31189,77,158513
36028,0.00054,172.217.160.0-255,1484,32673,77,158513
36029,0.000544,172.31.40.0-255,66,32739,77,158513
36030,0.000549,172.217.160.0-255,2902,35641,77,158513
36031,0.000551,172.31.40.0-255,66,35707,77,158513
36032,0.000554,172.217.160.0-255,1484,37191,77,158513
36033,0.000556,172.31.40.0-255,66,37257,77,158513
36034,0.000573,172.217.160.0-255,2902,40159,77,158513
36035,0.000576,172.31.40.0-255,66,40225,77,158513
36036,0.000578,172.217.160.0-255,1484,41709,77,158513
36037,0.00058,172.31.40.0-255,66,41775,77,158513
36038,0.00061,172.217.160.0-255,8215,49990,77,158513
36039,0.000612,172.31.40.0-255,66,50056,77,158513
36040,0.000637,172.217.160.0-255,7156,57212,77,158513
36041,0.00064,172.31.40.0-255,66,57278,77,158513
36042,0.000669,172.217.160.0-255,8215,65493,77,158513
36043,0.000673,172.217.160.0-255,372,65865,77,158513
36044,0.000822,172.31.40.0-255,66,65931,77,158513
36045,0.000952,172.217.160.0-255,370,66301,77,158513
36046,0.001059,172.217.160.0-255,1484,67785,77,158513
36047,0.001075,172.217.160.0-255,2902,70687,77,158513
36048,0.001079,172.217.160.0-255,2902,73589,77,158513
36049,0.001091,172.217.160.0-255,2902,76491,77,158513
36050,0.001103,172.217.160.0-255,1484,77975,77,158513
36051,0.001106,172.31.40.0-255,66,78041,77,158513
36052,0.001131,172.217.160.0-255,12469,90510,77,158513
36053,0.001136,172.217.160.0-255,4320,94830,77,158513
36054,0.001143,172.31.40.0-255,66,94896,77,158513
36055,0.001152,172.217.160.0-255,2902,97798,77,158513
36056,0.001164,172.217.160.0-255,2543,100341,77,158513
36057,0.001188,172.31.40.0-255,66,100407,77,158513
36058,0.002849,172.217.160.0-255,5738,106145,77,158513
36059,0.002857,172.31.40.0-255,66,106211,77,158513
36060,0.004503,172.217.160.0-255,2902,109113,77,158513
36061,0.00452,172.217.160.0-255,2902,112015,77,158513
36062,0.004688,172.31.40.0-255,66,112081,77,158513
36063,0.006358,172.217.160.0-255,5738,117819,77,158513
36064,0.006362,172.31.40.0-255,66,117885,77,158513
36065,0.008012,172.217.160.0-255,5738,123623,77,158513
36066,0.008018,172.31.40.0-255,66,123689,77,158513
36067,0.009678,172.217.160.0-255,5738,129427,77,158513
36068,0.009684,172.31.40.0-255,66,129493,77,158513
36069,0.011332,172.217.160.0-255,5738,135231,77,158513
36070,0.011338,172.31.40.0-255,66,135297,77,158513
36071,0.012985,172.217.160.0-255,5738,141035,77,158513
36072,0.013337,172.31.40.0-255,66,141101,77,158513
36073,0.014986,172.217.160.0-255,5738,146839,77,158513
36074,0.014993,172.31.40.0-255,66,146905,77,158513
36075,0.016695,172.217.160.0-255,5738,152643,77,158513
36076,0.016704,172.31.40.0-255,66,152709,77,158513
36077,0.018355,172.217.160.0-255,5738,158447,77,158513
36078,0.018363,172.31.40.0-255,66,158513,77,158513
36079,0.0,172.217.27.0-255,153,153,77,149246
36080,2.7e-05,172.31.40.0-255,66,219,77,149246
36081,3.5e-05,172.217.27.0-255,1484,1703,77,149246
36082,3.9e-05,172.31.40.0-255,66,1769,77,149246
36083,4.5e-05,172.217.27.0-255,2902,4671,77,149246
36084,4.9e-05,172.31.40.0-255,66,4737,77,149246
36085,5.7e-05,172.217.27.0-255,7156,11893,77,149246
36086,6e-05,172.31.40.0-255,66,11959,77,149246
36087,6.4e-05,172.217.27.0-255,2034,13993,77,149246
36088,6.6e-05,172.31.40.0-255,66,14059,77,149246
36089,8.7e-05,172.217.27.0-255,2902,16961,77,149246
36090,9e-05,172.31.40.0-255,66,17027,77,149246
36091,9.4e-05,172.217.27.0-255,2902,19929,77,149246
36092,9.6e-05,172.31.40.0-255,66,19995,77,149246
36093,0.000102,172.217.27.0-255,2902,22897,77,149246
36094,0.000104,172.31.40.0-255,66,22963,77,149246
36095,0.000124,172.217.27.0-255,1484,24447,77,149246
36096,0.000126,172.31.40.0-255,66,24513,77,149246
36097,0.000161,172.217.27.0-255,6797,31310,77,149246
36098,0.000164,172.31.40.0-255,66,31376,77,149246
36099,0.000478,172.217.27.0-255,1484,32860,77,149246
36100,0.000485,172.31.40.0-255,66,32926,77,149246
36101,0.000491,172.217.27.0-255,2902,35828,77,149246
36102,0.000494,172.31.40.0-255,66,35894,77,149246
36103,0.000497,172.217.27.0-255,1484,37378,77,149246
36104,0.000499,172.31.40.0-255,66,37444,77,149246
36105,0.000519,172.217.27.0-255,1484,38928,77,149246
36106,0.000522,172.31.40.0-255,66,38994,77,149246
36107,0.000528,172.217.27.0-255,4320,43314,77,149246
36108,0.00053,172.31.40.0-255,66,43380,77,149246
36109,0.00055,172.217.27.0-255,2902,46282,77,149246
36110,0.000552,172.31.40.0-255,66,46348,77,149246
36111,0.000568,172.217.27.0-255,6797,53145,77,149246
36112,0.00057,172.31.40.0-255,66,53211,77,149246
36113,0.000579,172.217.27.0-255,7156,60367,77,149246
36114,0.000582,172.31.40.0-255,66,60433,77,149246
36115,0.000601,172.217.27.0-255,2902,63335,77,149246
36116,0.000604,172.31.40.0-255,66,63401,77,149246
36117,0.000607,172.217.27.0-255,2817,66218,77,149246
36118,0.000609,172.31.40.0-255,66,66284,77,149246
36119,0.000972,172.217.27.0-255,130,66414,77,149246
36120,0.001145,172.217.27.0-255,1484,67898,77,149246
36121,0.00115,172.31.40.0-255,66,67964,77,149246
36122,0.001156,172.217.27.0-255,2902,70866,77,149246
36123,0.001159,172.31.40.0-255,66,70932,77,149246
36124,0.001163,172.217.27.0-255,2902,73834,77,149246
36125,0.001165,172.31.40.0-255,66,73900,77,149246
36126,0.001184,172.217.27.0-255,2902,76802,77,149246
36127,0.001188,172.31.40.0-255,66,76868,77,149246
36128,0.001195,172.217.27.0-255,6797,83665,77,149246
36129,0.001197,172.31.40.0-255,66,83731,77,149246
36130,0.00125,172.31.40.0-255,66,83797,77,149246
36131,0.001254,172.217.27.0-255,2543,86340,77,149246
36132,0.001256,172.31.40.0-255,66,86406,77,149246
36133,0.001258,172.217.27.0-255,348,86754,77,149246
36134,0.002863,172.217.27.0-255,4320,91074,77,149246
36135,0.002874,172.31.40.0-255,66,91140,77,149246
36136,0.002879,172.31.40.0-255,66,91206,77,149246
36137,0.004505,172.217.27.0-255,5738,96944,77,149246
36138,0.004511,172.31.40.0-255,66,97010,77,149246
36139,0.00613,172.217.27.0-255,5738,102748,77,149246
36140,0.006133,172.31.40.0-255,66,102814,77,149246
36141,0.00776,172.217.27.0-255,5738,108552,77,149246
36142,0.007765,172.31.40.0-255,66,108618,77,149246
36143,0.009395,172.217.27.0-255,5738,114356,77,149246
36144,0.009402,172.31.40.0-255,66,114422,77,149246
36145,0.011038,172.217.27.0-255,5738,120160,77,149246
36146,0.011045,172.31.40.0-255,66,120226,77,149246
36147,0.012674,172.217.27.0-255,5738,125964,77,149246
36148,0.012682,172.31.40.0-255,66,126030,77,149246
36149,0.014313,172.217.27.0-255,5738,131768,77,149246
36150,0.01432,172.31.40.0-255,66,131834,77,149246
36151,0.015951,172.217.27.0-255,5738,137572,77,149246
36152,0.01596,172.31.40.0-255,66,137638,77,149246
36153,0.017589,172.217.27.0-255,5738,143376,77,149246
36154,0.017597,172.31.40.0-255,66,143442,77,149246
36155,0.019227,172.217.27.0-255,5738,149180,77,149246
36156,0.019234,172.31.40.0-255,66,149246,77,149246
36157,0.0,74.125.24.0-255,297,297,77,372212
36158,2.3e-05,172.31.40.0-255,66,363,77,372212
36159,3e-05,74.125.24.0-255,1484,1847,77,372212
36160,3.4e-05,172.31.40.0-255,66,1913,77,372212
36161,4e-05,74.125.24.0-255,2902,4815,77,372212
36162,4.4e-05,172.31.40.0-255,66,4881,77,372212
36163,5.8e-05,74.125.24.0-255,4320,9201,77,372212
36164,6.2e-05,172.31.40.0-255,66,9267,77,372212
36165,8.9e-05,74.125.24.0-255,1484,10751,77,372212
36166,9.2e-05,172.31.40.0-255,66,10817,77,372212
36167,9.7e-05,74.125.24.0-255,2902,13719,77,372212
36168,9.9e-05,172.31.40.0-255,66,13785,77,372212
36169,0.000138,74.125.24.0-255,4320,18105,77,372212
36170,0.000141,172.31.40.0-255,66,18171,77,372212
36171,0.000169,74.125.24.0-255,1840,20011,77,372212
36172,0.000172,172.31.40.0-255,66,20077,77,372212
36173,0.00018,74.125.24.0-255,7156,27233,77,372212
36174,0.000182,172.31.40.0-255,66,27299,77,372212
36175,0.000187,74.125.24.0-255,3961,31260,77,372212
36176,0.000189,172.31.40.0-255,66,31326,77,372212
36177,0.000309,74.125.24.0-255,1484,32810,77,372212
36178,0.000314,172.31.40.0-255,66,32876,77,372212
36179,0.000319,74.125.24.0-255,2902,35778,77,372212
36180,0.000321,172.31.40.0-255,66,35844,77,372212
36181,0.000347,74.125.24.0-255,4320,40164,77,372212
36182,0.000349,172.31.40.0-255,66,40230,77,372212
36183,0.000406,74.125.24.0-255,9633,49863,77,372212
36184,0.000409,172.31.40.0-255,66,49929,77,372212
36185,0.000416,74.125.24.0-255,7156,57085,77,372212
36186,0.000419,172.31.40.0-255,66,57151,77,372212
36187,0.000471,74.125.24.0-255,2902,60053,77,372212
36188,0.000474,172.31.40.0-255,66,60119,77,372212
36189,0.000496,74.125.24.0-255,5379,65498,77,372212
36190,0.000499,172.31.40.0-255,66,65564,77,372212
36191,0.003461,74.125.24.0-255,645,66209,77,372212
36192,0.00349,74.125.24.0-255,1484,67693,77,372212
36193,0.003495,172.31.40.0-255,66,67759,77,372212
36194,0.003502,74.125.24.0-255,4320,72079,77,372212
36195,0.003504,172.31.40.0-255,66,72145,77,372212
36196,0.003508,74.125.24.0-255,1484,73629,77,372212
36197,0.003536,74.125.24.0-255,8574,82203,77,372212
36198,0.003539,172.31.40.0-255,66,82269,77,372212
36199,0.003544,74.125.24.0-255,2902,85171,77,372212
36200,0.003546,172.31.40.0-255,66,85237,77,372212
36201,0.003589,74.125.24.0-255,12828,98065,77,372212
36202,0.003592,172.31.40.0-255,66,98131,77,372212
36203,0.003596,74.125.24.0-255,2184,100315,77,372212
36204,0.003598,172.31.40.0-255,66,100381,77,372212
36205,0.003771,74.125.24.0-255,1484,101865,77,372212
36206,0.003789,74.125.24.0-255,2902,104767,77,372212
36207,0.003792,172.31.40.0-255,66,104833,77,372212
36208,0.003798,74.125.24.0-255,5738,110571,77,372212
36209,0.0038,172.31.40.0-255,66,110637,77,372212
36210,0.003822,74.125.24.0-255,2902,113539,77,372212
36211,0.003824,172.31.40.0-255,66,113605,77,372212
36212,0.003858,74.125.24.0-255,7156,120761,77,372212
36213,0.00386,172.31.40.0-255,66,120827,77,372212
36214,0.003879,172.31.40.0-255,66,120893,77,372212
36215,0.003896,74.125.24.0-255,12828,133721,77,372212
36216,0.003898,172.31.40.0-255,66,133787,77,372212
36217,0.00393,74.125.24.0-255,5738,139525,77,372212
36218,0.003933,172.31.40.0-255,66,139591,77,372212
36219,0.003942,74.125.24.0-255,10692,150283,77,372212
36220,0.003945,172.31.40.0-255,66,150349,77,372212
36221,0.004351,74.125.24.0-255,1484,151833,77,372212
36222,0.00437,74.125.24.0-255,2902,154735,77,372212
36223,0.004374,172.31.40.0-255,66,154801,77,372212
36224,0.004382,74.125.24.0-255,5738,160539,77,372212
36225,0.004385,172.31.40.0-255,66,160605,77,372212
36226,0.004415,74.125.24.0-255,9992,170597,77,372212
36227,0.004418,172.31.40.0-255,66,170663,77,372212
36228,0.004445,74.125.24.0-255,2902,173565,77,372212
36229,0.004447,172.31.40.0-255,66,173631,77,372212
36230,0.004476,74.125.24.0-255,10692,184323,77,372212
36231,0.004479,172.31.40.0-255,66,184389,77,372212
36232,0.004646,74.125.24.0-255,1484,185873,77,372212
36233,0.004665,74.125.24.0-255,2902,188775,77,372212
36234,0.004669,172.31.40.0-255,66,188841,77,372212
36235,0.004706,74.125.24.0-255,2902,191743,77,372212
36236,0.004709,172.31.40.0-255,66,191809,77,372212
36237,0.004733,74.125.24.0-255,7156,198965,77,372212
36238,0.004736,172.31.40.0-255,66,199031,77,372212
36239,0.00479,74.125.24.0-255,5738,204769,77,372212
36240,0.004793,172.31.40.0-255,66,204835,77,372212
36241,0.004805,74.125.24.0-255,2902,207737,77,372212
36242,0.004811,172.31.40.0-255,66,207803,77,372212
36243,0.004819,74.125.24.0-255,10692,218495,77,372212
36244,0.004822,172.31.40.0-255,66,218561,77,372212
36245,0.004953,74.125.24.0-255,1484,220045,77,372212
36246,0.004959,74.125.24.0-255,2902,222947,77,372212
36247,0.004962,172.31.40.0-255,66,223013,77,372212
36248,0.004973,74.125.24.0-255,1484,224497,77,372212
36249,0.004991,74.125.24.0-255,4320,228817,77,372212
36250,0.004994,172.31.40.0-255,66,228883,77,372212
36251,0.005026,74.125.24.0-255,12828,241711,77,372212
36252,0.005029,172.31.40.0-255,66,241777,77,372212
36253,0.005036,74.125.24.0-255,7156,248933,77,372212
36254,0.005039,172.31.40.0-255,66,248999,77,372212
36255,0.005058,74.125.24.0-255,3602,252601,77,372212
36256,0.00506,172.31.40.0-255,66,252667,77,372212
36257,0.005116,74.125.24.0-255,1484,254151,77,372212
36258,0.005129,74.125.24.0-255,2902,257053,77,372212
36259,0.005132,172.31.40.0-255,66,257119,77,372212
36260,0.005135,74.125.24.0-255,1484,258603,77,372212
36261,0.005162,74.125.24.0-255,4320,262923,77,372212
36262,0.005165,172.31.40.0-255,66,262989,77,372212
36263,0.005187,74.125.24.0-255,1484,264473,77,372212
36264,0.005218,74.125.24.0-255,11410,275883,77,372212
36265,0.005221,172.31.40.0-255,66,275949,77,372212
36266,0.005224,74.125.24.0-255,2902,278851,77,372212
36267,0.005226,172.31.40.0-255,66,278917,77,372212
36268,0.005254,74.125.24.0-255,9274,288191,77,372212
36269,0.005257,172.31.40.0-255,66,288257,77,372212
36270,0.005262,74.125.24.0-255,4320,292577,77,372212
36271,0.005264,172.31.40.0-255,66,292643,77,372212
36272,0.005278,74.125.24.0-255,5738,298381,77,372212
36273,0.00528,172.31.40.0-255,66,298447,77,372212
36274,0.005306,74.125.24.0-255,8574,307021,77,372212
36275,0.005308,172.31.40.0-255,66,307087,77,372212
36276,0.005331,74.125.24.0-255,8574,315661,77,372212
36277,0.005333,172.31.40.0-255,66,315727,77,372212
36278,0.005346,74.125.24.0-255,4320,320047,77,372212
36279,0.005351,172.31.40.0-255,66,320113,77,372212
36280,0.005381,74.125.24.0-255,3602,323715,77,372212
36281,0.005384,172.31.40.0-255,66,323781,77,372212
36282,0.005391,74.125.24.0-255,8574,332355,77,372212
36283,0.005393,172.31.40.0-255,66,332421,77,372212
36284,0.005399,74.125.24.0-255,5738,338159,77,372212
36285,0.005401,172.31.40.0-255,66,338225,77,372212
36286,0.00543,74.125.24.0-255,12828,351053,77,372212
36287,0.005433,172.31.40.0-255,66,351119,77,372212
36288,0.005437,74.125.24.0-255,3602,354721,77,372212
36289,0.00544,172.31.40.0-255,66,354787,77,372212
36290,0.005487,172.31.40.0-255,66,354853,77,372212
36291,0.005489,74.125.24.0-255,1484,356337,77,372212
36292,0.005524,74.125.24.0-255,12110,368447,77,372212
36293,0.005527,172.31.40.0-255,66,368513,77,372212
36294,0.005531,74.125.24.0-255,2637,371150,77,372212
36295,0.005533,172.31.40.0-255,66,371216,77,372212
36296,0.005536,74.125.24.0-255,105,371321,77,372212
36297,0.005586,74.125.24.0-255,129,371450,77,372212
36298,0.010477,172.31.40.0-255,105,371555,77,372212
36299,0.010517,172.31.40.0-255,105,371660,77,372212
36300,0.010798,172.31.40.0-255,90,371750,77,372212
36301,0.010808,172.31.40.0-255,66,371816,77,372212
36302,0.012727,74.125.24.0-255,66,371882,77,372212
36303,0.012749,74.125.24.0-255,66,371948,77,372212
36304,0.013027,74.125.24.0-255,66,372014,77,372212
36305,0.013052,74.125.24.0-255,66,372080,77,372212
36306,0.013058,172.31.40.0-255,66,372146,77,372212
36307,0.013062,74.125.24.0-255,66,372212,77,372212
36308,0.0,172.217.194.0-255,301,301,77,354035
36309,2.3e-05,172.31.40.0-255,66,367,77,354035
36310,3e-05,172.217.194.0-255,1484,1851,77,354035
36311,3.4e-05,172.31.40.0-255,66,1917,77,354035
36312,4.1e-05,172.217.194.0-255,4320,6237,77,354035
36313,5.1e-05,172.31.40.0-255,66,6303,77,354035
36314,5.8e-05,172.217.194.0-255,5738,12041,77,354035
36315,6.1e-05,172.31.40.0-255,66,12107,77,354035
36316,6.8e-05,172.217.194.0-255,6060,18167,77,354035
36317,7.1e-05,172.31.40.0-255,66,18233,77,354035
36318,8e-05,172.217.194.0-255,9992,28225,77,354035
36319,8.2e-05,172.31.40.0-255,66,28291,77,354035
36320,0.000103,172.217.194.0-255,2902,31193,77,354035
36321,0.000106,172.31.40.0-255,66,31259,77,354035
36322,0.000138,172.217.194.0-255,4320,35579,77,354035
36323,0.000141,172.31.40.0-255,66,35645,77,354035
36324,0.000185,172.31.40.0-255,66,35711,77,354035
36325,0.000205,172.31.40.0-255,66,35777,77,354035
36326,0.000437,172.217.194.0-255,100,35877,77,354035
36327,0.000442,172.31.40.0-255,66,35943,77,354035
36328,0.00055,172.217.194.0-255,1484,37427,77,354035
36329,0.000554,172.31.40.0-255,66,37493,77,354035
36330,0.000582,172.217.194.0-255,2902,40395,77,354035
36331,0.000585,172.31.40.0-255,66,40461,77,354035
36332,0.000592,172.217.194.0-255,5738,46199,77,354035
36333,0.000594,172.31.40.0-255,66,46265,77,354035
36334,0.000631,172.217.194.0-255,13887,60152,77,354035
36335,0.000635,172.31.40.0-255,66,60218,77,354035
36336,0.00064,172.217.194.0-255,2902,63120,77,354035
36337,0.000642,172.31.40.0-255,66,63186,77,354035
36338,0.000677,172.217.194.0-255,6797,69983,77,354035
36339,0.00068,172.31.40.0-255,66,70049,77,354035
36340,0.000775,172.217.194.0-255,1484,71533,77,354035
36341,0.000808,172.217.194.0-255,2902,74435,77,354035
36342,0.000812,172.31.40.0-255,66,74501,77,354035
36343,0.000819,172.217.194.0-255,4320,78821,77,354035
36344,0.000821,172.31.40.0-255,66,78887,77,354035
36345,0.000863,172.217.194.0-255,8574,87461,77,354035
36346,0.000866,172.31.40.0-255,66,87527,77,354035
36347,0.000874,172.217.194.0-255,7156,94683,77,354035
36348,0.000882,172.31.40.0-255,66,94749,77,354035
36349,0.000911,172.217.194.0-255,9274,104023,77,354035
36350,0.000915,172.31.40.0-255,66,104089,77,354035
36351,0.000972,172.217.194.0-255,5738,109827,77,354035
36352,0.000975,172.31.40.0-255,66,109893,77,354035
36353,0.000984,172.217.194.0-255,7156,117049,77,354035
36354,0.000987,172.31.40.0-255,66,117115,77,354035
36355,0.000996,172.217.194.0-255,2902,120017,77,354035
36356,0.000998,172.31.40.0-255,66,120083,77,354035
36357,0.001039,172.217.194.0-255,11410,131493,77,354035
36358,0.001042,172.31.40.0-255,66,131559,77,354035
36359,0.00105,172.217.194.0-255,6438,137997,77,354035
36360,0.001052,172.31.40.0-255,66,138063,77,354035
36361,0.001085,172.217.194.0-255,1484,139547,77,354035
36362,0.001088,172.217.194.0-255,2902,142449,77,354035
36363,0.001092,172.217.194.0-255,2902,145351,77,354035
36364,0.001103,172.31.40.0-255,66,145417,77,354035
36365,0.001106,172.31.40.0-255,66,145483,77,354035
36366,0.001111,172.217.194.0-255,2902,148385,77,354035
36367,0.001113,172.31.40.0-255,66,148451,77,354035
36368,0.001124,172.217.194.0-255,5738,154189,77,354035
36369,0.001129,172.31.40.0-255,66,154255,77,354035
36370,0.001151,172.217.194.0-255,4320,158575,77,354035
36371,0.001158,172.31.40.0-255,66,158641,77,354035
36372,0.001168,172.217.194.0-255,11410,170051,77,354035
36373,0.00117,172.31.40.0-255,66,170117,77,354035
36374,0.001176,172.217.194.0-255,6438,176555,77,354035
36375,0.001179,172.31.40.0-255,66,176621,77,354035
36376,0.001182,172.217.194.0-255,1484,178105,77,354035
36377,0.00121,172.217.194.0-255,5738,183843,77,354035
36378,0.001213,172.31.40.0-255,66,183909,77,354035
36379,0.001243,172.217.194.0-255,9992,193901,77,354035
36380,0.001246,172.31.40.0-255,66,193967,77,354035
36381,0.001275,172.217.194.0-255,5738,199705,77,354035
36382,0.001278,172.31.40.0-255,66,199771,77,354035
36383,0.001285,172.217.194.0-255,6438,206209,77,354035
36384,0.001296,172.217.194.0-255,4320,210529,77,354035
36385,0.00131,172.217.194.0-255,2902,213431,77,354035
36386,0.001355,172.217.194.0-255,5738,219169,77,354035
36387,0.001385,172.217.194.0-255,9992,229161,77,354035
36388,0.001394,172.217.194.0-255,10692,239853,77,354035
36389,0.001398,172.31.40.0-255,66,239919,77,354035
36390,0.001404,172.31.40.0-255,66,239985,77,354035
36391,0.001482,172.217.194.0-255,1484,241469,77,354035
36392,0.001498,172.217.194.0-255,2902,244371,77,354035
36393,0.001504,172.217.194.0-255,5738,250109,77,354035
36394,0.001518,172.217.194.0-255,2902,253011,77,354035
36395,0.001542,172.217.194.0-255,2902,255913,77,354035
36396,0.001548,172.217.194.0-255,4320,260233,77,354035
36397,0.001552,172.31.40.0-255,66,260299,77,354035
36398,0.001571,172.217.194.0-255,8574,268873,77,354035
36399,0.001578,172.217.194.0-255,5020,273893,77,354035
36400,0.001584,172.31.40.0-255,66,273959,77,354035
36401,0.001635,172.217.194.0-255,1484,275443,77,354035
36402,0.00164,172.217.194.0-255,2902,278345,77,354035
36403,0.001643,172.217.194.0-255,1484,279829,77,354035
36404,0.001661,172.217.194.0-255,4320,284149,77,354035
36405,0.001665,172.217.194.0-255,1484,285633,77,354035
36406,0.001674,172.31.40.0-255,66,285699,77,354035
36407,0.001704,172.217.194.0-255,11410,297109,77,354035
36408,0.001713,172.217.194.0-255,8574,305683,77,354035
36409,0.00173,172.217.194.0-255,5738,311421,77,354035
36410,0.001734,172.31.40.0-255,66,311487,77,354035
36411,0.001749,172.217.194.0-255,11410,322897,77,354035
36412,0.001754,172.31.40.0-255,66,322963,77,354035
36413,0.001771,172.217.194.0-255,6438,329401,77,354035
36414,0.001787,172.217.194.0-255,12110,341511,77,354035
36415,0.001814,172.217.194.0-255,5738,347249,77,354035
36416,0.00182,172.31.40.0-255,66,347315,77,354035
36417,0.001879,172.217.194.0-255,6378,353693,77,354035
36418,0.001882,172.217.194.0-255,105,353798,77,354035
36419,0.001888,172.31.40.0-255,66,353864,77,354035
36420,0.011545,172.31.40.0-255,105,353969,77,354035
36421,0.01392,172.217.194.0-255,66,354035,77,354035
36422,0.0,172.217.194.0-255,297,297,77,338656
36423,1.6e-05,172.31.40.0-255,66,363,77,338656
36424,2.2e-05,172.217.194.0-255,1484,1847,77,338656
36425,2.6e-05,172.31.40.0-255,66,1913,77,338656
36426,3.2e-05,172.217.194.0-255,4320,6233,77,338656
36427,4.4e-05,172.31.40.0-255,66,6299,77,338656
36428,5.1e-05,172.217.194.0-255,5738,12037,77,338656
36429,5.4e-05,172.31.40.0-255,66,12103,77,338656
36430,9.5e-05,172.217.194.0-255,3203,15306,77,338656
36431,9.8e-05,172.31.40.0-255,66,15372,77,338656
36432,0.000108,172.217.194.0-255,9992,25364,77,338656
36433,0.000111,172.31.40.0-255,66,25430,77,338656
36434,0.000118,172.217.194.0-255,5379,30809,77,338656
36435,0.000121,172.31.40.0-255,66,30875,77,338656
36436,0.000179,172.217.194.0-255,1484,32359,77,338656
36437,0.000182,172.31.40.0-255,66,32425,77,338656
36438,0.000187,172.217.194.0-255,2902,35327,77,338656
36439,0.000189,172.31.40.0-255,66,35393,77,338656
36440,0.000196,172.217.194.0-255,5738,41131,77,338656
36441,0.000198,172.31.40.0-255,66,41197,77,338656
36442,0.000208,172.217.194.0-255,12828,54025,77,338656
36443,0.000212,172.31.40.0-255,66,54091,77,338656
36444,0.000219,172.217.194.0-255,7156,61247,77,338656
36445,0.000221,172.31.40.0-255,66,61313,77,338656
36446,0.000226,172.217.194.0-255,2902,64215,77,338656
36447,0.000228,172.31.40.0-255,66,64281,77,338656
36448,0.000251,172.217.194.0-255,1376,65657,77,338656
36449,0.000254,172.31.40.0-255,66,65723,77,338656
36450,0.000434,172.217.194.0-255,1484,67207,77,338656
36451,0.000438,172.31.40.0-255,66,67273,77,338656
36452,0.000446,172.217.194.0-255,2902,70175,77,338656
36453,0.000449,172.31.40.0-255,66,70241,77,338656
36454,0.00046,172.217.194.0-255,5738,75979,77,338656
36455,0.000463,172.31.40.0-255,66,76045,77,338656
36456,0.000493,172.217.194.0-255,11410,87455,77,338656
36457,0.000495,172.31.40.0-255,66,87521,77,338656
36458,0.000525,172.217.194.0-255,1484,89005,77,338656
36459,0.000537,172.217.194.0-255,10692,99697,77,338656
36460,0.00054,172.31.40.0-255,66,99763,77,338656
36461,0.000709,172.217.194.0-255,1484,101247,77,338656
36462,0.000716,172.217.194.0-255,2902,104149,77,338656
36463,0.000719,172.31.40.0-255,66,104215,77,338656
36464,0.000727,172.217.194.0-255,5738,109953,77,338656
36465,0.00073,172.31.40.0-255,66,110019,77,338656
36466,0.000761,172.217.194.0-255,7156,117175,77,338656
36467,0.000766,172.31.40.0-255,66,117241,77,338656
36468,0.000779,172.217.194.0-255,5738,122979,77,338656
36469,0.000782,172.31.40.0-255,66,123045,77,338656
36470,0.000832,172.31.40.0-255,66,123111,77,338656
36471,0.000889,172.31.40.0-255,66,123177,77,338656
36472,0.000916,172.217.194.0-255,1484,124661,77,338656
36473,0.000925,172.217.194.0-255,7856,132517,77,338656
36474,0.000927,172.31.40.0-255,66,132583,77,338656
36475,0.000936,172.217.194.0-255,8574,141157,77,338656
36476,0.000938,172.31.40.0-255,66,141223,77,338656
36477,0.00096,172.31.40.0-255,66,141289,77,338656
36478,0.000965,172.217.194.0-255,3602,144891,77,338656
36479,0.000968,172.31.40.0-255,66,144957,77,338656
36480,0.001022,172.217.194.0-255,1484,146441,77,338656
36481,0.001027,172.217.194.0-255,2902,149343,77,338656
36482,0.00103,172.31.40.0-255,66,149409,77,338656
36483,0.001033,172.217.194.0-255,1484,150893,77,338656
36484,0.001065,172.217.194.0-255,4320,155213,77,338656
36485,0.00107,172.217.194.0-255,4320,159533,77,338656
36486,0.001073,172.31.40.0-255,66,159599,77,338656
36487,0.001076,172.31.40.0-255,66,159665,77,338656
36488,0.001099,172.217.194.0-255,2902,162567,77,338656
36489,0.001101,172.31.40.0-255,66,162633,77,338656
36490,0.001113,172.217.194.0-255,11410,174043,77,338656
36491,0.001115,172.31.40.0-255,66,174109,77,338656
36492,0.001147,172.217.194.0-255,2902,177011,77,338656
36493,0.00115,172.31.40.0-255,66,177077,77,338656
36494,0.001154,172.217.194.0-255,2184,179261,77,338656
36495,0.001156,172.31.40.0-255,66,179327,77,338656
36496,0.001166,172.217.194.0-255,8574,187901,77,338656
36497,0.001168,172.31.40.0-255,66,187967,77,338656
36498,0.001206,172.217.194.0-255,9992,197959,77,338656
36499,0.001209,172.31.40.0-255,66,198025,77,338656
36500,0.001224,172.217.194.0-255,11410,209435,77,338656
36501,0.00123,172.217.194.0-255,3602,213037,77,338656
36502,0.001264,172.31.40.0-255,66,213103,77,338656
36503,0.001423,172.217.194.0-255,1484,214587,77,338656
36504,0.00143,172.217.194.0-255,2902,217489,77,338656
36505,0.001433,172.31.40.0-255,66,217555,77,338656
36506,0.00146,172.217.194.0-255,5738,223293,77,338656
36507,0.001462,172.31.40.0-255,66,223359,77,338656
36508,0.001492,172.217.194.0-255,9992,233351,77,338656
36509,0.001497,172.31.40.0-255,66,233417,77,338656
36510,0.001507,172.217.194.0-255,1484,234901,77,338656
36511,0.001535,172.217.194.0-255,5738,240639,77,338656
36512,0.00154,172.31.40.0-255,66,240705,77,338656
36513,0.001561,172.217.194.0-255,6438,247143,77,338656
36514,0.001579,172.31.40.0-255,66,247209,77,338656
36515,0.001582,172.217.194.0-255,1484,248693,77,338656
36516,0.001605,172.217.194.0-255,2902,251595,77,338656
36517,0.001617,172.31.40.0-255,66,251661,77,338656
36518,0.001642,172.217.194.0-255,5738,257399,77,338656
36519,0.001649,172.217.194.0-255,5738,263137,77,338656
36520,0.001655,172.217.194.0-255,4320,267457,77,338656
36521,0.001666,172.31.40.0-255,66,267523,77,338656
36522,0.001696,172.217.194.0-255,8574,276097,77,338656
36523,0.001702,172.217.194.0-255,5020,281117,77,338656
36524,0.001705,172.217.194.0-255,1484,282601,77,338656
36525,0.001715,172.31.40.0-255,66,282667,77,338656
36526,0.001728,172.217.194.0-255,4320,286987,77,338656
36527,0.001771,172.217.194.0-255,5738,292725,77,338656
36528,0.001785,172.217.194.0-255,4320,297045,77,338656
36529,0.001809,172.217.194.0-255,13528,310573,77,338656
36530,0.001817,172.217.194.0-255,8574,319147,77,338656
36531,0.001821,172.31.40.0-255,66,319213,77,338656
36532,0.001834,172.217.194.0-255,5738,324951,77,338656
36533,0.001848,172.217.194.0-255,11410,336361,77,338656
36534,0.001864,172.217.194.0-255,1887,338248,77,338656
36535,0.001875,172.31.40.0-255,66,338314,77,338656
36536,0.001898,172.217.194.0-255,105,338419,77,338656
36537,0.011859,172.31.40.0-255,66,338485,77,338656
36538,0.011905,172.31.40.0-255,105,338590,77,338656
36539,0.014557,172.217.194.0-255,66,338656,77,338656
36540,0.0,172.31.40.0-255,105,105,77,459
36541,0.000275,172.31.40.0-255,90,195,77,459
36542,0.000295,172.31.40.0-255,66,261,77,459
36543,0.002895,74.125.24.0-255,66,327,77,459
36544,0.002926,74.125.24.0-255,66,393,77,459
36545,0.002949,172.31.40.0-255,66,459,77,459
