,TIME,SRC,PACKET_SIZE,CUMULATIVE_PACKET_SIZE,PAGE_NUMBER,TOTAL_PACKET_SIZE
0,0.0,74.125.130.0-255,810,810,1,79088
1,1.7e-05,74.125.130.0-255,1484,2294,1,79088
2,2.6e-05,172.31.36.0-255,66,2360,1,79088
3,3.4e-05,74.125.130.0-255,2902,5262,1,79088
4,3.7e-05,172.31.36.0-255,66,5328,1,79088
5,5e-05,74.125.130.0-255,5738,11066,1,79088
6,5.3e-05,172.31.36.0-255,66,11132,1,79088
7,0.000223,74.125.130.0-255,4709,15841,1,79088
8,0.000229,172.31.36.0-255,66,15907,1,79088
9,0.000393,74.125.130.0-255,5738,21645,1,79088
10,0.000397,172.31.36.0-255,66,21711,1,79088
11,0.000593,74.125.130.0-255,5738,27449,1,79088
12,0.000608,74.125.130.0-255,2902,30351,1,79088
13,0.000622,172.31.36.0-255,66,30417,1,79088
14,0.002148,74.125.130.0-255,5738,36155,1,79088
15,0.00216,172.31.36.0-255,66,36221,1,79088
16,0.002229,74.125.130.0-255,4320,40541,1,79088
17,0.002233,172.31.36.0-255,66,40607,1,79088
18,0.0036,74.125.130.0-255,1484,42091,1,79088
19,0.003649,74.125.130.0-255,5738,47829,1,79088
20,0.005968,172.31.36.0-255,66,47895,1,79088
21,0.006463,172.31.36.0-255,66,47961,1,79088
22,0.008238,172.31.36.0-255,66,48027,1,79088
23,0.008535,74.125.130.0-255,7156,55183,1,79088
24,0.008541,172.31.36.0-255,66,55249,1,79088
25,0.008569,74.125.130.0-255,2424,57673,1,79088
26,0.008573,172.31.36.0-255,66,57739,1,79088
27,0.008738,74.125.130.0-255,7156,64895,1,79088
28,0.008742,172.31.36.0-255,66,64961,1,79088
29,0.008798,172.31.36.0-255,66,65027,1,79088
30,0.009405,74.125.130.0-255,5738,70765,1,79088
31,0.00941,172.31.36.0-255,66,70831,1,79088
32,0.00946,172.31.36.0-255,66,70897,1,79088
33,0.010381,172.31.36.0-255,66,70963,1,79088
34,0.010415,74.125.130.0-255,4518,75481,1,79088
35,0.010419,172.31.36.0-255,66,75547,1,79088
36,0.010691,172.31.36.0-255,66,75613,1,79088
37,0.010743,172.31.36.0-255,66,75679,1,79088
38,0.011315,172.31.36.0-255,66,75745,1,79088
39,0.0114,172.31.36.0-255,66,75811,1,79088
40,0.011896,172.31.36.0-255,66,75877,1,79088
41,0.01195,172.31.36.0-255,66,75943,1,79088
42,0.01248,74.125.130.0-255,1484,77427,1,79088
43,0.012523,172.31.36.0-255,66,77493,1,79088
44,0.012582,172.31.36.0-255,66,77559,1,79088
45,0.013111,172.31.36.0-255,66,77625,1,79088
46,0.013705,172.31.36.0-255,105,77730,1,79088
47,0.015789,74.125.130.0-255,66,77796,1,79088
48,0.049943,172.31.36.0-255,168,77964,1,79088
49,0.049976,172.31.36.0-255,1124,79088,1,79088
50,0.0,74.125.130.0-255,150,150,1,302798
51,3e-05,172.31.36.0-255,66,216,1,302798
52,3.7e-05,74.125.130.0-255,1484,1700,1,302798
53,4.1e-05,172.31.36.0-255,66,1766,1,302798
54,5.4e-05,74.125.130.0-255,2902,4668,1,302798
55,5.8e-05,172.31.36.0-255,66,4734,1,302798
56,6.4e-05,74.125.130.0-255,5738,10472,1,302798
57,6.7e-05,172.31.36.0-255,66,10538,1,302798
58,8.9e-05,74.125.130.0-255,3472,14010,1,302798
59,9.2e-05,172.31.36.0-255,66,14076,1,302798
60,0.000215,74.125.130.0-255,1484,15560,1,302798
61,0.00022,172.31.36.0-255,66,15626,1,302798
62,0.000226,74.125.130.0-255,2902,18528,1,302798
63,0.000228,172.31.36.0-255,66,18594,1,302798
64,0.000233,74.125.130.0-255,2902,21496,1,302798
65,0.00024,172.31.36.0-255,66,21562,1,302798
66,0.000244,74.125.130.0-255,2902,24464,1,302798
67,0.000247,172.31.36.0-255,66,24530,1,302798
68,0.000279,74.125.130.0-255,1484,26014,1,302798
69,0.000282,172.31.36.0-255,66,26080,1,302798
70,0.000311,74.125.130.0-255,2902,28982,1,302798
71,0.000317,172.31.36.0-255,66,29048,1,302798
72,0.000336,74.125.130.0-255,6797,35845,1,302798
73,0.00034,172.31.36.0-255,66,35911,1,302798
74,0.000346,74.125.130.0-255,5738,41649,1,302798
75,0.000348,172.31.36.0-255,66,41715,1,302798
76,0.000365,172.31.36.0-255,66,41781,1,302798
77,0.000371,74.125.130.0-255,6438,48219,1,302798
78,0.000374,172.31.36.0-255,66,48285,1,302798
79,0.000388,74.125.130.0-255,646,48931,1,302798
80,0.000391,172.31.36.0-255,66,48997,1,302798
81,0.000495,74.125.130.0-255,1484,50481,1,302798
82,0.000515,74.125.130.0-255,2902,53383,1,302798
83,0.000519,172.31.36.0-255,66,53449,1,302798
84,0.000527,74.125.130.0-255,5738,59187,1,302798
85,0.00053,172.31.36.0-255,66,59253,1,302798
86,0.000571,172.31.36.0-255,66,59319,1,302798
87,0.000582,172.31.36.0-255,66,59385,1,302798
88,0.000604,74.125.130.0-255,1635,61020,1,302798
89,0.000607,172.31.36.0-255,66,61086,1,302798
90,0.000736,74.125.130.0-255,1484,62570,1,302798
91,0.00074,74.125.130.0-255,1484,64054,1,302798
92,0.000743,172.31.36.0-255,66,64120,1,302798
93,0.000771,74.125.130.0-255,1484,65604,1,302798
94,0.000777,74.125.130.0-255,4320,69924,1,302798
95,0.00078,172.31.36.0-255,66,69990,1,302798
96,0.000786,74.125.130.0-255,5738,75728,1,302798
97,0.000788,172.31.36.0-255,66,75794,1,302798
98,0.0008,74.125.130.0-255,5738,81532,1,302798
99,0.000804,172.31.36.0-255,66,81598,1,302798
100,0.000829,74.125.130.0-255,5738,87336,1,302798
101,0.000837,172.31.36.0-255,66,87402,1,302798
102,0.000847,172.31.36.0-255,66,87468,1,302798
103,0.001161,74.125.130.0-255,1484,88952,1,302798
104,0.001176,74.125.130.0-255,2902,91854,1,302798
105,0.00118,172.31.36.0-255,66,91920,1,302798
106,0.001184,74.125.130.0-255,1484,93404,1,302798
107,0.001207,74.125.130.0-255,4320,97724,1,302798
108,0.00121,172.31.36.0-255,66,97790,1,302798
109,0.001215,74.125.130.0-255,2902,100692,1,302798
110,0.001219,172.31.36.0-255,66,100758,1,302798
111,0.001234,74.125.130.0-255,5738,106496,1,302798
112,0.001238,172.31.36.0-255,66,106562,1,302798
113,0.001249,172.31.36.0-255,66,106628,1,302798
114,0.001275,74.125.130.0-255,5020,111648,1,302798
115,0.001283,172.31.36.0-255,66,111714,1,302798
116,0.001342,74.125.130.0-255,1484,113198,1,302798
117,0.001358,74.125.130.0-255,2902,116100,1,302798
118,0.001361,172.31.36.0-255,66,116166,1,302798
119,0.001366,74.125.130.0-255,2902,119068,1,302798
120,0.001368,172.31.36.0-255,66,119134,1,302798
121,0.001409,74.125.130.0-255,4320,123454,1,302798
122,0.001414,172.31.36.0-255,66,123520,1,302798
123,0.001431,172.31.36.0-255,66,123586,1,302798
124,0.001434,74.125.130.0-255,1484,125070,1,302798
125,0.001466,74.125.130.0-255,5738,130808,1,302798
126,0.001469,172.31.36.0-255,66,130874,1,302798
127,0.001476,74.125.130.0-255,5738,136612,1,302798
128,0.001478,172.31.36.0-255,66,136678,1,302798
129,0.001505,74.125.130.0-255,766,137444,1,302798
130,0.001649,74.125.130.0-255,1484,138928,1,302798
131,0.001653,172.31.36.0-255,66,138994,1,302798
132,0.00166,74.125.130.0-255,2902,141896,1,302798
133,0.001662,172.31.36.0-255,66,141962,1,302798
134,0.001679,74.125.130.0-255,5738,147700,1,302798
135,0.001682,172.31.36.0-255,66,147766,1,302798
136,0.00169,74.125.130.0-255,7156,154922,1,302798
137,0.001693,172.31.36.0-255,66,154988,1,302798
138,0.001762,172.31.36.0-255,66,155054,1,302798
139,0.001767,74.125.130.0-255,2184,157238,1,302798
140,0.001769,172.31.36.0-255,66,157304,1,302798
141,0.003767,74.125.130.0-255,5738,163042,1,302798
142,0.003774,172.31.36.0-255,66,163108,1,302798
143,0.005778,74.125.130.0-255,2902,166010,1,302798
144,0.005785,172.31.36.0-255,66,166076,1,302798
145,0.005816,74.125.130.0-255,2902,168978,1,302798
146,0.005819,172.31.36.0-255,66,169044,1,302798
147,0.007789,74.125.130.0-255,2902,171946,1,302798
148,0.007795,172.31.36.0-255,66,172012,1,302798
149,0.007832,74.125.130.0-255,2902,174914,1,302798
150,0.007836,172.31.36.0-255,66,174980,1,302798
151,0.009802,74.125.130.0-255,2902,177882,1,302798
152,0.009811,172.31.36.0-255,66,177948,1,302798
153,0.009848,74.125.130.0-255,2902,180850,1,302798
154,0.009852,172.31.36.0-255,66,180916,1,302798
155,0.011822,74.125.130.0-255,2902,183818,1,302798
156,0.01183,172.31.36.0-255,66,183884,1,302798
157,0.011864,74.125.130.0-255,2902,186786,1,302798
158,0.011868,172.31.36.0-255,66,186852,1,302798
159,0.013837,74.125.130.0-255,2902,189754,1,302798
160,0.013846,172.31.36.0-255,66,189820,1,302798
161,0.013879,74.125.130.0-255,2902,192722,1,302798
162,0.013883,172.31.36.0-255,66,192788,1,302798
163,0.015867,74.125.130.0-255,2902,195690,1,302798
164,0.015875,172.31.36.0-255,66,195756,1,302798
165,0.015905,74.125.130.0-255,2902,198658,1,302798
166,0.015909,172.31.36.0-255,66,198724,1,302798
167,0.017876,74.125.130.0-255,2902,201626,1,302798
168,0.017882,172.31.36.0-255,66,201692,1,302798
169,0.017919,74.125.130.0-255,2902,204594,1,302798
170,0.017923,172.31.36.0-255,66,204660,1,302798
171,0.019891,74.125.130.0-255,2902,207562,1,302798
172,0.0199,172.31.36.0-255,66,207628,1,302798
173,0.019933,74.125.130.0-255,2902,210530,1,302798
174,0.019937,172.31.36.0-255,66,210596,1,302798
175,0.021901,74.125.130.0-255,2902,213498,1,302798
176,0.021909,172.31.36.0-255,66,213564,1,302798
177,0.021943,74.125.130.0-255,2902,216466,1,302798
178,0.021948,172.31.36.0-255,66,216532,1,302798
179,0.023934,74.125.130.0-255,2902,219434,1,302798
180,0.023941,172.31.36.0-255,66,219500,1,302798
181,0.023976,74.125.130.0-255,2902,222402,1,302798
182,0.023981,172.31.36.0-255,66,222468,1,302798
183,0.025943,74.125.130.0-255,2902,225370,1,302798
184,0.02595,172.31.36.0-255,66,225436,1,302798
185,0.02598,74.125.130.0-255,2902,228338,1,302798
186,0.025984,172.31.36.0-255,66,228404,1,302798
187,0.027968,74.125.130.0-255,2902,231306,1,302798
188,0.027976,172.31.36.0-255,66,231372,1,302798
189,0.028013,74.125.130.0-255,2902,234274,1,302798
190,0.028017,172.31.36.0-255,66,234340,1,302798
191,0.029982,74.125.130.0-255,2902,237242,1,302798
192,0.029989,172.31.36.0-255,66,237308,1,302798
193,0.030022,74.125.130.0-255,2902,240210,1,302798
194,0.030027,172.31.36.0-255,66,240276,1,302798
195,0.030593,172.31.36.0-255,172,240448,1,302798
196,0.030639,172.31.36.0-255,1115,241563,1,302798
197,0.030714,172.31.36.0-255,1514,243077,1,302798
198,0.030716,172.31.36.0-255,1514,244591,1,302798
199,0.03072,172.31.36.0-255,1514,246105,1,302798
200,0.030722,172.31.36.0-255,1514,247619,1,302798
201,0.030746,172.31.36.0-255,1491,249110,1,302798
202,0.031999,74.125.130.0-255,2902,252012,1,302798
203,0.032006,172.31.36.0-255,66,252078,1,302798
204,0.032043,74.125.130.0-255,2902,254980,1,302798
205,0.032048,172.31.36.0-255,66,255046,1,302798
206,0.032073,104.244.42.0-255,66,255112,1,302798
207,0.03212,104.244.42.0-255,66,255178,1,302798
208,0.03223,104.244.42.0-255,66,255244,1,302798
209,0.032255,104.244.42.0-255,66,255310,1,302798
210,0.034015,74.125.130.0-255,2902,258212,1,302798
211,0.034021,172.31.36.0-255,66,258278,1,302798
212,0.034056,74.125.130.0-255,2902,261180,1,302798
213,0.034059,172.31.36.0-255,66,261246,1,302798
214,0.036029,74.125.130.0-255,2902,264148,1,302798
215,0.036034,172.31.36.0-255,66,264214,1,302798
216,0.036071,74.125.130.0-255,2902,267116,1,302798
217,0.036075,172.31.36.0-255,66,267182,1,302798
218,0.038038,74.125.130.0-255,2902,270084,1,302798
219,0.038043,172.31.36.0-255,66,270150,1,302798
220,0.038076,74.125.130.0-255,2902,273052,1,302798
221,0.038079,172.31.36.0-255,66,273118,1,302798
222,0.040047,74.125.130.0-255,2902,276020,1,302798
223,0.040052,172.31.36.0-255,66,276086,1,302798
224,0.040089,74.125.130.0-255,2902,278988,1,302798
225,0.040093,172.31.36.0-255,66,279054,1,302798
226,0.042057,74.125.130.0-255,2902,281956,1,302798
227,0.042078,172.31.36.0-255,66,282022,1,302798
228,0.042105,74.125.130.0-255,2902,284924,1,302798
229,0.04211,172.31.36.0-255,66,284990,1,302798
230,0.044079,74.125.130.0-255,2902,287892,1,302798
231,0.044084,172.31.36.0-255,66,287958,1,302798
232,0.044121,74.125.130.0-255,2902,290860,1,302798
233,0.044125,172.31.36.0-255,66,290926,1,302798
234,0.046085,74.125.130.0-255,2902,293828,1,302798
235,0.046091,172.31.36.0-255,66,293894,1,302798
236,0.04613,74.125.130.0-255,2902,296796,1,302798
237,0.046134,172.31.36.0-255,66,296862,1,302798
238,0.048091,74.125.130.0-255,2902,299764,1,302798
239,0.048096,172.31.36.0-255,66,299830,1,302798
240,0.048134,74.125.130.0-255,2902,302732,1,302798
241,0.048137,172.31.36.0-255,66,302798,1,302798
242,0.0,74.125.24.0-255,153,153,1,265444
243,2.3e-05,172.31.36.0-255,66,219,1,265444
244,3.1e-05,74.125.24.0-255,1484,1703,1,265444
245,3.5e-05,172.31.36.0-255,66,1769,1,265444
246,4.1e-05,74.125.24.0-255,2902,4671,1,265444
247,4.4e-05,172.31.36.0-255,66,4737,1,265444
248,5.2e-05,74.125.24.0-255,5738,10475,1,265444
249,5.6e-05,172.31.36.0-255,66,10541,1,265444
250,8.6e-05,74.125.24.0-255,2902,13443,1,265444
251,8.9e-05,172.31.36.0-255,66,13509,1,265444
252,0.000109,74.125.24.0-255,534,14043,1,265444
253,0.000111,172.31.36.0-255,66,14109,1,265444
254,0.000153,74.125.24.0-255,1484,15593,1,265444
255,0.000157,172.31.36.0-255,66,15659,1,265444
256,0.000179,74.125.24.0-255,2902,18561,1,265444
257,0.000182,172.31.36.0-255,66,18627,1,265444
258,0.000188,74.125.24.0-255,5738,24365,1,265444
259,0.000191,172.31.36.0-255,66,24431,1,265444
260,0.000196,74.125.24.0-255,4320,28751,1,265444
261,0.000198,172.31.36.0-255,66,28817,1,265444
262,0.00023,74.125.24.0-255,4320,33137,1,265444
263,0.000234,172.31.36.0-255,66,33203,1,265444
264,0.000263,172.31.36.0-255,66,33269,1,265444
265,0.000269,74.125.24.0-255,6797,40066,1,265444
266,0.000272,172.31.36.0-255,66,40132,1,265444
267,0.000638,74.125.24.0-255,1484,41616,1,265444
268,0.000644,172.31.36.0-255,66,41682,1,265444
269,0.000652,74.125.24.0-255,2902,44584,1,265444
270,0.000655,172.31.36.0-255,66,44650,1,265444
271,0.000673,74.125.24.0-255,4320,48970,1,265444
272,0.000676,172.31.36.0-255,66,49036,1,265444
273,0.000697,74.125.24.0-255,1484,50520,1,265444
274,0.000706,74.125.24.0-255,6797,57317,1,265444
275,0.000709,172.31.36.0-255,66,57383,1,265444
276,0.000712,74.125.24.0-255,647,58030,1,265444
277,0.00075,74.125.24.0-255,1484,59514,1,265444
278,0.000753,172.31.36.0-255,66,59580,1,265444
279,0.000759,74.125.24.0-255,4320,63900,1,265444
280,0.000762,172.31.36.0-255,66,63966,1,265444
281,0.000785,74.125.24.0-255,1484,65450,1,265444
282,0.000797,74.125.24.0-255,4320,69770,1,265444
283,0.0008,172.31.36.0-255,66,69836,1,265444
284,0.000821,74.125.24.0-255,4320,74156,1,265444
285,0.000824,172.31.36.0-255,66,74222,1,265444
286,0.00083,74.125.24.0-255,4320,78542,1,265444
287,0.000832,172.31.36.0-255,66,78608,1,265444
288,0.000853,172.31.36.0-255,66,78674,1,265444
289,0.000869,74.125.24.0-255,2543,81217,1,265444
290,0.000872,172.31.36.0-255,66,81283,1,265444
291,0.000875,74.125.24.0-255,1125,82408,1,265444
292,0.001016,74.125.24.0-255,1484,83892,1,265444
293,0.001021,172.31.36.0-255,66,83958,1,265444
294,0.001041,74.125.24.0-255,2902,86860,1,265444
295,0.001045,172.31.36.0-255,66,86926,1,265444
296,0.001051,74.125.24.0-255,5738,92664,1,265444
297,0.001053,172.31.36.0-255,66,92730,1,265444
298,0.001073,74.125.24.0-255,1484,94214,1,265444
299,0.001093,74.125.24.0-255,4320,98534,1,265444
300,0.001097,172.31.36.0-255,66,98600,1,265444
301,0.00112,74.125.24.0-255,7156,105756,1,265444
302,0.001124,172.31.36.0-255,66,105822,1,265444
303,0.001131,74.125.24.0-255,7156,112978,1,265444
304,0.001133,172.31.36.0-255,66,113044,1,265444
305,0.001136,74.125.24.0-255,1484,114528,1,265444
306,0.001157,74.125.24.0-255,2184,116712,1,265444
307,0.00116,172.31.36.0-255,66,116778,1,265444
308,0.00118,74.125.24.0-255,4320,121098,1,265444
309,0.001183,172.31.36.0-255,66,121164,1,265444
310,0.001186,74.125.24.0-255,1484,122648,1,265444
311,0.001206,74.125.24.0-255,5738,128386,1,265444
312,0.001209,172.31.36.0-255,66,128452,1,265444
313,0.001229,74.125.24.0-255,5738,134190,1,265444
314,0.001232,172.31.36.0-255,66,134256,1,265444
315,0.001251,74.125.24.0-255,7156,141412,1,265444
316,0.001254,172.31.36.0-255,66,141478,1,265444
317,0.001302,172.31.36.0-255,66,141544,1,265444
318,0.001358,74.125.24.0-255,1484,143028,1,265444
319,0.001364,74.125.24.0-255,2902,145930,1,265444
320,0.001367,172.31.36.0-255,66,145996,1,265444
321,0.001393,74.125.24.0-255,5738,151734,1,265444
322,0.001396,172.31.36.0-255,66,151800,1,265444
323,0.001404,74.125.24.0-255,7156,158956,1,265444
324,0.001406,172.31.36.0-255,66,159022,1,265444
325,0.001422,74.125.24.0-255,2902,161924,1,265444
326,0.001424,172.31.36.0-255,66,161990,1,265444
327,0.001458,172.31.36.0-255,66,162056,1,265444
328,0.001477,74.125.24.0-255,1484,163540,1,265444
329,0.001481,74.125.24.0-255,2184,165724,1,265444
330,0.001486,172.31.36.0-255,66,165790,1,265444
331,0.001631,74.125.24.0-255,1484,167274,1,265444
332,0.001637,74.125.24.0-255,2902,170176,1,265444
333,0.00164,172.31.36.0-255,66,170242,1,265444
334,0.001646,74.125.24.0-255,2902,173144,1,265444
335,0.001648,172.31.36.0-255,66,173210,1,265444
336,0.001662,74.125.24.0-255,2902,176112,1,265444
337,0.001665,172.31.36.0-255,66,176178,1,265444
338,0.001672,74.125.24.0-255,5738,181916,1,265444
339,0.001674,172.31.36.0-255,66,181982,1,265444
340,0.001704,74.125.24.0-255,7156,189138,1,265444
341,0.001707,172.31.36.0-255,66,189204,1,265444
342,0.001722,172.31.36.0-255,66,189270,1,265444
343,0.001764,74.125.24.0-255,4320,193590,1,265444
344,0.001766,172.31.36.0-255,66,193656,1,265444
345,0.001801,172.31.36.0-255,66,193722,1,265444
346,0.001829,172.31.36.0-255,66,193788,1,265444
347,0.00184,172.31.36.0-255,66,193854,1,265444
348,0.001843,74.125.24.0-255,766,194620,1,265444
349,0.001846,74.125.24.0-255,1484,196104,1,265444
350,0.001847,172.31.36.0-255,66,196170,1,265444
351,0.001852,74.125.24.0-255,2902,199072,1,265444
352,0.001854,172.31.36.0-255,66,199138,1,265444
353,0.001887,74.125.24.0-255,5738,204876,1,265444
354,0.001891,172.31.36.0-255,66,204942,1,265444
355,0.001926,172.31.36.0-255,66,205008,1,265444
356,0.001943,74.125.24.0-255,1484,206492,1,265444
357,0.00195,74.125.24.0-255,7156,213648,1,265444
358,0.001953,172.31.36.0-255,66,213714,1,265444
359,0.001977,74.125.24.0-255,3602,217316,1,265444
360,0.00198,172.31.36.0-255,66,217382,1,265444
361,0.001995,74.125.24.0-255,1484,218866,1,265444
362,0.002008,74.125.24.0-255,1484,220350,1,265444
363,0.002012,172.31.36.0-255,66,220416,1,265444
364,0.002031,74.125.24.0-255,1484,221900,1,265444
365,0.002038,74.125.24.0-255,5738,227638,1,265444
366,0.002041,172.31.36.0-255,66,227704,1,265444
367,0.002047,74.125.24.0-255,4320,232024,1,265444
368,0.002049,172.31.36.0-255,66,232090,1,265444
369,0.002088,172.31.36.0-255,66,232156,1,265444
370,0.002094,74.125.24.0-255,5738,237894,1,265444
371,0.002097,172.31.36.0-255,66,237960,1,265444
372,0.002103,74.125.24.0-255,7156,245116,1,265444
373,0.002106,172.31.36.0-255,66,245182,1,265444
374,0.002144,172.31.36.0-255,66,245248,1,265444
375,0.002158,172.31.36.0-255,66,245314,1,265444
376,0.002168,172.31.36.0-255,66,245380,1,265444
377,0.002199,74.125.24.0-255,6438,251818,1,265444
378,0.002203,172.31.36.0-255,66,251884,1,265444
379,0.00222,172.31.36.0-255,66,251950,1,265444
380,0.002232,172.31.36.0-255,66,252016,1,265444
381,0.002244,172.31.36.0-255,66,252082,1,265444
382,0.002273,74.125.24.0-255,3925,256007,1,265444
383,0.002276,74.125.24.0-255,105,256112,1,265444
384,0.00228,172.31.36.0-255,66,256178,1,265444
385,0.005044,172.31.36.0-255,66,256244,1,265444
386,0.005082,172.31.36.0-255,105,256349,1,265444
387,0.007371,74.125.24.0-255,66,256415,1,265444
388,0.031729,172.31.36.0-255,172,256587,1,265444
389,0.031759,172.31.36.0-255,1114,257701,1,265444
390,0.031839,172.31.36.0-255,1514,259215,1,265444
391,0.031841,172.31.36.0-255,1514,260729,1,265444
392,0.031843,172.31.36.0-255,1514,262243,1,265444
393,0.031847,172.31.36.0-255,1514,263757,1,265444
394,0.031848,172.31.36.0-255,1489,265246,1,265444
395,0.033278,104.244.42.0-255,66,265312,1,265444
396,0.033412,104.244.42.0-255,66,265378,1,265444
397,0.033462,104.244.42.0-255,66,265444,1,265444
398,0.0,74.125.24.0-255,146,146,1,248127
399,1.6e-05,172.31.36.0-255,66,212,1,248127
400,2.4e-05,74.125.24.0-255,1484,1696,1,248127
401,2.8e-05,172.31.36.0-255,66,1762,1,248127
402,3.3e-05,74.125.24.0-255,2902,4664,1,248127
403,3.7e-05,172.31.36.0-255,66,4730,1,248127
404,4.3e-05,74.125.24.0-255,5738,10468,1,248127
405,4.7e-05,172.31.36.0-255,66,10534,1,248127
406,8e-05,74.125.24.0-255,3483,14017,1,248127
407,8.3e-05,172.31.36.0-255,66,14083,1,248127
408,0.000314,74.125.24.0-255,1484,15567,1,248127
409,0.00032,172.31.36.0-255,66,15633,1,248127
410,0.000325,74.125.24.0-255,2902,18535,1,248127
411,0.000328,172.31.36.0-255,66,18601,1,248127
412,0.000335,74.125.24.0-255,5738,24339,1,248127
413,0.000337,172.31.36.0-255,66,24405,1,248127
414,0.000359,74.125.24.0-255,5738,30143,1,248127
415,0.000369,172.31.36.0-255,66,30209,1,248127
416,0.000383,74.125.24.0-255,1125,31334,1,248127
417,0.000385,172.31.36.0-255,66,31400,1,248127
418,0.000766,74.125.24.0-255,1484,32884,1,248127
419,0.000773,172.31.36.0-255,66,32950,1,248127
420,0.000782,74.125.24.0-255,2902,35852,1,248127
421,0.000784,172.31.36.0-255,66,35918,1,248127
422,0.000791,74.125.24.0-255,4320,40238,1,248127
423,0.000793,172.31.36.0-255,66,40304,1,248127
424,0.000818,74.125.24.0-255,1484,41788,1,248127
425,0.00082,172.31.36.0-255,66,41854,1,248127
426,0.000828,74.125.24.0-255,5738,47592,1,248127
427,0.00083,172.31.36.0-255,66,47658,1,248127
428,0.000837,74.125.24.0-255,7156,54814,1,248127
429,0.000839,172.31.36.0-255,66,54880,1,248127
430,0.000871,74.125.24.0-255,6797,61677,1,248127
431,0.000874,172.31.36.0-255,66,61743,1,248127
432,0.00088,74.125.24.0-255,3961,65704,1,248127
433,0.000882,172.31.36.0-255,66,65770,1,248127
434,0.001211,74.125.24.0-255,646,66416,1,248127
435,0.001307,74.125.24.0-255,1484,67900,1,248127
436,0.001314,172.31.36.0-255,66,67966,1,248127
437,0.00132,74.125.24.0-255,2902,70868,1,248127
438,0.001322,172.31.36.0-255,66,70934,1,248127
439,0.001329,74.125.24.0-255,5738,76672,1,248127
440,0.001331,172.31.36.0-255,66,76738,1,248127
441,0.00135,74.125.24.0-255,2902,79640,1,248127
442,0.001352,172.31.36.0-255,66,79706,1,248127
443,0.00138,172.31.36.0-255,66,79772,1,248127
444,0.001402,74.125.24.0-255,2902,82674,1,248127
445,0.001404,172.31.36.0-255,66,82740,1,248127
446,0.00142,74.125.24.0-255,6797,89537,1,248127
447,0.001422,172.31.36.0-255,66,89603,1,248127
448,0.002113,74.125.24.0-255,1484,91087,1,248127
449,0.002119,74.125.24.0-255,2902,93989,1,248127
450,0.002123,172.31.36.0-255,66,94055,1,248127
451,0.002126,74.125.24.0-255,1484,95539,1,248127
452,0.002145,74.125.24.0-255,2902,98441,1,248127
453,0.002147,172.31.36.0-255,66,98507,1,248127
454,0.002153,74.125.24.0-255,5738,104245,1,248127
455,0.002155,172.31.36.0-255,66,104311,1,248127
456,0.002167,74.125.24.0-255,2902,107213,1,248127
457,0.002169,172.31.36.0-255,66,107279,1,248127
458,0.002187,74.125.24.0-255,2902,110181,1,248127
459,0.002189,172.31.36.0-255,66,110247,1,248127
460,0.002209,172.31.36.0-255,66,110313,1,248127
461,0.00223,74.125.24.0-255,2184,112497,1,248127
462,0.002231,172.31.36.0-255,66,112563,1,248127
463,0.002259,74.125.24.0-255,2902,115465,1,248127
464,0.002261,172.31.36.0-255,66,115531,1,248127
465,0.00228,74.125.24.0-255,7156,122687,1,248127
466,0.002282,172.31.36.0-255,66,122753,1,248127
467,0.002314,172.31.36.0-255,66,122819,1,248127
468,0.002325,74.125.24.0-255,1484,124303,1,248127
469,0.002351,172.31.36.0-255,66,124369,1,248127
470,0.004725,74.125.24.0-255,4320,128689,1,248127
471,0.004728,172.31.36.0-255,66,128755,1,248127
472,0.004745,74.125.24.0-255,1484,130239,1,248127
473,0.007085,74.125.24.0-255,4320,134559,1,248127
474,0.00709,172.31.36.0-255,66,134625,1,248127
475,0.009423,74.125.24.0-255,5738,140363,1,248127
476,0.009432,172.31.36.0-255,66,140429,1,248127
477,0.011777,74.125.24.0-255,5738,146167,1,248127
478,0.011786,172.31.36.0-255,66,146233,1,248127
479,0.014124,74.125.24.0-255,5738,151971,1,248127
480,0.014135,172.31.36.0-255,66,152037,1,248127
481,0.016485,74.125.24.0-255,5738,157775,1,248127
482,0.016495,172.31.36.0-255,66,157841,1,248127
483,0.018825,74.125.24.0-255,5738,163579,1,248127
484,0.018833,172.31.36.0-255,66,163645,1,248127
485,0.021154,74.125.24.0-255,5738,169383,1,248127
486,0.021161,172.31.36.0-255,66,169449,1,248127
487,0.02349,74.125.24.0-255,5738,175187,1,248127
488,0.023496,172.31.36.0-255,66,175253,1,248127
489,0.025845,74.125.24.0-255,5738,180991,1,248127
490,0.025856,172.31.36.0-255,66,181057,1,248127
491,0.02818,74.125.24.0-255,5738,186795,1,248127
492,0.028187,172.31.36.0-255,66,186861,1,248127
493,0.030538,74.125.24.0-255,5738,192599,1,248127
494,0.030546,172.31.36.0-255,66,192665,1,248127
495,0.032876,74.125.24.0-255,5738,198403,1,248127
496,0.032884,172.31.36.0-255,66,198469,1,248127
497,0.035202,74.125.24.0-255,5738,204207,1,248127
498,0.035209,172.31.36.0-255,66,204273,1,248127
499,0.035241,172.31.36.0-255,172,204445,1,248127
500,0.035271,172.31.36.0-255,1113,205558,1,248127
501,0.035393,172.31.36.0-255,1514,207072,1,248127
502,0.0354,172.31.36.0-255,1514,208586,1,248127
503,0.035401,172.31.36.0-255,1514,210100,1,248127
504,0.035402,172.31.36.0-255,1514,211614,1,248127
505,0.035429,172.31.36.0-255,1491,213105,1,248127
506,0.036845,104.244.42.0-255,66,213171,1,248127
507,0.036854,104.244.42.0-255,66,213237,1,248127
508,0.037044,104.244.42.0-255,66,213303,1,248127
509,0.037556,74.125.24.0-255,5738,219041,1,248127
510,0.037563,172.31.36.0-255,66,219107,1,248127
511,0.039922,74.125.24.0-255,5738,224845,1,248127
512,0.03993,172.31.36.0-255,66,224911,1,248127
513,0.042289,74.125.24.0-255,5738,230649,1,248127
514,0.042298,172.31.36.0-255,66,230715,1,248127
515,0.044676,74.125.24.0-255,5738,236453,1,248127
516,0.044682,172.31.36.0-255,66,236519,1,248127
517,0.047011,74.125.24.0-255,5738,242257,1,248127
518,0.047017,172.31.36.0-255,66,242323,1,248127
519,0.049356,74.125.24.0-255,5738,248061,1,248127
520,0.049362,172.31.36.0-255,66,248127,1,248127
521,0.0,172.217.194.0-255,152,152,1,290977
522,1.8e-05,172.31.36.0-255,66,218,1,290977
523,2.4e-05,172.217.194.0-255,1484,1702,1,290977
524,2.8e-05,172.31.36.0-255,66,1768,1,290977
525,3.4e-05,172.217.194.0-255,2902,4670,1,290977
526,3.8e-05,172.31.36.0-255,66,4736,1,290977
527,4.5e-05,172.217.194.0-255,5738,10474,1,290977
528,4.8e-05,172.31.36.0-255,66,10540,1,290977
529,5.4e-05,172.217.194.0-255,4320,14860,1,290977
530,5.6e-05,172.31.36.0-255,66,14926,1,290977
531,9.7e-05,172.31.36.0-255,66,14992,1,290977
532,0.000104,172.217.194.0-255,6797,21789,1,290977
533,0.000107,172.31.36.0-255,66,21855,1,290977
534,0.00013,172.217.194.0-255,4320,26175,1,290977
535,0.000133,172.31.36.0-255,66,26241,1,290977
536,0.000163,172.31.36.0-255,66,26307,1,290977
537,0.000168,172.217.194.0-255,2902,29209,1,290977
538,0.00017,172.31.36.0-255,66,29275,1,290977
539,0.000182,172.217.194.0-255,1125,30400,1,290977
540,0.000184,172.31.36.0-255,66,30466,1,290977
541,0.000227,172.217.194.0-255,1484,31950,1,290977
542,0.00023,172.31.36.0-255,66,32016,1,290977
543,0.000233,172.217.194.0-255,1484,33500,1,290977
544,0.000235,172.31.36.0-255,66,33566,1,290977
545,0.000249,172.217.194.0-255,1484,35050,1,290977
546,0.000252,172.31.36.0-255,66,35116,1,290977
547,0.00026,172.217.194.0-255,5738,40854,1,290977
548,0.000262,172.31.36.0-255,66,40920,1,290977
549,0.000265,172.217.194.0-255,1484,42404,1,290977
550,0.000267,172.31.36.0-255,66,42470,1,290977
551,0.000283,172.217.194.0-255,4320,46790,1,290977
552,0.000315,172.217.194.0-255,1469,48259,1,290977
553,0.000471,172.31.36.0-255,66,48325,1,290977
554,0.00066,172.217.194.0-255,363,48688,1,290977
555,0.000852,172.217.194.0-255,1484,50172,1,290977
556,0.000858,172.217.194.0-255,2902,53074,1,290977
557,0.000864,172.217.194.0-255,5738,58812,1,290977
558,0.000884,172.217.194.0-255,6797,65609,1,290977
559,0.000897,172.31.36.0-255,66,65675,1,290977
560,0.000966,172.217.194.0-255,1484,67159,1,290977
561,0.00097,172.217.194.0-255,1484,68643,1,290977
562,0.000973,172.31.36.0-255,66,68709,1,290977
563,0.000994,172.217.194.0-255,1484,70193,1,290977
564,0.001001,172.217.194.0-255,5738,75931,1,290977
565,0.001017,172.31.36.0-255,66,75997,1,290977
566,0.001026,172.217.194.0-255,2902,78899,1,290977
567,0.001043,172.217.194.0-255,3961,82860,1,290977
568,0.001052,172.31.36.0-255,66,82926,1,290977
569,0.0012,172.217.194.0-255,1484,84410,1,290977
570,0.00122,172.217.194.0-255,2902,87312,1,290977
571,0.001226,172.217.194.0-255,5738,93050,1,290977
572,0.001236,172.31.36.0-255,66,93116,1,290977
573,0.001246,172.217.194.0-255,5738,98854,1,290977
574,0.001262,172.217.194.0-255,4320,103174,1,290977
575,0.001274,172.31.36.0-255,66,103240,1,290977
576,0.001293,172.217.194.0-255,5020,108260,1,290977
577,0.001298,172.31.36.0-255,66,108326,1,290977
578,0.001368,172.217.194.0-255,1484,109810,1,290977
579,0.001372,172.217.194.0-255,1484,111294,1,290977
580,0.001382,172.217.194.0-255,1484,112778,1,290977
581,0.001386,172.217.194.0-255,1484,114262,1,290977
582,0.001404,172.217.194.0-255,4320,118582,1,290977
583,0.001439,172.217.194.0-255,7156,125738,1,290977
584,0.001441,172.31.36.0-255,66,125804,1,290977
585,0.001453,172.217.194.0-255,5738,131542,1,290977
586,0.001468,172.31.36.0-255,66,131608,1,290977
587,0.00148,172.217.194.0-255,2184,133792,1,290977
588,0.001499,172.31.36.0-255,66,133858,1,290977
589,0.001537,172.217.194.0-255,1484,135342,1,290977
590,0.00154,172.217.194.0-255,1484,136826,1,290977
591,0.001545,172.31.36.0-255,66,136892,1,290977
592,0.00156,172.217.194.0-255,1484,138376,1,290977
593,0.001567,172.217.194.0-255,5738,144114,1,290977
594,0.001582,172.217.194.0-255,1484,145598,1,290977
595,0.001586,172.31.36.0-255,66,145664,1,290977
596,0.001617,172.217.194.0-255,1484,147148,1,290977
597,0.00163,172.31.36.0-255,66,147214,1,290977
598,0.001643,172.217.194.0-255,5738,152952,1,290977
599,0.001647,172.31.36.0-255,66,153018,1,290977
600,0.001667,172.217.194.0-255,3602,156620,1,290977
601,0.001673,172.31.36.0-255,66,156686,1,290977
602,0.003694,172.217.194.0-255,5738,162424,1,290977
603,0.003701,172.31.36.0-255,66,162490,1,290977
604,0.005762,172.217.194.0-255,5738,168228,1,290977
605,0.006462,172.31.36.0-255,66,168294,1,290977
606,0.008532,172.217.194.0-255,5738,174032,1,290977
607,0.008539,172.31.36.0-255,66,174098,1,290977
608,0.010563,172.217.194.0-255,5738,179836,1,290977
609,0.010571,172.31.36.0-255,66,179902,1,290977
610,0.01259,172.217.194.0-255,5738,185640,1,290977
611,0.014448,172.31.36.0-255,66,185706,1,290977
612,0.016553,172.217.194.0-255,5738,191444,1,290977
613,0.016566,172.31.36.0-255,66,191510,1,290977
614,0.018628,172.217.194.0-255,5738,197248,1,290977
615,0.018636,172.31.36.0-255,66,197314,1,290977
616,0.020689,172.217.194.0-255,5738,203052,1,290977
617,0.020696,172.31.36.0-255,66,203118,1,290977
618,0.022781,172.217.194.0-255,5738,208856,1,290977
619,0.022791,172.31.36.0-255,66,208922,1,290977
620,0.02485,172.217.194.0-255,5738,214660,1,290977
621,0.024857,172.31.36.0-255,66,214726,1,290977
622,0.026938,172.217.194.0-255,5738,220464,1,290977
623,0.026948,172.31.36.0-255,66,220530,1,290977
624,0.029037,172.217.194.0-255,5738,226268,1,290977
625,0.029046,172.31.36.0-255,66,226334,1,290977
626,0.031123,172.217.194.0-255,5738,232072,1,290977
627,0.031132,172.31.36.0-255,66,232138,1,290977
628,0.033184,172.217.194.0-255,5738,237876,1,290977
629,0.033193,172.31.36.0-255,66,237942,1,290977
630,0.035207,172.217.194.0-255,5738,243680,1,290977
631,0.03522,172.31.36.0-255,66,243746,1,290977
632,0.03725,172.217.194.0-255,5738,249484,1,290977
633,0.037257,172.31.36.0-255,66,249550,1,290977
634,0.039297,172.217.194.0-255,5738,255288,1,290977
635,0.039306,172.31.36.0-255,66,255354,1,290977
636,0.041329,172.217.194.0-255,5738,261092,1,290977
637,0.041337,172.31.36.0-255,66,261158,1,290977
638,0.042152,172.31.36.0-255,171,261329,1,290977
639,0.042186,172.31.36.0-255,1139,262468,1,290977
640,0.042257,172.31.36.0-255,1514,263982,1,290977
641,0.042259,172.31.36.0-255,1514,265496,1,290977
642,0.04226,172.31.36.0-255,1514,267010,1,290977
643,0.04229,172.31.36.0-255,1514,268524,1,290977
644,0.042292,172.31.36.0-255,325,268849,1,290977
645,0.043416,172.217.194.0-255,5738,274587,1,290977
646,0.043423,172.31.36.0-255,66,274653,1,290977
647,0.04371,104.244.42.0-255,66,274719,1,290977
648,0.043764,104.244.42.0-255,66,274785,1,290977
649,0.043863,104.244.42.0-255,66,274851,1,290977
650,0.04387,104.244.42.0-255,66,274917,1,290977
651,0.045532,172.217.194.0-255,5738,280655,1,290977
652,0.045539,172.31.36.0-255,66,280721,1,290977
653,0.047625,172.217.194.0-255,4320,285041,1,290977
654,0.047632,172.31.36.0-255,66,285107,1,290977
655,0.047649,172.217.194.0-255,1484,286591,1,290977
656,0.04973,172.217.194.0-255,4320,290911,1,290977
657,0.049738,172.31.36.0-255,66,290977,1,290977
658,0.0,74.125.24.0-255,152,152,1,215773
659,1.5e-05,172.31.36.0-255,66,218,1,215773
660,2.2e-05,74.125.24.0-255,1484,1702,1,215773
661,2.6e-05,172.31.36.0-255,66,1768,1,215773
662,3.9e-05,74.125.24.0-255,2902,4670,1,215773
663,4.2e-05,172.31.36.0-255,66,4736,1,215773
664,5e-05,74.125.24.0-255,5738,10474,1,215773
665,5.3e-05,172.31.36.0-255,66,10540,1,215773
666,7.2e-05,74.125.24.0-255,1484,12024,1,215773
667,7.9e-05,172.31.36.0-255,66,12090,1,215773
668,8.4e-05,74.125.24.0-255,2038,14128,1,215773
669,8.6e-05,172.31.36.0-255,66,14194,1,215773
670,0.000124,74.125.24.0-255,1484,15678,1,215773
671,0.000127,172.31.36.0-255,66,15744,1,215773
672,0.000132,74.125.24.0-255,2902,18646,1,215773
673,0.000135,172.31.36.0-255,66,18712,1,215773
674,0.000183,74.125.24.0-255,5738,24450,1,215773
675,0.000186,172.31.36.0-255,66,24516,1,215773
676,0.000193,74.125.24.0-255,6797,31313,1,215773
677,0.000195,172.31.36.0-255,66,31379,1,215773
678,0.00025,74.125.24.0-255,1484,32863,1,215773
679,0.000254,74.125.24.0-255,2902,35765,1,215773
680,0.000259,172.31.36.0-255,66,35831,1,215773
681,0.000262,172.31.36.0-255,66,35897,1,215773
682,0.000295,74.125.24.0-255,5738,41635,1,215773
683,0.000298,172.31.36.0-255,66,41701,1,215773
684,0.000318,74.125.24.0-255,1484,43185,1,215773
685,0.00032,172.31.36.0-255,66,43251,1,215773
686,0.000358,172.31.36.0-255,66,43317,1,215773
687,0.000362,74.125.24.0-255,2902,46219,1,215773
688,0.000365,172.31.36.0-255,66,46285,1,215773
689,0.000394,74.125.24.0-255,6797,53082,1,215773
690,0.000396,172.31.36.0-255,66,53148,1,215773
691,0.001412,74.125.24.0-255,645,53793,1,215773
692,0.001723,74.125.24.0-255,1484,55277,1,215773
693,0.001728,172.31.36.0-255,66,55343,1,215773
694,0.001753,74.125.24.0-255,2902,58245,1,215773
695,0.001755,172.31.36.0-255,66,58311,1,215773
696,0.001762,74.125.24.0-255,5738,64049,1,215773
697,0.001763,172.31.36.0-255,66,64115,1,215773
698,0.001768,74.125.24.0-255,4320,68435,1,215773
699,0.00177,172.31.36.0-255,66,68501,1,215773
700,0.001806,74.125.24.0-255,4320,72821,1,215773
701,0.001809,172.31.36.0-255,66,72887,1,215773
702,0.001836,172.31.36.0-255,66,72953,1,215773
703,0.001841,74.125.24.0-255,3054,76007,1,215773
704,0.001842,172.31.36.0-255,66,76073,1,215773
705,0.001866,74.125.24.0-255,1484,77557,1,215773
706,0.001898,172.31.36.0-255,66,77623,1,215773
707,0.001916,74.125.24.0-255,2543,80166,1,215773
708,0.001918,172.31.36.0-255,66,80232,1,215773
709,0.003931,74.125.24.0-255,5738,85970,1,215773
710,0.003937,172.31.36.0-255,66,86036,1,215773
711,0.005986,74.125.24.0-255,5738,91774,1,215773
712,0.005993,172.31.36.0-255,66,91840,1,215773
713,0.008035,74.125.24.0-255,5738,97578,1,215773
714,0.008042,172.31.36.0-255,66,97644,1,215773
715,0.010054,74.125.24.0-255,5738,103382,1,215773
716,0.010062,172.31.36.0-255,66,103448,1,215773
717,0.012088,74.125.24.0-255,5738,109186,1,215773
718,0.012096,172.31.36.0-255,66,109252,1,215773
719,0.014135,74.125.24.0-255,5738,114990,1,215773
720,0.014151,172.31.36.0-255,66,115056,1,215773
721,0.016166,74.125.24.0-255,5738,120794,1,215773
722,0.016181,172.31.36.0-255,66,120860,1,215773
723,0.018214,74.125.24.0-255,5738,126598,1,215773
724,0.018224,172.31.36.0-255,66,126664,1,215773
725,0.020261,74.125.24.0-255,5738,132402,1,215773
726,0.02027,172.31.36.0-255,66,132468,1,215773
727,0.022294,74.125.24.0-255,5738,138206,1,215773
728,0.022303,172.31.36.0-255,66,138272,1,215773
729,0.024303,74.125.24.0-255,5738,144010,1,215773
730,0.024311,172.31.36.0-255,66,144076,1,215773
731,0.026311,74.125.24.0-255,5738,149814,1,215773
732,0.026319,172.31.36.0-255,66,149880,1,215773
733,0.028354,74.125.24.0-255,5738,155618,1,215773
734,0.02836,172.31.36.0-255,66,155684,1,215773
735,0.029761,172.31.36.0-255,172,155856,1,215773
736,0.029791,172.31.36.0-255,1115,156971,1,215773
737,0.029821,172.31.36.0-255,564,157535,1,215773
738,0.030369,74.125.24.0-255,5738,163273,1,215773
739,0.030375,172.31.36.0-255,66,163339,1,215773
740,0.031318,104.244.42.0-255,66,163405,1,215773
741,0.03137,104.244.42.0-255,66,163471,1,215773
742,0.031422,104.244.42.0-255,66,163537,1,215773
743,0.032402,74.125.24.0-255,5738,169275,1,215773
744,0.032408,172.31.36.0-255,66,169341,1,215773
745,0.03444,74.125.24.0-255,5738,175079,1,215773
746,0.034446,172.31.36.0-255,66,175145,1,215773
747,0.036444,74.125.24.0-255,5738,180883,1,215773
748,0.03645,172.31.36.0-255,66,180949,1,215773
749,0.038492,74.125.24.0-255,5738,186687,1,215773
750,0.038498,172.31.36.0-255,66,186753,1,215773
751,0.040518,74.125.24.0-255,5738,192491,1,215773
752,0.04054,172.31.36.0-255,66,192557,1,215773
753,0.04254,74.125.24.0-255,5738,198295,1,215773
754,0.042546,172.31.36.0-255,66,198361,1,215773
755,0.04456,74.125.24.0-255,5738,204099,1,215773
756,0.044566,172.31.36.0-255,66,204165,1,215773
757,0.046593,74.125.24.0-255,5738,209903,1,215773
758,0.046599,172.31.36.0-255,66,209969,1,215773
759,0.048618,74.125.24.0-255,5738,215707,1,215773
760,0.048623,172.31.36.0-255,66,215773,1,215773
761,0.0,172.217.194.0-255,153,153,1,193563
762,2.3e-05,172.31.36.0-255,66,219,1,193563
763,3e-05,172.217.194.0-255,1484,1703,1,193563
764,3.6e-05,172.31.36.0-255,66,1769,1,193563
765,4.2e-05,172.217.194.0-255,2902,4671,1,193563
766,5.3e-05,172.31.36.0-255,66,4737,1,193563
767,6.2e-05,172.217.194.0-255,7156,11893,1,193563
768,6.6e-05,172.31.36.0-255,66,11959,1,193563
769,7e-05,172.217.194.0-255,2017,13976,1,193563
770,7.3e-05,172.31.36.0-255,66,14042,1,193563
771,7.8e-05,172.217.194.0-255,2902,16944,1,193563
772,8e-05,172.31.36.0-255,66,17010,1,193563
773,0.000119,172.217.194.0-255,7156,24166,1,193563
774,0.000122,172.31.36.0-255,66,24232,1,193563
775,0.000131,172.217.194.0-255,6797,31029,1,193563
776,0.000133,172.31.36.0-255,66,31095,1,193563
777,0.000232,172.217.194.0-255,1484,32579,1,193563
778,0.000235,172.31.36.0-255,66,32645,1,193563
779,0.000239,172.217.194.0-255,1484,34129,1,193563
780,0.000241,172.31.36.0-255,66,34195,1,193563
781,0.000263,172.217.194.0-255,1484,35679,1,193563
782,0.000266,172.31.36.0-255,66,35745,1,193563
783,0.000278,172.217.194.0-255,5738,41483,1,193563
784,0.000281,172.31.36.0-255,66,41549,1,193563
785,0.000288,172.217.194.0-255,5738,47287,1,193563
786,0.000291,172.31.36.0-255,66,47353,1,193563
787,0.000313,172.31.36.0-255,66,47419,1,193563
788,0.000349,172.31.36.0-255,66,47485,1,193563
789,0.000352,172.217.194.0-255,360,47845,1,193563
790,0.000354,172.31.36.0-255,66,47911,1,193563
791,0.000812,172.217.194.0-255,385,48296,1,193563
792,0.001265,172.217.194.0-255,1484,49780,1,193563
793,0.001271,172.31.36.0-255,66,49846,1,193563
794,0.001277,172.217.194.0-255,2902,52748,1,193563
795,0.001279,172.31.36.0-255,66,52814,1,193563
796,0.001291,172.217.194.0-255,5738,58552,1,193563
797,0.001295,172.31.36.0-255,66,58618,1,193563
798,0.001347,172.31.36.0-255,66,58684,1,193563
799,0.001365,172.31.36.0-255,66,58750,1,193563
800,0.00166,172.217.194.0-255,1484,60234,1,193563
801,0.001665,172.217.194.0-255,1484,61718,1,193563
802,0.001668,172.31.36.0-255,66,61784,1,193563
803,0.001681,172.217.194.0-255,1484,63268,1,193563
804,0.001693,172.217.194.0-255,5738,69006,1,193563
805,0.001695,172.31.36.0-255,66,69072,1,193563
806,0.001698,172.217.194.0-255,1484,70556,1,193563
807,0.00174,172.31.36.0-255,66,70622,1,193563
808,0.001751,172.31.36.0-255,66,70688,1,193563
809,0.004074,172.217.194.0-255,5738,76426,1,193563
810,0.004082,172.31.36.0-255,66,76492,1,193563
811,0.006431,172.217.194.0-255,5738,82230,1,193563
812,0.006434,172.31.36.0-255,66,82296,1,193563
813,0.008766,172.217.194.0-255,5738,88034,1,193563
814,0.008772,172.31.36.0-255,66,88100,1,193563
815,0.011106,172.217.194.0-255,5738,93838,1,193563
816,0.011114,172.31.36.0-255,66,93904,1,193563
817,0.013444,172.217.194.0-255,5738,99642,1,193563
818,0.013451,172.31.36.0-255,66,99708,1,193563
819,0.015797,172.217.194.0-255,5738,105446,1,193563
820,0.015806,172.31.36.0-255,66,105512,1,193563
821,0.018134,172.217.194.0-255,5738,111250,1,193563
822,0.018142,172.31.36.0-255,66,111316,1,193563
823,0.020493,172.217.194.0-255,5738,117054,1,193563
824,0.020502,172.31.36.0-255,66,117120,1,193563
825,0.022843,172.217.194.0-255,5738,122858,1,193563
826,0.02285,172.31.36.0-255,66,122924,1,193563
827,0.025202,172.217.194.0-255,5738,128662,1,193563
828,0.025209,172.31.36.0-255,66,128728,1,193563
829,0.027549,172.217.194.0-255,5738,134466,1,193563
830,0.027556,172.31.36.0-255,66,134532,1,193563
831,0.029919,172.217.194.0-255,5738,140270,1,193563
832,0.029932,172.31.36.0-255,66,140336,1,193563
833,0.032275,172.217.194.0-255,5738,146074,1,193563
834,0.032283,172.31.36.0-255,66,146140,1,193563
835,0.034658,172.217.194.0-255,5738,151878,1,193563
836,0.034667,172.31.36.0-255,66,151944,1,193563
837,0.037,172.217.194.0-255,5738,157682,1,193563
838,0.037009,172.31.36.0-255,66,157748,1,193563
839,0.039336,172.217.194.0-255,4320,162068,1,193563
840,0.039344,172.31.36.0-255,66,162134,1,193563
841,0.039373,172.217.194.0-255,1484,163618,1,193563
842,0.041673,172.217.194.0-255,4320,167938,1,193563
843,0.041681,172.31.36.0-255,66,168004,1,193563
844,0.043065,172.31.36.0-255,187,168191,1,193563
845,0.043095,172.31.36.0-255,982,169173,1,193563
846,0.043178,172.31.36.0-255,1514,170687,1,193563
847,0.04318,172.31.36.0-255,1514,172201,1,193563
848,0.043181,172.31.36.0-255,1514,173715,1,193563
849,0.043182,172.31.36.0-255,1514,175229,1,193563
850,0.04321,172.31.36.0-255,484,175713,1,193563
851,0.044005,172.217.194.0-255,5738,181451,1,193563
852,0.044012,172.31.36.0-255,66,181517,1,193563
853,0.044587,104.244.42.0-255,66,181583,1,193563
854,0.044596,104.244.42.0-255,66,181649,1,193563
855,0.044703,104.244.42.0-255,66,181715,1,193563
856,0.044707,104.244.42.0-255,66,181781,1,193563
857,0.045385,104.244.42.0-255,108,181889,1,193563
858,0.045395,172.31.36.0-255,66,181955,1,193563
859,0.046345,172.217.194.0-255,5738,187693,1,193563
860,0.046354,172.31.36.0-255,66,187759,1,193563
861,0.048691,172.217.194.0-255,5738,193497,1,193563
862,0.048701,172.31.36.0-255,66,193563,1,193563
863,0.0,172.217.194.0-255,146,146,1,219272
864,2e-05,172.31.36.0-255,66,212,1,219272
865,2.7e-05,172.217.194.0-255,1484,1696,1,219272
866,3.3e-05,172.31.36.0-255,66,1762,1,219272
867,3.9e-05,172.217.194.0-255,2902,4664,1,219272
868,4.2e-05,172.31.36.0-255,66,4730,1,219272
869,5e-05,172.217.194.0-255,5738,10468,1,219272
870,5.3e-05,172.31.36.0-255,66,10534,1,219272
871,8e-05,172.217.194.0-255,5738,16272,1,219272
872,8.5e-05,172.31.36.0-255,66,16338,1,219272
873,0.000112,172.217.194.0-255,1965,18303,1,219272
874,0.000115,172.31.36.0-255,66,18369,1,219272
875,0.000126,172.31.36.0-255,66,18435,1,219272
876,0.000129,172.217.194.0-255,1484,19919,1,219272
877,0.000131,172.31.36.0-255,66,19985,1,219272
878,0.000136,172.217.194.0-255,2543,22528,1,219272
879,0.000139,172.31.36.0-255,66,22594,1,219272
880,0.000275,172.217.194.0-255,1484,24078,1,219272
881,0.000281,172.31.36.0-255,66,24144,1,219272
882,0.000286,172.217.194.0-255,2902,27046,1,219272
883,0.000289,172.31.36.0-255,66,27112,1,219272
884,0.000293,172.217.194.0-255,2902,30014,1,219272
885,0.000295,172.31.36.0-255,66,30080,1,219272
886,0.000314,172.217.194.0-255,2902,32982,1,219272
887,0.000317,172.31.36.0-255,66,33048,1,219272
888,0.000332,172.217.194.0-255,4320,37368,1,219272
889,0.000334,172.31.36.0-255,66,37434,1,219272
890,0.000356,172.31.36.0-255,66,37500,1,219272
891,0.000382,172.217.194.0-255,2902,40402,1,219272
892,0.000385,172.31.36.0-255,66,40468,1,219272
893,0.000406,172.31.36.0-255,66,40534,1,219272
894,0.000408,172.217.194.0-255,680,41214,1,219272
895,0.000536,172.217.194.0-255,1484,42698,1,219272
896,0.000542,172.31.36.0-255,66,42764,1,219272
897,0.000547,172.217.194.0-255,2902,45666,1,219272
898,0.00055,172.31.36.0-255,66,45732,1,219272
899,0.000571,172.217.194.0-255,5738,51470,1,219272
900,0.000575,172.31.36.0-255,66,51536,1,219272
901,0.00058,172.217.194.0-255,4320,55856,1,219272
902,0.000582,172.31.36.0-255,66,55922,1,219272
903,0.000641,172.31.36.0-255,66,55988,1,219272
904,0.000691,172.31.36.0-255,66,56054,1,219272
905,0.001128,172.217.194.0-255,1484,57538,1,219272
906,0.001147,172.217.194.0-255,2902,60440,1,219272
907,0.001151,172.31.36.0-255,66,60506,1,219272
908,0.001179,172.217.194.0-255,2902,63408,1,219272
909,0.001181,172.31.36.0-255,66,63474,1,219272
910,0.001203,172.217.194.0-255,2902,66376,1,219272
911,0.001205,172.31.36.0-255,66,66442,1,219272
912,0.001216,172.31.36.0-255,66,66508,1,219272
913,0.001242,172.31.36.0-255,66,66574,1,219272
914,0.001248,172.217.194.0-255,5020,71594,1,219272
915,0.00125,172.31.36.0-255,66,71660,1,219272
916,0.001281,172.217.194.0-255,5738,77398,1,219272
917,0.001284,172.31.36.0-255,66,77464,1,219272
918,0.001292,172.217.194.0-255,7156,84620,1,219272
919,0.001294,172.31.36.0-255,66,84686,1,219272
920,0.001331,172.31.36.0-255,66,84752,1,219272
921,0.001334,172.217.194.0-255,1484,86236,1,219272
922,0.001362,172.31.36.0-255,66,86302,1,219272
923,0.001366,172.217.194.0-255,766,87068,1,219272
924,0.001569,172.217.194.0-255,1484,88552,1,219272
925,0.001575,172.31.36.0-255,66,88618,1,219272
926,0.001597,172.217.194.0-255,2902,91520,1,219272
927,0.001599,172.31.36.0-255,66,91586,1,219272
928,0.001624,172.217.194.0-255,5738,97324,1,219272
929,0.001627,172.31.36.0-255,66,97390,1,219272
930,0.001652,172.31.36.0-255,66,97456,1,219272
931,0.001669,172.217.194.0-255,5738,103194,1,219272
932,0.001672,172.31.36.0-255,66,103260,1,219272
933,0.001687,172.217.194.0-255,4320,107580,1,219272
934,0.00169,172.31.36.0-255,66,107646,1,219272
935,0.001696,172.217.194.0-255,5020,112666,1,219272
936,0.001699,172.31.36.0-255,66,112732,1,219272
937,0.004299,172.217.194.0-255,5738,118470,1,219272
938,0.004307,172.31.36.0-255,66,118536,1,219272
939,0.006917,172.217.194.0-255,5738,124274,1,219272
940,0.006929,172.31.36.0-255,66,124340,1,219272
941,0.009526,172.217.194.0-255,5738,130078,1,219272
942,0.009533,172.31.36.0-255,66,130144,1,219272
943,0.012105,172.217.194.0-255,5738,135882,1,219272
944,0.012113,172.31.36.0-255,66,135948,1,219272
945,0.014703,172.217.194.0-255,5738,141686,1,219272
946,0.014711,172.31.36.0-255,66,141752,1,219272
947,0.017295,172.217.194.0-255,5738,147490,1,219272
948,0.017305,172.31.36.0-255,66,147556,1,219272
949,0.019889,172.217.194.0-255,5738,153294,1,219272
950,0.019898,172.31.36.0-255,66,153360,1,219272
951,0.022522,172.217.194.0-255,5738,159098,1,219272
952,0.022529,172.31.36.0-255,66,159164,1,219272
953,0.02514,172.217.194.0-255,5738,164902,1,219272
954,0.025148,172.31.36.0-255,66,164968,1,219272
955,0.027725,172.217.194.0-255,5738,170706,1,219272
956,0.027734,172.31.36.0-255,66,170772,1,219272
957,0.030316,172.217.194.0-255,5738,176510,1,219272
958,0.030324,172.31.36.0-255,66,176576,1,219272
959,0.032919,172.217.194.0-255,5738,182314,1,219272
960,0.032925,172.31.36.0-255,66,182380,1,219272
961,0.033679,172.31.36.0-255,192,182572,1,219272
962,0.03371,172.31.36.0-255,958,183530,1,219272
963,0.033766,172.31.36.0-255,720,184250,1,219272
964,0.035181,104.244.42.0-255,66,184316,1,219272
965,0.035225,104.244.42.0-255,66,184382,1,219272
966,0.035317,104.244.42.0-255,66,184448,1,219272
967,0.035518,172.217.194.0-255,5738,190186,1,219272
968,0.035526,172.31.36.0-255,66,190252,1,219272
969,0.038115,172.217.194.0-255,5738,195990,1,219272
970,0.038121,172.31.36.0-255,66,196056,1,219272
971,0.040759,172.217.194.0-255,5738,201794,1,219272
972,0.040766,172.31.36.0-255,66,201860,1,219272
973,0.043371,172.217.194.0-255,5738,207598,1,219272
974,0.043382,172.31.36.0-255,66,207664,1,219272
975,0.045995,172.217.194.0-255,5738,213402,1,219272
976,0.046002,172.31.36.0-255,66,213468,1,219272
977,0.048612,172.217.194.0-255,5738,219206,1,219272
978,0.048619,172.31.36.0-255,66,219272,1,219272
979,0.0,172.217.194.0-255,153,153,1,204966
980,3.4e-05,172.31.36.0-255,66,219,1,204966
981,4.1e-05,172.217.194.0-255,1484,1703,1,204966
982,4.5e-05,172.31.36.0-255,66,1769,1,204966
983,5e-05,172.217.194.0-255,2902,4671,1,204966
984,6.1e-05,172.31.36.0-255,66,4737,1,204966
985,6.8e-05,172.217.194.0-255,5738,10475,1,204966
986,7.2e-05,172.31.36.0-255,66,10541,1,204966
987,9.9e-05,172.217.194.0-255,1484,12025,1,204966
988,0.000102,172.31.36.0-255,66,12091,1,204966
989,0.000112,172.217.194.0-255,2039,14130,1,204966
990,0.000114,172.31.36.0-255,66,14196,1,204966
991,0.000126,172.31.36.0-255,66,14262,1,204966
992,0.00013,172.217.194.0-255,2902,17164,1,204966
993,0.000132,172.31.36.0-255,66,17230,1,204966
994,0.000163,172.217.194.0-255,2543,19773,1,204966
995,0.000166,172.31.36.0-255,66,19839,1,204966
996,0.000238,172.217.194.0-255,1484,21323,1,204966
997,0.000242,172.31.36.0-255,66,21389,1,204966
998,0.000248,172.217.194.0-255,2902,24291,1,204966
999,0.000251,172.31.36.0-255,66,24357,1,204966
1000,0.000263,172.217.194.0-255,5738,30095,1,204966
1001,0.000265,172.31.36.0-255,66,30161,1,204966
1002,0.00031,172.31.36.0-255,66,30227,1,204966
1003,0.000339,172.217.194.0-255,5738,35965,1,204966
1004,0.000344,172.31.36.0-255,66,36031,1,204966
1005,0.000372,172.217.194.0-255,5020,41051,1,204966
1006,0.000375,172.31.36.0-255,66,41117,1,204966
1007,0.000412,172.217.194.0-255,676,41793,1,204966
1008,0.000415,172.31.36.0-255,66,41859,1,204966
1009,0.000505,172.217.194.0-255,1484,43343,1,204966
1010,0.000509,172.217.194.0-255,2902,46245,1,204966
1011,0.000513,172.31.36.0-255,66,46311,1,204966
1012,0.000544,172.217.194.0-255,5738,52049,1,204966
1013,0.000548,172.31.36.0-255,66,52115,1,204966
1014,0.000554,172.217.194.0-255,5738,57853,1,204966
1015,0.000557,172.31.36.0-255,66,57919,1,204966
1016,0.000577,172.217.194.0-255,4320,62239,1,204966
1017,0.000587,172.31.36.0-255,66,62305,1,204966
1018,0.000598,172.217.194.0-255,1484,63789,1,204966
1019,0.000633,172.31.36.0-255,66,63855,1,204966
1020,0.00119,172.217.194.0-255,1484,65339,1,204966
1021,0.001215,172.217.194.0-255,2902,68241,1,204966
1022,0.001219,172.31.36.0-255,66,68307,1,204966
1023,0.001256,172.217.194.0-255,5738,74045,1,204966
1024,0.001259,172.31.36.0-255,66,74111,1,204966
1025,0.001264,172.217.194.0-255,4320,78431,1,204966
1026,0.001265,172.31.36.0-255,66,78497,1,204966
1027,0.001302,172.31.36.0-255,66,78563,1,204966
1028,0.001337,172.31.36.0-255,66,78629,1,204966
1029,0.002107,172.217.194.0-255,1484,80113,1,204966
1030,0.002124,172.217.194.0-255,2902,83015,1,204966
1031,0.002128,172.31.36.0-255,66,83081,1,204966
1032,0.002137,172.217.194.0-255,5738,88819,1,204966
1033,0.002138,172.31.36.0-255,66,88885,1,204966
1034,0.002172,172.31.36.0-255,66,88951,1,204966
1035,0.002181,172.31.36.0-255,66,89017,1,204966
1036,0.002199,172.217.194.0-255,3602,92619,1,204966
1037,0.0022,172.31.36.0-255,66,92685,1,204966
1038,0.004709,172.217.194.0-255,1484,94169,1,204966
1039,0.004745,172.217.194.0-255,2902,97071,1,204966
1040,0.004749,172.31.36.0-255,66,97137,1,204966
1041,0.004775,172.217.194.0-255,1484,98621,1,204966
1042,0.007277,172.217.194.0-255,4320,102941,1,204966
1043,0.007284,172.31.36.0-255,66,103007,1,204966
1044,0.009833,172.217.194.0-255,5738,108745,1,204966
1045,0.009848,172.31.36.0-255,66,108811,1,204966
1046,0.012436,172.217.194.0-255,5738,114549,1,204966
1047,0.012451,172.31.36.0-255,66,114615,1,204966
1048,0.014989,172.217.194.0-255,5738,120353,1,204966
1049,0.014997,172.31.36.0-255,66,120419,1,204966
1050,0.017549,172.217.194.0-255,5738,126157,1,204966
1051,0.017556,172.31.36.0-255,66,126223,1,204966
1052,0.020094,172.217.194.0-255,5738,131961,1,204966
1053,0.020104,172.31.36.0-255,66,132027,1,204966
1054,0.022659,172.217.194.0-255,5738,137765,1,204966
1055,0.022667,172.31.36.0-255,66,137831,1,204966
1056,0.025235,172.217.194.0-255,5738,143569,1,204966
1057,0.025248,172.31.36.0-255,66,143635,1,204966
1058,0.02778,172.217.194.0-255,5738,149373,1,204966
1059,0.027789,172.31.36.0-255,66,149439,1,204966
1060,0.030366,172.217.194.0-255,5738,155177,1,204966
1061,0.030374,172.31.36.0-255,66,155243,1,204966
1062,0.032925,172.217.194.0-255,5738,160981,1,204966
1063,0.032933,172.31.36.0-255,66,161047,1,204966
1064,0.03549,172.217.194.0-255,5738,166785,1,204966
1065,0.035497,172.31.36.0-255,66,166851,1,204966
1066,0.038063,172.217.194.0-255,5738,172589,1,204966
1067,0.038072,172.31.36.0-255,66,172655,1,204966
1068,0.040029,172.31.36.0-255,172,172827,1,204966
1069,0.040058,172.31.36.0-255,1114,173941,1,204966
1070,0.040113,172.31.36.0-255,1514,175455,1,204966
1071,0.040115,172.31.36.0-255,1514,176969,1,204966
1072,0.04012,172.31.36.0-255,1514,178483,1,204966
1073,0.040121,172.31.36.0-255,1514,179997,1,204966
1074,0.040139,172.31.36.0-255,1489,181486,1,204966
1075,0.040635,172.217.194.0-255,5738,187224,1,204966
1076,0.040641,172.31.36.0-255,66,187290,1,204966
1077,0.041562,104.244.42.0-255,66,187356,1,204966
1078,0.041581,104.244.42.0-255,66,187422,1,204966
1079,0.041669,104.244.42.0-255,66,187488,1,204966
1080,0.041763,104.244.42.0-255,66,187554,1,204966
1081,0.043168,172.217.194.0-255,5738,193292,1,204966
1082,0.043176,172.31.36.0-255,66,193358,1,204966
1083,0.045694,172.217.194.0-255,5738,199096,1,204966
1084,0.045701,172.31.36.0-255,66,199162,1,204966
1085,0.048242,172.217.194.0-255,5738,204900,1,204966
1086,0.048248,172.31.36.0-255,66,204966,1,204966
1087,0.0,74.125.68.0-255,143,143,1,320864
1088,2.2e-05,172.31.36.0-255,66,209,1,320864
1089,2.9e-05,74.125.68.0-255,1484,1693,1,320864
1090,3.5e-05,172.31.36.0-255,66,1759,1,320864
1091,4.9e-05,74.125.68.0-255,2902,4661,1,320864
1092,5.3e-05,172.31.36.0-255,66,4727,1,320864
1093,9.1e-05,74.125.68.0-255,5738,10465,1,320864
1094,9.5e-05,172.31.36.0-255,66,10531,1,320864
1095,0.000128,74.125.68.0-255,6310,16841,1,320864
1096,0.000133,172.31.36.0-255,66,16907,1,320864
1097,0.000163,74.125.68.0-255,7156,24063,1,320864
1098,0.000167,172.31.36.0-255,66,24129,1,320864
1099,0.000196,74.125.68.0-255,2902,27031,1,320864
1100,0.000199,172.31.36.0-255,66,27097,1,320864
1101,0.000202,74.125.68.0-255,1484,28581,1,320864
1102,0.000204,172.31.36.0-255,66,28647,1,320864
1103,0.000238,74.125.68.0-255,2543,31190,1,320864
1104,0.000241,172.31.36.0-255,66,31256,1,320864
1105,0.000385,74.125.68.0-255,1484,32740,1,320864
1106,0.000391,172.31.36.0-255,66,32806,1,320864
1107,0.000397,74.125.68.0-255,2902,35708,1,320864
1108,0.000399,172.31.36.0-255,66,35774,1,320864
1109,0.000425,74.125.68.0-255,1484,37258,1,320864
1110,0.000428,172.31.36.0-255,66,37324,1,320864
1111,0.000433,74.125.68.0-255,2902,40226,1,320864
1112,0.000436,172.31.36.0-255,66,40292,1,320864
1113,0.000461,74.125.68.0-255,5738,46030,1,320864
1114,0.000465,172.31.36.0-255,66,46096,1,320864
1115,0.000496,74.125.68.0-255,4320,50416,1,320864
1116,0.0005,172.31.36.0-255,66,50482,1,320864
1117,0.000521,74.125.68.0-255,5738,56220,1,320864
1118,0.000524,172.31.36.0-255,66,56286,1,320864
1119,0.000576,172.31.36.0-255,66,56352,1,320864
1120,0.000866,74.125.68.0-255,361,56713,1,320864
1121,0.000906,74.125.68.0-255,133,56846,1,320864
1122,0.001075,74.125.68.0-255,1484,58330,1,320864
1123,0.00108,172.31.36.0-255,66,58396,1,320864
1124,0.001085,74.125.68.0-255,1484,59880,1,320864
1125,0.001089,74.125.68.0-255,2902,62782,1,320864
1126,0.001092,172.31.36.0-255,66,62848,1,320864
1127,0.001118,74.125.68.0-255,5738,68586,1,320864
1128,0.001121,172.31.36.0-255,66,68652,1,320864
1129,0.00115,74.125.68.0-255,5738,74390,1,320864
1130,0.001153,172.31.36.0-255,66,74456,1,320864
1131,0.001181,74.125.68.0-255,2902,77358,1,320864
1132,0.001185,172.31.36.0-255,66,77424,1,320864
1133,0.001212,74.125.68.0-255,2902,80326,1,320864
1134,0.001216,172.31.36.0-255,66,80392,1,320864
1135,0.001244,74.125.68.0-255,7156,87548,1,320864
1136,0.001248,172.31.36.0-255,66,87614,1,320864
1137,0.001276,74.125.68.0-255,2902,90516,1,320864
1138,0.00128,172.31.36.0-255,66,90582,1,320864
1139,0.001306,74.125.68.0-255,766,91348,1,320864
1140,0.001324,74.125.68.0-255,2902,94250,1,320864
1141,0.001327,172.31.36.0-255,66,94316,1,320864
1142,0.001367,172.31.36.0-255,66,94382,1,320864
1143,0.001408,74.125.68.0-255,1484,95866,1,320864
1144,0.001437,74.125.68.0-255,5738,101604,1,320864
1145,0.001441,172.31.36.0-255,66,101670,1,320864
1146,0.001468,172.31.36.0-255,66,101736,1,320864
1147,0.001501,74.125.68.0-255,5020,106756,1,320864
1148,0.001506,172.31.36.0-255,66,106822,1,320864
1149,0.001608,74.125.68.0-255,5738,112560,1,320864
1150,0.001616,172.31.36.0-255,66,112626,1,320864
1151,0.001648,74.125.68.0-255,4320,116946,1,320864
1152,0.001652,172.31.36.0-255,66,117012,1,320864
1153,0.0017,172.31.36.0-255,66,117078,1,320864
1154,0.001796,74.125.68.0-255,5020,122098,1,320864
1155,0.001802,172.31.36.0-255,66,122164,1,320864
1156,0.001829,74.125.68.0-255,1484,123648,1,320864
1157,0.001844,74.125.68.0-255,5738,129386,1,320864
1158,0.001847,172.31.36.0-255,66,129452,1,320864
1159,0.001877,172.31.36.0-255,66,129518,1,320864
1160,0.001898,74.125.68.0-255,1484,131002,1,320864
1161,0.001973,74.125.68.0-255,4320,135322,1,320864
1162,0.001976,172.31.36.0-255,66,135388,1,320864
1163,0.002006,172.31.36.0-255,66,135454,1,320864
1164,0.002218,74.125.68.0-255,1484,136938,1,320864
1165,0.002261,74.125.68.0-255,2902,139840,1,320864
1166,0.002264,172.31.36.0-255,66,139906,1,320864
1167,0.002267,74.125.68.0-255,1484,141390,1,320864
1168,0.002291,74.125.68.0-255,2902,144292,1,320864
1169,0.002293,172.31.36.0-255,66,144358,1,320864
1170,0.002317,74.125.68.0-255,5738,150096,1,320864
1171,0.00232,172.31.36.0-255,66,150162,1,320864
1172,0.002322,74.125.68.0-255,1484,151646,1,320864
1173,0.002344,74.125.68.0-255,2902,154548,1,320864
1174,0.002347,74.125.68.0-255,1484,156032,1,320864
1175,0.002358,74.125.68.0-255,1484,157516,1,320864
1176,0.002362,74.125.68.0-255,2902,160418,1,320864
1177,0.002381,74.125.68.0-255,1484,161902,1,320864
1178,0.002393,74.125.68.0-255,2902,164804,1,320864
1179,0.002414,74.125.68.0-255,1484,166288,1,320864
1180,0.002425,74.125.68.0-255,2902,169190,1,320864
1181,0.002441,74.125.68.0-255,766,169956,1,320864
1182,0.003243,74.125.68.0-255,1484,171440,1,320864
1183,0.00326,74.125.68.0-255,2902,174342,1,320864
1184,0.00328,74.125.68.0-255,1484,175826,1,320864
1185,0.003293,74.125.68.0-255,1484,177310,1,320864
1186,0.00336,74.125.68.0-255,7156,184466,1,320864
1187,0.003379,74.125.68.0-255,2902,187368,1,320864
1188,0.003432,172.31.36.0-255,66,187434,1,320864
1189,0.00345,74.125.68.0-255,5738,193172,1,320864
1190,0.003468,172.31.36.0-255,66,193238,1,320864
1191,0.003488,74.125.68.0-255,2184,195422,1,320864
1192,0.003494,74.125.68.0-255,4320,199742,1,320864
1193,0.003502,172.31.36.0-255,66,199808,1,320864
1194,0.003531,74.125.68.0-255,5738,205546,1,320864
1195,0.00354,172.31.36.0-255,66,205612,1,320864
1196,0.003566,74.125.68.0-255,2902,208514,1,320864
1197,0.003579,172.31.36.0-255,66,208580,1,320864
1198,0.0036,172.31.36.0-255,66,208646,1,320864
1199,0.003632,74.125.68.0-255,1484,210130,1,320864
1200,0.003688,74.125.68.0-255,1484,211614,1,320864
1201,0.003692,74.125.68.0-255,1484,213098,1,320864
1202,0.003696,172.31.36.0-255,66,213164,1,320864
1203,0.003727,74.125.68.0-255,5020,218184,1,320864
1204,0.003736,172.31.36.0-255,66,218250,1,320864
1205,0.003809,74.125.68.0-255,1484,219734,1,320864
1206,0.003813,74.125.68.0-255,1484,221218,1,320864
1207,0.003825,172.31.36.0-255,66,221284,1,320864
1208,0.003828,74.125.68.0-255,1484,222768,1,320864
1209,0.00383,74.125.68.0-255,1484,224252,1,320864
1210,0.003833,74.125.68.0-255,1484,225736,1,320864
1211,0.003833,172.31.36.0-255,66,225802,1,320864
1212,0.003871,74.125.68.0-255,1484,227286,1,320864
1213,0.003878,74.125.68.0-255,5738,233024,1,320864
1214,0.003878,172.31.36.0-255,66,233090,1,320864
1215,0.003883,172.31.36.0-255,66,233156,1,320864
1216,0.003907,74.125.68.0-255,1484,234640,1,320864
1217,0.003914,74.125.68.0-255,5738,240378,1,320864
1218,0.003923,172.31.36.0-255,66,240444,1,320864
1219,0.003941,74.125.68.0-255,2902,243346,1,320864
1220,0.003949,172.31.36.0-255,66,243412,1,320864
1221,0.003971,74.125.68.0-255,2902,246314,1,320864
1222,0.003976,172.31.36.0-255,66,246380,1,320864
1223,0.004005,74.125.68.0-255,6438,252818,1,320864
1224,0.004022,172.31.36.0-255,66,252884,1,320864
1225,0.004996,74.125.68.0-255,1484,254368,1,320864
1226,0.005022,74.125.68.0-255,2902,257270,1,320864
1227,0.005026,172.31.36.0-255,66,257336,1,320864
1228,0.005057,74.125.68.0-255,4320,261656,1,320864
1229,0.005061,172.31.36.0-255,66,261722,1,320864
1230,0.005068,74.125.68.0-255,5738,267460,1,320864
1231,0.00507,172.31.36.0-255,66,267526,1,320864
1232,0.005083,74.125.68.0-255,2902,270428,1,320864
1233,0.005086,172.31.36.0-255,66,270494,1,320864
1234,0.005118,172.31.36.0-255,66,270560,1,320864
1235,0.005135,74.125.68.0-255,1484,272044,1,320864
1236,0.005171,74.125.68.0-255,4320,276364,1,320864
1237,0.005175,172.31.36.0-255,66,276430,1,320864
1238,0.005215,74.125.68.0-255,5020,281450,1,320864
1239,0.005218,172.31.36.0-255,66,281516,1,320864
1240,0.005246,74.125.68.0-255,4320,285836,1,320864
1241,0.00525,172.31.36.0-255,66,285902,1,320864
1242,0.005282,74.125.68.0-255,7156,293058,1,320864
1243,0.005285,172.31.36.0-255,66,293124,1,320864
1244,0.005328,74.125.68.0-255,1484,294608,1,320864
1245,0.005355,172.31.36.0-255,66,294674,1,320864
1246,0.005371,74.125.68.0-255,1484,296158,1,320864
1247,0.005445,74.125.68.0-255,5020,301178,1,320864
1248,0.005449,172.31.36.0-255,66,301244,1,320864
1249,0.005483,74.125.68.0-255,4320,305564,1,320864
1250,0.005487,172.31.36.0-255,66,305630,1,320864
1251,0.00551,74.125.68.0-255,1484,307114,1,320864
1252,0.005524,74.125.68.0-255,3725,310839,1,320864
1253,0.005527,172.31.36.0-255,66,310905,1,320864
1254,0.005552,74.125.68.0-255,105,311010,1,320864
1255,0.005585,74.125.68.0-255,129,311139,1,320864
1256,0.006292,172.31.36.0-255,105,311244,1,320864
1257,0.006317,172.31.36.0-255,105,311349,1,320864
1258,0.006588,172.31.36.0-255,90,311439,1,320864
1259,0.006597,172.31.36.0-255,66,311505,1,320864
1260,0.008465,74.125.68.0-255,66,311571,1,320864
1261,0.008473,74.125.68.0-255,66,311637,1,320864
1262,0.008739,74.125.68.0-255,66,311703,1,320864
1263,0.00881,74.125.68.0-255,66,311769,1,320864
1264,0.008815,172.31.36.0-255,66,311835,1,320864
1265,0.038308,172.31.36.0-255,172,312007,1,320864
1266,0.03834,172.31.36.0-255,1115,313122,1,320864
1267,0.038384,172.31.36.0-255,1514,314636,1,320864
1268,0.038387,172.31.36.0-255,1514,316150,1,320864
1269,0.038393,172.31.36.0-255,1514,317664,1,320864
1270,0.038394,172.31.36.0-255,1514,319178,1,320864
1271,0.038415,172.31.36.0-255,1488,320666,1,320864
1272,0.039866,104.244.42.0-255,66,320732,1,320864
1273,0.039874,104.244.42.0-255,66,320798,1,320864
1274,0.03997,104.244.42.0-255,66,320864,1,320864
1275,0.0,74.125.24.0-255,154,154,1,273963
1276,2.2e-05,172.31.36.0-255,66,220,1,273963
1277,3e-05,74.125.24.0-255,1484,1704,1,273963
1278,3.5e-05,172.31.36.0-255,66,1770,1,273963
1279,4.1e-05,74.125.24.0-255,2902,4672,1,273963
1280,5.4e-05,172.31.36.0-255,66,4738,1,273963
1281,6.2e-05,74.125.24.0-255,7156,11894,1,273963
1282,6.6e-05,172.31.36.0-255,66,11960,1,273963
1283,7e-05,74.125.24.0-255,2099,14059,1,273963
1284,7.3e-05,172.31.36.0-255,66,14125,1,273963
1285,0.000257,74.125.24.0-255,1484,15609,1,273963
1286,0.000262,172.31.36.0-255,66,15675,1,273963
1287,0.000268,74.125.24.0-255,2902,18577,1,273963
1288,0.00027,172.31.36.0-255,66,18643,1,273963
1289,0.000288,74.125.24.0-255,2902,21545,1,273963
1290,0.000294,172.31.36.0-255,66,21611,1,273963
1291,0.000308,74.125.24.0-255,2902,24513,1,273963
1292,0.000314,172.31.36.0-255,66,24579,1,273963
1293,0.000321,74.125.24.0-255,4320,28899,1,273963
1294,0.000323,172.31.36.0-255,66,28965,1,273963
1295,0.000356,74.125.24.0-255,2543,31508,1,273963
1296,0.000358,172.31.36.0-255,66,31574,1,273963
1297,0.000366,74.125.24.0-255,7156,38730,1,273963
1298,0.000368,172.31.36.0-255,66,38796,1,273963
1299,0.000387,172.31.36.0-255,66,38862,1,273963
1300,0.000419,74.125.24.0-255,5738,44600,1,273963
1301,0.000421,172.31.36.0-255,66,44666,1,273963
1302,0.000448,74.125.24.0-255,5319,49985,1,273963
1303,0.000451,172.31.36.0-255,66,50051,1,273963
1304,0.000455,74.125.24.0-255,131,50182,1,273963
1305,0.000457,172.31.36.0-255,66,50248,1,273963
1306,0.000627,74.125.24.0-255,1484,51732,1,273963
1307,0.000636,74.125.24.0-255,2902,54634,1,273963
1308,0.00064,172.31.36.0-255,66,54700,1,273963
1309,0.000646,74.125.24.0-255,4320,59020,1,273963
1310,0.000648,172.31.36.0-255,66,59086,1,273963
1311,0.000672,74.125.24.0-255,1484,60570,1,273963
1312,0.000684,74.125.24.0-255,7156,67726,1,273963
1313,0.000687,172.31.36.0-255,66,67792,1,273963
1314,0.000714,74.125.24.0-255,5738,73530,1,273963
1315,0.000716,172.31.36.0-255,66,73596,1,273963
1316,0.00076,172.31.36.0-255,66,73662,1,273963
1317,0.000933,74.125.24.0-255,1484,75146,1,273963
1318,0.00094,74.125.24.0-255,2902,78048,1,273963
1319,0.000943,172.31.36.0-255,66,78114,1,273963
1320,0.000949,74.125.24.0-255,2902,81016,1,273963
1321,0.000951,172.31.36.0-255,66,81082,1,273963
1322,0.000981,74.125.24.0-255,2902,83984,1,273963
1323,0.000984,172.31.36.0-255,66,84050,1,273963
1324,0.00099,74.125.24.0-255,7156,91206,1,273963
1325,0.000993,172.31.36.0-255,66,91272,1,273963
1326,0.00104,172.31.36.0-255,66,91338,1,273963
1327,0.001068,74.125.24.0-255,4320,95658,1,273963
1328,0.00107,172.31.36.0-255,66,95724,1,273963
1329,0.001075,74.125.24.0-255,2184,97908,1,273963
1330,0.001077,172.31.36.0-255,66,97974,1,273963
1331,0.001691,74.125.24.0-255,1484,99458,1,273963
1332,0.001711,74.125.24.0-255,2902,102360,1,273963
1333,0.001715,172.31.36.0-255,66,102426,1,273963
1334,0.001721,74.125.24.0-255,4320,106746,1,273963
1335,0.001723,172.31.36.0-255,66,106812,1,273963
1336,0.001737,74.125.24.0-255,1484,108296,1,273963
1337,0.001765,74.125.24.0-255,7156,115452,1,273963
1338,0.001767,172.31.36.0-255,66,115518,1,273963
1339,0.001805,172.31.36.0-255,66,115584,1,273963
1340,0.001863,74.125.24.0-255,6438,122022,1,273963
1341,0.001867,172.31.36.0-255,66,122088,1,273963
1342,0.001998,74.125.24.0-255,1484,123572,1,273963
1343,0.002012,74.125.24.0-255,1484,125056,1,273963
1344,0.002015,172.31.36.0-255,66,125122,1,273963
1345,0.002042,74.125.24.0-255,1484,126606,1,273963
1346,0.002049,74.125.24.0-255,5738,132344,1,273963
1347,0.002051,172.31.36.0-255,66,132410,1,273963
1348,0.002059,74.125.24.0-255,7156,139566,1,273963
1349,0.002062,172.31.36.0-255,66,139632,1,273963
1350,0.002087,74.125.24.0-255,1484,141116,1,273963
1351,0.0021,172.31.36.0-255,66,141182,1,273963
1352,0.002128,74.125.24.0-255,3602,144784,1,273963
1353,0.002131,172.31.36.0-255,66,144850,1,273963
1354,0.002145,172.31.36.0-255,66,144916,1,273963
1355,0.002185,74.125.24.0-255,1484,146400,1,273963
1356,0.002198,172.31.36.0-255,66,146466,1,273963
1357,0.002205,74.125.24.0-255,6438,152904,1,273963
1358,0.002207,172.31.36.0-255,66,152970,1,273963
1359,0.002212,74.125.24.0-255,4320,157290,1,273963
1360,0.002215,172.31.36.0-255,66,157356,1,273963
1361,0.002255,74.125.24.0-255,2902,160258,1,273963
1362,0.002258,172.31.36.0-255,66,160324,1,273963
1363,0.002287,172.31.36.0-255,66,160390,1,273963
1364,0.00229,74.125.24.0-255,1484,161874,1,273963
1365,0.002328,172.31.36.0-255,66,161940,1,273963
1366,0.002418,74.125.24.0-255,1484,163424,1,273963
1367,0.002423,74.125.24.0-255,2902,166326,1,273963
1368,0.002427,172.31.36.0-255,66,166392,1,273963
1369,0.002459,74.125.24.0-255,5738,172130,1,273963
1370,0.002462,172.31.36.0-255,66,172196,1,273963
1371,0.002481,172.31.36.0-255,66,172262,1,273963
1372,0.002508,172.31.36.0-255,66,172328,1,273963
1373,0.002527,74.125.24.0-255,2184,174512,1,273963
1374,0.002529,172.31.36.0-255,66,174578,1,273963
1375,0.002595,172.31.36.0-255,66,174644,1,273963
1376,0.00263,74.125.24.0-255,5738,180382,1,273963
1377,0.002632,172.31.36.0-255,66,180448,1,273963
1378,0.002635,74.125.24.0-255,1484,181932,1,273963
1379,0.002656,172.31.36.0-255,66,181998,1,273963
1380,0.002659,74.125.24.0-255,766,182764,1,273963
1381,0.005261,74.125.24.0-255,4320,187084,1,273963
1382,0.00527,172.31.36.0-255,66,187150,1,273963
1383,0.007867,74.125.24.0-255,5738,192888,1,273963
1384,0.007872,172.31.36.0-255,66,192954,1,273963
1385,0.010485,74.125.24.0-255,5738,198692,1,273963
1386,0.010492,172.31.36.0-255,66,198758,1,273963
1387,0.01308,74.125.24.0-255,5738,204496,1,273963
1388,0.013089,172.31.36.0-255,66,204562,1,273963
1389,0.015721,74.125.24.0-255,5738,210300,1,273963
1390,0.015731,172.31.36.0-255,66,210366,1,273963
1391,0.018341,74.125.24.0-255,5738,216104,1,273963
1392,0.018351,172.31.36.0-255,66,216170,1,273963
1393,0.020981,74.125.24.0-255,5738,221908,1,273963
1394,0.020993,172.31.36.0-255,66,221974,1,273963
1395,0.02361,74.125.24.0-255,5738,227712,1,273963
1396,0.023621,172.31.36.0-255,66,227778,1,273963
1397,0.026266,74.125.24.0-255,5738,233516,1,273963
1398,0.026273,172.31.36.0-255,66,233582,1,273963
1399,0.028859,74.125.24.0-255,5738,239320,1,273963
1400,0.028867,172.31.36.0-255,66,239386,1,273963
1401,0.031478,74.125.24.0-255,5738,245124,1,273963
1402,0.031486,172.31.36.0-255,66,245190,1,273963
1403,0.034095,74.125.24.0-255,5738,250928,1,273963
1404,0.034104,172.31.36.0-255,66,250994,1,273963
1405,0.036713,74.125.24.0-255,5738,256732,1,273963
1406,0.036723,172.31.36.0-255,66,256798,1,273963
1407,0.039311,74.125.24.0-255,5738,262536,1,273963
1408,0.039322,172.31.36.0-255,66,262602,1,273963
1409,0.041921,74.125.24.0-255,1570,264172,1,273963
1410,0.041932,172.31.36.0-255,66,264238,1,273963
1411,0.042613,172.31.36.0-255,105,264343,1,273963
1412,0.042652,172.31.36.0-255,105,264448,1,273963
1413,0.042887,172.31.36.0-255,90,264538,1,273963
1414,0.042896,172.31.36.0-255,66,264604,1,273963
1415,0.04519,74.125.24.0-255,66,264670,1,273963
1416,0.045212,74.125.24.0-255,66,264736,1,273963
1417,0.045452,172.31.36.0-255,172,264908,1,273963
1418,0.045464,74.125.24.0-255,66,264974,1,273963
1419,0.045508,172.31.36.0-255,1114,266088,1,273963
1420,0.045575,172.31.36.0-255,1514,267602,1,273963
1421,0.045598,172.31.36.0-255,1514,269116,1,273963
1422,0.045599,172.31.36.0-255,1514,270630,1,273963
1423,0.045621,172.31.36.0-255,1514,272144,1,273963
1424,0.045622,172.31.36.0-255,1489,273633,1,273963
1425,0.045691,74.125.24.0-255,66,273699,1,273963
1426,0.045698,172.31.36.0-255,66,273765,1,273963
1427,0.047018,104.244.42.0-255,66,273831,1,273963
1428,0.047052,104.244.42.0-255,66,273897,1,273963
1429,0.04716,104.244.42.0-255,66,273963,1,273963
1430,0.0,74.125.24.0-255,153,153,1,272968
1431,3.3e-05,172.31.36.0-255,66,219,1,272968
1432,3.9e-05,74.125.24.0-255,1484,1703,1,272968
1433,4.3e-05,172.31.36.0-255,66,1769,1,272968
1434,4.8e-05,74.125.24.0-255,2902,4671,1,272968
1435,5.1e-05,172.31.36.0-255,66,4737,1,272968
1436,5.8e-05,74.125.24.0-255,7156,11893,1,272968
1437,6.1e-05,172.31.36.0-255,66,11959,1,272968
1438,8e-05,74.125.24.0-255,2015,13974,1,272968
1439,8.3e-05,172.31.36.0-255,66,14040,1,272968
1440,8.7e-05,74.125.24.0-255,2902,16942,1,272968
1441,8.9e-05,172.31.36.0-255,66,17008,1,272968
1442,0.00012,74.125.24.0-255,7156,24164,1,272968
1443,0.000123,172.31.36.0-255,66,24230,1,272968
1444,0.000128,74.125.24.0-255,5738,29968,1,272968
1445,0.000131,172.31.36.0-255,66,30034,1,272968
1446,0.00016,74.125.24.0-255,1125,31159,1,272968
1447,0.000163,172.31.36.0-255,66,31225,1,272968
1448,0.000245,74.125.24.0-255,1484,32709,1,272968
1449,0.000248,172.31.36.0-255,66,32775,1,272968
1450,0.000253,74.125.24.0-255,2902,35677,1,272968
1451,0.000255,172.31.36.0-255,66,35743,1,272968
1452,0.000279,74.125.24.0-255,5738,41481,1,272968
1453,0.000283,172.31.36.0-255,66,41547,1,272968
1454,0.000286,74.125.24.0-255,1484,43031,1,272968
1455,0.000288,172.31.36.0-255,66,43097,1,272968
1456,0.000291,74.125.24.0-255,1484,44581,1,272968
1457,0.000293,172.31.36.0-255,66,44647,1,272968
1458,0.000322,172.31.36.0-255,66,44713,1,272968
1459,0.000328,74.125.24.0-255,4320,49033,1,272968
1460,0.00033,172.31.36.0-255,66,49099,1,272968
1461,0.000361,172.31.36.0-255,66,49165,1,272968
1462,0.000364,74.125.24.0-255,362,49527,1,272968
1463,0.000393,74.125.24.0-255,133,49660,1,272968
1464,0.000397,74.125.24.0-255,347,50007,1,272968
1465,0.000605,74.125.24.0-255,1484,51491,1,272968
1466,0.000609,74.125.24.0-255,2902,54393,1,272968
1467,0.000611,172.31.36.0-255,66,54459,1,272968
1468,0.000615,172.31.36.0-255,66,54525,1,272968
1469,0.000635,74.125.24.0-255,5738,60263,1,272968
1470,0.000639,172.31.36.0-255,66,60329,1,272968
1471,0.000643,74.125.24.0-255,2902,63231,1,272968
1472,0.000645,172.31.36.0-255,66,63297,1,272968
1473,0.000672,172.31.36.0-255,66,63363,1,272968
1474,0.000701,74.125.24.0-255,1484,64847,1,272968
1475,0.000725,172.31.36.0-255,66,64913,1,272968
1476,0.001165,74.125.24.0-255,1484,66397,1,272968
1477,0.001171,74.125.24.0-255,2902,69299,1,272968
1478,0.001175,172.31.36.0-255,66,69365,1,272968
1479,0.001201,74.125.24.0-255,5738,75103,1,272968
1480,0.001205,172.31.36.0-255,66,75169,1,272968
1481,0.001208,74.125.24.0-255,1484,76653,1,272968
1482,0.001236,172.31.36.0-255,66,76719,1,272968
1483,0.001257,74.125.24.0-255,5738,82457,1,272968
1484,0.00126,172.31.36.0-255,66,82523,1,272968
1485,0.00129,74.125.24.0-255,5020,87543,1,272968
1486,0.001293,172.31.36.0-255,66,87609,1,272968
1487,0.001727,74.125.24.0-255,1484,89093,1,272968
1488,0.001737,74.125.24.0-255,2902,91995,1,272968
1489,0.001741,172.31.36.0-255,66,92061,1,272968
1490,0.001762,74.125.24.0-255,5738,97799,1,272968
1491,0.001765,172.31.36.0-255,66,97865,1,272968
1492,0.001769,74.125.24.0-255,2902,100767,1,272968
1493,0.001772,172.31.36.0-255,66,100833,1,272968
1494,0.001796,172.31.36.0-255,66,100899,1,272968
1495,0.001803,74.125.24.0-255,5738,106637,1,272968
1496,0.001805,172.31.36.0-255,66,106703,1,272968
1497,0.001823,74.125.24.0-255,5020,111723,1,272968
1498,0.001825,172.31.36.0-255,66,111789,1,272968
1499,0.001868,74.125.24.0-255,1484,113273,1,272968
1500,0.001873,74.125.24.0-255,2902,116175,1,272968
1501,0.001875,172.31.36.0-255,66,116241,1,272968
1502,0.001898,74.125.24.0-255,5738,121979,1,272968
1503,0.0019,172.31.36.0-255,66,122045,1,272968
1504,0.001916,74.125.24.0-255,5738,127783,1,272968
1505,0.001918,172.31.36.0-255,66,127849,1,272968
1506,0.001936,74.125.24.0-255,1484,129333,1,272968
1507,0.001953,172.31.36.0-255,66,129399,1,272968
1508,0.001957,74.125.24.0-255,2184,131583,1,272968
1509,0.001959,172.31.36.0-255,66,131649,1,272968
1510,0.003946,74.125.24.0-255,5738,137387,1,272968
1511,0.003953,172.31.36.0-255,66,137453,1,272968
1512,0.005958,74.125.24.0-255,5738,143191,1,272968
1513,0.005962,172.31.36.0-255,66,143257,1,272968
1514,0.007975,74.125.24.0-255,5738,148995,1,272968
1515,0.007982,172.31.36.0-255,66,149061,1,272968
1516,0.009952,74.125.24.0-255,5738,154799,1,272968
1517,0.009959,172.31.36.0-255,66,154865,1,272968
1518,0.012033,74.125.24.0-255,5738,160603,1,272968
1519,0.012039,172.31.36.0-255,66,160669,1,272968
1520,0.014051,74.125.24.0-255,5738,166407,1,272968
1521,0.014058,172.31.36.0-255,66,166473,1,272968
1522,0.016082,74.125.24.0-255,5738,172211,1,272968
1523,0.01609,172.31.36.0-255,66,172277,1,272968
1524,0.018065,74.125.24.0-255,5738,178015,1,272968
1525,0.018072,172.31.36.0-255,66,178081,1,272968
1526,0.020071,74.125.24.0-255,5738,183819,1,272968
1527,0.020081,172.31.36.0-255,66,183885,1,272968
1528,0.02205,74.125.24.0-255,5738,189623,1,272968
1529,0.022057,172.31.36.0-255,66,189689,1,272968
1530,0.024063,74.125.24.0-255,5738,195427,1,272968
1531,0.02407,172.31.36.0-255,66,195493,1,272968
1532,0.026064,74.125.24.0-255,5738,201231,1,272968
1533,0.026071,172.31.36.0-255,66,201297,1,272968
1534,0.028104,74.125.24.0-255,5738,207035,1,272968
1535,0.028112,172.31.36.0-255,66,207101,1,272968
1536,0.030125,74.125.24.0-255,5738,212839,1,272968
1537,0.030133,172.31.36.0-255,66,212905,1,272968
1538,0.032144,74.125.24.0-255,5738,218643,1,272968
1539,0.032151,172.31.36.0-255,66,218709,1,272968
1540,0.032622,172.31.36.0-255,188,218897,1,272968
1541,0.032666,172.31.36.0-255,958,219855,1,272968
1542,0.032739,172.31.36.0-255,1514,221369,1,272968
1543,0.03274,172.31.36.0-255,1514,222883,1,272968
1544,0.032741,172.31.36.0-255,1514,224397,1,272968
1545,0.032746,172.31.36.0-255,1514,225911,1,272968
1546,0.032747,172.31.36.0-255,1514,227425,1,272968
1547,0.032748,172.31.36.0-255,199,227624,1,272968
1548,0.034118,104.244.42.0-255,66,227690,1,272968
1549,0.034131,74.125.24.0-255,5738,233428,1,272968
1550,0.034136,172.31.36.0-255,66,233494,1,272968
1551,0.034178,104.244.42.0-255,66,233560,1,272968
1552,0.034261,104.244.42.0-255,66,233626,1,272968
1553,0.034268,104.244.42.0-255,66,233692,1,272968
1554,0.036145,74.125.24.0-255,4320,238012,1,272968
1555,0.03615,172.31.36.0-255,66,238078,1,272968
1556,0.036167,74.125.24.0-255,1484,239562,1,272968
1557,0.038117,74.125.24.0-255,4320,243882,1,272968
1558,0.038121,172.31.36.0-255,66,243948,1,272968
1559,0.04009,74.125.24.0-255,5738,249686,1,272968
1560,0.040095,172.31.36.0-255,66,249752,1,272968
1561,0.042093,74.125.24.0-255,5738,255490,1,272968
1562,0.042097,172.31.36.0-255,66,255556,1,272968
1563,0.044074,74.125.24.0-255,5738,261294,1,272968
1564,0.04408,172.31.36.0-255,66,261360,1,272968
1565,0.046093,74.125.24.0-255,5738,267098,1,272968
1566,0.046099,172.31.36.0-255,66,267164,1,272968
1567,0.048088,74.125.24.0-255,5738,272902,1,272968
1568,0.048093,172.31.36.0-255,66,272968,1,272968
1569,0.0,172.217.194.0-255,153,153,1,215646
1570,2.7e-05,172.31.36.0-255,66,219,1,215646
1571,3.3e-05,172.217.194.0-255,1484,1703,1,215646
1572,3.7e-05,172.31.36.0-255,66,1769,1,215646
1573,5.1e-05,172.217.194.0-255,2902,4671,1,215646
1574,5.4e-05,172.31.36.0-255,66,4737,1,215646
1575,6.1e-05,172.217.194.0-255,7156,11893,1,215646
1576,6.4e-05,172.31.36.0-255,66,11959,1,215646
1577,7e-05,172.217.194.0-255,4865,16824,1,215646
1578,7.3e-05,172.31.36.0-255,66,16890,1,215646
1579,0.000107,172.31.36.0-255,66,16956,1,215646
1580,0.000135,172.217.194.0-255,1125,18081,1,215646
1581,0.000138,172.31.36.0-255,66,18147,1,215646
1582,0.000162,172.217.194.0-255,1484,19631,1,215646
1583,0.000164,172.31.36.0-255,66,19697,1,215646
1584,0.000169,172.217.194.0-255,2902,22599,1,215646
1585,0.000171,172.31.36.0-255,66,22665,1,215646
1586,0.000175,172.217.194.0-255,1484,24149,1,215646
1587,0.000182,172.31.36.0-255,66,24215,1,215646
1588,0.000211,172.217.194.0-255,4320,28535,1,215646
1589,0.000215,172.31.36.0-255,66,28601,1,215646
1590,0.000222,172.217.194.0-255,7156,35757,1,215646
1591,0.000224,172.31.36.0-255,66,35823,1,215646
1592,0.00026,172.217.194.0-255,6797,42620,1,215646
1593,0.000264,172.31.36.0-255,66,42686,1,215646
1594,0.000267,172.217.194.0-255,1484,44170,1,215646
1595,0.000269,172.31.36.0-255,66,44236,1,215646
1596,0.00028,172.31.36.0-255,66,44302,1,215646
1597,0.000318,172.217.194.0-255,1784,46086,1,215646
1598,0.000321,172.31.36.0-255,66,46152,1,215646
1599,0.000325,172.217.194.0-255,2902,49054,1,215646
1600,0.000328,172.31.36.0-255,66,49120,1,215646
1601,0.000333,172.217.194.0-255,4320,53440,1,215646
1602,0.000338,172.31.36.0-255,66,53506,1,215646
1603,0.00035,172.217.194.0-255,2902,56408,1,215646
1604,0.000353,172.31.36.0-255,66,56474,1,215646
1605,0.000402,172.217.194.0-255,6797,63271,1,215646
1606,0.000407,172.31.36.0-255,66,63337,1,215646
1607,0.000409,172.217.194.0-255,7156,70493,1,215646
1608,0.000412,172.31.36.0-255,66,70559,1,215646
1609,0.000459,172.31.36.0-255,66,70625,1,215646
1610,0.000542,172.217.194.0-255,1484,72109,1,215646
1611,0.000549,172.217.194.0-255,2902,75011,1,215646
1612,0.000552,172.31.36.0-255,66,75077,1,215646
1613,0.000559,172.217.194.0-255,4320,79397,1,215646
1614,0.000562,172.31.36.0-255,66,79463,1,215646
1615,0.00058,172.217.194.0-255,1484,80947,1,215646
1616,0.000587,172.217.194.0-255,7156,88103,1,215646
1617,0.000591,172.31.36.0-255,66,88169,1,215646
1618,0.000596,172.217.194.0-255,4320,92489,1,215646
1619,0.000599,172.31.36.0-255,66,92555,1,215646
1620,0.000636,172.31.36.0-255,66,92621,1,215646
1621,0.000641,172.217.194.0-255,2184,94805,1,215646
1622,0.000643,172.31.36.0-255,66,94871,1,215646
1623,0.000683,172.217.194.0-255,2902,97773,1,215646
1624,0.000686,172.31.36.0-255,66,97839,1,215646
1625,0.000693,172.217.194.0-255,7156,104995,1,215646
1626,0.000698,172.31.36.0-255,66,105061,1,215646
1627,0.0007,172.217.194.0-255,7156,112217,1,215646
1628,0.000702,172.31.36.0-255,66,112283,1,215646
1629,0.000714,172.31.36.0-255,66,112349,1,215646
1630,0.000747,172.217.194.0-255,5738,118087,1,215646
1631,0.000752,172.31.36.0-255,66,118153,1,215646
1632,0.000756,172.217.194.0-255,766,118919,1,215646
1633,0.001105,172.217.194.0-255,1484,120403,1,215646
1634,0.001111,172.31.36.0-255,66,120469,1,215646
1635,0.001117,172.217.194.0-255,2902,123371,1,215646
1636,0.001119,172.31.36.0-255,66,123437,1,215646
1637,0.001123,172.217.194.0-255,1484,124921,1,215646
1638,0.001154,172.217.194.0-255,4320,129241,1,215646
1639,0.001157,172.31.36.0-255,66,129307,1,215646
1640,0.001164,172.217.194.0-255,5738,135045,1,215646
1641,0.001166,172.31.36.0-255,66,135111,1,215646
1642,0.001179,172.31.36.0-255,66,135177,1,215646
1643,0.001204,172.217.194.0-255,5020,140197,1,215646
1644,0.001207,172.31.36.0-255,66,140263,1,215646
1645,0.001253,172.217.194.0-255,1484,141747,1,215646
1646,0.001259,172.217.194.0-255,2902,144649,1,215646
1647,0.001262,172.31.36.0-255,66,144715,1,215646
1648,0.001298,172.217.194.0-255,5738,150453,1,215646
1649,0.001301,172.31.36.0-255,66,150519,1,215646
1650,0.001318,172.31.36.0-255,66,150585,1,215646
1651,0.001368,172.31.36.0-255,66,150651,1,215646
1652,0.001466,172.217.194.0-255,5020,155671,1,215646
1653,0.001469,172.217.194.0-255,1484,157155,1,215646
1654,0.001482,172.217.194.0-255,2902,160057,1,215646
1655,0.001508,172.217.194.0-255,5738,165795,1,215646
1656,0.001512,172.217.194.0-255,2902,168697,1,215646
1657,0.00155,172.217.194.0-255,5738,174435,1,215646
1658,0.001571,172.217.194.0-255,5020,179455,1,215646
1659,0.001631,172.217.194.0-255,1484,180939,1,215646
1660,0.001635,172.217.194.0-255,2902,183841,1,215646
1661,0.00166,172.217.194.0-255,5738,189579,1,215646
1662,0.001663,172.217.194.0-255,1484,191063,1,215646
1663,0.0017,172.217.194.0-255,1484,192547,1,215646
1664,0.00173,172.217.194.0-255,7156,199703,1,215646
1665,0.001794,172.217.194.0-255,3602,203305,1,215646
1666,0.001807,172.217.194.0-255,1484,204789,1,215646
1667,0.001856,172.217.194.0-255,1484,206273,1,215646
1668,0.001894,172.217.194.0-255,105,206378,1,215646
1669,0.00532,172.31.36.0-255,66,206444,1,215646
1670,0.007526,172.31.36.0-255,105,206549,1,215646
1671,0.0098,172.217.194.0-255,66,206615,1,215646
1672,0.035665,172.31.36.0-255,172,206787,1,215646
1673,0.035696,172.31.36.0-255,1115,207902,1,215646
1674,0.035745,172.31.36.0-255,1514,209416,1,215646
1675,0.035747,172.31.36.0-255,1514,210930,1,215646
1676,0.035748,172.31.36.0-255,1514,212444,1,215646
1677,0.03575,172.31.36.0-255,1514,213958,1,215646
1678,0.035751,172.31.36.0-255,1490,215448,1,215646
1679,0.037161,104.244.42.0-255,66,215514,1,215646
1680,0.037193,104.244.42.0-255,66,215580,1,215646
1681,0.037274,104.244.42.0-255,66,215646,1,215646
1682,0.0,74.125.24.0-255,143,143,1,283811
1683,3.5e-05,172.31.36.0-255,66,209,1,283811
1684,4.2e-05,74.125.24.0-255,1484,1693,1,283811
1685,4.6e-05,172.31.36.0-255,66,1759,1,283811
1686,5.1e-05,74.125.24.0-255,2902,4661,1,283811
1687,5.4e-05,172.31.36.0-255,66,4727,1,283811
1688,6.1e-05,74.125.24.0-255,5738,10465,1,283811
1689,6.3e-05,172.31.36.0-255,66,10531,1,283811
1690,9.5e-05,74.125.24.0-255,6365,16896,1,283811
1691,0.0001,172.31.36.0-255,66,16962,1,283811
1692,0.000109,74.125.24.0-255,4320,21282,1,283811
1693,0.000111,172.31.36.0-255,66,21348,1,283811
1694,0.000143,172.31.36.0-255,66,21414,1,283811
1695,0.000489,74.125.24.0-255,1484,22898,1,283811
1696,0.000494,172.31.36.0-255,66,22964,1,283811
1697,0.000499,74.125.24.0-255,2902,25866,1,283811
1698,0.000501,172.31.36.0-255,66,25932,1,283811
1699,0.00053,74.125.24.0-255,5738,31670,1,283811
1700,0.000533,172.31.36.0-255,66,31736,1,283811
1701,0.000553,74.125.24.0-255,5738,37474,1,283811
1702,0.000556,172.31.36.0-255,66,37540,1,283811
1703,0.000575,74.125.24.0-255,5379,42919,1,283811
1704,0.000578,172.31.36.0-255,66,42985,1,283811
1705,0.000589,172.31.36.0-255,66,43051,1,283811
1706,0.000606,74.125.24.0-255,4271,47322,1,283811
1707,0.000608,172.31.36.0-255,66,47388,1,283811
1708,0.000655,74.125.24.0-255,110,47498,1,283811
1709,0.00066,172.31.36.0-255,66,47564,1,283811
1710,0.000779,74.125.24.0-255,1484,49048,1,283811
1711,0.000784,172.31.36.0-255,66,49114,1,283811
1712,0.000789,74.125.24.0-255,2902,52016,1,283811
1713,0.000791,172.31.36.0-255,66,52082,1,283811
1714,0.000797,74.125.24.0-255,5738,57820,1,283811
1715,0.000799,172.31.36.0-255,66,57886,1,283811
1716,0.000816,74.125.24.0-255,1484,59370,1,283811
1717,0.000838,74.125.24.0-255,2902,62272,1,283811
1718,0.000841,172.31.36.0-255,66,62338,1,283811
1719,0.000847,74.125.24.0-255,5738,68076,1,283811
1720,0.000849,172.31.36.0-255,66,68142,1,283811
1721,0.000879,172.31.36.0-255,66,68208,1,283811
1722,0.000882,74.125.24.0-255,766,68974,1,283811
1723,0.00091,74.125.24.0-255,333,69307,1,283811
1724,0.00094,74.125.24.0-255,1484,70791,1,283811
1725,0.000944,172.31.36.0-255,66,70857,1,283811
1726,0.000948,74.125.24.0-255,1484,72341,1,283811
1727,0.000964,74.125.24.0-255,2902,75243,1,283811
1728,0.000967,172.31.36.0-255,66,75309,1,283811
1729,0.000971,74.125.24.0-255,1484,76793,1,283811
1730,0.00099,74.125.24.0-255,4320,81113,1,283811
1731,0.000994,172.31.36.0-255,66,81179,1,283811
1732,0.001002,74.125.24.0-255,7156,88335,1,283811
1733,0.001004,172.31.36.0-255,66,88401,1,283811
1734,0.001026,74.125.24.0-255,1484,89885,1,283811
1735,0.001058,172.31.36.0-255,66,89951,1,283811
1736,0.001061,74.125.24.0-255,216,90167,1,283811
1737,0.001109,74.125.24.0-255,1484,91651,1,283811
1738,0.001113,172.31.36.0-255,66,91717,1,283811
1739,0.001131,74.125.24.0-255,1484,93201,1,283811
1740,0.001137,74.125.24.0-255,4320,97521,1,283811
1741,0.00114,172.31.36.0-255,66,97587,1,283811
1742,0.001157,74.125.24.0-255,5738,103325,1,283811
1743,0.00116,172.31.36.0-255,66,103391,1,283811
1744,0.001187,74.125.24.0-255,4320,107711,1,283811
1745,0.00119,172.31.36.0-255,66,107777,1,283811
1746,0.001207,172.31.36.0-255,66,107843,1,283811
1747,0.00121,74.125.24.0-255,766,108609,1,283811
1748,0.001432,74.125.24.0-255,1484,110093,1,283811
1749,0.001436,172.31.36.0-255,66,110159,1,283811
1750,0.001442,74.125.24.0-255,2902,113061,1,283811
1751,0.001444,172.31.36.0-255,66,113127,1,283811
1752,0.001447,74.125.24.0-255,1484,114611,1,283811
1753,0.001472,74.125.24.0-255,4320,118931,1,283811
1754,0.001477,172.31.36.0-255,66,118997,1,283811
1755,0.001479,74.125.24.0-255,7156,126153,1,283811
1756,0.001481,172.31.36.0-255,66,126219,1,283811
1757,0.001502,74.125.24.0-255,5738,131957,1,283811
1758,0.001505,172.31.36.0-255,66,132023,1,283811
1759,0.001512,74.125.24.0-255,7156,139179,1,283811
1760,0.001514,172.31.36.0-255,66,139245,1,283811
1761,0.001536,74.125.24.0-255,3602,142847,1,283811
1762,0.001538,172.31.36.0-255,66,142913,1,283811
1763,0.00158,74.125.24.0-255,1484,144397,1,283811
1764,0.001584,74.125.24.0-255,1484,145881,1,283811
1765,0.001586,172.31.36.0-255,66,145947,1,283811
1766,0.001598,74.125.24.0-255,1484,147431,1,283811
1767,0.001621,74.125.24.0-255,5738,153169,1,283811
1768,0.001625,172.31.36.0-255,66,153235,1,283811
1769,0.001657,172.31.36.0-255,66,153301,1,283811
1770,0.001693,74.125.24.0-255,1484,154785,1,283811
1771,0.001715,172.31.36.0-255,66,154851,1,283811
1772,0.00175,172.31.36.0-255,66,154917,1,283811
1773,0.001792,74.125.24.0-255,5738,160655,1,283811
1774,0.001796,172.31.36.0-255,66,160721,1,283811
1775,0.001831,74.125.24.0-255,4320,165041,1,283811
1776,0.001835,172.31.36.0-255,66,165107,1,283811
1777,0.001851,172.31.36.0-255,66,165173,1,283811
1778,0.001867,74.125.24.0-255,1484,166657,1,283811
1779,0.001887,74.125.24.0-255,2902,169559,1,283811
1780,0.001891,172.31.36.0-255,66,169625,1,283811
1781,0.001897,74.125.24.0-255,5738,175363,1,283811
1782,0.0019,172.31.36.0-255,66,175429,1,283811
1783,0.001927,172.31.36.0-255,66,175495,1,283811
1784,0.001944,74.125.24.0-255,4320,179815,1,283811
1785,0.001947,172.31.36.0-255,66,179881,1,283811
1786,0.001962,74.125.24.0-255,6438,186319,1,283811
1787,0.001966,74.125.24.0-255,2902,189221,1,283811
1788,0.001967,172.31.36.0-255,66,189287,1,283811
1789,0.00197,172.31.36.0-255,66,189353,1,283811
1790,0.002006,172.31.36.0-255,66,189419,1,283811
1791,0.002017,172.31.36.0-255,66,189485,1,283811
1792,0.00204,74.125.24.0-255,4320,193805,1,283811
1793,0.002042,172.31.36.0-255,66,193871,1,283811
1794,0.002048,74.125.24.0-255,2902,196773,1,283811
1795,0.002051,172.31.36.0-255,66,196839,1,283811
1796,0.002065,74.125.24.0-255,5020,201859,1,283811
1797,0.002068,172.31.36.0-255,66,201925,1,283811
1798,0.002351,74.125.24.0-255,1484,203409,1,283811
1799,0.002369,74.125.24.0-255,2902,206311,1,283811
1800,0.002373,172.31.36.0-255,66,206377,1,283811
1801,0.002389,74.125.24.0-255,4320,210697,1,283811
1802,0.002393,172.31.36.0-255,66,210763,1,283811
1803,0.004711,74.125.24.0-255,1484,212247,1,283811
1804,0.004732,74.125.24.0-255,4320,216567,1,283811
1805,0.004737,172.31.36.0-255,66,216633,1,283811
1806,0.007095,74.125.24.0-255,5738,222371,1,283811
1807,0.007102,172.31.36.0-255,66,222437,1,283811
1808,0.009445,74.125.24.0-255,5738,228175,1,283811
1809,0.009451,172.31.36.0-255,66,228241,1,283811
1810,0.011788,74.125.24.0-255,5738,233979,1,283811
1811,0.011796,172.31.36.0-255,66,234045,1,283811
1812,0.014116,74.125.24.0-255,5738,239783,1,283811
1813,0.014124,172.31.36.0-255,66,239849,1,283811
1814,0.016455,74.125.24.0-255,5738,245587,1,283811
1815,0.016462,172.31.36.0-255,66,245653,1,283811
1816,0.018819,74.125.24.0-255,5738,251391,1,283811
1817,0.018827,172.31.36.0-255,66,251457,1,283811
1818,0.021185,74.125.24.0-255,5738,257195,1,283811
1819,0.021197,172.31.36.0-255,66,257261,1,283811
1820,0.023548,74.125.24.0-255,5738,262999,1,283811
1821,0.023553,172.31.36.0-255,66,263065,1,283811
1822,0.02589,74.125.24.0-255,5738,268803,1,283811
1823,0.025895,172.31.36.0-255,66,268869,1,283811
1824,0.027507,172.31.36.0-255,167,269036,1,283811
1825,0.027538,172.31.36.0-255,1114,270150,1,283811
1826,0.027581,172.31.36.0-255,1514,271664,1,283811
1827,0.027583,172.31.36.0-255,327,271991,1,283811
1828,0.028246,74.125.24.0-255,5738,277729,1,283811
1829,0.028252,172.31.36.0-255,66,277795,1,283811
1830,0.029094,104.244.42.0-255,66,277861,1,283811
1831,0.029124,104.244.42.0-255,66,277927,1,283811
1832,0.029163,104.244.42.0-255,66,277993,1,283811
1833,0.030627,74.125.24.0-255,1484,279477,1,283811
1834,0.030658,74.125.24.0-255,4097,283574,1,283811
1835,0.030664,172.31.36.0-255,66,283640,1,283811
1836,0.030832,172.31.36.0-255,105,283745,1,283811
1837,0.033133,74.125.24.0-255,66,283811,1,283811
1838,0.0,74.125.68.0-255,152,152,1,345383
1839,2.2e-05,172.31.36.0-255,66,218,1,345383
1840,2.9e-05,74.125.68.0-255,1484,1702,1,345383
1841,3.4e-05,172.31.36.0-255,66,1768,1,345383
1842,3.9e-05,74.125.68.0-255,2902,4670,1,345383
1843,5e-05,172.31.36.0-255,66,4736,1,345383
1844,5.8e-05,74.125.68.0-255,7156,11892,1,345383
1845,6.1e-05,172.31.36.0-255,66,11958,1,345383
1846,6.5e-05,74.125.68.0-255,2071,14029,1,345383
1847,6.9e-05,172.31.36.0-255,66,14095,1,345383
1848,0.000138,74.125.68.0-255,1484,15579,1,345383
1849,0.000141,172.31.36.0-255,66,15645,1,345383
1850,0.000173,74.125.68.0-255,2902,18547,1,345383
1851,0.000175,172.31.36.0-255,66,18613,1,345383
1852,0.000181,74.125.68.0-255,4320,22933,1,345383
1853,0.000184,172.31.36.0-255,66,22999,1,345383
1854,0.000229,74.125.68.0-255,5738,28737,1,345383
1855,0.000232,172.31.36.0-255,66,28803,1,345383
1856,0.000248,74.125.68.0-255,2543,31346,1,345383
1857,0.00025,172.31.36.0-255,66,31412,1,345383
1858,0.000408,74.125.68.0-255,1484,32896,1,345383
1859,0.000413,172.31.36.0-255,66,32962,1,345383
1860,0.00042,74.125.68.0-255,2902,35864,1,345383
1861,0.000422,172.31.36.0-255,66,35930,1,345383
1862,0.000454,74.125.68.0-255,5738,41668,1,345383
1863,0.000457,172.31.36.0-255,66,41734,1,345383
1864,0.000465,74.125.68.0-255,6797,48531,1,345383
1865,0.000468,172.31.36.0-255,66,48597,1,345383
1866,0.000495,74.125.68.0-255,7156,55753,1,345383
1867,0.000498,172.31.36.0-255,66,55819,1,345383
1868,0.000519,74.125.68.0-255,5738,61557,1,345383
1869,0.000522,172.31.36.0-255,66,61623,1,345383
1870,0.000547,74.125.68.0-255,2902,64525,1,345383
1871,0.000551,74.125.68.0-255,1125,65650,1,345383
1872,0.000613,172.31.36.0-255,66,65716,1,345383
1873,0.000666,74.125.68.0-255,647,66363,1,345383
1874,0.000807,74.125.68.0-255,1484,67847,1,345383
1875,0.000829,74.125.68.0-255,2902,70749,1,345383
1876,0.000833,74.125.68.0-255,1484,72233,1,345383
1877,0.000839,172.31.36.0-255,66,72299,1,345383
1878,0.000851,74.125.68.0-255,4320,76619,1,345383
1879,0.000868,172.31.36.0-255,66,76685,1,345383
1880,0.000872,74.125.68.0-255,1484,78169,1,345383
1881,0.000923,74.125.68.0-255,2902,81071,1,345383
1882,0.000927,172.31.36.0-255,66,81137,1,345383
1883,0.000935,172.31.36.0-255,66,81203,1,345383
1884,0.000985,172.31.36.0-255,66,81269,1,345383
1885,0.001023,74.125.68.0-255,1484,82753,1,345383
1886,0.001028,74.125.68.0-255,2902,85655,1,345383
1887,0.001032,172.31.36.0-255,66,85721,1,345383
1888,0.001042,74.125.68.0-255,4320,90041,1,345383
1889,0.001059,172.31.36.0-255,66,90107,1,345383
1890,0.001063,74.125.68.0-255,1484,91591,1,345383
1891,0.001111,172.31.36.0-255,66,91657,1,345383
1892,0.001138,74.125.68.0-255,5738,97395,1,345383
1893,0.001146,172.31.36.0-255,66,97461,1,345383
1894,0.001167,74.125.68.0-255,5738,103199,1,345383
1895,0.001171,74.125.68.0-255,2184,105383,1,345383
1896,0.001187,74.125.68.0-255,1484,106867,1,345383
1897,0.001192,172.31.36.0-255,66,106933,1,345383
1898,0.001203,74.125.68.0-255,2902,109835,1,345383
1899,0.001234,74.125.68.0-255,5738,115573,1,345383
1900,0.00124,74.125.68.0-255,4320,119893,1,345383
1901,0.001256,172.31.36.0-255,66,119959,1,345383
1902,0.001296,74.125.68.0-255,4320,124279,1,345383
1903,0.001312,172.31.36.0-255,66,124345,1,345383
1904,0.001339,74.125.68.0-255,3602,127947,1,345383
1905,0.001347,172.31.36.0-255,66,128013,1,345383
1906,0.001386,74.125.68.0-255,1484,129497,1,345383
1907,0.001402,74.125.68.0-255,2902,132399,1,345383
1908,0.001416,172.31.36.0-255,66,132465,1,345383
1909,0.001441,74.125.68.0-255,1484,133949,1,345383
1910,0.001456,74.125.68.0-255,1484,135433,1,345383
1911,0.001459,74.125.68.0-255,1484,136917,1,345383
1912,0.001476,74.125.68.0-255,2902,139819,1,345383
1913,0.001482,74.125.68.0-255,4320,144139,1,345383
1914,0.00149,172.31.36.0-255,66,144205,1,345383
1915,0.001501,74.125.68.0-255,4320,148525,1,345383
1916,0.00151,74.125.68.0-255,4320,152845,1,345383
1917,0.001525,74.125.68.0-255,5738,158583,1,345383
1918,0.001531,172.31.36.0-255,66,158649,1,345383
1919,0.001567,74.125.68.0-255,3602,162251,1,345383
1920,0.001593,172.31.36.0-255,66,162317,1,345383
1921,0.001723,74.125.68.0-255,1484,163801,1,345383
1922,0.001728,74.125.68.0-255,1484,165285,1,345383
1923,0.001772,172.31.36.0-255,66,165351,1,345383
1924,0.001782,74.125.68.0-255,2902,168253,1,345383
1925,0.001792,74.125.68.0-255,5738,173991,1,345383
1926,0.001808,172.31.36.0-255,66,174057,1,345383
1927,0.001818,74.125.68.0-255,5738,179795,1,345383
1928,0.001842,74.125.68.0-255,4320,184115,1,345383
1929,0.001862,74.125.68.0-255,3602,187717,1,345383
1930,0.00187,172.31.36.0-255,66,187783,1,345383
1931,0.002018,74.125.68.0-255,1484,189267,1,345383
1932,0.002038,74.125.68.0-255,1484,190751,1,345383
1933,0.00205,74.125.68.0-255,1484,192235,1,345383
1934,0.002055,74.125.68.0-255,2902,195137,1,345383
1935,0.00206,74.125.68.0-255,4320,199457,1,345383
1936,0.002072,172.31.36.0-255,66,199523,1,345383
1937,0.002109,74.125.68.0-255,4320,203843,1,345383
1938,0.002126,74.125.68.0-255,4320,208163,1,345383
1939,0.00213,74.125.68.0-255,4320,212483,1,345383
1940,0.002151,74.125.68.0-255,5738,218221,1,345383
1941,0.002168,74.125.68.0-255,3602,221823,1,345383
1942,0.002172,74.125.68.0-255,4320,226143,1,345383
1943,0.002193,74.125.68.0-255,7156,233299,1,345383
1944,0.002203,74.125.68.0-255,2902,236201,1,345383
1945,0.002207,74.125.68.0-255,4320,240521,1,345383
1946,0.002291,74.125.68.0-255,2902,243423,1,345383
1947,0.007249,172.31.36.0-255,66,243489,1,345383
1948,0.009788,74.125.68.0-255,5738,249227,1,345383
1949,0.009797,172.31.36.0-255,66,249293,1,345383
1950,0.012339,74.125.68.0-255,5738,255031,1,345383
1951,0.012346,172.31.36.0-255,66,255097,1,345383
1952,0.014863,74.125.68.0-255,5738,260835,1,345383
1953,0.014871,172.31.36.0-255,66,260901,1,345383
1954,0.017397,74.125.68.0-255,5738,266639,1,345383
1955,0.017408,172.31.36.0-255,66,266705,1,345383
1956,0.019932,74.125.68.0-255,5738,272443,1,345383
1957,0.019943,172.31.36.0-255,66,272509,1,345383
1958,0.022472,74.125.68.0-255,5738,278247,1,345383
1959,0.022488,172.31.36.0-255,66,278313,1,345383
1960,0.025008,74.125.68.0-255,5738,284051,1,345383
1961,0.025015,172.31.36.0-255,66,284117,1,345383
1962,0.027527,74.125.68.0-255,5738,289855,1,345383
1963,0.027538,172.31.36.0-255,66,289921,1,345383
1964,0.030053,74.125.68.0-255,5738,295659,1,345383
1965,0.03006,172.31.36.0-255,66,295725,1,345383
1966,0.032576,74.125.68.0-255,5738,301463,1,345383
1967,0.032586,172.31.36.0-255,66,301529,1,345383
1968,0.035103,74.125.68.0-255,5738,307267,1,345383
1969,0.035113,172.31.36.0-255,66,307333,1,345383
1970,0.037626,74.125.68.0-255,5738,313071,1,345383
1971,0.037634,172.31.36.0-255,66,313137,1,345383
1972,0.040158,74.125.68.0-255,5738,318875,1,345383
1973,0.040166,172.31.36.0-255,66,318941,1,345383
1974,0.042722,74.125.68.0-255,5738,324679,1,345383
1975,0.042731,172.31.36.0-255,66,324745,1,345383
1976,0.043463,172.31.36.0-255,172,324917,1,345383
1977,0.043495,172.31.36.0-255,1115,326032,1,345383
1978,0.043559,172.31.36.0-255,1514,327546,1,345383
1979,0.043561,172.31.36.0-255,1514,329060,1,345383
1980,0.043566,172.31.36.0-255,1514,330574,1,345383
1981,0.043567,172.31.36.0-255,1514,332088,1,345383
1982,0.043585,172.31.36.0-255,1489,333577,1,345383
1983,0.045,104.244.42.0-255,66,333643,1,345383
1984,0.045058,104.244.42.0-255,66,333709,1,345383
1985,0.045142,104.244.42.0-255,66,333775,1,345383
1986,0.045236,74.125.68.0-255,5738,339513,1,345383
1987,0.045242,172.31.36.0-255,66,339579,1,345383
1988,0.047762,74.125.68.0-255,5738,345317,1,345383
1989,0.04777,172.31.36.0-255,66,345383,1,345383
1990,0.0,172.217.194.0-255,160,160,1,229650
1991,2.2e-05,172.31.36.0-255,66,226,1,229650
1992,2.8e-05,172.217.194.0-255,1484,1710,1,229650
1993,3.1e-05,172.31.36.0-255,66,1776,1,229650
1994,3.7e-05,172.217.194.0-255,2902,4678,1,229650
1995,4.1e-05,172.31.36.0-255,66,4744,1,229650
1996,5.5e-05,172.217.194.0-255,7156,11900,1,229650
1997,5.7e-05,172.31.36.0-255,66,11966,1,229650
1998,6.1e-05,172.217.194.0-255,2074,14040,1,229650
1999,6.3e-05,172.31.36.0-255,66,14106,1,229650
2000,8.5e-05,172.217.194.0-255,2902,17008,1,229650
2001,9.1e-05,172.31.36.0-255,66,17074,1,229650
2002,0.000119,172.217.194.0-255,7156,24230,1,229650
2003,0.000121,172.31.36.0-255,66,24296,1,229650
2004,0.000127,172.217.194.0-255,4320,28616,1,229650
2005,0.000129,172.31.36.0-255,66,28682,1,229650
2006,0.000143,172.217.194.0-255,1484,30166,1,229650
2007,0.000145,172.31.36.0-255,66,30232,1,229650
2008,0.000187,172.217.194.0-255,1125,31357,1,229650
2009,0.00019,172.31.36.0-255,66,31423,1,229650
2010,0.000218,172.217.194.0-255,1484,32907,1,229650
2011,0.00022,172.31.36.0-255,66,32973,1,229650
2012,0.000223,172.217.194.0-255,1484,34457,1,229650
2013,0.000224,172.31.36.0-255,66,34523,1,229650
2014,0.000229,172.217.194.0-255,4320,38843,1,229650
2015,0.000231,172.31.36.0-255,66,38909,1,229650
2016,0.000267,172.31.36.0-255,66,38975,1,229650
2017,0.000276,172.31.36.0-255,66,39041,1,229650
2018,0.000297,172.217.194.0-255,4320,43361,1,229650
2019,0.000299,172.31.36.0-255,66,43427,1,229650
2020,0.000322,172.217.194.0-255,2797,46224,1,229650
2021,0.000324,172.31.36.0-255,66,46290,1,229650
2022,0.001495,172.217.194.0-255,117,46407,1,229650
2023,0.001592,172.217.194.0-255,1484,47891,1,229650
2024,0.001597,172.31.36.0-255,66,47957,1,229650
2025,0.001604,172.217.194.0-255,2902,50859,1,229650
2026,0.001607,172.31.36.0-255,66,50925,1,229650
2027,0.001621,172.217.194.0-255,5738,56663,1,229650
2028,0.001624,172.31.36.0-255,66,56729,1,229650
2029,0.001629,172.217.194.0-255,2902,59631,1,229650
2030,0.001631,172.31.36.0-255,66,59697,1,229650
2031,0.001681,172.31.36.0-255,66,59763,1,229650
2032,0.001701,172.31.36.0-255,66,59829,1,229650
2033,0.001705,172.217.194.0-255,1125,60954,1,229650
2034,0.001869,172.217.194.0-255,1484,62438,1,229650
2035,0.001875,172.31.36.0-255,66,62504,1,229650
2036,0.001881,172.217.194.0-255,2902,65406,1,229650
2037,0.001884,172.31.36.0-255,66,65472,1,229650
2038,0.001898,172.217.194.0-255,5738,71210,1,229650
2039,0.0019,172.31.36.0-255,66,71276,1,229650
2040,0.001952,172.31.36.0-255,66,71342,1,229650
2041,0.001964,172.31.36.0-255,66,71408,1,229650
2042,0.001973,172.217.194.0-255,766,72174,1,229650
2043,0.001993,172.217.194.0-255,1484,73658,1,229650
2044,0.001996,172.31.36.0-255,66,73724,1,229650
2045,0.002002,172.217.194.0-255,4320,78044,1,229650
2046,0.002005,172.31.36.0-255,66,78110,1,229650
2047,0.002015,172.217.194.0-255,2902,81012,1,229650
2048,0.002018,172.31.36.0-255,66,81078,1,229650
2049,0.002065,172.217.194.0-255,7156,88234,1,229650
2050,0.002069,172.31.36.0-255,66,88300,1,229650
2051,0.002091,172.31.36.0-255,66,88366,1,229650
2052,0.002099,172.217.194.0-255,6438,94804,1,229650
2053,0.002102,172.31.36.0-255,66,94870,1,229650
2054,0.002133,172.217.194.0-255,7156,102026,1,229650
2055,0.002136,172.31.36.0-255,66,102092,1,229650
2056,0.002148,172.217.194.0-255,5738,107830,1,229650
2057,0.002151,172.31.36.0-255,66,107896,1,229650
2058,0.002157,172.217.194.0-255,2902,110798,1,229650
2059,0.00216,172.31.36.0-255,66,110864,1,229650
2060,0.002206,172.31.36.0-255,66,110930,1,229650
2061,0.002215,172.217.194.0-255,6438,117368,1,229650
2062,0.002217,172.31.36.0-255,66,117434,1,229650
2063,0.004814,172.217.194.0-255,5738,123172,1,229650
2064,0.004824,172.31.36.0-255,66,123238,1,229650
2065,0.007455,172.217.194.0-255,5738,128976,1,229650
2066,0.00746,172.31.36.0-255,66,129042,1,229650
2067,0.010072,172.217.194.0-255,5738,134780,1,229650
2068,0.010079,172.31.36.0-255,66,134846,1,229650
2069,0.012693,172.217.194.0-255,5738,140584,1,229650
2070,0.012703,172.31.36.0-255,66,140650,1,229650
2071,0.015313,172.217.194.0-255,4320,144970,1,229650
2072,0.015323,172.31.36.0-255,66,145036,1,229650
2073,0.015355,172.217.194.0-255,1484,146520,1,229650
2074,0.017954,172.217.194.0-255,4320,150840,1,229650
2075,0.017967,172.31.36.0-255,66,150906,1,229650
2076,0.020582,172.217.194.0-255,5738,156644,1,229650
2077,0.020593,172.31.36.0-255,66,156710,1,229650
2078,0.023202,172.217.194.0-255,5738,162448,1,229650
2079,0.023214,172.31.36.0-255,66,162514,1,229650
2080,0.025834,172.217.194.0-255,5738,168252,1,229650
2081,0.025846,172.31.36.0-255,66,168318,1,229650
2082,0.028489,172.217.194.0-255,5738,174056,1,229650
2083,0.028497,172.31.36.0-255,66,174122,1,229650
2084,0.031099,172.217.194.0-255,5738,179860,1,229650
2085,0.031107,172.31.36.0-255,66,179926,1,229650
2086,0.033008,172.31.36.0-255,172,180098,1,229650
2087,0.033058,172.31.36.0-255,1115,181213,1,229650
2088,0.033136,172.31.36.0-255,1514,182727,1,229650
2089,0.033147,172.31.36.0-255,1514,184241,1,229650
2090,0.033149,172.31.36.0-255,1514,185755,1,229650
2091,0.03315,172.31.36.0-255,1514,187269,1,229650
2092,0.033182,172.31.36.0-255,1489,188758,1,229650
2093,0.033718,172.217.194.0-255,5738,194496,1,229650
2094,0.033725,172.31.36.0-255,66,194562,1,229650
2095,0.03454,104.244.42.0-255,66,194628,1,229650
2096,0.034632,104.244.42.0-255,66,194694,1,229650
2097,0.034749,104.244.42.0-255,66,194760,1,229650
2098,0.036342,172.217.194.0-255,5738,200498,1,229650
2099,0.036348,172.31.36.0-255,66,200564,1,229650
2100,0.038955,172.217.194.0-255,5738,206302,1,229650
2101,0.03896,172.31.36.0-255,66,206368,1,229650
2102,0.041552,172.217.194.0-255,5738,212106,1,229650
2103,0.041558,172.31.36.0-255,66,212172,1,229650
2104,0.044162,172.217.194.0-255,5738,217910,1,229650
2105,0.044168,172.31.36.0-255,66,217976,1,229650
2106,0.04679,172.217.194.0-255,5738,223714,1,229650
2107,0.046796,172.31.36.0-255,66,223780,1,229650
2108,0.049384,172.217.194.0-255,4320,228100,1,229650
2109,0.049388,172.31.36.0-255,66,228166,1,229650
2110,0.049418,172.217.194.0-255,1484,229650,1,229650
2111,0.0,172.217.194.0-255,153,153,1,251254
2112,2e-05,172.31.36.0-255,66,219,1,251254
2113,2.7e-05,172.217.194.0-255,1484,1703,1,251254
2114,3.1e-05,172.31.36.0-255,66,1769,1,251254
2115,3.7e-05,172.217.194.0-255,2902,4671,1,251254
2116,4e-05,172.31.36.0-255,66,4737,1,251254
2117,4.5e-05,172.217.194.0-255,2902,7639,1,251254
2118,4.8e-05,172.31.36.0-255,66,7705,1,251254
2119,6.9e-05,172.217.194.0-255,4320,12025,1,251254
2120,7.2e-05,172.31.36.0-255,66,12091,1,251254
2121,7.6e-05,172.217.194.0-255,2140,14231,1,251254
2122,7.8e-05,172.31.36.0-255,66,14297,1,251254
2123,9e-05,172.31.36.0-255,66,14363,1,251254
2124,0.00011,172.217.194.0-255,1484,15847,1,251254
2125,0.000112,172.31.36.0-255,66,15913,1,251254
2126,0.000121,172.217.194.0-255,5379,21292,1,251254
2127,0.000123,172.31.36.0-255,66,21358,1,251254
2128,0.000163,172.217.194.0-255,1484,22842,1,251254
2129,0.000165,172.31.36.0-255,66,22908,1,251254
2130,0.000171,172.217.194.0-255,2902,25810,1,251254
2131,0.000173,172.31.36.0-255,66,25876,1,251254
2132,0.000192,172.217.194.0-255,5738,31614,1,251254
2133,0.000196,172.31.36.0-255,66,31680,1,251254
2134,0.000212,172.217.194.0-255,2902,34582,1,251254
2135,0.000215,172.31.36.0-255,66,34648,1,251254
2136,0.000242,172.31.36.0-255,66,34714,1,251254
2137,0.000266,172.217.194.0-255,5738,40452,1,251254
2138,0.000269,172.31.36.0-255,66,40518,1,251254
2139,0.000292,172.217.194.0-255,6713,47231,1,251254
2140,0.000295,172.31.36.0-255,66,47297,1,251254
2141,0.000386,172.217.194.0-255,114,47411,1,251254
2142,0.000529,172.217.194.0-255,1484,48895,1,251254
2143,0.000535,172.217.194.0-255,2902,51797,1,251254
2144,0.000567,172.217.194.0-255,4320,56117,1,251254
2145,0.000579,172.217.194.0-255,1484,57601,1,251254
2146,0.001305,172.217.194.0-255,1484,59085,1,251254
2147,0.001314,172.217.194.0-255,2902,61987,1,251254
2148,0.00132,172.217.194.0-255,4320,66307,1,251254
2149,0.001333,172.217.194.0-255,1484,67791,1,251254
2150,0.001336,172.217.194.0-255,1484,69275,1,251254
2151,0.001374,172.217.194.0-255,5738,75013,1,251254
2152,0.001434,172.217.194.0-255,2902,77915,1,251254
2153,0.001679,172.31.36.0-255,66,77981,1,251254
2154,0.001703,172.217.194.0-255,1484,79465,1,251254
2155,0.001723,172.217.194.0-255,2902,82367,1,251254
2156,0.001729,172.217.194.0-255,2902,85269,1,251254
2157,0.00174,172.217.194.0-255,1484,86753,1,251254
2158,0.001752,172.217.194.0-255,1484,88237,1,251254
2159,0.001771,172.217.194.0-255,7156,95393,1,251254
2160,0.0018,172.217.194.0-255,1484,96877,1,251254
2161,0.001854,172.217.194.0-255,2902,99779,1,251254
2162,0.001866,172.217.194.0-255,2902,102681,1,251254
2163,0.001902,172.217.194.0-255,3602,106283,1,251254
2164,0.001922,172.217.194.0-255,1484,107767,1,251254
2165,0.001924,172.217.194.0-255,1484,109251,1,251254
2166,0.001944,172.217.194.0-255,1484,110735,1,251254
2167,0.00195,172.217.194.0-255,5738,116473,1,251254
2168,0.001971,172.217.194.0-255,4320,120793,1,251254
2169,0.002046,172.217.194.0-255,2184,122977,1,251254
2170,0.002101,172.31.36.0-255,66,123043,1,251254
2171,0.004255,172.217.194.0-255,5738,128781,1,251254
2172,0.004262,172.31.36.0-255,66,128847,1,251254
2173,0.006388,172.217.194.0-255,5738,134585,1,251254
2174,0.007502,172.31.36.0-255,66,134651,1,251254
2175,0.009561,172.217.194.0-255,5738,140389,1,251254
2176,0.009567,172.31.36.0-255,66,140455,1,251254
2177,0.01167,172.217.194.0-255,5738,146193,1,251254
2178,0.011678,172.31.36.0-255,66,146259,1,251254
2179,0.013771,172.217.194.0-255,5738,151997,1,251254
2180,0.01478,172.31.36.0-255,66,152063,1,251254
2181,0.016854,172.217.194.0-255,5738,157801,1,251254
2182,0.016862,172.31.36.0-255,66,157867,1,251254
2183,0.018999,172.217.194.0-255,5738,163605,1,251254
2184,0.019006,172.31.36.0-255,66,163671,1,251254
2185,0.021051,172.217.194.0-255,5738,169409,1,251254
2186,0.021058,172.31.36.0-255,66,169475,1,251254
2187,0.023107,172.217.194.0-255,5738,175213,1,251254
2188,0.023114,172.31.36.0-255,66,175279,1,251254
2189,0.025166,172.217.194.0-255,5738,181017,1,251254
2190,0.025173,172.31.36.0-255,66,181083,1,251254
2191,0.026227,172.31.36.0-255,167,181250,1,251254
2192,0.026252,172.31.36.0-255,1114,182364,1,251254
2193,0.0263,172.31.36.0-255,1514,183878,1,251254
2194,0.026302,172.31.36.0-255,1514,185392,1,251254
2195,0.026303,172.31.36.0-255,1514,186906,1,251254
2196,0.026304,172.31.36.0-255,108,187014,1,251254
2197,0.027196,172.217.194.0-255,5738,192752,1,251254
2198,0.027202,172.31.36.0-255,66,192818,1,251254
2199,0.027772,104.244.42.0-255,66,192884,1,251254
2200,0.027806,104.244.42.0-255,66,192950,1,251254
2201,0.027843,104.244.42.0-255,66,193016,1,251254
2202,0.027847,104.244.42.0-255,66,193082,1,251254
2203,0.029301,172.217.194.0-255,2902,195984,1,251254
2204,0.029307,172.31.36.0-255,66,196050,1,251254
2205,0.029326,172.217.194.0-255,2902,198952,1,251254
2206,0.029351,172.31.36.0-255,66,199018,1,251254
2207,0.031441,172.217.194.0-255,5738,204756,1,251254
2208,0.031493,172.31.36.0-255,66,204822,1,251254
2209,0.03356,172.217.194.0-255,5738,210560,1,251254
2210,0.033567,172.31.36.0-255,66,210626,1,251254
2211,0.035631,172.217.194.0-255,5738,216364,1,251254
2212,0.035637,172.31.36.0-255,66,216430,1,251254
2213,0.037717,172.217.194.0-255,5738,222168,1,251254
2214,0.037723,172.31.36.0-255,66,222234,1,251254
2215,0.039775,172.217.194.0-255,5738,227972,1,251254
2216,0.039783,172.31.36.0-255,66,228038,1,251254
2217,0.041853,172.217.194.0-255,5738,233776,1,251254
2218,0.04186,172.31.36.0-255,66,233842,1,251254
2219,0.043921,172.217.194.0-255,5738,239580,1,251254
2220,0.043927,172.31.36.0-255,66,239646,1,251254
2221,0.045985,172.217.194.0-255,5738,245384,1,251254
2222,0.045992,172.31.36.0-255,66,245450,1,251254
2223,0.048072,172.217.194.0-255,5738,251188,1,251254
2224,0.048079,172.31.36.0-255,66,251254,1,251254
2225,0.0,172.217.194.0-255,150,150,1,176777
2226,3.4e-05,172.31.36.0-255,66,216,1,176777
2227,4.1e-05,172.217.194.0-255,1484,1700,1,176777
2228,4.6e-05,172.31.36.0-255,66,1766,1,176777
2229,5.1e-05,172.217.194.0-255,2902,4668,1,176777
2230,5.3e-05,172.31.36.0-255,66,4734,1,176777
2231,6e-05,172.217.194.0-255,7156,11890,1,176777
2232,6.3e-05,172.31.36.0-255,66,11956,1,176777
2233,8.6e-05,172.31.36.0-255,66,12022,1,176777
2234,9.3e-05,172.217.194.0-255,6797,18819,1,176777
2235,9.7e-05,172.31.36.0-255,66,18885,1,176777
2236,0.000146,172.217.194.0-255,1484,20369,1,176777
2237,0.000149,172.31.36.0-255,66,20435,1,176777
2238,0.000154,172.217.194.0-255,2902,23337,1,176777
2239,0.000156,172.31.36.0-255,66,23403,1,176777
2240,0.00016,172.217.194.0-255,2902,26305,1,176777
2241,0.000162,172.31.36.0-255,66,26371,1,176777
2242,0.000183,172.217.194.0-255,2902,29273,1,176777
2243,0.00019,172.31.36.0-255,66,29339,1,176777
2244,0.000198,172.217.194.0-255,6797,36136,1,176777
2245,0.0002,172.31.36.0-255,66,36202,1,176777
2246,0.000208,172.217.194.0-255,7156,43358,1,176777
2247,0.00021,172.31.36.0-255,66,43424,1,176777
2248,0.000253,172.31.36.0-255,66,43490,1,176777
2249,0.000292,172.217.194.0-255,114,43604,1,176777
2250,0.000296,172.31.36.0-255,66,43670,1,176777
2251,0.000322,172.217.194.0-255,387,44057,1,176777
2252,0.000325,172.31.36.0-255,66,44123,1,176777
2253,0.000332,172.31.36.0-255,101,44224,1,176777
2254,0.000495,172.217.194.0-255,1484,45708,1,176777
2255,0.000501,172.217.194.0-255,2902,48610,1,176777
2256,0.000506,172.31.36.0-255,66,48676,1,176777
2257,0.000544,172.217.194.0-255,1484,50160,1,176777
2258,0.000563,172.217.194.0-255,4320,54480,1,176777
2259,0.000566,172.31.36.0-255,66,54546,1,176777
2260,0.000584,172.31.36.0-255,66,54612,1,176777
2261,0.000587,172.217.194.0-255,1484,56096,1,176777
2262,0.000637,172.31.36.0-255,66,56162,1,176777
2263,0.00067,172.217.194.0-255,1484,57646,1,176777
2264,0.000683,172.217.194.0-255,1484,59130,1,176777
2265,0.000686,172.31.36.0-255,66,59196,1,176777
2266,0.000698,172.217.194.0-255,1484,60680,1,176777
2267,0.000707,172.217.194.0-255,5738,66418,1,176777
2268,0.00071,172.31.36.0-255,66,66484,1,176777
2269,0.000715,172.217.194.0-255,2902,69386,1,176777
2270,0.000717,172.31.36.0-255,66,69452,1,176777
2271,0.000748,172.31.36.0-255,66,69518,1,176777
2272,0.000767,172.31.36.0-255,66,69584,1,176777
2273,0.000799,172.217.194.0-255,5738,75322,1,176777
2274,0.000803,172.31.36.0-255,66,75388,1,176777
2275,0.000838,172.217.194.0-255,7156,82544,1,176777
2276,0.000842,172.31.36.0-255,66,82610,1,176777
2277,0.000862,172.31.36.0-255,66,82676,1,176777
2278,0.000869,172.217.194.0-255,6438,89114,1,176777
2279,0.000873,172.31.36.0-255,66,89180,1,176777
2280,0.000907,172.31.36.0-255,66,89246,1,176777
2281,0.000945,172.31.36.0-255,66,89312,1,176777
2282,0.000949,172.217.194.0-255,1484,90796,1,176777
2283,0.000995,172.31.36.0-255,66,90862,1,176777
2284,0.001054,172.217.194.0-255,1484,92346,1,176777
2285,0.001067,172.217.194.0-255,2902,95248,1,176777
2286,0.00107,172.31.36.0-255,66,95314,1,176777
2287,0.001077,172.217.194.0-255,5738,101052,1,176777
2288,0.001079,172.31.36.0-255,66,101118,1,176777
2289,0.001122,172.31.36.0-255,66,101184,1,176777
2290,0.001163,172.31.36.0-255,66,101250,1,176777
2291,0.001196,172.31.36.0-255,66,101316,1,176777
2292,0.001222,172.217.194.0-255,2902,104218,1,176777
2293,0.001225,172.31.36.0-255,66,104284,1,176777
2294,0.00123,172.217.194.0-255,2902,107186,1,176777
2295,0.001233,172.31.36.0-255,66,107252,1,176777
2296,0.001256,172.217.194.0-255,2543,109795,1,176777
2297,0.001263,172.31.36.0-255,66,109861,1,176777
2298,0.001322,172.217.194.0-255,2902,112763,1,176777
2299,0.001326,172.31.36.0-255,66,112829,1,176777
2300,0.001363,172.217.194.0-255,2902,115731,1,176777
2301,0.001366,172.31.36.0-255,66,115797,1,176777
2302,0.001369,172.217.194.0-255,1484,117281,1,176777
2303,0.00138,172.31.36.0-255,66,117347,1,176777
2304,0.001397,172.31.36.0-255,66,117413,1,176777
2305,0.001423,172.217.194.0-255,1484,118897,1,176777
2306,0.001429,172.217.194.0-255,2902,121799,1,176777
2307,0.001432,172.31.36.0-255,66,121865,1,176777
2308,0.001438,172.217.194.0-255,5738,127603,1,176777
2309,0.00144,172.31.36.0-255,66,127669,1,176777
2310,0.001493,172.217.194.0-255,2902,130571,1,176777
2311,0.001498,172.31.36.0-255,66,130637,1,176777
2312,0.00152,172.217.194.0-255,3961,134598,1,176777
2313,0.001523,172.31.36.0-255,66,134664,1,176777
2314,0.001586,172.217.194.0-255,1484,136148,1,176777
2315,0.001603,172.217.194.0-255,2902,139050,1,176777
2316,0.001606,172.31.36.0-255,66,139116,1,176777
2317,0.001632,172.217.194.0-255,5738,144854,1,176777
2318,0.001635,172.31.36.0-255,66,144920,1,176777
2319,0.001676,172.31.36.0-255,66,144986,1,176777
2320,0.001704,172.217.194.0-255,7156,152142,1,176777
2321,0.001709,172.31.36.0-255,66,152208,1,176777
2322,0.001737,172.217.194.0-255,5020,157228,1,176777
2323,0.00174,172.31.36.0-255,66,157294,1,176777
2324,0.001771,172.31.36.0-255,66,157360,1,176777
2325,0.001777,172.217.194.0-255,5738,163098,1,176777
2326,0.001781,172.31.36.0-255,66,163164,1,176777
2327,0.001826,172.31.36.0-255,66,163230,1,176777
2328,0.001856,172.217.194.0-255,2184,165414,1,176777
2329,0.001861,172.31.36.0-255,66,165480,1,176777
2330,0.001871,172.31.36.0-255,66,165546,1,176777
2331,0.001884,172.31.36.0-255,66,165612,1,176777
2332,0.001924,172.31.36.0-255,66,165678,1,176777
2333,0.001928,172.217.194.0-255,1488,167166,1,176777
2334,0.00193,172.31.36.0-255,66,167232,1,176777
2335,0.001944,172.217.194.0-255,105,167337,1,176777
2336,0.002604,172.217.194.0-255,66,167403,1,176777
2337,0.008358,172.31.36.0-255,105,167508,1,176777
2338,0.010619,172.217.194.0-255,66,167574,1,176777
2339,0.03886,172.31.36.0-255,172,167746,1,176777
2340,0.038911,172.31.36.0-255,1113,168859,1,176777
2341,0.03896,172.31.36.0-255,1514,170373,1,176777
2342,0.038962,172.31.36.0-255,1514,171887,1,176777
2343,0.038963,172.31.36.0-255,1514,173401,1,176777
2344,0.038968,172.31.36.0-255,1514,174915,1,176777
2345,0.038969,172.31.36.0-255,1490,176405,1,176777
2346,0.04042,104.244.42.0-255,66,176471,1,176777
2347,0.040462,104.244.42.0-255,66,176537,1,176777
2348,0.040521,104.244.42.0-255,66,176603,1,176777
2349,0.04333,104.244.42.0-255,108,176711,1,176777
2350,0.043344,172.31.36.0-255,66,176777,1,176777
2351,0.0,172.31.36.0-255,66,66,1,66
2352,0.0,74.125.24.0-255,150,150,1,258227
2353,2.3e-05,172.31.36.0-255,66,216,1,258227
2354,3e-05,74.125.24.0-255,1484,1700,1,258227
2355,3.4e-05,172.31.36.0-255,66,1766,1,258227
2356,4e-05,74.125.24.0-255,2902,4668,1,258227
2357,5.1e-05,172.31.36.0-255,66,4734,1,258227
2358,5.8e-05,74.125.24.0-255,4320,9054,1,258227
2359,6e-05,172.31.36.0-255,66,9120,1,258227
2360,6.6e-05,74.125.24.0-255,4320,13440,1,258227
2361,6.9e-05,172.31.36.0-255,66,13506,1,258227
2362,0.0001,74.125.24.0-255,4902,18408,1,258227
2363,0.000105,172.31.36.0-255,66,18474,1,258227
2364,0.000139,74.125.24.0-255,7156,25630,1,258227
2365,0.000142,172.31.36.0-255,66,25696,1,258227
2366,0.000183,74.125.24.0-255,2902,28598,1,258227
2367,0.000185,172.31.36.0-255,66,28664,1,258227
2368,0.00021,74.125.24.0-255,2543,31207,1,258227
2369,0.000213,172.31.36.0-255,66,31273,1,258227
2370,0.000642,74.125.24.0-255,1484,32757,1,258227
2371,0.000648,172.31.36.0-255,66,32823,1,258227
2372,0.000654,74.125.24.0-255,2902,35725,1,258227
2373,0.000656,172.31.36.0-255,66,35791,1,258227
2374,0.000693,74.125.24.0-255,5738,41529,1,258227
2375,0.000696,172.31.36.0-255,66,41595,1,258227
2376,0.000699,74.125.24.0-255,1484,43079,1,258227
2377,0.000702,172.31.36.0-255,66,43145,1,258227
2378,0.000732,74.125.24.0-255,7156,50301,1,258227
2379,0.000735,172.31.36.0-255,66,50367,1,258227
2380,0.000747,74.125.24.0-255,2543,52910,1,258227
2381,0.000756,172.31.36.0-255,66,52976,1,258227
2382,0.000782,74.125.24.0-255,2902,55878,1,258227
2383,0.000785,172.31.36.0-255,66,55944,1,258227
2384,0.000813,74.125.24.0-255,5738,61682,1,258227
2385,0.000816,172.31.36.0-255,66,61748,1,258227
2386,0.000835,74.125.24.0-255,4233,65981,1,258227
2387,0.000838,172.31.36.0-255,66,66047,1,258227
2388,0.000978,74.125.24.0-255,383,66430,1,258227
2389,0.001135,172.31.36.0-255,66,66496,1,258227
2390,0.001273,74.125.24.0-255,1484,67980,1,258227
2391,0.001283,74.125.24.0-255,2902,70882,1,258227
2392,0.001286,172.31.36.0-255,66,70948,1,258227
2393,0.001295,74.125.24.0-255,4320,75268,1,258227
2394,0.001297,172.31.36.0-255,66,75334,1,258227
2395,0.001318,74.125.24.0-255,1484,76818,1,258227
2396,0.001365,74.125.24.0-255,7156,83974,1,258227
2397,0.001368,172.31.36.0-255,66,84040,1,258227
2398,0.001395,74.125.24.0-255,5738,89778,1,258227
2399,0.001398,172.31.36.0-255,66,89844,1,258227
2400,0.001446,172.31.36.0-255,66,89910,1,258227
2401,0.001465,74.125.24.0-255,2184,92094,1,258227
2402,0.001467,172.31.36.0-255,66,92160,1,258227
2403,0.001528,74.125.24.0-255,7156,99316,1,258227
2404,0.001531,172.31.36.0-255,66,99382,1,258227
2405,0.001559,74.125.24.0-255,4320,103702,1,258227
2406,0.001561,172.31.36.0-255,66,103768,1,258227
2407,0.001613,74.125.24.0-255,7156,110924,1,258227
2408,0.001617,172.31.36.0-255,66,110990,1,258227
2409,0.001658,172.31.36.0-255,66,111056,1,258227
2410,0.001779,74.125.24.0-255,5738,116794,1,258227
2411,0.001783,172.31.36.0-255,66,116860,1,258227
2412,0.001821,172.31.36.0-255,66,116926,1,258227
2413,0.001917,74.125.24.0-255,5738,122664,1,258227
2414,0.001921,172.31.36.0-255,66,122730,1,258227
2415,0.00196,172.31.36.0-255,66,122796,1,258227
2416,0.002042,74.125.24.0-255,4320,127116,1,258227
2417,0.002046,172.31.36.0-255,66,127182,1,258227
2418,0.002083,172.31.36.0-255,66,127248,1,258227
2419,0.002191,74.125.24.0-255,1484,128732,1,258227
2420,0.002298,74.125.24.0-255,4320,133052,1,258227
2421,0.006701,172.31.36.0-255,66,133118,1,258227
2422,0.008782,74.125.24.0-255,5738,138856,1,258227
2423,0.008789,172.31.36.0-255,66,138922,1,258227
2424,0.010872,74.125.24.0-255,5738,144660,1,258227
2425,0.010879,172.31.36.0-255,66,144726,1,258227
2426,0.012935,74.125.24.0-255,5738,150464,1,258227
2427,0.012944,172.31.36.0-255,66,150530,1,258227
2428,0.014984,74.125.24.0-255,5738,156268,1,258227
2429,0.014991,172.31.36.0-255,66,156334,1,258227
2430,0.017082,74.125.24.0-255,5738,162072,1,258227
2431,0.017096,172.31.36.0-255,66,162138,1,258227
2432,0.019204,74.125.24.0-255,5738,167876,1,258227
2433,0.019215,172.31.36.0-255,66,167942,1,258227
2434,0.021317,74.125.24.0-255,5738,173680,1,258227
2435,0.021328,172.31.36.0-255,66,173746,1,258227
2436,0.023401,74.125.24.0-255,5738,179484,1,258227
2437,0.023408,172.31.36.0-255,66,179550,1,258227
2438,0.025514,74.125.24.0-255,5738,185288,1,258227
2439,0.025522,172.31.36.0-255,66,185354,1,258227
2440,0.027581,74.125.24.0-255,5738,191092,1,258227
2441,0.027589,172.31.36.0-255,66,191158,1,258227
2442,0.02967,74.125.24.0-255,5738,196896,1,258227
2443,0.029678,172.31.36.0-255,66,196962,1,258227
2444,0.031719,74.125.24.0-255,5738,202700,1,258227
2445,0.031727,172.31.36.0-255,66,202766,1,258227
2446,0.033796,74.125.24.0-255,5738,208504,1,258227
2447,0.033804,172.31.36.0-255,66,208570,1,258227
2448,0.035882,74.125.24.0-255,5738,214308,1,258227
2449,0.035887,172.31.36.0-255,66,214374,1,258227
2450,0.036655,172.31.36.0-255,172,214546,1,258227
2451,0.036689,172.31.36.0-255,1113,215659,1,258227
2452,0.036815,172.31.36.0-255,1514,217173,1,258227
2453,0.036818,172.31.36.0-255,1514,218687,1,258227
2454,0.036823,172.31.36.0-255,1514,220201,1,258227
2455,0.036824,172.31.36.0-255,1514,221715,1,258227
2456,0.036842,172.31.36.0-255,1490,223205,1,258227
2457,0.03796,74.125.24.0-255,5738,228943,1,258227
2458,0.037967,172.31.36.0-255,66,229009,1,258227
2459,0.038184,104.244.42.0-255,66,229075,1,258227
2460,0.038226,104.244.42.0-255,66,229141,1,258227
2461,0.038408,104.244.42.0-255,66,229207,1,258227
2462,0.040049,74.125.24.0-255,5738,234945,1,258227
2463,0.040059,172.31.36.0-255,66,235011,1,258227
2464,0.042124,74.125.24.0-255,5738,240749,1,258227
2465,0.042131,172.31.36.0-255,66,240815,1,258227
2466,0.044177,74.125.24.0-255,5738,246553,1,258227
2467,0.044183,172.31.36.0-255,66,246619,1,258227
2468,0.046277,74.125.24.0-255,5738,252357,1,258227
2469,0.046284,172.31.36.0-255,66,252423,1,258227
2470,0.048394,74.125.24.0-255,5738,258161,1,258227
2471,0.048402,172.31.36.0-255,66,258227,1,258227
2472,0.0,74.125.24.0-255,153,153,1,229755
2473,3.3e-05,172.31.36.0-255,66,219,1,229755
2474,4e-05,74.125.24.0-255,1484,1703,1,229755
2475,4.4e-05,172.31.36.0-255,66,1769,1,229755
2476,5e-05,74.125.24.0-255,2902,4671,1,229755
2477,5.2e-05,172.31.36.0-255,66,4737,1,229755
2478,6.1e-05,74.125.24.0-255,7156,11893,1,229755
2479,6.3e-05,172.31.36.0-255,66,11959,1,229755
2480,6.9e-05,74.125.24.0-255,2147,14106,1,229755
2481,7.2e-05,172.31.36.0-255,66,14172,1,229755
2482,9.6e-05,74.125.24.0-255,2902,17074,1,229755
2483,0.0001,172.31.36.0-255,66,17140,1,229755
2484,0.000114,74.125.24.0-255,5738,22878,1,229755
2485,0.000116,172.31.36.0-255,66,22944,1,229755
2486,0.00015,74.125.24.0-255,2902,25846,1,229755
2487,0.000153,172.31.36.0-255,66,25912,1,229755
2488,0.000169,74.125.24.0-255,5379,31291,1,229755
2489,0.000173,172.31.36.0-255,66,31357,1,229755
2490,0.00031,74.125.24.0-255,1484,32841,1,229755
2491,0.000315,172.31.36.0-255,66,32907,1,229755
2492,0.000319,74.125.24.0-255,1484,34391,1,229755
2493,0.000321,172.31.36.0-255,66,34457,1,229755
2494,0.000333,74.125.24.0-255,1484,35941,1,229755
2495,0.000336,172.31.36.0-255,66,36007,1,229755
2496,0.000343,74.125.24.0-255,5738,41745,1,229755
2497,0.000346,172.31.36.0-255,66,41811,1,229755
2498,0.000351,74.125.24.0-255,4320,46131,1,229755
2499,0.000353,172.31.36.0-255,66,46197,1,229755
2500,0.000364,74.125.24.0-255,1484,47681,1,229755
2501,0.000366,172.31.36.0-255,66,47747,1,229755
2502,0.000387,74.125.24.0-255,2902,50649,1,229755
2503,0.00039,172.31.36.0-255,66,50715,1,229755
2504,0.000421,172.31.36.0-255,66,50781,1,229755
2505,0.000427,74.125.24.0-255,3961,54742,1,229755
2506,0.000429,172.31.36.0-255,66,54808,1,229755
2507,0.000431,74.125.24.0-255,357,55165,1,229755
2508,0.000453,74.125.24.0-255,387,55552,1,229755
2509,0.00053,74.125.24.0-255,1484,57036,1,229755
2510,0.000534,172.31.36.0-255,66,57102,1,229755
2511,0.000539,74.125.24.0-255,2902,60004,1,229755
2512,0.000541,172.31.36.0-255,66,60070,1,229755
2513,0.000544,74.125.24.0-255,1484,61554,1,229755
2514,0.000568,74.125.24.0-255,4320,65874,1,229755
2515,0.000572,172.31.36.0-255,66,65940,1,229755
2516,0.000609,172.31.36.0-255,66,66006,1,229755
2517,0.000633,74.125.24.0-255,5379,71385,1,229755
2518,0.000636,172.31.36.0-255,66,71451,1,229755
2519,0.000643,74.125.24.0-255,7156,78607,1,229755
2520,0.000646,172.31.36.0-255,66,78673,1,229755
2521,0.000663,74.125.24.0-255,2543,81216,1,229755
2522,0.000669,172.31.36.0-255,66,81282,1,229755
2523,0.000785,74.125.24.0-255,1484,82766,1,229755
2524,0.000789,74.125.24.0-255,1484,84250,1,229755
2525,0.000792,172.31.36.0-255,66,84316,1,229755
2526,0.000807,74.125.24.0-255,1484,85800,1,229755
2527,0.000813,74.125.24.0-255,5738,91538,1,229755
2528,0.000816,172.31.36.0-255,66,91604,1,229755
2529,0.00082,74.125.24.0-255,2902,94506,1,229755
2530,0.000822,172.31.36.0-255,66,94572,1,229755
2531,0.000825,74.125.24.0-255,1484,96056,1,229755
2532,0.000859,172.31.36.0-255,66,96122,1,229755
2533,0.000872,74.125.24.0-255,2902,99024,1,229755
2534,0.000875,172.31.36.0-255,66,99090,1,229755
2535,0.000902,172.31.36.0-255,66,99156,1,229755
2536,0.000919,74.125.24.0-255,4320,103476,1,229755
2537,0.000922,172.31.36.0-255,66,103542,1,229755
2538,0.000945,74.125.24.0-255,7156,110698,1,229755
2539,0.000949,172.31.36.0-255,66,110764,1,229755
2540,0.00095,74.125.24.0-255,5738,116502,1,229755
2541,0.000954,172.31.36.0-255,66,116568,1,229755
2542,0.000977,74.125.24.0-255,4320,120888,1,229755
2543,0.000981,172.31.36.0-255,66,120954,1,229755
2544,0.001002,172.31.36.0-255,66,121020,1,229755
2545,0.001041,74.125.24.0-255,1484,122504,1,229755
2546,0.001071,172.31.36.0-255,66,122570,1,229755
2547,0.001085,172.31.36.0-255,66,122636,1,229755
2548,0.001086,74.125.24.0-255,4320,126956,1,229755
2549,0.001088,172.31.36.0-255,66,127022,1,229755
2550,0.001109,74.125.24.0-255,766,127788,1,229755
2551,0.001115,74.125.24.0-255,4320,132108,1,229755
2552,0.001117,172.31.36.0-255,66,132174,1,229755
2553,0.001134,74.125.24.0-255,1484,133658,1,229755
2554,0.001139,74.125.24.0-255,4320,137978,1,229755
2555,0.001141,172.31.36.0-255,66,138044,1,229755
2556,0.001144,74.125.24.0-255,1484,139528,1,229755
2557,0.001181,172.31.36.0-255,66,139594,1,229755
2558,0.001186,74.125.24.0-255,4320,143914,1,229755
2559,0.001188,172.31.36.0-255,66,143980,1,229755
2560,0.001212,172.31.36.0-255,66,144046,1,229755
2561,0.001243,74.125.24.0-255,1484,145530,1,229755
2562,0.001248,74.125.24.0-255,2902,148432,1,229755
2563,0.00125,172.31.36.0-255,66,148498,1,229755
2564,0.001255,74.125.24.0-255,4320,152818,1,229755
2565,0.001258,172.31.36.0-255,66,152884,1,229755
2566,0.00127,74.125.24.0-255,1484,154368,1,229755
2567,0.001273,74.125.24.0-255,1484,155852,1,229755
2568,0.001275,172.31.36.0-255,66,155918,1,229755
2569,0.001317,172.31.36.0-255,66,155984,1,229755
2570,0.001345,172.31.36.0-255,66,156050,1,229755
2571,0.001362,74.125.24.0-255,2184,158234,1,229755
2572,0.001365,172.31.36.0-255,66,158300,1,229755
2573,0.001425,74.125.24.0-255,1484,159784,1,229755
2574,0.001432,74.125.24.0-255,2902,162686,1,229755
2575,0.001436,172.31.36.0-255,66,162752,1,229755
2576,0.00144,74.125.24.0-255,2902,165654,1,229755
2577,0.001443,172.31.36.0-255,66,165720,1,229755
2578,0.001462,74.125.24.0-255,2902,168622,1,229755
2579,0.001465,172.31.36.0-255,66,168688,1,229755
2580,0.001478,172.31.36.0-255,66,168754,1,229755
2581,0.001484,74.125.24.0-255,5738,174492,1,229755
2582,0.001487,172.31.36.0-255,66,174558,1,229755
2583,0.001511,74.125.24.0-255,5020,179578,1,229755
2584,0.001515,172.31.36.0-255,66,179644,1,229755
2585,0.001598,74.125.24.0-255,1484,181128,1,229755
2586,0.001623,74.125.24.0-255,2902,184030,1,229755
2587,0.001628,172.31.36.0-255,66,184096,1,229755
2588,0.001635,74.125.24.0-255,5738,189834,1,229755
2589,0.001637,172.31.36.0-255,66,189900,1,229755
2590,0.001648,172.31.36.0-255,66,189966,1,229755
2591,0.00169,74.125.24.0-255,5738,195704,1,229755
2592,0.001694,172.31.36.0-255,66,195770,1,229755
2593,0.001727,172.31.36.0-255,66,195836,1,229755
2594,0.001758,74.125.24.0-255,7156,202992,1,229755
2595,0.001762,172.31.36.0-255,66,203058,1,229755
2596,0.001774,172.31.36.0-255,66,203124,1,229755
2597,0.001812,74.125.24.0-255,4320,207444,1,229755
2598,0.001816,172.31.36.0-255,66,207510,1,229755
2599,0.001844,172.31.36.0-255,66,207576,1,229755
2600,0.001847,74.125.24.0-255,766,208342,1,229755
2601,0.001852,74.125.24.0-255,4320,212662,1,229755
2602,0.001856,172.31.36.0-255,66,212728,1,229755
2603,0.001889,74.125.24.0-255,4320,217048,1,229755
2604,0.001894,172.31.36.0-255,66,217114,1,229755
2605,0.001905,172.31.36.0-255,66,217180,1,229755
2606,0.001921,172.31.36.0-255,66,217246,1,229755
2607,0.001946,74.125.24.0-255,4320,221566,1,229755
2608,0.00195,172.31.36.0-255,66,221632,1,229755
2609,0.001961,74.125.24.0-255,3540,225172,1,229755
2610,0.001965,172.31.36.0-255,66,225238,1,229755
2611,0.001968,74.125.24.0-255,105,225343,1,229755
2612,0.007314,172.31.36.0-255,66,225409,1,229755
2613,0.009357,172.31.36.0-255,105,225514,1,229755
2614,0.011628,74.125.24.0-255,66,225580,1,229755
2615,0.029431,172.31.36.0-255,172,225752,1,229755
2616,0.029462,172.31.36.0-255,1114,226866,1,229755
2617,0.02951,172.31.36.0-255,1514,228380,1,229755
2618,0.029512,172.31.36.0-255,1177,229557,1,229755
2619,0.030965,104.244.42.0-255,66,229623,1,229755
2620,0.030998,104.244.42.0-255,66,229689,1,229755
2621,0.031023,104.244.42.0-255,66,229755,1,229755
2622,0.0,172.217.194.0-255,153,153,1,267706
2623,3.4e-05,172.31.36.0-255,66,219,1,267706
2624,4.1e-05,172.217.194.0-255,1484,1703,1,267706
2625,4.5e-05,172.31.36.0-255,66,1769,1,267706
2626,5e-05,172.217.194.0-255,2902,4671,1,267706
2627,5.2e-05,172.31.36.0-255,66,4737,1,267706
2628,5.9e-05,172.217.194.0-255,7156,11893,1,267706
2629,6.2e-05,172.31.36.0-255,66,11959,1,267706
2630,8.7e-05,172.217.194.0-255,1985,13944,1,267706
2631,8.9e-05,172.31.36.0-255,66,14010,1,267706
2632,0.000432,172.217.194.0-255,1484,15494,1,267706
2633,0.000437,172.31.36.0-255,66,15560,1,267706
2634,0.000443,172.217.194.0-255,2902,18462,1,267706
2635,0.000445,172.217.194.0-255,1484,19946,1,267706
2636,0.000447,172.31.36.0-255,66,20012,1,267706
2637,0.000451,172.31.36.0-255,66,20078,1,267706
2638,0.00046,172.217.194.0-255,4320,24398,1,267706
2639,0.000462,172.31.36.0-255,66,24464,1,267706
2640,0.000466,172.217.194.0-255,1484,25948,1,267706
2641,0.000468,172.31.36.0-255,66,26014,1,267706
2642,0.000489,172.217.194.0-255,5379,31393,1,267706
2643,0.000492,172.31.36.0-255,66,31459,1,267706
2644,0.000526,172.31.36.0-255,66,31525,1,267706
2645,0.000549,172.217.194.0-255,5738,37263,1,267706
2646,0.000552,172.31.36.0-255,66,37329,1,267706
2647,0.000557,172.217.194.0-255,2543,39872,1,267706
2648,0.00056,172.31.36.0-255,66,39938,1,267706
2649,0.000603,172.217.194.0-255,2902,42840,1,267706
2650,0.000607,172.217.194.0-255,4320,47160,1,267706
2651,0.000608,172.31.36.0-255,66,47226,1,267706
2652,0.000612,172.31.36.0-255,66,47292,1,267706
2653,0.000614,172.217.194.0-255,7156,54448,1,267706
2654,0.000616,172.31.36.0-255,66,54514,1,267706
2655,0.000633,172.217.194.0-255,1484,55998,1,267706
2656,0.000638,172.217.194.0-255,1125,57123,1,267706
2657,0.000641,172.31.36.0-255,66,57189,1,267706
2658,0.000662,172.217.194.0-255,378,57567,1,267706
2659,0.00069,172.217.194.0-255,100,57667,1,267706
2660,0.000729,172.217.194.0-255,1484,59151,1,267706
2661,0.000733,172.31.36.0-255,66,59217,1,267706
2662,0.000753,172.217.194.0-255,2902,62119,1,267706
2663,0.000756,172.31.36.0-255,66,62185,1,267706
2664,0.000763,172.217.194.0-255,7156,69341,1,267706
2665,0.000765,172.31.36.0-255,66,69407,1,267706
2666,0.0008,172.217.194.0-255,5379,74786,1,267706
2667,0.000803,172.31.36.0-255,66,74852,1,267706
2668,0.00081,172.217.194.0-255,5738,80590,1,267706
2669,0.000812,172.31.36.0-255,66,80656,1,267706
2670,0.00084,172.217.194.0-255,5738,86394,1,267706
2671,0.000844,172.31.36.0-255,66,86460,1,267706
2672,0.000863,172.217.194.0-255,5676,92136,1,267706
2673,0.000866,172.31.36.0-255,66,92202,1,267706
2674,0.001284,172.217.194.0-255,1484,93686,1,267706
2675,0.001295,172.217.194.0-255,2902,96588,1,267706
2676,0.001299,172.31.36.0-255,66,96654,1,267706
2677,0.001307,172.217.194.0-255,5738,102392,1,267706
2678,0.001309,172.31.36.0-255,66,102458,1,267706
2679,0.001321,172.31.36.0-255,66,102524,1,267706
2680,0.001346,172.217.194.0-255,2902,105426,1,267706
2681,0.00135,172.31.36.0-255,66,105492,1,267706
2682,0.001362,172.31.36.0-255,66,105558,1,267706
2683,0.001558,172.217.194.0-255,1484,107042,1,267706
2684,0.001565,172.217.194.0-255,2902,109944,1,267706
2685,0.001569,172.31.36.0-255,66,110010,1,267706
2686,0.001573,172.217.194.0-255,1484,111494,1,267706
2687,0.001595,172.217.194.0-255,4320,115814,1,267706
2688,0.001598,172.31.36.0-255,66,115880,1,267706
2689,0.001605,172.217.194.0-255,4320,120200,1,267706
2690,0.001607,172.31.36.0-255,66,120266,1,267706
2691,0.001643,172.31.36.0-255,66,120332,1,267706
2692,0.001655,172.31.36.0-255,66,120398,1,267706
2693,0.001941,172.217.194.0-255,1484,121882,1,267706
2694,0.001947,172.217.194.0-255,2902,124784,1,267706
2695,0.001952,172.31.36.0-255,66,124850,1,267706
2696,0.001972,172.217.194.0-255,5738,130588,1,267706
2697,0.001974,172.31.36.0-255,66,130654,1,267706
2698,0.002004,172.31.36.0-255,66,130720,1,267706
2699,0.002015,172.31.36.0-255,66,130786,1,267706
2700,0.002033,172.217.194.0-255,2902,133688,1,267706
2701,0.002035,172.31.36.0-255,66,133754,1,267706
2702,0.002053,172.217.194.0-255,2184,135938,1,267706
2703,0.002055,172.31.36.0-255,66,136004,1,267706
2704,0.002508,172.217.194.0-255,1484,137488,1,267706
2705,0.002533,172.217.194.0-255,2902,140390,1,267706
2706,0.002536,172.31.36.0-255,66,140456,1,267706
2707,0.002541,172.217.194.0-255,2902,143358,1,267706
2708,0.002543,172.31.36.0-255,66,143424,1,267706
2709,0.002557,172.217.194.0-255,2902,146326,1,267706
2710,0.002559,172.31.36.0-255,66,146392,1,267706
2711,0.002587,172.217.194.0-255,7156,153548,1,267706
2712,0.00259,172.31.36.0-255,66,153614,1,267706
2713,0.002599,172.31.36.0-255,66,153680,1,267706
2714,0.002633,172.217.194.0-255,4320,158000,1,267706
2715,0.002635,172.31.36.0-255,66,158066,1,267706
2716,0.002646,172.217.194.0-255,1484,159550,1,267706
2717,0.00265,172.217.194.0-255,2184,161734,1,267706
2718,0.002652,172.31.36.0-255,66,161800,1,267706
2719,0.002795,172.217.194.0-255,1484,163284,1,267706
2720,0.0028,172.217.194.0-255,2902,166186,1,267706
2721,0.002803,172.31.36.0-255,66,166252,1,267706
2722,0.002808,172.217.194.0-255,2902,169154,1,267706
2723,0.00281,172.31.36.0-255,66,169220,1,267706
2724,0.002826,172.217.194.0-255,2902,172122,1,267706
2725,0.002828,172.31.36.0-255,66,172188,1,267706
2726,0.00284,172.217.194.0-255,5738,177926,1,267706
2727,0.002842,172.31.36.0-255,66,177992,1,267706
2728,0.002865,172.217.194.0-255,1484,179476,1,267706
2729,0.002874,172.31.36.0-255,66,179542,1,267706
2730,0.002884,172.31.36.0-255,66,179608,1,267706
2731,0.003114,172.217.194.0-255,1484,181092,1,267706
2732,0.003131,172.217.194.0-255,2902,183994,1,267706
2733,0.003134,172.31.36.0-255,66,184060,1,267706
2734,0.003141,172.217.194.0-255,5738,189798,1,267706
2735,0.003142,172.31.36.0-255,66,189864,1,267706
2736,0.003156,172.217.194.0-255,1484,191348,1,267706
2737,0.003172,172.217.194.0-255,5738,197086,1,267706
2738,0.003174,172.31.36.0-255,66,197152,1,267706
2739,0.003198,172.217.194.0-255,5738,202890,1,267706
2740,0.003201,172.31.36.0-255,66,202956,1,267706
2741,0.003213,172.31.36.0-255,66,203022,1,267706
2742,0.00324,172.217.194.0-255,7156,210178,1,267706
2743,0.003242,172.31.36.0-255,66,210244,1,267706
2744,0.003275,172.31.36.0-255,66,210310,1,267706
2745,0.003279,172.217.194.0-255,2902,213212,1,267706
2746,0.003281,172.31.36.0-255,66,213278,1,267706
2747,0.003306,172.31.36.0-255,66,213344,1,267706
2748,0.003356,172.217.194.0-255,1484,214828,1,267706
2749,0.003359,172.217.194.0-255,1484,216312,1,267706
2750,0.003362,172.31.36.0-255,66,216378,1,267706
2751,0.003388,172.217.194.0-255,4320,220698,1,267706
2752,0.003391,172.31.36.0-255,66,220764,1,267706
2753,0.00342,172.31.36.0-255,66,220830,1,267706
2754,0.003441,172.217.194.0-255,2902,223732,1,267706
2755,0.003444,172.31.36.0-255,66,223798,1,267706
2756,0.003473,172.31.36.0-255,66,223864,1,267706
2757,0.003482,172.217.194.0-255,2902,226766,1,267706
2758,0.003484,172.31.36.0-255,66,226832,1,267706
2759,0.003502,172.217.194.0-255,2184,229016,1,267706
2760,0.003505,172.31.36.0-255,66,229082,1,267706
2761,0.003649,172.217.194.0-255,1484,230566,1,267706
2762,0.003667,172.217.194.0-255,2902,233468,1,267706
2763,0.00367,172.31.36.0-255,66,233534,1,267706
2764,0.003675,172.217.194.0-255,2902,236436,1,267706
2765,0.003677,172.31.36.0-255,66,236502,1,267706
2766,0.003691,172.217.194.0-255,2902,239404,1,267706
2767,0.003693,172.31.36.0-255,66,239470,1,267706
2768,0.003695,172.217.194.0-255,1484,240954,1,267706
2769,0.003711,172.217.194.0-255,4320,245274,1,267706
2770,0.003713,172.31.36.0-255,66,245340,1,267706
2771,0.003737,172.217.194.0-255,4320,249660,1,267706
2772,0.003741,172.31.36.0-255,66,249726,1,267706
2773,0.003754,172.217.194.0-255,2902,252628,1,267706
2774,0.003757,172.31.36.0-255,66,252694,1,267706
2775,0.003789,172.31.36.0-255,66,252760,1,267706
2776,0.003808,172.217.194.0-255,5020,257780,1,267706
2777,0.00381,172.31.36.0-255,66,257846,1,267706
2778,0.003856,172.31.36.0-255,66,257912,1,267706
2779,0.003876,172.217.194.0-255,174,258086,1,267706
2780,0.003879,172.217.194.0-255,105,258191,1,267706
2781,0.004139,172.31.36.0-255,101,258292,1,267706
2782,0.005104,172.31.36.0-255,105,258397,1,267706
2783,0.006124,172.217.194.0-255,66,258463,1,267706
2784,0.007085,172.217.194.0-255,66,258529,1,267706
2785,0.032655,172.31.36.0-255,188,258717,1,267706
2786,0.032712,172.31.36.0-255,958,259675,1,267706
2787,0.032799,172.31.36.0-255,1514,261189,1,267706
2788,0.032801,172.31.36.0-255,1514,262703,1,267706
2789,0.032806,172.31.36.0-255,1514,264217,1,267706
2790,0.032807,172.31.36.0-255,1514,265731,1,267706
2791,0.032869,172.31.36.0-255,1514,267245,1,267706
2792,0.03287,172.31.36.0-255,197,267442,1,267706
2793,0.034164,104.244.42.0-255,66,267508,1,267706
2794,0.034258,104.244.42.0-255,66,267574,1,267706
2795,0.034396,104.244.42.0-255,66,267640,1,267706
2796,0.034399,104.244.42.0-255,66,267706,1,267706
2797,0.0,172.217.194.0-255,153,153,1,246084
2798,1.4e-05,172.31.36.0-255,66,219,1,246084
2799,2.2e-05,172.217.194.0-255,1484,1703,1,246084
2800,2.6e-05,172.31.36.0-255,66,1769,1,246084
2801,3.9e-05,172.217.194.0-255,2902,4671,1,246084
2802,4.2e-05,172.31.36.0-255,66,4737,1,246084
2803,4.8e-05,172.217.194.0-255,4320,9057,1,246084
2804,5.1e-05,172.31.36.0-255,66,9123,1,246084
2805,8.5e-05,172.217.194.0-255,4858,13981,1,246084
2806,8.8e-05,172.31.36.0-255,66,14047,1,246084
2807,0.000109,172.217.194.0-255,5738,19785,1,246084
2808,0.000112,172.31.36.0-255,66,19851,1,246084
2809,0.000138,172.31.36.0-255,66,19917,1,246084
2810,0.000198,172.31.36.0-255,66,19983,1,246084
2811,0.000223,172.31.36.0-255,66,20049,1,246084
2812,0.000228,172.217.194.0-255,2543,22592,1,246084
2813,0.00023,172.31.36.0-255,66,22658,1,246084
2814,0.000441,172.217.194.0-255,1484,24142,1,246084
2815,0.000447,172.31.36.0-255,66,24208,1,246084
2816,0.000472,172.217.194.0-255,2902,27110,1,246084
2817,0.000475,172.31.36.0-255,66,27176,1,246084
2818,0.000482,172.217.194.0-255,5738,32914,1,246084
2819,0.000485,172.31.36.0-255,66,32980,1,246084
2820,0.000528,172.217.194.0-255,6797,39777,1,246084
2821,0.000531,172.31.36.0-255,66,39843,1,246084
2822,0.000539,172.217.194.0-255,4902,44745,1,246084
2823,0.000541,172.31.36.0-255,66,44811,1,246084
2824,0.000552,172.217.194.0-255,5738,50549,1,246084
2825,0.000554,172.31.36.0-255,66,50615,1,246084
2826,0.0006,172.217.194.0-255,6797,57412,1,246084
2827,0.000603,172.31.36.0-255,66,57478,1,246084
2828,0.00061,172.217.194.0-255,7156,64634,1,246084
2829,0.000613,172.31.36.0-255,66,64700,1,246084
2830,0.000667,172.31.36.0-255,66,64766,1,246084
2831,0.001046,172.217.194.0-255,1484,66250,1,246084
2832,0.001052,172.217.194.0-255,2902,69152,1,246084
2833,0.001056,172.31.36.0-255,66,69218,1,246084
2834,0.001064,172.217.194.0-255,5738,74956,1,246084
2835,0.001066,172.31.36.0-255,66,75022,1,246084
2836,0.001094,172.31.36.0-255,66,75088,1,246084
2837,0.001132,172.217.194.0-255,4320,79408,1,246084
2838,0.001135,172.31.36.0-255,66,79474,1,246084
2839,0.001146,172.31.36.0-255,66,79540,1,246084
2840,0.001154,172.217.194.0-255,766,80306,1,246084
2841,0.001616,172.217.194.0-255,1484,81790,1,246084
2842,0.00162,172.31.36.0-255,66,81856,1,246084
2843,0.001626,172.217.194.0-255,2902,84758,1,246084
2844,0.001628,172.31.36.0-255,66,84824,1,246084
2845,0.001632,172.217.194.0-255,2902,87726,1,246084
2846,0.001634,172.31.36.0-255,66,87792,1,246084
2847,0.00167,172.217.194.0-255,2902,90694,1,246084
2848,0.001677,172.31.36.0-255,66,90760,1,246084
2849,0.001691,172.31.36.0-255,66,90826,1,246084
2850,0.001729,172.31.36.0-255,66,90892,1,246084
2851,0.001964,172.217.194.0-255,1484,92376,1,246084
2852,0.001969,172.217.194.0-255,1484,93860,1,246084
2853,0.001972,172.31.36.0-255,66,93926,1,246084
2854,0.002001,172.217.194.0-255,1484,95410,1,246084
2855,0.002007,172.217.194.0-255,5738,101148,1,246084
2856,0.00202,172.31.36.0-255,66,101214,1,246084
2857,0.002028,172.31.36.0-255,66,101280,1,246084
2858,0.002034,172.217.194.0-255,4320,105600,1,246084
2859,0.002036,172.31.36.0-255,66,105666,1,246084
2860,0.00205,172.31.36.0-255,66,105732,1,246084
2861,0.002074,172.217.194.0-255,2184,107916,1,246084
2862,0.00208,172.31.36.0-255,66,107982,1,246084
2863,0.004111,172.217.194.0-255,2902,110884,1,246084
2864,0.004118,172.31.36.0-255,66,110950,1,246084
2865,0.004147,172.217.194.0-255,2902,113852,1,246084
2866,0.00415,172.31.36.0-255,66,113918,1,246084
2867,0.006165,172.217.194.0-255,2902,116820,1,246084
2868,0.00617,172.31.36.0-255,66,116886,1,246084
2869,0.006204,172.217.194.0-255,2902,119788,1,246084
2870,0.006207,172.31.36.0-255,66,119854,1,246084
2871,0.008261,172.217.194.0-255,2902,122756,1,246084
2872,0.008267,172.31.36.0-255,66,122822,1,246084
2873,0.008325,172.217.194.0-255,2902,125724,1,246084
2874,0.008329,172.31.36.0-255,66,125790,1,246084
2875,0.010343,172.217.194.0-255,2902,128692,1,246084
2876,0.01035,172.31.36.0-255,66,128758,1,246084
2877,0.010398,172.217.194.0-255,2902,131660,1,246084
2878,0.010401,172.31.36.0-255,66,131726,1,246084
2879,0.01243,172.217.194.0-255,2902,134628,1,246084
2880,0.012437,172.31.36.0-255,66,134694,1,246084
2881,0.012458,172.217.194.0-255,2902,137596,1,246084
2882,0.012461,172.31.36.0-255,66,137662,1,246084
2883,0.014494,172.217.194.0-255,2902,140564,1,246084
2884,0.014501,172.31.36.0-255,66,140630,1,246084
2885,0.014537,172.217.194.0-255,2902,143532,1,246084
2886,0.01454,172.31.36.0-255,66,143598,1,246084
2887,0.016587,172.217.194.0-255,2902,146500,1,246084
2888,0.016595,172.31.36.0-255,66,146566,1,246084
2889,0.016628,172.217.194.0-255,2902,149468,1,246084
2890,0.016632,172.31.36.0-255,66,149534,1,246084
2891,0.018677,172.217.194.0-255,2902,152436,1,246084
2892,0.018689,172.31.36.0-255,66,152502,1,246084
2893,0.018719,172.217.194.0-255,2902,155404,1,246084
2894,0.018722,172.31.36.0-255,66,155470,1,246084
2895,0.020794,172.217.194.0-255,2902,158372,1,246084
2896,0.020804,172.31.36.0-255,66,158438,1,246084
2897,0.020832,172.217.194.0-255,2902,161340,1,246084
2898,0.020835,172.31.36.0-255,66,161406,1,246084
2899,0.022879,172.217.194.0-255,2902,164308,1,246084
2900,0.022885,172.31.36.0-255,66,164374,1,246084
2901,0.022913,172.217.194.0-255,2902,167276,1,246084
2902,0.022915,172.31.36.0-255,66,167342,1,246084
2903,0.024997,172.217.194.0-255,5738,173080,1,246084
2904,0.025004,172.31.36.0-255,66,173146,1,246084
2905,0.027096,172.217.194.0-255,5738,178884,1,246084
2906,0.027103,172.31.36.0-255,66,178950,1,246084
2907,0.029197,172.217.194.0-255,5738,184688,1,246084
2908,0.029206,172.31.36.0-255,66,184754,1,246084
2909,0.031276,172.217.194.0-255,5738,190492,1,246084
2910,0.031283,172.31.36.0-255,66,190558,1,246084
2911,0.033364,172.217.194.0-255,5738,196296,1,246084
2912,0.033374,172.31.36.0-255,66,196362,1,246084
2913,0.035473,172.217.194.0-255,5738,202100,1,246084
2914,0.03549,172.31.36.0-255,66,202166,1,246084
2915,0.037608,172.217.194.0-255,5738,207904,1,246084
2916,0.037624,172.31.36.0-255,66,207970,1,246084
2917,0.038782,172.31.36.0-255,171,208141,1,246084
2918,0.038845,172.31.36.0-255,1137,209278,1,246084
2919,0.038904,172.31.36.0-255,1514,210792,1,246084
2920,0.038928,172.31.36.0-255,1514,212306,1,246084
2921,0.03893,172.31.36.0-255,1514,213820,1,246084
2922,0.038952,172.31.36.0-255,1514,215334,1,246084
2923,0.038953,172.31.36.0-255,1466,216800,1,246084
2924,0.039726,172.217.194.0-255,5738,222538,1,246084
2925,0.039739,172.31.36.0-255,66,222604,1,246084
2926,0.040312,104.244.42.0-255,66,222670,1,246084
2927,0.040401,104.244.42.0-255,66,222736,1,246084
2928,0.040463,104.244.42.0-255,66,222802,1,246084
2929,0.04051,104.244.42.0-255,66,222868,1,246084
2930,0.041811,172.217.194.0-255,5738,228606,1,246084
2931,0.041822,172.31.36.0-255,66,228672,1,246084
2932,0.043897,172.217.194.0-255,5738,234410,1,246084
2933,0.043906,172.31.36.0-255,66,234476,1,246084
2934,0.046022,172.217.194.0-255,5738,240214,1,246084
2935,0.046033,172.31.36.0-255,66,240280,1,246084
2936,0.048129,172.217.194.0-255,5738,246018,1,246084
2937,0.048136,172.31.36.0-255,66,246084,1,246084
2938,0.0,172.217.194.0-255,146,146,1,197532
2939,3.4e-05,172.31.36.0-255,66,212,1,197532
2940,4.2e-05,172.217.194.0-255,1484,1696,1,197532
2941,4.6e-05,172.31.36.0-255,66,1762,1,197532
2942,5.1e-05,172.217.194.0-255,2902,4664,1,197532
2943,6.5e-05,172.31.36.0-255,66,4730,1,197532
2944,7.3e-05,172.217.194.0-255,7156,11886,1,197532
2945,7.6e-05,172.31.36.0-255,66,11952,1,197532
2946,7.8e-05,172.217.194.0-255,1484,13436,1,197532
2947,8e-05,172.31.36.0-255,66,13502,1,197532
2948,9.4e-05,172.217.194.0-255,1484,14986,1,197532
2949,9.6e-05,172.31.36.0-255,66,15052,1,197532
2950,0.0001,172.31.36.0-255,66,15118,1,197532
2951,0.000111,172.217.194.0-255,5379,20497,1,197532
2952,0.000123,172.31.36.0-255,66,20563,1,197532
2953,0.00017,172.31.36.0-255,66,20629,1,197532
2954,0.000199,172.217.194.0-255,1484,22113,1,197532
2955,0.000202,172.31.36.0-255,66,22179,1,197532
2956,0.000207,172.217.194.0-255,2543,24722,1,197532
2957,0.000209,172.31.36.0-255,66,24788,1,197532
2958,0.000578,172.217.194.0-255,1484,26272,1,197532
2959,0.000583,172.31.36.0-255,66,26338,1,197532
2960,0.000589,172.217.194.0-255,2902,29240,1,197532
2961,0.000592,172.31.36.0-255,66,29306,1,197532
2962,0.000625,172.217.194.0-255,5738,35044,1,197532
2963,0.000628,172.31.36.0-255,66,35110,1,197532
2964,0.000635,172.217.194.0-255,6797,41907,1,197532
2965,0.000637,172.31.36.0-255,66,41973,1,197532
2966,0.000657,172.217.194.0-255,647,42620,1,197532
2967,0.00066,172.31.36.0-255,66,42686,1,197532
2968,0.000695,172.217.194.0-255,1484,44170,1,197532
2969,0.0007,172.217.194.0-255,1484,45654,1,197532
2970,0.000703,172.31.36.0-255,66,45720,1,197532
2971,0.000728,172.217.194.0-255,1484,47204,1,197532
2972,0.000736,172.217.194.0-255,5738,52942,1,197532
2973,0.000738,172.31.36.0-255,66,53008,1,197532
2974,0.000745,172.217.194.0-255,5738,58746,1,197532
2975,0.000747,172.31.36.0-255,66,58812,1,197532
2976,0.000789,172.31.36.0-255,66,58878,1,197532
2977,0.000806,172.31.36.0-255,66,58944,1,197532
2978,0.00138,172.217.194.0-255,1484,60428,1,197532
2979,0.001391,172.217.194.0-255,2902,63330,1,197532
2980,0.001395,172.31.36.0-255,66,63396,1,197532
2981,0.001403,172.217.194.0-255,5738,69134,1,197532
2982,0.001405,172.31.36.0-255,66,69200,1,197532
2983,0.001457,172.31.36.0-255,66,69266,1,197532
2984,0.001461,172.217.194.0-255,1484,70750,1,197532
2985,0.00149,172.31.36.0-255,66,70816,1,197532
2986,0.001567,172.217.194.0-255,1484,72300,1,197532
2987,0.001575,172.217.194.0-255,2902,75202,1,197532
2988,0.001578,172.31.36.0-255,66,75268,1,197532
2989,0.001585,172.217.194.0-255,5738,81006,1,197532
2990,0.001588,172.31.36.0-255,66,81072,1,197532
2991,0.001598,172.217.194.0-255,1484,82556,1,197532
2992,0.00164,172.31.36.0-255,66,82622,1,197532
2993,0.001662,172.31.36.0-255,66,82688,1,197532
2994,0.001722,172.217.194.0-255,1484,84172,1,197532
2995,0.001726,172.217.194.0-255,2902,87074,1,197532
2996,0.001728,172.31.36.0-255,66,87140,1,197532
2997,0.00175,172.217.194.0-255,5738,92878,1,197532
2998,0.001753,172.31.36.0-255,66,92944,1,197532
2999,0.00178,172.31.36.0-255,66,93010,1,197532
3000,0.001805,172.217.194.0-255,1484,94494,1,197532
3001,0.001815,172.31.36.0-255,66,94560,1,197532
3002,0.001841,172.217.194.0-255,2184,96744,1,197532
3003,0.001843,172.31.36.0-255,66,96810,1,197532
3004,0.001848,172.217.194.0-255,2902,99712,1,197532
3005,0.00185,172.31.36.0-255,66,99778,1,197532
3006,0.001855,172.217.194.0-255,2902,102680,1,197532
3007,0.001857,172.31.36.0-255,66,102746,1,197532
3008,0.001884,172.217.194.0-255,4320,107066,1,197532
3009,0.001887,172.31.36.0-255,66,107132,1,197532
3010,0.001905,172.31.36.0-255,66,107198,1,197532
3011,0.001956,172.31.36.0-255,66,107264,1,197532
3012,0.001966,172.31.36.0-255,66,107330,1,197532
3013,0.001992,172.217.194.0-255,2902,110232,1,197532
3014,0.001994,172.31.36.0-255,66,110298,1,197532
3015,0.002021,172.31.36.0-255,66,110364,1,197532
3016,0.002054,172.217.194.0-255,5020,115384,1,197532
3017,0.002056,172.31.36.0-255,66,115450,1,197532
3018,0.002069,172.31.36.0-255,66,115516,1,197532
3019,0.002088,172.31.36.0-255,66,115582,1,197532
3020,0.002094,172.217.194.0-255,6438,122020,1,197532
3021,0.002096,172.31.36.0-255,66,122086,1,197532
3022,0.002147,172.217.194.0-255,1484,123570,1,197532
3023,0.002151,172.217.194.0-255,1484,125054,1,197532
3024,0.002153,172.31.36.0-255,66,125120,1,197532
3025,0.002175,172.217.194.0-255,1484,126604,1,197532
3026,0.002181,172.217.194.0-255,5738,132342,1,197532
3027,0.002183,172.31.36.0-255,66,132408,1,197532
3028,0.00219,172.217.194.0-255,5738,138146,1,197532
3029,0.002192,172.31.36.0-255,66,138212,1,197532
3030,0.00222,172.217.194.0-255,2902,141114,1,197532
3031,0.002222,172.31.36.0-255,66,141180,1,197532
3032,0.002257,172.31.36.0-255,66,141246,1,197532
3033,0.002264,172.217.194.0-255,7156,148402,1,197532
3034,0.002266,172.31.36.0-255,66,148468,1,197532
3035,0.002291,172.31.36.0-255,66,148534,1,197532
3036,0.002332,172.217.194.0-255,5738,154272,1,197532
3037,0.002334,172.31.36.0-255,66,154338,1,197532
3038,0.002371,172.31.36.0-255,66,154404,1,197532
3039,0.002373,172.217.194.0-255,1484,155888,1,197532
3040,0.002377,172.217.194.0-255,2902,158790,1,197532
3041,0.002379,172.31.36.0-255,66,158856,1,197532
3042,0.002385,172.217.194.0-255,5738,164594,1,197532
3043,0.002392,172.31.36.0-255,66,164660,1,197532
3044,0.002398,172.217.194.0-255,5738,170398,1,197532
3045,0.0024,172.31.36.0-255,66,170464,1,197532
3046,0.002405,172.217.194.0-255,4320,174784,1,197532
3047,0.002406,172.31.36.0-255,66,174850,1,197532
3048,0.002409,172.217.194.0-255,1484,176334,1,197532
3049,0.002454,172.31.36.0-255,66,176400,1,197532
3050,0.002484,172.217.194.0-255,1484,177884,1,197532
3051,0.002496,172.217.194.0-255,4320,182204,1,197532
3052,0.002498,172.31.36.0-255,66,182270,1,197532
3053,0.002527,172.217.194.0-255,5659,187929,1,197532
3054,0.00253,172.31.36.0-255,66,187995,1,197532
3055,0.002533,172.217.194.0-255,97,188092,1,197532
3056,0.002552,172.217.194.0-255,105,188197,1,197532
3057,0.007227,172.31.36.0-255,66,188263,1,197532
3058,0.007255,172.31.36.0-255,105,188368,1,197532
3059,0.009551,172.217.194.0-255,66,188434,1,197532
3060,0.037027,172.31.36.0-255,172,188606,1,197532
3061,0.037058,172.31.36.0-255,1115,189721,1,197532
3062,0.037108,172.31.36.0-255,1514,191235,1,197532
3063,0.037109,172.31.36.0-255,1514,192749,1,197532
3064,0.037116,172.31.36.0-255,1514,194263,1,197532
3065,0.037117,172.31.36.0-255,1514,195777,1,197532
3066,0.037148,172.31.36.0-255,1491,197268,1,197532
3067,0.038519,104.244.42.0-255,66,197334,1,197532
3068,0.038539,104.244.42.0-255,66,197400,1,197532
3069,0.038622,104.244.42.0-255,66,197466,1,197532
3070,0.038652,104.244.42.0-255,66,197532,1,197532
3071,0.0,74.125.24.0-255,148,148,1,218046
3072,2.3e-05,172.31.36.0-255,66,214,1,218046
3073,2.9e-05,74.125.24.0-255,1484,1698,1,218046
3074,3.4e-05,172.31.36.0-255,66,1764,1,218046
3075,5.9e-05,74.125.24.0-255,2902,4666,1,218046
3076,6.7e-05,172.31.36.0-255,66,4732,1,218046
3077,7.4e-05,74.125.24.0-255,7156,11888,1,218046
3078,7.6e-05,172.31.36.0-255,66,11954,1,218046
3079,8e-05,74.125.24.0-255,2902,14856,1,218046
3080,8.3e-05,172.31.36.0-255,66,14922,1,218046
3081,0.000127,172.31.36.0-255,66,14988,1,218046
3082,0.000133,74.125.24.0-255,6797,21785,1,218046
3083,0.000135,172.31.36.0-255,66,21851,1,218046
3084,0.000189,74.125.24.0-255,1484,23335,1,218046
3085,0.000194,172.31.36.0-255,66,23401,1,218046
3086,0.000199,74.125.24.0-255,2902,26303,1,218046
3087,0.000201,172.31.36.0-255,66,26369,1,218046
3088,0.000207,74.125.24.0-255,5738,32107,1,218046
3089,0.000216,172.31.36.0-255,66,32173,1,218046
3090,0.000253,74.125.24.0-255,6797,38970,1,218046
3091,0.000256,172.31.36.0-255,66,39036,1,218046
3092,0.000294,74.125.24.0-255,7156,46192,1,218046
3093,0.000297,172.31.36.0-255,66,46258,1,218046
3094,0.000302,74.125.24.0-255,5738,51996,1,218046
3095,0.000304,172.31.36.0-255,66,52062,1,218046
3096,0.000354,74.125.24.0-255,4319,56381,1,218046
3097,0.000357,172.31.36.0-255,66,56447,1,218046
3098,0.000429,74.125.24.0-255,352,56799,1,218046
3099,0.000433,172.31.36.0-255,66,56865,1,218046
3100,0.000621,74.125.24.0-255,1484,58349,1,218046
3101,0.000625,172.31.36.0-255,66,58415,1,218046
3102,0.00063,74.125.24.0-255,2902,61317,1,218046
3103,0.000632,172.31.36.0-255,66,61383,1,218046
3104,0.000637,74.125.24.0-255,4320,65703,1,218046
3105,0.000641,172.31.36.0-255,66,65769,1,218046
3106,0.000653,74.125.24.0-255,1484,67253,1,218046
3107,0.000685,74.125.24.0-255,5738,72991,1,218046
3108,0.000688,172.31.36.0-255,66,73057,1,218046
3109,0.000717,74.125.24.0-255,1125,74182,1,218046
3110,0.000725,74.125.24.0-255,7156,81338,1,218046
3111,0.000728,172.31.36.0-255,66,81404,1,218046
3112,0.000734,74.125.24.0-255,5738,87142,1,218046
3113,0.000737,172.31.36.0-255,66,87208,1,218046
3114,0.000755,74.125.24.0-255,3961,91169,1,218046
3115,0.000762,172.31.36.0-255,66,91235,1,218046
3116,0.00123,74.125.24.0-255,1484,92719,1,218046
3117,0.001239,74.125.24.0-255,2902,95621,1,218046
3118,0.001244,172.31.36.0-255,66,95687,1,218046
3119,0.00125,74.125.24.0-255,5738,101425,1,218046
3120,0.001253,172.31.36.0-255,66,101491,1,218046
3121,0.001272,74.125.24.0-255,4320,105811,1,218046
3122,0.001275,172.31.36.0-255,66,105877,1,218046
3123,0.001317,172.31.36.0-255,66,105943,1,218046
3124,0.001332,172.31.36.0-255,66,106009,1,218046
3125,0.00163,74.125.24.0-255,1484,107493,1,218046
3126,0.001637,74.125.24.0-255,2902,110395,1,218046
3127,0.001641,172.31.36.0-255,66,110461,1,218046
3128,0.001648,74.125.24.0-255,5738,116199,1,218046
3129,0.00165,172.31.36.0-255,66,116265,1,218046
3130,0.001691,172.31.36.0-255,66,116331,1,218046
3131,0.001696,74.125.24.0-255,2902,119233,1,218046
3132,0.001698,172.31.36.0-255,66,119299,1,218046
3133,0.00173,172.31.36.0-255,66,119365,1,218046
3134,0.001741,172.31.36.0-255,66,119431,1,218046
3135,0.001747,74.125.24.0-255,5738,125169,1,218046
3136,0.001749,172.31.36.0-255,66,125235,1,218046
3137,0.001797,74.125.24.0-255,2902,128137,1,218046
3138,0.0018,172.31.36.0-255,66,128203,1,218046
3139,0.001839,172.31.36.0-255,66,128269,1,218046
3140,0.00194,74.125.24.0-255,1484,129753,1,218046
3141,0.001944,74.125.24.0-255,2902,132655,1,218046
3142,0.001946,172.31.36.0-255,66,132721,1,218046
3143,0.001975,74.125.24.0-255,5738,138459,1,218046
3144,0.001978,172.31.36.0-255,66,138525,1,218046
3145,0.001985,74.125.24.0-255,7156,145681,1,218046
3146,0.001987,172.31.36.0-255,66,145747,1,218046
3147,0.002016,74.125.24.0-255,5738,151485,1,218046
3148,0.002018,172.31.36.0-255,66,151551,1,218046
3149,0.002029,172.31.36.0-255,66,151617,1,218046
3150,0.002031,74.125.24.0-255,766,152383,1,218046
3151,0.002116,74.125.24.0-255,1484,153867,1,218046
3152,0.002118,172.31.36.0-255,66,153933,1,218046
3153,0.002123,74.125.24.0-255,2902,156835,1,218046
3154,0.002125,172.31.36.0-255,66,156901,1,218046
3155,0.002156,74.125.24.0-255,5738,162639,1,218046
3156,0.002159,172.31.36.0-255,66,162705,1,218046
3157,0.002175,74.125.24.0-255,7156,169861,1,218046
3158,0.002177,172.31.36.0-255,66,169927,1,218046
3159,0.002221,74.125.24.0-255,5738,175665,1,218046
3160,0.002223,172.31.36.0-255,66,175731,1,218046
3161,0.002253,172.31.36.0-255,66,175797,1,218046
3162,0.002257,74.125.24.0-255,2184,177981,1,218046
3163,0.002259,172.31.36.0-255,66,178047,1,218046
3164,0.002263,74.125.24.0-255,2902,180949,1,218046
3165,0.002265,172.31.36.0-255,66,181015,1,218046
3166,0.002272,74.125.24.0-255,7156,188171,1,218046
3167,0.002275,172.31.36.0-255,66,188237,1,218046
3168,0.002282,74.125.24.0-255,7156,195393,1,218046
3169,0.002284,172.31.36.0-255,66,195459,1,218046
3170,0.002298,172.31.36.0-255,66,195525,1,218046
3171,0.002301,74.125.24.0-255,766,196291,1,218046
3172,0.002313,172.31.36.0-255,66,196357,1,218046
3173,0.002316,74.125.24.0-255,1484,197841,1,218046
3174,0.002346,74.125.24.0-255,1484,199325,1,218046
3175,0.002348,172.31.36.0-255,66,199391,1,218046
3176,0.002365,172.31.36.0-255,66,199457,1,218046
3177,0.002367,74.125.24.0-255,766,200223,1,218046
3178,0.002376,74.125.24.0-255,1484,201707,1,218046
3179,0.002378,172.31.36.0-255,66,201773,1,218046
3180,0.002423,172.31.36.0-255,66,201839,1,218046
3181,0.002434,172.31.36.0-255,66,201905,1,218046
3182,0.002436,74.125.24.0-255,766,202671,1,218046
3183,0.002446,172.31.36.0-255,66,202737,1,218046
3184,0.002485,74.125.24.0-255,5738,208475,1,218046
3185,0.002488,172.31.36.0-255,66,208541,1,218046
3186,0.002502,172.31.36.0-255,66,208607,1,218046
3187,0.002516,172.31.36.0-255,66,208673,1,218046
3188,0.002542,74.125.24.0-255,105,208778,1,218046
3189,0.006516,172.31.36.0-255,66,208844,1,218046
3190,0.006544,172.31.36.0-255,105,208949,1,218046
3191,0.008786,74.125.24.0-255,66,209015,1,218046
3192,0.041916,172.31.36.0-255,172,209187,1,218046
3193,0.041947,172.31.36.0-255,1113,210300,1,218046
3194,0.041996,172.31.36.0-255,1514,211814,1,218046
3195,0.041998,172.31.36.0-255,1514,213328,1,218046
3196,0.042003,172.31.36.0-255,1514,214842,1,218046
3197,0.042004,172.31.36.0-255,1514,216356,1,218046
3198,0.042022,172.31.36.0-255,1492,217848,1,218046
3199,0.043408,104.244.42.0-255,66,217914,1,218046
3200,0.043441,104.244.42.0-255,66,217980,1,218046
3201,0.043524,104.244.42.0-255,66,218046,1,218046
3202,0.0,172.31.36.0-255,66,66,1,66
3203,0.0,172.31.36.0-255,105,105,1,276
3204,0.001848,157.240.13.0-255,105,210,1,276
3205,0.00186,172.31.36.0-255,66,276,1,276
3206,0.0,172.217.160.0-255,153,153,1,244548
3207,4.8e-05,172.31.36.0-255,66,219,1,244548
3208,5.7e-05,172.217.160.0-255,1484,1703,1,244548
3209,6.3e-05,172.31.36.0-255,66,1769,1,244548
3210,7.7e-05,172.217.160.0-255,2902,4671,1,244548
3211,8.1e-05,172.31.36.0-255,66,4737,1,244548
3212,8.6e-05,172.217.160.0-255,1484,6221,1,244548
3213,8.8e-05,172.31.36.0-255,66,6287,1,244548
3214,9.1e-05,172.217.160.0-255,1484,7771,1,244548
3215,9.3e-05,172.31.36.0-255,66,7837,1,244548
3216,9.9e-05,172.217.160.0-255,4320,12157,1,244548
3217,0.000101,172.31.36.0-255,66,12223,1,244548
3218,0.000115,172.31.36.0-255,66,12289,1,244548
3219,0.000122,172.217.160.0-255,5738,18027,1,244548
3220,0.000125,172.31.36.0-255,66,18093,1,244548
3221,0.000201,172.31.36.0-255,66,18159,1,244548
3222,0.00024,172.31.36.0-255,66,18225,1,244548
3223,0.0004,172.217.160.0-255,1484,19709,1,244548
3224,0.000404,172.31.36.0-255,66,19775,1,244548
3225,0.00041,172.217.160.0-255,2902,22677,1,244548
3226,0.000412,172.31.36.0-255,66,22743,1,244548
3227,0.000415,172.217.160.0-255,1484,24227,1,244548
3228,0.000417,172.31.36.0-255,66,24293,1,244548
3229,0.000455,172.217.160.0-255,4320,28613,1,244548
3230,0.000459,172.31.36.0-255,66,28679,1,244548
3231,0.000466,172.217.160.0-255,6797,35476,1,244548
3232,0.000469,172.31.36.0-255,66,35542,1,244548
3233,0.000513,172.217.160.0-255,371,35913,1,244548
3234,0.000516,172.31.36.0-255,66,35979,1,244548
3235,0.000853,172.217.160.0-255,372,36351,1,244548
3236,0.000944,172.31.36.0-255,66,36417,1,244548
3237,0.001025,172.217.160.0-255,1484,37901,1,244548
3238,0.001035,172.217.160.0-255,2902,40803,1,244548
3239,0.001039,172.31.36.0-255,66,40869,1,244548
3240,0.001047,172.217.160.0-255,5738,46607,1,244548
3241,0.00105,172.31.36.0-255,66,46673,1,244548
3242,0.001077,172.217.160.0-255,1484,48157,1,244548
3243,0.001104,172.31.36.0-255,66,48223,1,244548
3244,0.001138,172.217.160.0-255,3961,52184,1,244548
3245,0.001142,172.31.36.0-255,66,52250,1,244548
3246,0.001161,172.31.36.0-255,66,52316,1,244548
3247,0.001208,172.217.160.0-255,1484,53800,1,244548
3248,0.001212,172.217.160.0-255,1484,55284,1,244548
3249,0.001215,172.31.36.0-255,66,55350,1,244548
3250,0.001239,172.217.160.0-255,1484,56834,1,244548
3251,0.001247,172.217.160.0-255,5738,62572,1,244548
3252,0.00125,172.31.36.0-255,66,62638,1,244548
3253,0.001258,172.217.160.0-255,5738,68376,1,244548
3254,0.00126,172.31.36.0-255,66,68442,1,244548
3255,0.001268,172.217.160.0-255,7156,75598,1,244548
3256,0.001271,172.31.36.0-255,66,75664,1,244548
3257,0.0013,172.217.160.0-255,5738,81402,1,244548
3258,0.001303,172.31.36.0-255,66,81468,1,244548
3259,0.001317,172.217.160.0-255,4471,85939,1,244548
3260,0.001319,172.31.36.0-255,66,86005,1,244548
3261,0.001352,172.217.160.0-255,1484,87489,1,244548
3262,0.001358,172.217.160.0-255,2902,90391,1,244548
3263,0.001361,172.31.36.0-255,66,90457,1,244548
3264,0.001366,172.217.160.0-255,2902,93359,1,244548
3265,0.001368,172.31.36.0-255,66,93425,1,244548
3266,0.001394,172.217.160.0-255,2902,96327,1,244548
3267,0.001397,172.31.36.0-255,66,96393,1,244548
3268,0.001414,172.31.36.0-255,66,96459,1,244548
3269,0.001426,172.31.36.0-255,66,96525,1,244548
3270,0.001429,172.217.160.0-255,766,97291,1,244548
3271,0.003359,172.217.160.0-255,4320,101611,1,244548
3272,0.003372,172.31.36.0-255,66,101677,1,244548
3273,0.005323,172.217.160.0-255,5738,107415,1,244548
3274,0.005328,172.31.36.0-255,66,107481,1,244548
3275,0.007275,172.217.160.0-255,5738,113219,1,244548
3276,0.007284,172.31.36.0-255,66,113285,1,244548
3277,0.009272,172.217.160.0-255,5738,119023,1,244548
3278,0.009284,172.31.36.0-255,66,119089,1,244548
3279,0.011257,172.217.160.0-255,5738,124827,1,244548
3280,0.011276,172.31.36.0-255,66,124893,1,244548
3281,0.013238,172.217.160.0-255,5738,130631,1,244548
3282,0.013258,172.31.36.0-255,66,130697,1,244548
3283,0.015206,172.217.160.0-255,5738,136435,1,244548
3284,0.015226,172.31.36.0-255,66,136501,1,244548
3285,0.017183,172.217.160.0-255,5738,142239,1,244548
3286,0.0172,172.31.36.0-255,66,142305,1,244548
3287,0.01917,172.217.160.0-255,5738,148043,1,244548
3288,0.019188,172.31.36.0-255,66,148109,1,244548
3289,0.021145,172.217.160.0-255,5738,153847,1,244548
3290,0.021163,172.31.36.0-255,66,153913,1,244548
3291,0.023134,172.217.160.0-255,5738,159651,1,244548
3292,0.023153,172.31.36.0-255,66,159717,1,244548
3293,0.025119,172.217.160.0-255,5738,165455,1,244548
3294,0.025138,172.31.36.0-255,66,165521,1,244548
3295,0.027126,172.217.160.0-255,5738,171259,1,244548
3296,0.027143,172.31.36.0-255,66,171325,1,244548
3297,0.029117,172.217.160.0-255,5738,177063,1,244548
3298,0.029136,172.31.36.0-255,66,177129,1,244548
3299,0.031126,172.217.160.0-255,5738,182867,1,244548
3300,0.031142,172.31.36.0-255,66,182933,1,244548
3301,0.033112,172.217.160.0-255,5738,188671,1,244548
3302,0.033134,172.31.36.0-255,66,188737,1,244548
3303,0.035129,172.217.160.0-255,5738,194475,1,244548
3304,0.035155,172.31.36.0-255,66,194541,1,244548
3305,0.037157,172.217.160.0-255,5738,200279,1,244548
3306,0.03718,172.31.36.0-255,66,200345,1,244548
3307,0.039139,172.217.160.0-255,5738,206083,1,244548
3308,0.039165,172.31.36.0-255,66,206149,1,244548
3309,0.041141,172.217.160.0-255,5738,211887,1,244548
3310,0.041166,172.31.36.0-255,66,211953,1,244548
3311,0.043129,172.217.160.0-255,5738,217691,1,244548
3312,0.043152,172.31.36.0-255,66,217757,1,244548
3313,0.044817,172.31.36.0-255,192,217949,1,244548
3314,0.04485,172.31.36.0-255,1114,219063,1,244548
3315,0.044936,172.31.36.0-255,1514,220577,1,244548
3316,0.044956,172.31.36.0-255,1514,222091,1,244548
3317,0.044962,172.31.36.0-255,1514,223605,1,244548
3318,0.044964,172.31.36.0-255,1514,225119,1,244548
3319,0.044983,172.31.36.0-255,1489,226608,1,244548
3320,0.045092,172.217.160.0-255,2902,229510,1,244548
3321,0.045102,172.31.36.0-255,66,229576,1,244548
3322,0.045136,172.217.160.0-255,2902,232478,1,244548
3323,0.04514,172.31.36.0-255,66,232544,1,244548
3324,0.046401,104.244.42.0-255,66,232610,1,244548
3325,0.046436,104.244.42.0-255,66,232676,1,244548
3326,0.046575,104.244.42.0-255,66,232742,1,244548
3327,0.047035,172.217.160.0-255,2902,235644,1,244548
3328,0.04705,172.31.36.0-255,66,235710,1,244548
3329,0.047129,172.217.160.0-255,2902,238612,1,244548
3330,0.047135,172.31.36.0-255,66,238678,1,244548
3331,0.049029,172.217.160.0-255,1484,240162,1,244548
3332,0.049094,172.217.160.0-255,4320,244482,1,244548
3333,0.049109,172.31.36.0-255,66,244548,1,244548
3334,0.0,74.125.24.0-255,153,153,1,238146
3335,2.2e-05,172.31.36.0-255,66,219,1,238146
3336,3e-05,74.125.24.0-255,1484,1703,1,238146
3337,3.4e-05,172.31.36.0-255,66,1769,1,238146
3338,4e-05,74.125.24.0-255,2902,4671,1,238146
3339,4.2e-05,172.31.36.0-255,66,4737,1,238146
3340,4.9e-05,74.125.24.0-255,5738,10475,1,238146
3341,5.1e-05,172.31.36.0-255,66,10541,1,238146
3342,7.1e-05,74.125.24.0-255,3367,13908,1,238146
3343,7.3e-05,172.31.36.0-255,66,13974,1,238146
3344,0.000112,74.125.24.0-255,4320,18294,1,238146
3345,0.000115,172.31.36.0-255,66,18360,1,238146
3346,0.00012,74.125.24.0-255,2902,21262,1,238146
3347,0.000122,172.31.36.0-255,66,21328,1,238146
3348,0.000144,74.125.24.0-255,7156,28484,1,238146
3349,0.000147,172.31.36.0-255,66,28550,1,238146
3350,0.000171,74.125.24.0-255,2543,31093,1,238146
3351,0.000173,172.31.36.0-255,66,31159,1,238146
3352,0.000268,74.125.24.0-255,1484,32643,1,238146
3353,0.000272,172.31.36.0-255,66,32709,1,238146
3354,0.000277,74.125.24.0-255,2902,35611,1,238146
3355,0.00028,172.31.36.0-255,66,35677,1,238146
3356,0.000284,74.125.24.0-255,2902,38579,1,238146
3357,0.000286,172.31.36.0-255,66,38645,1,238146
3358,0.000309,74.125.24.0-255,2902,41547,1,238146
3359,0.000311,172.31.36.0-255,66,41613,1,238146
3360,0.000323,172.31.36.0-255,66,41679,1,238146
3361,0.000353,74.125.24.0-255,5379,47058,1,238146
3362,0.000356,172.31.36.0-255,66,47124,1,238146
3363,0.000363,74.125.24.0-255,7156,54280,1,238146
3364,0.000365,172.31.36.0-255,66,54346,1,238146
3365,0.000369,74.125.24.0-255,2875,57221,1,238146
3366,0.000372,172.31.36.0-255,66,57287,1,238146
3367,0.000759,74.125.24.0-255,109,57396,1,238146
3368,0.000796,74.125.24.0-255,1484,58880,1,238146
3369,0.0008,172.31.36.0-255,66,58946,1,238146
3370,0.000805,74.125.24.0-255,2902,61848,1,238146
3371,0.000807,172.31.36.0-255,66,61914,1,238146
3372,0.000814,74.125.24.0-255,4320,66234,1,238146
3373,0.000816,172.31.36.0-255,66,66300,1,238146
3374,0.000839,74.125.24.0-255,2902,69202,1,238146
3375,0.000842,172.31.36.0-255,66,69268,1,238146
3376,0.000862,74.125.24.0-255,5066,74334,1,238146
3377,0.000865,172.31.36.0-255,66,74400,1,238146
3378,0.001341,74.125.24.0-255,1484,75884,1,238146
3379,0.00135,74.125.24.0-255,2902,78786,1,238146
3380,0.001354,172.31.36.0-255,66,78852,1,238146
3381,0.001362,74.125.24.0-255,4320,83172,1,238146
3382,0.001363,172.31.36.0-255,66,83238,1,238146
3383,0.001376,74.125.24.0-255,1484,84722,1,238146
3384,0.001382,74.125.24.0-255,4320,89042,1,238146
3385,0.001384,172.31.36.0-255,66,89108,1,238146
3386,0.001411,74.125.24.0-255,2902,92010,1,238146
3387,0.001413,172.31.36.0-255,66,92076,1,238146
3388,0.001426,172.31.36.0-255,66,92142,1,238146
3389,0.001455,74.125.24.0-255,4320,96462,1,238146
3390,0.001458,172.31.36.0-255,66,96528,1,238146
3391,0.001463,74.125.24.0-255,2184,98712,1,238146
3392,0.001465,172.31.36.0-255,66,98778,1,238146
3393,0.001521,74.125.24.0-255,1484,100262,1,238146
3394,0.001526,74.125.24.0-255,2902,103164,1,238146
3395,0.001528,172.31.36.0-255,66,103230,1,238146
3396,0.001548,74.125.24.0-255,5738,108968,1,238146
3397,0.00155,172.31.36.0-255,66,109034,1,238146
3398,0.001568,74.125.24.0-255,2902,111936,1,238146
3399,0.00157,172.31.36.0-255,66,112002,1,238146
3400,0.001607,74.125.24.0-255,7156,119158,1,238146
3401,0.001609,172.31.36.0-255,66,119224,1,238146
3402,0.001624,74.125.24.0-255,2902,122126,1,238146
3403,0.001626,172.31.36.0-255,66,122192,1,238146
3404,0.001635,172.31.36.0-255,66,122258,1,238146
3405,0.001638,74.125.24.0-255,2184,124442,1,238146
3406,0.001641,172.31.36.0-255,66,124508,1,238146
3407,0.004246,74.125.24.0-255,5738,130246,1,238146
3408,0.004252,172.31.36.0-255,66,130312,1,238146
3409,0.006861,74.125.24.0-255,2902,133214,1,238146
3410,0.006865,172.31.36.0-255,66,133280,1,238146
3411,0.006882,74.125.24.0-255,2902,136182,1,238146
3412,0.006885,172.31.36.0-255,66,136248,1,238146
3413,0.009471,74.125.24.0-255,5738,141986,1,238146
3414,0.009479,172.31.36.0-255,66,142052,1,238146
3415,0.0121,74.125.24.0-255,5738,147790,1,238146
3416,0.012109,172.31.36.0-255,66,147856,1,238146
3417,0.014719,74.125.24.0-255,5738,153594,1,238146
3418,0.014729,172.31.36.0-255,66,153660,1,238146
3419,0.017335,74.125.24.0-255,5738,159398,1,238146
3420,0.017344,172.31.36.0-255,66,159464,1,238146
3421,0.019964,74.125.24.0-255,5738,165202,1,238146
3422,0.019972,172.31.36.0-255,66,165268,1,238146
3423,0.022571,74.125.24.0-255,5738,171006,1,238146
3424,0.022578,172.31.36.0-255,66,171072,1,238146
3425,0.025194,74.125.24.0-255,5738,176810,1,238146
3426,0.025202,172.31.36.0-255,66,176876,1,238146
3427,0.027788,74.125.24.0-255,5738,182614,1,238146
3428,0.027796,172.31.36.0-255,66,182680,1,238146
3429,0.030409,74.125.24.0-255,5738,188418,1,238146
3430,0.030418,172.31.36.0-255,66,188484,1,238146
3431,0.032999,74.125.24.0-255,5738,194222,1,238146
3432,0.033007,172.31.36.0-255,66,194288,1,238146
3433,0.034277,172.31.36.0-255,176,194464,1,238146
3434,0.034314,172.31.36.0-255,1114,195578,1,238146
3435,0.034381,172.31.36.0-255,1514,197092,1,238146
3436,0.034382,172.31.36.0-255,1514,198606,1,238146
3437,0.034387,172.31.36.0-255,1514,200120,1,238146
3438,0.034389,172.31.36.0-255,1514,201634,1,238146
3439,0.034406,172.31.36.0-255,1490,203124,1,238146
3440,0.035604,74.125.24.0-255,5738,208862,1,238146
3441,0.035611,172.31.36.0-255,66,208928,1,238146
3442,0.035806,104.244.42.0-255,66,208994,1,238146
3443,0.03584,104.244.42.0-255,66,209060,1,238146
3444,0.035977,104.244.42.0-255,66,209126,1,238146
3445,0.038201,74.125.24.0-255,5738,214864,1,238146
3446,0.038208,172.31.36.0-255,66,214930,1,238146
3447,0.040809,74.125.24.0-255,5738,220668,1,238146
3448,0.040817,172.31.36.0-255,66,220734,1,238146
3449,0.043424,74.125.24.0-255,5738,226472,1,238146
3450,0.043432,172.31.36.0-255,66,226538,1,238146
3451,0.046049,74.125.24.0-255,5738,232276,1,238146
3452,0.046056,172.31.36.0-255,66,232342,1,238146
3453,0.048657,74.125.24.0-255,5738,238080,1,238146
3454,0.048664,172.31.36.0-255,66,238146,1,238146
3455,0.0,172.217.194.0-255,150,150,1,152917
3456,2.5e-05,172.31.36.0-255,66,216,1,152917
3457,3.2e-05,172.217.194.0-255,1484,1700,1,152917
3458,3.7e-05,172.31.36.0-255,66,1766,1,152917
3459,5e-05,172.217.194.0-255,2902,4668,1,152917
3460,5.3e-05,172.31.36.0-255,66,4734,1,152917
3461,6.1e-05,172.217.194.0-255,7156,11890,1,152917
3462,6.4e-05,172.31.36.0-255,66,11956,1,152917
3463,6.8e-05,172.217.194.0-255,2079,14035,1,152917
3464,7.3e-05,172.31.36.0-255,66,14101,1,152917
3465,7.8e-05,172.217.194.0-255,2902,17003,1,152917
3466,8e-05,172.31.36.0-255,66,17069,1,152917
3467,0.000118,172.217.194.0-255,7156,24225,1,152917
3468,0.000122,172.31.36.0-255,66,24291,1,152917
3469,0.00013,172.217.194.0-255,6797,31088,1,152917
3470,0.000132,172.31.36.0-255,66,31154,1,152917
3471,0.000256,172.217.194.0-255,1484,32638,1,152917
3472,0.00026,172.31.36.0-255,66,32704,1,152917
3473,0.000266,172.217.194.0-255,2902,35606,1,152917
3474,0.000268,172.31.36.0-255,66,35672,1,152917
3475,0.000278,172.217.194.0-255,4320,39992,1,152917
3476,0.000281,172.31.36.0-255,66,40058,1,152917
3477,0.000302,172.217.194.0-255,1484,41542,1,152917
3478,0.000305,172.31.36.0-255,66,41608,1,152917
3479,0.000311,172.217.194.0-255,4320,45928,1,152917
3480,0.000313,172.31.36.0-255,66,45994,1,152917
3481,0.000363,172.31.36.0-255,66,46060,1,152917
3482,0.000376,172.31.36.0-255,66,46126,1,152917
3483,0.000379,172.217.194.0-255,359,46485,1,152917
3484,0.000381,172.31.36.0-255,66,46551,1,152917
3485,0.000475,172.217.194.0-255,387,46938,1,152917
3486,0.000743,172.217.194.0-255,1484,48422,1,152917
3487,0.000748,172.31.36.0-255,66,48488,1,152917
3488,0.000755,172.217.194.0-255,2902,51390,1,152917
3489,0.000758,172.31.36.0-255,66,51456,1,152917
3490,0.00077,172.217.194.0-255,5738,57194,1,152917
3491,0.000772,172.31.36.0-255,66,57260,1,152917
3492,0.000818,172.31.36.0-255,66,57326,1,152917
3493,0.00083,172.31.36.0-255,66,57392,1,152917
3494,0.000833,172.217.194.0-255,766,58158,1,152917
3495,0.000973,172.217.194.0-255,1484,59642,1,152917
3496,0.000978,172.31.36.0-255,66,59708,1,152917
3497,0.000984,172.217.194.0-255,2902,62610,1,152917
3498,0.000986,172.31.36.0-255,66,62676,1,152917
3499,0.000998,172.217.194.0-255,5738,68414,1,152917
3500,0.001,172.31.36.0-255,66,68480,1,152917
3501,0.001008,172.217.194.0-255,5738,74218,1,152917
3502,0.00101,172.31.36.0-255,66,74284,1,152917
3503,0.001047,172.31.36.0-255,66,74350,1,152917
3504,0.001051,172.217.194.0-255,1484,75834,1,152917
3505,0.001077,172.217.194.0-255,3602,79436,1,152917
3506,0.00108,172.31.36.0-255,66,79502,1,152917
3507,0.001344,172.217.194.0-255,1484,80986,1,152917
3508,0.001351,172.217.194.0-255,2902,83888,1,152917
3509,0.001354,172.31.36.0-255,66,83954,1,152917
3510,0.00136,172.217.194.0-255,4320,88274,1,152917
3511,0.001362,172.31.36.0-255,66,88340,1,152917
3512,0.001387,172.217.194.0-255,1484,89824,1,152917
3513,0.001391,172.217.194.0-255,1484,91308,1,152917
3514,0.001393,172.31.36.0-255,66,91374,1,152917
3515,0.001426,172.31.36.0-255,66,91440,1,152917
3516,0.001432,172.217.194.0-255,4320,95760,1,152917
3517,0.001434,172.31.36.0-255,66,95826,1,152917
3518,0.001468,172.217.194.0-255,6438,102264,1,152917
3519,0.001471,172.31.36.0-255,66,102330,1,152917
3520,0.001522,172.31.36.0-255,66,102396,1,152917
3521,0.001549,172.217.194.0-255,2902,105298,1,152917
3522,0.001552,172.31.36.0-255,66,105364,1,152917
3523,0.001563,172.31.36.0-255,66,105430,1,152917
3524,0.001578,172.31.36.0-255,66,105496,1,152917
3525,0.001678,172.217.194.0-255,1484,106980,1,152917
3526,0.001683,172.217.194.0-255,1484,108464,1,152917
3527,0.001686,172.31.36.0-255,66,108530,1,152917
3528,0.001713,172.217.194.0-255,1484,110014,1,152917
3529,0.001721,172.217.194.0-255,5738,115752,1,152917
3530,0.001724,172.31.36.0-255,66,115818,1,152917
3531,0.001737,172.31.36.0-255,66,115884,1,152917
3532,0.001752,172.31.36.0-255,66,115950,1,152917
3533,0.001918,172.217.194.0-255,1484,117434,1,152917
3534,0.001925,172.217.194.0-255,2902,120336,1,152917
3535,0.001928,172.31.36.0-255,66,120402,1,152917
3536,0.001933,172.217.194.0-255,2902,123304,1,152917
3537,0.001935,172.31.36.0-255,66,123370,1,152917
3538,0.001968,172.217.194.0-255,2902,126272,1,152917
3539,0.001971,172.31.36.0-255,66,126338,1,152917
3540,0.001991,172.31.36.0-255,66,126404,1,152917
3541,0.002003,172.31.36.0-255,66,126470,1,152917
3542,0.002058,172.31.36.0-255,66,126536,1,152917
3543,0.002071,172.31.36.0-255,66,126602,1,152917
3544,0.002099,172.217.194.0-255,5738,132340,1,152917
3545,0.002102,172.31.36.0-255,66,132406,1,152917
3546,0.002129,172.217.194.0-255,4320,136726,1,152917
3547,0.002132,172.31.36.0-255,66,136792,1,152917
3548,0.002149,172.31.36.0-255,66,136858,1,152917
3549,0.002162,172.31.36.0-255,66,136924,1,152917
3550,0.002185,172.217.194.0-255,2184,139108,1,152917
3551,0.002188,172.31.36.0-255,66,139174,1,152917
3552,0.002203,172.31.36.0-255,66,139240,1,152917
3553,0.002214,172.31.36.0-255,66,139306,1,152917
3554,0.002305,172.31.36.0-255,66,139372,1,152917
3555,0.00233,172.31.36.0-255,66,139438,1,152917
3556,0.002335,172.217.194.0-255,4040,143478,1,152917
3557,0.002338,172.31.36.0-255,66,143544,1,152917
3558,0.004615,172.217.194.0-255,105,143649,1,152917
3559,0.010091,172.31.36.0-255,66,143715,1,152917
3560,0.010131,172.31.36.0-255,105,143820,1,152917
3561,0.012472,172.217.194.0-255,66,143886,1,152917
3562,0.042536,172.31.36.0-255,172,144058,1,152917
3563,0.042574,172.31.36.0-255,1113,145171,1,152917
3564,0.042646,172.31.36.0-255,1514,146685,1,152917
3565,0.042648,172.31.36.0-255,1514,148199,1,152917
3566,0.042649,172.31.36.0-255,1514,149713,1,152917
3567,0.042655,172.31.36.0-255,1514,151227,1,152917
3568,0.042675,172.31.36.0-255,1492,152719,1,152917
3569,0.044061,104.244.42.0-255,66,152785,1,152917
3570,0.044083,104.244.42.0-255,66,152851,1,152917
3571,0.044201,104.244.42.0-255,66,152917,1,152917
3572,0.0,74.125.24.0-255,289,289,1,157089
3573,3.3e-05,172.31.36.0-255,66,355,1,157089
3574,4e-05,74.125.24.0-255,1484,1839,1,157089
3575,4.3e-05,172.31.36.0-255,66,1905,1,157089
3576,4.9e-05,74.125.24.0-255,4320,6225,1,157089
3577,5.1e-05,172.31.36.0-255,66,6291,1,157089
3578,6.2e-05,172.31.36.0-255,66,6357,1,157089
3579,9.6e-05,172.31.36.0-255,66,6423,1,157089
3580,0.000132,74.125.24.0-255,2543,8966,1,157089
3581,0.000135,172.31.36.0-255,66,9032,1,157089
3582,0.00031,74.125.24.0-255,1484,10516,1,157089
3583,0.000314,172.31.36.0-255,66,10582,1,157089
3584,0.000329,74.125.24.0-255,1484,12066,1,157089
3585,0.000332,172.31.36.0-255,66,12132,1,157089
3586,0.000344,74.125.24.0-255,1484,13616,1,157089
3587,0.000349,74.125.24.0-255,5738,19354,1,157089
3588,0.000349,172.31.36.0-255,66,19420,1,157089
3589,0.000353,172.31.36.0-255,66,19486,1,157089
3590,0.000382,172.31.36.0-255,66,19552,1,157089
3591,0.0004,74.125.24.0-255,3961,23513,1,157089
3592,0.000403,172.31.36.0-255,66,23579,1,157089
3593,0.000429,74.125.24.0-255,1484,25063,1,157089
3594,0.000433,172.31.36.0-255,66,25129,1,157089
3595,0.000451,172.31.36.0-255,66,25195,1,157089
3596,0.000878,74.125.24.0-255,110,25305,1,157089
3597,0.000882,172.31.36.0-255,66,25371,1,157089
3598,0.001058,74.125.24.0-255,1484,26855,1,157089
3599,0.001063,172.31.36.0-255,66,26921,1,157089
3600,0.001068,74.125.24.0-255,2902,29823,1,157089
3601,0.00107,172.31.36.0-255,66,29889,1,157089
3602,0.001094,74.125.24.0-255,5738,35627,1,157089
3603,0.001096,172.31.36.0-255,66,35693,1,157089
3604,0.00113,74.125.24.0-255,1484,37177,1,157089
3605,0.001159,172.31.36.0-255,66,37243,1,157089
3606,0.001188,172.31.36.0-255,66,37309,1,157089
3607,0.001204,74.125.24.0-255,1125,38434,1,157089
3608,0.00376,74.125.24.0-255,4320,42754,1,157089
3609,0.003767,172.31.36.0-255,66,42820,1,157089
3610,0.006316,74.125.24.0-255,5738,48558,1,157089
3611,0.006323,172.31.36.0-255,66,48624,1,157089
3612,0.008878,74.125.24.0-255,5738,54362,1,157089
3613,0.008884,172.31.36.0-255,66,54428,1,157089
3614,0.011432,74.125.24.0-255,5738,60166,1,157089
3615,0.011441,172.31.36.0-255,66,60232,1,157089
3616,0.013997,74.125.24.0-255,5738,65970,1,157089
3617,0.014008,172.31.36.0-255,66,66036,1,157089
3618,0.016555,74.125.24.0-255,5738,71774,1,157089
3619,0.016563,172.31.36.0-255,66,71840,1,157089
3620,0.019119,74.125.24.0-255,5738,77578,1,157089
3621,0.019126,172.31.36.0-255,66,77644,1,157089
3622,0.021696,74.125.24.0-255,5738,83382,1,157089
3623,0.021704,172.31.36.0-255,66,83448,1,157089
3624,0.024258,74.125.24.0-255,5738,89186,1,157089
3625,0.024267,172.31.36.0-255,66,89252,1,157089
3626,0.026822,74.125.24.0-255,5738,94990,1,157089
3627,0.02683,172.31.36.0-255,66,95056,1,157089
3628,0.029383,74.125.24.0-255,5738,100794,1,157089
3629,0.029391,172.31.36.0-255,66,100860,1,157089
3630,0.031878,172.31.36.0-255,172,101032,1,157089
3631,0.031951,74.125.24.0-255,5738,106770,1,157089
3632,0.031957,172.31.36.0-255,66,106836,1,157089
3633,0.031966,172.31.36.0-255,1113,107949,1,157089
3634,0.03215,172.31.36.0-255,1514,109463,1,157089
3635,0.032152,172.31.36.0-255,1514,110977,1,157089
3636,0.032153,172.31.36.0-255,1514,112491,1,157089
3637,0.032154,172.31.36.0-255,1514,114005,1,157089
3638,0.032184,172.31.36.0-255,1490,115495,1,157089
3639,0.033408,104.244.42.0-255,66,115561,1,157089
3640,0.033496,104.244.42.0-255,66,115627,1,157089
3641,0.03371,104.244.42.0-255,66,115693,1,157089
3642,0.033772,104.244.42.0-255,66,115759,1,157089
3643,0.034503,74.125.24.0-255,2902,118661,1,157089
3644,0.034507,172.31.36.0-255,66,118727,1,157089
3645,0.034538,74.125.24.0-255,2902,121629,1,157089
3646,0.034541,172.31.36.0-255,66,121695,1,157089
3647,0.035307,104.244.42.0-255,108,121803,1,157089
3648,0.035326,172.31.36.0-255,66,121869,1,157089
3649,0.037058,74.125.24.0-255,1484,123353,1,157089
3650,0.037084,74.125.24.0-255,1484,124837,1,157089
3651,0.037088,172.31.36.0-255,66,124903,1,157089
3652,0.037107,74.125.24.0-255,2902,127805,1,157089
3653,0.03711,172.31.36.0-255,66,127871,1,157089
3654,0.039623,74.125.24.0-255,2902,130773,1,157089
3655,0.039629,172.31.36.0-255,66,130839,1,157089
3656,0.039648,74.125.24.0-255,2902,133741,1,157089
3657,0.039651,172.31.36.0-255,66,133807,1,157089
3658,0.042192,74.125.24.0-255,5738,139545,1,157089
3659,0.042197,172.31.36.0-255,66,139611,1,157089
3660,0.044732,74.125.24.0-255,1484,141095,1,157089
3661,0.044761,74.125.24.0-255,4320,145415,1,157089
3662,0.044765,172.31.36.0-255,66,145481,1,157089
3663,0.047338,74.125.24.0-255,5738,151219,1,157089
3664,0.047343,172.31.36.0-255,66,151285,1,157089
3665,0.049873,74.125.24.0-255,5738,157023,1,157089
3666,0.049877,172.31.36.0-255,66,157089,1,157089
3667,0.0,74.125.24.0-255,153,153,1,211494
3668,2.7e-05,172.31.36.0-255,66,219,1,211494
3669,3.4e-05,74.125.24.0-255,1484,1703,1,211494
3670,3.8e-05,172.31.36.0-255,66,1769,1,211494
3671,5.1e-05,74.125.24.0-255,2902,4671,1,211494
3672,5.4e-05,172.31.36.0-255,66,4737,1,211494
3673,6.1e-05,74.125.24.0-255,7156,11893,1,211494
3674,6.4e-05,172.31.36.0-255,66,11959,1,211494
3675,7.5e-05,172.31.36.0-255,66,12025,1,211494
3676,0.000106,74.125.24.0-255,7156,19181,1,211494
3677,0.00011,172.31.36.0-255,66,19247,1,211494
3678,0.000137,74.125.24.0-255,3961,23208,1,211494
3679,0.00014,172.31.36.0-255,66,23274,1,211494
3680,0.000168,74.125.24.0-255,1484,24758,1,211494
3681,0.00017,172.31.36.0-255,66,24824,1,211494
3682,0.000176,74.125.24.0-255,2902,27726,1,211494
3683,0.000178,172.31.36.0-255,66,27792,1,211494
3684,0.000184,74.125.24.0-255,5738,33530,1,211494
3685,0.000187,172.31.36.0-255,66,33596,1,211494
3686,0.000191,74.125.24.0-255,2902,36498,1,211494
3687,0.000193,172.31.36.0-255,66,36564,1,211494
3688,0.00022,74.125.24.0-255,3961,40525,1,211494
3689,0.000223,172.31.36.0-255,66,40591,1,211494
3690,0.000235,172.31.36.0-255,66,40657,1,211494
3691,0.000264,74.125.24.0-255,5738,46395,1,211494
3692,0.000267,172.31.36.0-255,66,46461,1,211494
3693,0.000272,74.125.24.0-255,2876,49337,1,211494
3694,0.000274,172.31.36.0-255,66,49403,1,211494
3695,0.000277,74.125.24.0-255,113,49516,1,211494
3696,0.000279,172.31.36.0-255,66,49582,1,211494
3697,0.000383,74.125.24.0-255,328,49910,1,211494
3698,0.000389,172.31.36.0-255,66,49976,1,211494
3699,0.000791,74.125.24.0-255,1484,51460,1,211494
3700,0.000796,172.31.36.0-255,66,51526,1,211494
3701,0.000801,74.125.24.0-255,2902,54428,1,211494
3702,0.000803,172.31.36.0-255,66,54494,1,211494
3703,0.000808,74.125.24.0-255,2902,57396,1,211494
3704,0.000816,172.31.36.0-255,66,57462,1,211494
3705,0.000851,74.125.24.0-255,2902,60364,1,211494
3706,0.000854,172.31.36.0-255,66,60430,1,211494
3707,0.000869,172.31.36.0-255,66,60496,1,211494
3708,0.000876,172.31.36.0-255,66,60562,1,211494
3709,0.000933,74.125.24.0-255,2184,62746,1,211494
3710,0.000936,172.31.36.0-255,66,62812,1,211494
3711,0.001379,74.125.24.0-255,1484,64296,1,211494
3712,0.001385,172.31.36.0-255,66,64362,1,211494
3713,0.001395,74.125.24.0-255,2902,67264,1,211494
3714,0.001397,172.31.36.0-255,66,67330,1,211494
3715,0.001411,74.125.24.0-255,5738,73068,1,211494
3716,0.001414,172.31.36.0-255,66,73134,1,211494
3717,0.001422,74.125.24.0-255,5738,78872,1,211494
3718,0.001424,172.31.36.0-255,66,78938,1,211494
3719,0.00143,74.125.24.0-255,5738,84676,1,211494
3720,0.001432,172.31.36.0-255,66,84742,1,211494
3721,0.001462,74.125.24.0-255,1484,86226,1,211494
3722,0.001465,172.31.36.0-255,66,86292,1,211494
3723,0.001487,74.125.24.0-255,5738,92030,1,211494
3724,0.00149,172.31.36.0-255,66,92096,1,211494
3725,0.00152,74.125.24.0-255,5020,97116,1,211494
3726,0.001524,172.31.36.0-255,66,97182,1,211494
3727,0.003871,74.125.24.0-255,5738,102920,1,211494
3728,0.003877,172.31.36.0-255,66,102986,1,211494
3729,0.006175,74.125.24.0-255,2902,105888,1,211494
3730,0.006178,172.31.36.0-255,66,105954,1,211494
3731,0.006194,74.125.24.0-255,1484,107438,1,211494
3732,0.006196,172.31.36.0-255,66,107504,1,211494
3733,0.00622,74.125.24.0-255,1484,108988,1,211494
3734,0.008492,74.125.24.0-255,2902,111890,1,211494
3735,0.008498,172.31.36.0-255,66,111956,1,211494
3736,0.010806,74.125.24.0-255,5738,117694,1,211494
3737,0.010815,172.31.36.0-255,66,117760,1,211494
3738,0.013158,74.125.24.0-255,5738,123498,1,211494
3739,0.013167,172.31.36.0-255,66,123564,1,211494
3740,0.015477,74.125.24.0-255,5738,129302,1,211494
3741,0.015484,172.31.36.0-255,66,129368,1,211494
3742,0.017843,74.125.24.0-255,5738,135106,1,211494
3743,0.017851,172.31.36.0-255,66,135172,1,211494
3744,0.020193,74.125.24.0-255,5738,140910,1,211494
3745,0.020203,172.31.36.0-255,66,140976,1,211494
3746,0.022522,74.125.24.0-255,5738,146714,1,211494
3747,0.022531,172.31.36.0-255,66,146780,1,211494
3748,0.024847,74.125.24.0-255,5738,152518,1,211494
3749,0.024856,172.31.36.0-255,66,152584,1,211494
3750,0.027199,74.125.24.0-255,5738,158322,1,211494
3751,0.027211,172.31.36.0-255,66,158388,1,211494
3752,0.029522,74.125.24.0-255,5738,164126,1,211494
3753,0.02953,172.31.36.0-255,66,164192,1,211494
3754,0.031864,74.125.24.0-255,5738,169930,1,211494
3755,0.031869,172.31.36.0-255,66,169996,1,211494
3756,0.033616,172.31.36.0-255,172,170168,1,211494
3757,0.033644,172.31.36.0-255,1115,171283,1,211494
3758,0.033683,172.31.36.0-255,563,171846,1,211494
3759,0.034185,74.125.24.0-255,5738,177584,1,211494
3760,0.034193,172.31.36.0-255,66,177650,1,211494
3761,0.035183,104.244.42.0-255,66,177716,1,211494
3762,0.03519,104.244.42.0-255,66,177782,1,211494
3763,0.035322,104.244.42.0-255,66,177848,1,211494
3764,0.036181,104.244.42.0-255,108,177956,1,211494
3765,0.036185,172.31.36.0-255,66,178022,1,211494
3766,0.036506,74.125.24.0-255,5738,183760,1,211494
3767,0.03651,172.31.36.0-255,66,183826,1,211494
3768,0.038811,74.125.24.0-255,5738,189564,1,211494
3769,0.038816,172.31.36.0-255,66,189630,1,211494
3770,0.041092,74.125.24.0-255,5738,195368,1,211494
3771,0.041098,172.31.36.0-255,66,195434,1,211494
3772,0.043389,74.125.24.0-255,5738,201172,1,211494
3773,0.043395,172.31.36.0-255,66,201238,1,211494
3774,0.045689,74.125.24.0-255,4320,205558,1,211494
3775,0.045707,172.31.36.0-255,66,205624,1,211494
3776,0.04573,74.125.24.0-255,1484,207108,1,211494
3777,0.048044,74.125.24.0-255,4320,211428,1,211494
3778,0.04805,172.31.36.0-255,66,211494,1,211494
3779,0.0,74.125.24.0-255,143,143,1,188868
3780,2.6e-05,172.31.36.0-255,66,209,1,188868
3781,3.3e-05,74.125.24.0-255,1484,1693,1,188868
3782,3.7e-05,172.31.36.0-255,66,1759,1,188868
3783,4.2e-05,74.125.24.0-255,2902,4661,1,188868
3784,4.4e-05,172.31.36.0-255,66,4727,1,188868
3785,5e-05,74.125.24.0-255,5738,10465,1,188868
3786,5.2e-05,172.31.36.0-255,66,10531,1,188868
3787,5.5e-05,74.125.24.0-255,1484,12015,1,188868
3788,5.7e-05,172.31.36.0-255,66,12081,1,188868
3789,7.2e-05,74.125.24.0-255,2012,14093,1,188868
3790,7.4e-05,172.31.36.0-255,66,14159,1,188868
3791,7.9e-05,74.125.24.0-255,4320,18479,1,188868
3792,8.1e-05,172.31.36.0-255,66,18545,1,188868
3793,9.2e-05,172.31.36.0-255,66,18611,1,188868
3794,9.7e-05,74.125.24.0-255,2543,21154,1,188868
3795,0.0001,172.31.36.0-255,66,21220,1,188868
3796,0.000261,74.125.24.0-255,1484,22704,1,188868
3797,0.000267,172.31.36.0-255,66,22770,1,188868
3798,0.000272,74.125.24.0-255,2902,25672,1,188868
3799,0.000275,172.31.36.0-255,66,25738,1,188868
3800,0.000277,74.125.24.0-255,1484,27222,1,188868
3801,0.00028,172.31.36.0-255,66,27288,1,188868
3802,0.000299,74.125.24.0-255,4320,31608,1,188868
3803,0.000305,172.31.36.0-255,66,31674,1,188868
3804,0.00033,74.125.24.0-255,5738,37412,1,188868
3805,0.000334,172.31.36.0-255,66,37478,1,188868
3806,0.000349,74.125.24.0-255,1125,38603,1,188868
3807,0.000352,172.31.36.0-255,66,38669,1,188868
3808,0.000484,74.125.24.0-255,1484,40153,1,188868
3809,0.000488,172.31.36.0-255,66,40219,1,188868
3810,0.000506,74.125.24.0-255,2902,43121,1,188868
3811,0.000517,172.31.36.0-255,66,43187,1,188868
3812,0.000524,74.125.24.0-255,2902,46089,1,188868
3813,0.000532,172.31.36.0-255,66,46155,1,188868
3814,0.000539,74.125.24.0-255,2902,49057,1,188868
3815,0.000541,74.125.24.0-255,1484,50541,1,188868
3816,0.000552,172.31.36.0-255,66,50607,1,188868
3817,0.000558,74.125.24.0-255,5725,56332,1,188868
3818,0.000562,74.125.24.0-255,332,56664,1,188868
3819,0.000571,172.31.36.0-255,66,56730,1,188868
3820,0.000726,74.125.24.0-255,1484,58214,1,188868
3821,0.000732,74.125.24.0-255,2902,61116,1,188868
3822,0.000735,172.31.36.0-255,66,61182,1,188868
3823,0.00074,74.125.24.0-255,2902,64084,1,188868
3824,0.000749,172.31.36.0-255,66,64150,1,188868
3825,0.000755,74.125.24.0-255,2902,67052,1,188868
3826,0.000764,172.31.36.0-255,66,67118,1,188868
3827,0.000789,74.125.24.0-255,5738,72856,1,188868
3828,0.000799,172.31.36.0-255,66,72922,1,188868
3829,0.0008,74.125.24.0-255,1125,74047,1,188868
3830,0.000804,74.125.24.0-255,1484,75531,1,188868
3831,0.000813,172.31.36.0-255,66,75597,1,188868
3832,0.000824,74.125.24.0-255,5738,81335,1,188868
3833,0.000826,74.125.24.0-255,1484,82819,1,188868
3834,0.005199,172.31.36.0-255,66,82885,1,188868
3835,0.007505,74.125.24.0-255,5738,88623,1,188868
3836,0.007511,172.31.36.0-255,66,88689,1,188868
3837,0.009582,74.125.24.0-255,5738,94427,1,188868
3838,0.009589,172.31.36.0-255,66,94493,1,188868
3839,0.01162,74.125.24.0-255,5738,100231,1,188868
3840,0.011628,172.31.36.0-255,66,100297,1,188868
3841,0.013746,74.125.24.0-255,5738,106035,1,188868
3842,0.013755,172.31.36.0-255,66,106101,1,188868
3843,0.015797,74.125.24.0-255,5738,111839,1,188868
3844,0.015805,172.31.36.0-255,66,111905,1,188868
3845,0.017912,74.125.24.0-255,2902,114807,1,188868
3846,0.017919,172.31.36.0-255,66,114873,1,188868
3847,0.017956,74.125.24.0-255,2902,117775,1,188868
3848,0.017973,172.31.36.0-255,66,117841,1,188868
3849,0.01997,74.125.24.0-255,2902,120743,1,188868
3850,0.019977,172.31.36.0-255,66,120809,1,188868
3851,0.020011,74.125.24.0-255,2902,123711,1,188868
3852,0.020029,172.31.36.0-255,66,123777,1,188868
3853,0.02232,74.125.24.0-255,2902,126679,1,188868
3854,0.022327,172.31.36.0-255,66,126745,1,188868
3855,0.022361,74.125.24.0-255,2902,129647,1,188868
3856,0.022382,172.31.36.0-255,66,129713,1,188868
3857,0.026179,74.125.24.0-255,2902,132615,1,188868
3858,0.026188,172.31.36.0-255,66,132681,1,188868
3859,0.026226,74.125.24.0-255,2902,135583,1,188868
3860,0.026255,172.31.36.0-255,66,135649,1,188868
3861,0.029106,172.31.36.0-255,172,135821,1,188868
3862,0.029137,172.31.36.0-255,1113,136934,1,188868
3863,0.029192,172.31.36.0-255,1514,138448,1,188868
3864,0.029194,172.31.36.0-255,1514,139962,1,188868
3865,0.029195,172.31.36.0-255,1514,141476,1,188868
3866,0.029196,172.31.36.0-255,1514,142990,1,188868
3867,0.029222,172.31.36.0-255,1490,144480,1,188868
3868,0.030242,74.125.24.0-255,2902,147382,1,188868
3869,0.03025,172.31.36.0-255,66,147448,1,188868
3870,0.030284,74.125.24.0-255,2902,150350,1,188868
3871,0.030305,172.31.36.0-255,66,150416,1,188868
3872,0.030658,104.244.42.0-255,66,150482,1,188868
3873,0.030666,104.244.42.0-255,66,150548,1,188868
3874,0.030762,104.244.42.0-255,66,150614,1,188868
3875,0.03432,74.125.24.0-255,4320,154934,1,188868
3876,0.034326,172.31.36.0-255,66,155000,1,188868
3877,0.034359,74.125.24.0-255,1484,156484,1,188868
3878,0.038115,74.125.24.0-255,2902,159386,1,188868
3879,0.038121,172.31.36.0-255,66,159452,1,188868
3880,0.040968,74.125.24.0-255,5738,165190,1,188868
3881,0.041021,172.31.36.0-255,66,165256,1,188868
3882,0.043473,74.125.24.0-255,5738,170994,1,188868
3883,0.043479,172.31.36.0-255,66,171060,1,188868
3884,0.045518,74.125.24.0-255,2902,173962,1,188868
3885,0.045523,172.31.36.0-255,66,174028,1,188868
3886,0.045551,74.125.24.0-255,2902,176930,1,188868
3887,0.045575,172.31.36.0-255,66,176996,1,188868
3888,0.047575,74.125.24.0-255,2902,179898,1,188868
3889,0.04758,172.31.36.0-255,66,179964,1,188868
3890,0.047611,74.125.24.0-255,2902,182866,1,188868
3891,0.047635,172.31.36.0-255,66,182932,1,188868
3892,0.049736,74.125.24.0-255,2902,185834,1,188868
3893,0.049741,172.31.36.0-255,66,185900,1,188868
3894,0.049795,74.125.24.0-255,2902,188802,1,188868
3895,0.04982,172.31.36.0-255,66,188868,1,188868
3896,0.0,172.217.194.0-255,152,152,1,217194
3897,2.2e-05,172.31.36.0-255,66,218,1,217194
3898,2.9e-05,172.217.194.0-255,1484,1702,1,217194
3899,3.4e-05,172.31.36.0-255,66,1768,1,217194
3900,4e-05,172.217.194.0-255,2902,4670,1,217194
3901,4.3e-05,172.31.36.0-255,66,4736,1,217194
3902,4.9e-05,172.217.194.0-255,4320,9056,1,217194
3903,5.1e-05,172.31.36.0-255,66,9122,1,217194
3904,7.1e-05,172.217.194.0-255,2902,12024,1,217194
3905,7.4e-05,172.31.36.0-255,66,12090,1,217194
3906,8.6e-05,172.31.36.0-255,66,12156,1,217194
3907,0.000104,172.217.194.0-255,3349,15505,1,217194
3908,0.000106,172.31.36.0-255,66,15571,1,217194
3909,0.000109,172.217.194.0-255,1484,17055,1,217194
3910,0.000112,172.31.36.0-255,66,17121,1,217194
3911,0.000127,172.217.194.0-255,5379,22500,1,217194
3912,0.00013,172.31.36.0-255,66,22566,1,217194
3913,0.000209,172.217.194.0-255,1484,24050,1,217194
3914,0.000212,172.31.36.0-255,66,24116,1,217194
3915,0.000217,172.217.194.0-255,2902,27018,1,217194
3916,0.00022,172.31.36.0-255,66,27084,1,217194
3917,0.000237,172.217.194.0-255,5738,32822,1,217194
3918,0.000239,172.31.36.0-255,66,32888,1,217194
3919,0.000243,172.217.194.0-255,1484,34372,1,217194
3920,0.000245,172.31.36.0-255,66,34438,1,217194
3921,0.000286,172.31.36.0-255,66,34504,1,217194
3922,0.000296,172.31.36.0-255,66,34570,1,217194
3923,0.000317,172.217.194.0-255,2184,36754,1,217194
3924,0.000319,172.31.36.0-255,66,36820,1,217194
3925,0.000441,172.217.194.0-255,377,37197,1,217194
3926,0.000509,172.217.194.0-255,1518,38715,1,217194
3927,0.000514,172.31.36.0-255,66,38781,1,217194
3928,0.000539,172.217.194.0-255,1484,40265,1,217194
3929,0.000553,172.217.194.0-255,2902,43167,1,217194
3930,0.000555,172.31.36.0-255,66,43233,1,217194
3931,0.000562,172.217.194.0-255,7156,50389,1,217194
3932,0.000565,172.31.36.0-255,66,50455,1,217194
3933,0.000582,172.31.36.0-255,66,50521,1,217194
3934,0.000588,172.217.194.0-255,5020,55541,1,217194
3935,0.000591,172.31.36.0-255,66,55607,1,217194
3936,0.000637,172.217.194.0-255,5738,61345,1,217194
3937,0.000641,172.31.36.0-255,66,61411,1,217194
3938,0.000667,172.31.36.0-255,66,61477,1,217194
3939,0.000675,172.217.194.0-255,7156,68633,1,217194
3940,0.000677,172.31.36.0-255,66,68699,1,217194
3941,0.000715,172.31.36.0-255,66,68765,1,217194
3942,0.000721,172.217.194.0-255,3961,72726,1,217194
3943,0.000723,172.31.36.0-255,66,72792,1,217194
3944,0.001227,172.217.194.0-255,1484,74276,1,217194
3945,0.001234,172.217.194.0-255,2902,77178,1,217194
3946,0.001237,172.31.36.0-255,66,77244,1,217194
3947,0.001244,172.217.194.0-255,5738,82982,1,217194
3948,0.001247,172.31.36.0-255,66,83048,1,217194
3949,0.00125,172.217.194.0-255,1484,84532,1,217194
3950,0.001261,172.31.36.0-255,66,84598,1,217194
3951,0.001309,172.217.194.0-255,2902,87500,1,217194
3952,0.001312,172.31.36.0-255,66,87566,1,217194
3953,0.001344,172.31.36.0-255,66,87632,1,217194
3954,0.003641,172.217.194.0-255,5738,93370,1,217194
3955,0.003648,172.31.36.0-255,66,93436,1,217194
3956,0.005938,172.217.194.0-255,4320,97756,1,217194
3957,0.005942,172.31.36.0-255,66,97822,1,217194
3958,0.005956,172.217.194.0-255,1484,99306,1,217194
3959,0.008223,172.217.194.0-255,4320,103626,1,217194
3960,0.00823,172.31.36.0-255,66,103692,1,217194
3961,0.010516,172.217.194.0-255,5738,109430,1,217194
3962,0.010524,172.31.36.0-255,66,109496,1,217194
3963,0.012858,172.217.194.0-255,5738,115234,1,217194
3964,0.012865,172.31.36.0-255,66,115300,1,217194
3965,0.01516,172.217.194.0-255,5738,121038,1,217194
3966,0.015171,172.31.36.0-255,66,121104,1,217194
3967,0.01747,172.217.194.0-255,5738,126842,1,217194
3968,0.017478,172.31.36.0-255,66,126908,1,217194
3969,0.019775,172.217.194.0-255,5738,132646,1,217194
3970,0.019783,172.31.36.0-255,66,132712,1,217194
3971,0.022081,172.217.194.0-255,5738,138450,1,217194
3972,0.022088,172.31.36.0-255,66,138516,1,217194
3973,0.024388,172.217.194.0-255,5738,144254,1,217194
3974,0.024396,172.31.36.0-255,66,144320,1,217194
3975,0.02668,172.217.194.0-255,5738,150058,1,217194
3976,0.026687,172.31.36.0-255,66,150124,1,217194
3977,0.028984,172.217.194.0-255,5738,155862,1,217194
3978,0.028991,172.31.36.0-255,66,155928,1,217194
3979,0.031296,172.217.194.0-255,5738,161666,1,217194
3980,0.031304,172.31.36.0-255,66,161732,1,217194
3981,0.033609,172.217.194.0-255,5738,167470,1,217194
3982,0.033617,172.31.36.0-255,66,167536,1,217194
3983,0.033748,172.31.36.0-255,172,167708,1,217194
3984,0.033776,172.31.36.0-255,1114,168822,1,217194
3985,0.033897,172.31.36.0-255,1514,170336,1,217194
3986,0.033899,172.31.36.0-255,1514,171850,1,217194
3987,0.033905,172.31.36.0-255,1514,173364,1,217194
3988,0.03391,172.31.36.0-255,1514,174878,1,217194
3989,0.033912,172.31.36.0-255,1490,176368,1,217194
3990,0.035318,104.244.42.0-255,66,176434,1,217194
3991,0.035359,104.244.42.0-255,66,176500,1,217194
3992,0.035509,104.244.42.0-255,66,176566,1,217194
3993,0.035932,172.217.194.0-255,5738,182304,1,217194
3994,0.035943,172.31.36.0-255,66,182370,1,217194
3995,0.038283,172.217.194.0-255,5738,188108,1,217194
3996,0.038301,172.31.36.0-255,66,188174,1,217194
3997,0.040594,172.217.194.0-255,5738,193912,1,217194
3998,0.040598,172.31.36.0-255,66,193978,1,217194
3999,0.042887,172.217.194.0-255,5738,199716,1,217194
4000,0.042895,172.31.36.0-255,66,199782,1,217194
4001,0.045191,172.217.194.0-255,5738,205520,1,217194
4002,0.045204,172.31.36.0-255,66,205586,1,217194
4003,0.0475,172.217.194.0-255,5738,211324,1,217194
4004,0.047518,172.31.36.0-255,66,211390,1,217194
4005,0.0498,172.217.194.0-255,5738,217128,1,217194
4006,0.049814,172.31.36.0-255,66,217194,1,217194
4007,0.0,74.125.24.0-255,153,153,1,227520
4008,3e-05,172.31.36.0-255,66,219,1,227520
4009,3.7e-05,74.125.24.0-255,1484,1703,1,227520
4010,4.1e-05,172.31.36.0-255,66,1769,1,227520
4011,4.6e-05,74.125.24.0-255,2902,4671,1,227520
4012,4.9e-05,172.31.36.0-255,66,4737,1,227520
4013,5.5e-05,74.125.24.0-255,5738,10475,1,227520
4014,5.7e-05,172.31.36.0-255,66,10541,1,227520
4015,8.2e-05,74.125.24.0-255,3482,14023,1,227520
4016,8.5e-05,172.31.36.0-255,66,14089,1,227520
4017,0.00033,74.125.24.0-255,1484,15573,1,227520
4018,0.000336,172.31.36.0-255,66,15639,1,227520
4019,0.000342,74.125.24.0-255,2902,18541,1,227520
4020,0.000344,172.31.36.0-255,66,18607,1,227520
4021,0.000372,74.125.24.0-255,5738,24345,1,227520
4022,0.000376,172.31.36.0-255,66,24411,1,227520
4023,0.000401,74.125.24.0-255,6797,31208,1,227520
4024,0.000404,172.31.36.0-255,66,31274,1,227520
4025,0.000411,74.125.24.0-255,5738,37012,1,227520
4026,0.000414,172.31.36.0-255,66,37078,1,227520
4027,0.000433,74.125.24.0-255,1484,38562,1,227520
4028,0.000435,172.31.36.0-255,66,38628,1,227520
4029,0.000447,172.31.36.0-255,66,38694,1,227520
4030,0.000472,74.125.24.0-255,7156,45850,1,227520
4031,0.000475,172.31.36.0-255,66,45916,1,227520
4032,0.000503,74.125.24.0-255,5738,51654,1,227520
4033,0.000507,172.31.36.0-255,66,51720,1,227520
4034,0.00053,74.125.24.0-255,5020,56740,1,227520
4035,0.000533,172.31.36.0-255,66,56806,1,227520
4036,0.000537,74.125.24.0-255,707,57513,1,227520
4037,0.000539,172.31.36.0-255,66,57579,1,227520
4038,0.000784,74.125.24.0-255,1484,59063,1,227520
4039,0.00079,74.125.24.0-255,2902,61965,1,227520
4040,0.000793,172.31.36.0-255,66,62031,1,227520
4041,0.000811,74.125.24.0-255,2902,64933,1,227520
4042,0.000814,172.31.36.0-255,66,64999,1,227520
4043,0.000835,74.125.24.0-255,2902,67901,1,227520
4044,0.000838,172.31.36.0-255,66,67967,1,227520
4045,0.000845,74.125.24.0-255,7156,75123,1,227520
4046,0.000847,172.31.36.0-255,66,75189,1,227520
4047,0.000863,74.125.24.0-255,4320,79509,1,227520
4048,0.000865,172.31.36.0-255,66,79575,1,227520
4049,0.000901,172.31.36.0-255,66,79641,1,227520
4050,0.000905,74.125.24.0-255,2184,81825,1,227520
4051,0.000907,172.31.36.0-255,66,81891,1,227520
4052,0.000919,74.125.24.0-255,1484,83375,1,227520
4053,0.000936,74.125.24.0-255,2902,86277,1,227520
4054,0.000939,172.31.36.0-255,66,86343,1,227520
4055,0.00097,74.125.24.0-255,1484,87827,1,227520
4056,0.000988,74.125.24.0-255,4320,92147,1,227520
4057,0.000991,172.31.36.0-255,66,92213,1,227520
4058,0.000995,74.125.24.0-255,2902,95115,1,227520
4059,0.000997,172.31.36.0-255,66,95181,1,227520
4060,0.001001,74.125.24.0-255,4320,99501,1,227520
4061,0.001004,172.31.36.0-255,66,99567,1,227520
4062,0.001014,172.31.36.0-255,66,99633,1,227520
4063,0.001025,172.31.36.0-255,66,99699,1,227520
4064,0.001038,74.125.24.0-255,1484,101183,1,227520
4065,0.001057,74.125.24.0-255,7156,108339,1,227520
4066,0.001061,172.31.36.0-255,66,108405,1,227520
4067,0.001068,74.125.24.0-255,7156,115561,1,227520
4068,0.00107,172.31.36.0-255,66,115627,1,227520
4069,0.001094,74.125.24.0-255,2902,118529,1,227520
4070,0.001098,172.31.36.0-255,66,118595,1,227520
4071,0.001103,74.125.24.0-255,4320,122915,1,227520
4072,0.001105,172.31.36.0-255,66,122981,1,227520
4073,0.001128,172.31.36.0-255,66,123047,1,227520
4074,0.001351,74.125.24.0-255,1484,124531,1,227520
4075,0.001357,74.125.24.0-255,2902,127433,1,227520
4076,0.00136,172.31.36.0-255,66,127499,1,227520
4077,0.001381,74.125.24.0-255,5738,133237,1,227520
4078,0.001386,172.31.36.0-255,66,133303,1,227520
4079,0.001417,172.31.36.0-255,66,133369,1,227520
4080,0.00142,74.125.24.0-255,7156,140525,1,227520
4081,0.001422,172.31.36.0-255,66,140591,1,227520
4082,0.001455,74.125.24.0-255,3602,144193,1,227520
4083,0.001458,172.31.36.0-255,66,144259,1,227520
4084,0.003911,74.125.24.0-255,1484,145743,1,227520
4085,0.003921,74.125.24.0-255,2902,148645,1,227520
4086,0.003925,172.31.36.0-255,66,148711,1,227520
4087,0.003933,74.125.24.0-255,5738,154449,1,227520
4088,0.003936,172.31.36.0-255,66,154515,1,227520
4089,0.003951,74.125.24.0-255,4320,158835,1,227520
4090,0.003953,172.31.36.0-255,66,158901,1,227520
4091,0.003979,74.125.24.0-255,5738,164639,1,227520
4092,0.00398,172.31.36.0-255,66,164705,1,227520
4093,0.00402,172.31.36.0-255,66,164771,1,227520
4094,0.004047,74.125.24.0-255,4320,169091,1,227520
4095,0.004049,172.31.36.0-255,66,169157,1,227520
4096,0.004069,74.125.24.0-255,2902,172059,1,227520
4097,0.004071,172.31.36.0-255,66,172125,1,227520
4098,0.004081,172.31.36.0-255,66,172191,1,227520
4099,0.00412,74.125.24.0-255,7156,179347,1,227520
4100,0.004122,172.31.36.0-255,66,179413,1,227520
4101,0.004151,172.31.36.0-255,66,179479,1,227520
4102,0.004162,172.31.36.0-255,66,179545,1,227520
4103,0.004184,172.31.36.0-255,66,179611,1,227520
4104,0.004187,74.125.24.0-255,1484,181095,1,227520
4105,0.004191,74.125.24.0-255,2902,183997,1,227520
4106,0.004194,172.31.36.0-255,66,184063,1,227520
4107,0.004258,74.125.24.0-255,5738,189801,1,227520
4108,0.004261,172.31.36.0-255,66,189867,1,227520
4109,0.004275,172.31.36.0-255,66,189933,1,227520
4110,0.004287,172.31.36.0-255,66,189999,1,227520
4111,0.00431,74.125.24.0-255,5020,195019,1,227520
4112,0.004313,172.31.36.0-255,66,195085,1,227520
4113,0.004319,74.125.24.0-255,4320,199405,1,227520
4114,0.004321,172.31.36.0-255,66,199471,1,227520
4115,0.004338,74.125.24.0-255,7156,206627,1,227520
4116,0.004341,172.31.36.0-255,66,206693,1,227520
4117,0.004369,74.125.24.0-255,4320,211013,1,227520
4118,0.004372,172.31.36.0-255,66,211079,1,227520
4119,0.004386,172.31.36.0-255,66,211145,1,227520
4120,0.004408,74.125.24.0-255,1484,212629,1,227520
4121,0.004424,74.125.24.0-255,7156,219785,1,227520
4122,0.004427,172.31.36.0-255,66,219851,1,227520
4123,0.004458,172.31.36.0-255,66,219917,1,227520
4124,0.0045,74.125.24.0-255,766,220683,1,227520
4125,0.004509,172.31.36.0-255,66,220749,1,227520
4126,0.00452,74.125.24.0-255,2902,223651,1,227520
4127,0.004545,74.125.24.0-255,1412,225063,1,227520
4128,0.004546,172.31.36.0-255,66,225129,1,227520
4129,0.004731,74.125.24.0-255,105,225234,1,227520
4130,0.006154,172.31.36.0-255,66,225300,1,227520
4131,0.006181,172.31.36.0-255,105,225405,1,227520
4132,0.008422,74.125.24.0-255,66,225471,1,227520
4133,0.032811,172.31.36.0-255,172,225643,1,227520
4134,0.032837,172.31.36.0-255,1114,226757,1,227520
4135,0.03289,172.31.36.0-255,565,227322,1,227520
4136,0.034346,104.244.42.0-255,66,227388,1,227520
4137,0.034418,104.244.42.0-255,66,227454,1,227520
4138,0.03442,104.244.42.0-255,66,227520,1,227520
4139,0.0,172.217.194.0-255,739,739,1,115657
4140,1.2e-05,172.217.194.0-255,1484,2223,1,115657
4141,1.8e-05,172.31.36.0-255,66,2289,1,115657
4142,2.3e-05,172.217.194.0-255,1484,3773,1,115657
4143,4.3e-05,172.217.194.0-255,2902,6675,1,115657
4144,4.6e-05,172.31.36.0-255,66,6741,1,115657
4145,0.000175,172.217.194.0-255,4320,11061,1,115657
4146,0.00018,172.31.36.0-255,66,11127,1,115657
4147,0.000194,172.217.194.0-255,3406,14533,1,115657
4148,0.000196,172.31.36.0-255,66,14599,1,115657
4149,0.000515,172.31.36.0-255,66,14665,1,115657
4150,0.001079,172.217.194.0-255,1125,15790,1,115657
4151,0.002344,172.217.194.0-255,5738,21528,1,115657
4152,0.002351,172.31.36.0-255,66,21594,1,115657
4153,0.002479,172.217.194.0-255,4320,25914,1,115657
4154,0.002481,172.31.36.0-255,66,25980,1,115657
4155,0.002965,172.217.194.0-255,4320,30300,1,115657
4156,0.003587,172.217.194.0-255,2902,33202,1,115657
4157,0.004698,172.217.194.0-255,2902,36104,1,115657
4158,0.005064,172.31.36.0-255,66,36170,1,115657
4159,0.007429,172.217.194.0-255,5738,41908,1,115657
4160,0.007436,172.31.36.0-255,66,41974,1,115657
4161,0.007469,172.31.36.0-255,66,42040,1,115657
4162,0.007507,172.217.194.0-255,5738,47778,1,115657
4163,0.007509,172.31.36.0-255,66,47844,1,115657
4164,0.007575,172.31.36.0-255,66,47910,1,115657
4165,0.007776,172.217.194.0-255,5738,53648,1,115657
4166,0.007781,172.31.36.0-255,66,53714,1,115657
4167,0.007813,172.31.36.0-255,66,53780,1,115657
4168,0.008029,172.217.194.0-255,5738,59518,1,115657
4169,0.008032,172.31.36.0-255,66,59584,1,115657
4170,0.008066,172.31.36.0-255,66,59650,1,115657
4171,0.008292,172.217.194.0-255,2902,62552,1,115657
4172,0.008297,172.31.36.0-255,66,62618,1,115657
4173,0.008316,172.217.194.0-255,5738,68356,1,115657
4174,0.008318,172.31.36.0-255,66,68422,1,115657
4175,0.008344,172.217.194.0-255,5502,73924,1,115657
4176,0.008362,172.31.36.0-255,66,73990,1,115657
4177,0.009804,172.217.194.0-255,4556,78546,1,115657
4178,0.009814,172.31.36.0-255,66,78612,1,115657
4179,0.00983,172.31.36.0-255,66,78678,1,115657
4180,0.009865,172.31.36.0-255,66,78744,1,115657
4181,0.010065,172.217.194.0-255,4320,83064,1,115657
4182,0.010069,172.31.36.0-255,66,83130,1,115657
4183,0.010095,172.31.36.0-255,66,83196,1,115657
4184,0.010333,172.31.36.0-255,66,83262,1,115657
4185,0.010375,172.31.36.0-255,66,83328,1,115657
4186,0.010393,172.217.194.0-255,4320,87648,1,115657
4187,0.010396,172.31.36.0-255,66,87714,1,115657
4188,0.010792,172.217.194.0-255,7156,94870,1,115657
4189,0.010798,172.31.36.0-255,66,94936,1,115657
4190,0.010843,172.31.36.0-255,66,95002,1,115657
4191,0.011265,172.31.36.0-255,66,95068,1,115657
4192,0.011273,172.217.194.0-255,7156,102224,1,115657
4193,0.011276,172.31.36.0-255,66,102290,1,115657
4194,0.011363,172.31.36.0-255,66,102356,1,115657
4195,0.011703,172.31.36.0-255,66,102422,1,115657
4196,0.011744,172.31.36.0-255,66,102488,1,115657
4197,0.012154,172.217.194.0-255,7156,109644,1,115657
4198,0.012158,172.31.36.0-255,66,109710,1,115657
4199,0.012175,172.217.194.0-255,1258,110968,1,115657
4200,0.012255,172.217.194.0-255,4320,115288,1,115657
4201,0.012258,172.31.36.0-255,66,115354,1,115657
4202,0.012295,172.31.36.0-255,66,115420,1,115657
4203,0.012335,172.31.36.0-255,66,115486,1,115657
4204,0.013124,172.31.36.0-255,105,115591,1,115657
4205,0.019689,172.217.194.0-255,66,115657,1,115657
4206,0.0,74.125.24.0-255,153,153,1,257085
4207,2.4e-05,172.31.36.0-255,66,219,1,257085
4208,3.1e-05,74.125.24.0-255,1484,1703,1,257085
4209,3.6e-05,172.31.36.0-255,66,1769,1,257085
4210,4.1e-05,74.125.24.0-255,2902,4671,1,257085
4211,4.5e-05,172.31.36.0-255,66,4737,1,257085
4212,5e-05,74.125.24.0-255,2902,7639,1,257085
4213,5.2e-05,172.31.36.0-255,66,7705,1,257085
4214,8e-05,74.125.24.0-255,6203,13908,1,257085
4215,8.3e-05,172.31.36.0-255,66,13974,1,257085
4216,0.000447,74.125.24.0-255,1484,15458,1,257085
4217,0.000453,172.31.36.0-255,66,15524,1,257085
4218,0.00046,74.125.24.0-255,2902,18426,1,257085
4219,0.000463,172.31.36.0-255,66,18492,1,257085
4220,0.000467,74.125.24.0-255,2902,21394,1,257085
4221,0.00047,172.31.36.0-255,66,21460,1,257085
4222,0.000486,74.125.24.0-255,2902,24362,1,257085
4223,0.000489,172.31.36.0-255,66,24428,1,257085
4224,0.000493,74.125.24.0-255,2902,27330,1,257085
4225,0.000495,172.31.36.0-255,66,27396,1,257085
4226,0.000521,172.31.36.0-255,66,27462,1,257085
4227,0.000543,74.125.24.0-255,2543,30005,1,257085
4228,0.000545,172.31.36.0-255,66,30071,1,257085
4229,0.000552,74.125.24.0-255,7156,37227,1,257085
4230,0.000554,172.31.36.0-255,66,37293,1,257085
4231,0.000596,74.125.24.0-255,2543,39836,1,257085
4232,0.000599,172.31.36.0-255,66,39902,1,257085
4233,0.000793,74.125.24.0-255,1484,41386,1,257085
4234,0.000797,172.31.36.0-255,66,41452,1,257085
4235,0.000802,74.125.24.0-255,2902,44354,1,257085
4236,0.000805,172.31.36.0-255,66,44420,1,257085
4237,0.000811,74.125.24.0-255,5738,50158,1,257085
4238,0.000813,172.31.36.0-255,66,50224,1,257085
4239,0.000831,74.125.24.0-255,5738,55962,1,257085
4240,0.000833,172.31.36.0-255,66,56028,1,257085
4241,0.000853,74.125.24.0-255,1448,57476,1,257085
4242,0.000928,74.125.24.0-255,1484,58960,1,257085
4243,0.000931,172.31.36.0-255,66,59026,1,257085
4244,0.000936,74.125.24.0-255,2902,61928,1,257085
4245,0.000938,172.31.36.0-255,66,61994,1,257085
4246,0.000944,74.125.24.0-255,4320,66314,1,257085
4247,0.000946,172.31.36.0-255,66,66380,1,257085
4248,0.000961,74.125.24.0-255,1484,67864,1,257085
4249,0.000964,74.125.24.0-255,1484,69348,1,257085
4250,0.000968,172.31.36.0-255,66,69414,1,257085
4251,0.000988,74.125.24.0-255,7156,76570,1,257085
4252,0.000991,172.31.36.0-255,66,76636,1,257085
4253,0.001017,74.125.24.0-255,4320,80956,1,257085
4254,0.00102,172.31.36.0-255,66,81022,1,257085
4255,0.001028,74.125.24.0-255,7156,88178,1,257085
4256,0.00103,172.31.36.0-255,66,88244,1,257085
4257,0.001088,172.31.36.0-255,66,88310,1,257085
4258,0.001108,74.125.24.0-255,4347,92657,1,257085
4259,0.001111,172.31.36.0-255,66,92723,1,257085
4260,0.001552,74.125.24.0-255,1484,94207,1,257085
4261,0.001567,74.125.24.0-255,2902,97109,1,257085
4262,0.001571,172.31.36.0-255,66,97175,1,257085
4263,0.001593,74.125.24.0-255,5738,102913,1,257085
4264,0.001596,172.31.36.0-255,66,102979,1,257085
4265,0.00163,172.31.36.0-255,66,103045,1,257085
4266,0.001635,74.125.24.0-255,2902,105947,1,257085
4267,0.001637,172.31.36.0-255,66,106013,1,257085
4268,0.001662,172.31.36.0-255,66,106079,1,257085
4269,0.002136,74.125.24.0-255,1484,107563,1,257085
4270,0.002145,74.125.24.0-255,2902,110465,1,257085
4271,0.002149,172.31.36.0-255,66,110531,1,257085
4272,0.002155,74.125.24.0-255,2902,113433,1,257085
4273,0.002157,172.31.36.0-255,66,113499,1,257085
4274,0.002173,74.125.24.0-255,2902,116401,1,257085
4275,0.002175,172.31.36.0-255,66,116467,1,257085
4276,0.002181,74.125.24.0-255,4320,120787,1,257085
4277,0.002182,172.31.36.0-255,66,120853,1,257085
4278,0.002204,172.31.36.0-255,66,120919,1,257085
4279,0.00221,74.125.24.0-255,4320,125239,1,257085
4280,0.002212,172.31.36.0-255,66,125305,1,257085
4281,0.002235,74.125.24.0-255,6438,131743,1,257085
4282,0.002238,172.31.36.0-255,66,131809,1,257085
4283,0.004525,74.125.24.0-255,5738,137547,1,257085
4284,0.004532,172.31.36.0-255,66,137613,1,257085
4285,0.006812,74.125.24.0-255,5738,143351,1,257085
4286,0.006819,172.31.36.0-255,66,143417,1,257085
4287,0.009099,74.125.24.0-255,5738,149155,1,257085
4288,0.009107,172.31.36.0-255,66,149221,1,257085
4289,0.011423,74.125.24.0-255,5738,154959,1,257085
4290,0.011432,172.31.36.0-255,66,155025,1,257085
4291,0.013708,74.125.24.0-255,5738,160763,1,257085
4292,0.013715,172.31.36.0-255,66,160829,1,257085
4293,0.016026,74.125.24.0-255,5738,166567,1,257085
4294,0.016034,172.31.36.0-255,66,166633,1,257085
4295,0.018385,74.125.24.0-255,5738,172371,1,257085
4296,0.018392,172.31.36.0-255,66,172437,1,257085
4297,0.020715,74.125.24.0-255,5738,178175,1,257085
4298,0.020725,172.31.36.0-255,66,178241,1,257085
4299,0.023023,74.125.24.0-255,5738,183979,1,257085
4300,0.023033,172.31.36.0-255,66,184045,1,257085
4301,0.025337,74.125.24.0-255,5738,189783,1,257085
4302,0.025345,172.31.36.0-255,66,189849,1,257085
4303,0.027603,74.125.24.0-255,5738,195587,1,257085
4304,0.027611,172.31.36.0-255,66,195653,1,257085
4305,0.029909,74.125.24.0-255,5738,201391,1,257085
4306,0.029919,172.31.36.0-255,66,201457,1,257085
4307,0.03218,74.125.24.0-255,5738,207195,1,257085
4308,0.032188,172.31.36.0-255,66,207261,1,257085
4309,0.033017,172.31.36.0-255,172,207433,1,257085
4310,0.033048,172.31.36.0-255,1114,208547,1,257085
4311,0.033118,172.31.36.0-255,1514,210061,1,257085
4312,0.03312,172.31.36.0-255,1514,211575,1,257085
4313,0.033121,172.31.36.0-255,1514,213089,1,257085
4314,0.033126,172.31.36.0-255,1514,214603,1,257085
4315,0.033127,172.31.36.0-255,1489,216092,1,257085
4316,0.034454,74.125.24.0-255,5738,221830,1,257085
4317,0.034461,172.31.36.0-255,66,221896,1,257085
4318,0.034572,104.244.42.0-255,66,221962,1,257085
4319,0.034579,104.244.42.0-255,66,222028,1,257085
4320,0.034678,104.244.42.0-255,66,222094,1,257085
4321,0.036731,74.125.24.0-255,5738,227832,1,257085
4322,0.036738,172.31.36.0-255,66,227898,1,257085
4323,0.039014,74.125.24.0-255,5738,233636,1,257085
4324,0.039021,172.31.36.0-255,66,233702,1,257085
4325,0.041347,74.125.24.0-255,5738,239440,1,257085
4326,0.041354,172.31.36.0-255,66,239506,1,257085
4327,0.043678,74.125.24.0-255,5738,245244,1,257085
4328,0.043684,172.31.36.0-255,66,245310,1,257085
4329,0.043798,172.31.36.0-255,101,245411,1,257085
4330,0.04597,74.125.24.0-255,5738,251149,1,257085
4331,0.045977,172.31.36.0-255,66,251215,1,257085
4332,0.046019,74.125.24.0-255,66,251281,1,257085
4333,0.048245,74.125.24.0-255,5738,257019,1,257085
4334,0.048251,172.31.36.0-255,66,257085,1,257085
4335,0.0,74.125.24.0-255,153,153,1,255058
4336,3.1e-05,172.31.36.0-255,66,219,1,255058
4337,3.8e-05,74.125.24.0-255,1484,1703,1,255058
4338,4.2e-05,172.31.36.0-255,66,1769,1,255058
4339,4.6e-05,74.125.24.0-255,2902,4671,1,255058
4340,4.8e-05,172.31.36.0-255,66,4737,1,255058
4341,6.4e-05,74.125.24.0-255,2902,7639,1,255058
4342,6.6e-05,172.31.36.0-255,66,7705,1,255058
4343,8.4e-05,74.125.24.0-255,4320,12025,1,255058
4344,8.7e-05,172.31.36.0-255,66,12091,1,255058
4345,0.000113,74.125.24.0-255,2057,14148,1,255058
4346,0.000116,172.31.36.0-255,66,14214,1,255058
4347,0.000201,74.125.24.0-255,1484,15698,1,255058
4348,0.000205,172.31.36.0-255,66,15764,1,255058
4349,0.000209,74.125.24.0-255,1484,17248,1,255058
4350,0.000211,172.31.36.0-255,66,17314,1,255058
4351,0.000224,74.125.24.0-255,1484,18798,1,255058
4352,0.000227,172.31.36.0-255,66,18864,1,255058
4353,0.000234,74.125.24.0-255,5738,24602,1,255058
4354,0.000237,172.31.36.0-255,66,24668,1,255058
4355,0.00026,74.125.24.0-255,5738,30406,1,255058
4356,0.000263,172.31.36.0-255,66,30472,1,255058
4357,0.000284,74.125.24.0-255,1125,31597,1,255058
4358,0.000287,172.31.36.0-255,66,31663,1,255058
4359,0.000294,74.125.24.0-255,7156,38819,1,255058
4360,0.000296,74.125.24.0-255,1484,40303,1,255058
4361,0.000299,172.31.36.0-255,66,40369,1,255058
4362,0.000303,172.31.36.0-255,66,40435,1,255058
4363,0.000328,172.31.36.0-255,66,40501,1,255058
4364,0.000338,172.31.36.0-255,66,40567,1,255058
4365,0.000369,74.125.24.0-255,2540,43107,1,255058
4366,0.000372,172.31.36.0-255,66,43173,1,255058
4367,0.000411,74.125.24.0-255,352,43525,1,255058
4368,0.000598,74.125.24.0-255,1484,45009,1,255058
4369,0.000601,74.125.24.0-255,1484,46493,1,255058
4370,0.000603,172.31.36.0-255,66,46559,1,255058
4371,0.00062,74.125.24.0-255,1484,48043,1,255058
4372,0.000622,172.31.36.0-255,66,48109,1,255058
4373,0.000629,74.125.24.0-255,5738,53847,1,255058
4374,0.000631,172.31.36.0-255,66,53913,1,255058
4375,0.000639,74.125.24.0-255,7156,61069,1,255058
4376,0.000641,172.31.36.0-255,66,61135,1,255058
4377,0.000674,74.125.24.0-255,2184,63319,1,255058
4378,0.000674,172.31.36.0-255,66,63385,1,255058
4379,0.000677,172.31.36.0-255,66,63451,1,255058
4380,0.001296,74.125.24.0-255,1484,64935,1,255058
4381,0.001315,74.125.24.0-255,2902,67837,1,255058
4382,0.00132,172.31.36.0-255,66,67903,1,255058
4383,0.001326,74.125.24.0-255,2902,70805,1,255058
4384,0.001328,172.31.36.0-255,66,70871,1,255058
4385,0.001362,74.125.24.0-255,7156,78027,1,255058
4386,0.001365,172.31.36.0-255,66,78093,1,255058
4387,0.00137,74.125.24.0-255,2902,80995,1,255058
4388,0.001372,172.31.36.0-255,66,81061,1,255058
4389,0.001397,172.31.36.0-255,66,81127,1,255058
4390,0.001402,74.125.24.0-255,3602,84729,1,255058
4391,0.001404,172.31.36.0-255,66,84795,1,255058
4392,0.001552,74.125.24.0-255,1484,86279,1,255058
4393,0.00156,74.125.24.0-255,2902,89181,1,255058
4394,0.001564,172.31.36.0-255,66,89247,1,255058
4395,0.001571,74.125.24.0-255,5738,94985,1,255058
4396,0.001573,172.31.36.0-255,66,95051,1,255058
4397,0.001614,172.31.36.0-255,66,95117,1,255058
4398,0.001631,74.125.24.0-255,1484,96601,1,255058
4399,0.001664,172.31.36.0-255,66,96667,1,255058
4400,0.001723,74.125.24.0-255,1484,98151,1,255058
4401,0.001728,74.125.24.0-255,2902,101053,1,255058
4402,0.001731,172.31.36.0-255,66,101119,1,255058
4403,0.001736,74.125.24.0-255,5738,106857,1,255058
4404,0.001738,172.31.36.0-255,66,106923,1,255058
4405,0.00175,172.31.36.0-255,66,106989,1,255058
4406,0.001757,74.125.24.0-255,7156,114145,1,255058
4407,0.00176,172.31.36.0-255,66,114211,1,255058
4408,0.001777,74.125.24.0-255,3602,117813,1,255058
4409,0.001779,172.31.36.0-255,66,117879,1,255058
4410,0.003814,74.125.24.0-255,1484,119363,1,255058
4411,0.003842,74.125.24.0-255,1484,120847,1,255058
4412,0.003845,172.31.36.0-255,66,120913,1,255058
4413,0.003862,74.125.24.0-255,2902,123815,1,255058
4414,0.003864,172.31.36.0-255,66,123881,1,255058
4415,0.005913,74.125.24.0-255,2902,126783,1,255058
4416,0.005917,172.31.36.0-255,66,126849,1,255058
4417,0.005931,74.125.24.0-255,2902,129751,1,255058
4418,0.005933,172.31.36.0-255,66,129817,1,255058
4419,0.008006,74.125.24.0-255,2902,132719,1,255058
4420,0.008013,172.31.36.0-255,66,132785,1,255058
4421,0.008022,74.125.24.0-255,2902,135687,1,255058
4422,0.008024,172.31.36.0-255,66,135753,1,255058
4423,0.010277,74.125.24.0-255,5738,141491,1,255058
4424,0.010342,172.31.36.0-255,66,141557,1,255058
4425,0.01243,74.125.24.0-255,5738,147295,1,255058
4426,0.012437,172.31.36.0-255,66,147361,1,255058
4427,0.014484,74.125.24.0-255,5738,153099,1,255058
4428,0.014491,172.31.36.0-255,66,153165,1,255058
4429,0.016605,74.125.24.0-255,5738,158903,1,255058
4430,0.016613,172.31.36.0-255,66,158969,1,255058
4431,0.0187,74.125.24.0-255,5738,164707,1,255058
4432,0.018708,172.31.36.0-255,66,164773,1,255058
4433,0.020799,74.125.24.0-255,5738,170511,1,255058
4434,0.020806,172.31.36.0-255,66,170577,1,255058
4435,0.022915,74.125.24.0-255,5738,176315,1,255058
4436,0.022924,172.31.36.0-255,66,176381,1,255058
4437,0.025025,74.125.24.0-255,5738,182119,1,255058
4438,0.025032,172.31.36.0-255,66,182185,1,255058
4439,0.027146,74.125.24.0-255,5738,187923,1,255058
4440,0.027153,172.31.36.0-255,66,187989,1,255058
4441,0.029227,74.125.24.0-255,5738,193727,1,255058
4442,0.029235,172.31.36.0-255,66,193793,1,255058
4443,0.031336,74.125.24.0-255,5738,199531,1,255058
4444,0.031343,172.31.36.0-255,66,199597,1,255058
4445,0.033458,74.125.24.0-255,5738,205335,1,255058
4446,0.033466,172.31.36.0-255,66,205401,1,255058
4447,0.035531,74.125.24.0-255,5738,211139,1,255058
4448,0.035538,172.31.36.0-255,66,211205,1,255058
4449,0.037453,172.31.36.0-255,172,211377,1,255058
4450,0.037498,172.31.36.0-255,1115,212492,1,255058
4451,0.037528,172.31.36.0-255,1514,214006,1,255058
4452,0.03753,172.31.36.0-255,1514,215520,1,255058
4453,0.037531,172.31.36.0-255,1514,217034,1,255058
4454,0.037536,172.31.36.0-255,1514,218548,1,255058
4455,0.037537,172.31.36.0-255,1488,220036,1,255058
4456,0.037635,74.125.24.0-255,5738,225774,1,255058
4457,0.037642,172.31.36.0-255,66,225840,1,255058
4458,0.039006,104.244.42.0-255,66,225906,1,255058
4459,0.039141,104.244.42.0-255,66,225972,1,255058
4460,0.039146,104.244.42.0-255,66,226038,1,255058
4461,0.039725,74.125.24.0-255,5738,231776,1,255058
4462,0.039731,172.31.36.0-255,66,231842,1,255058
4463,0.041787,74.125.24.0-255,5738,237580,1,255058
4464,0.041795,172.31.36.0-255,66,237646,1,255058
4465,0.043868,74.125.24.0-255,5738,243384,1,255058
4466,0.043873,172.31.36.0-255,66,243450,1,255058
4467,0.045951,74.125.24.0-255,5738,249188,1,255058
4468,0.045956,172.31.36.0-255,66,249254,1,255058
4469,0.048064,74.125.24.0-255,5738,254992,1,255058
4470,0.048069,172.31.36.0-255,66,255058,1,255058
4471,0.0,172.217.194.0-255,146,146,1,216337
4472,1.3e-05,172.31.36.0-255,66,212,1,216337
4473,1.7e-05,172.217.194.0-255,1484,1696,1,216337
4474,2.2e-05,172.31.36.0-255,66,1762,1,216337
4475,3.5e-05,172.217.194.0-255,2902,4664,1,216337
4476,3.8e-05,172.31.36.0-255,66,4730,1,216337
4477,4.4e-05,172.217.194.0-255,4320,9050,1,216337
4478,4.6e-05,172.31.36.0-255,66,9116,1,216337
4479,8.8e-05,172.31.36.0-255,66,9182,1,216337
4480,9.1e-05,172.217.194.0-255,1484,10666,1,216337
4481,9.3e-05,172.31.36.0-255,66,10732,1,216337
4482,0.000123,172.31.36.0-255,66,10798,1,216337
4483,0.000164,172.217.194.0-255,1484,12282,1,216337
4484,0.000167,172.31.36.0-255,66,12348,1,216337
4485,0.000193,172.217.194.0-255,2902,15250,1,216337
4486,0.000195,172.31.36.0-255,66,15316,1,216337
4487,0.000202,172.217.194.0-255,5738,21054,1,216337
4488,0.000205,172.31.36.0-255,66,21120,1,216337
4489,0.000212,172.217.194.0-255,6797,27917,1,216337
4490,0.000214,172.31.36.0-255,66,27983,1,216337
4491,0.00024,172.217.194.0-255,7156,35139,1,216337
4492,0.000243,172.31.36.0-255,66,35205,1,216337
4493,0.000271,172.217.194.0-255,7156,42361,1,216337
4494,0.000274,172.31.36.0-255,66,42427,1,216337
4495,0.000279,172.217.194.0-255,2543,44970,1,216337
4496,0.000282,172.31.36.0-255,66,45036,1,216337
4497,0.000284,172.217.194.0-255,343,45379,1,216337
4498,0.000286,172.31.36.0-255,66,45445,1,216337
4499,0.000369,172.217.194.0-255,118,45563,1,216337
4500,0.000373,172.31.36.0-255,66,45629,1,216337
4501,0.000392,172.217.194.0-255,379,46008,1,216337
4502,0.000394,172.31.36.0-255,66,46074,1,216337
4503,0.000638,172.217.194.0-255,1484,47558,1,216337
4504,0.000645,172.31.36.0-255,66,47624,1,216337
4505,0.00065,172.217.194.0-255,2902,50526,1,216337
4506,0.000653,172.31.36.0-255,66,50592,1,216337
4507,0.000659,172.217.194.0-255,5738,56330,1,216337
4508,0.000666,172.31.36.0-255,66,56396,1,216337
4509,0.00067,172.217.194.0-255,1484,57880,1,216337
4510,0.000715,172.31.36.0-255,66,57946,1,216337
4511,0.000792,172.31.36.0-255,66,58012,1,216337
4512,0.001437,172.217.194.0-255,1484,59496,1,216337
4513,0.001441,172.217.194.0-255,1484,60980,1,216337
4514,0.001445,172.31.36.0-255,66,61046,1,216337
4515,0.001459,172.217.194.0-255,1484,62530,1,216337
4516,0.00147,172.217.194.0-255,5738,68268,1,216337
4517,0.001476,172.217.194.0-255,5738,74006,1,216337
4518,0.001481,172.31.36.0-255,66,74072,1,216337
4519,0.001505,172.217.194.0-255,1484,75556,1,216337
4520,0.001517,172.217.194.0-255,1484,77040,1,216337
4521,0.001528,172.31.36.0-255,66,77106,1,216337
4522,0.001551,172.217.194.0-255,2184,79290,1,216337
4523,0.001563,172.31.36.0-255,66,79356,1,216337
4524,0.002038,172.217.194.0-255,1484,80840,1,216337
4525,0.002043,172.31.36.0-255,66,80906,1,216337
4526,0.002074,172.217.194.0-255,2902,83808,1,216337
4527,0.002077,172.31.36.0-255,66,83874,1,216337
4528,0.002084,172.217.194.0-255,5738,89612,1,216337
4529,0.002086,172.31.36.0-255,66,89678,1,216337
4530,0.002103,172.217.194.0-255,1484,91162,1,216337
4531,0.00646,172.31.36.0-255,66,91228,1,216337
4532,0.008558,172.217.194.0-255,5738,96966,1,216337
4533,0.008566,172.31.36.0-255,66,97032,1,216337
4534,0.010672,172.217.194.0-255,5738,102770,1,216337
4535,0.01068,172.31.36.0-255,66,102836,1,216337
4536,0.012796,172.217.194.0-255,5738,108574,1,216337
4537,0.012805,172.31.36.0-255,66,108640,1,216337
4538,0.014903,172.217.194.0-255,5738,114378,1,216337
4539,0.014917,172.31.36.0-255,66,114444,1,216337
4540,0.017,172.217.194.0-255,5738,120182,1,216337
4541,0.017008,172.31.36.0-255,66,120248,1,216337
4542,0.019098,172.217.194.0-255,5738,125986,1,216337
4543,0.019107,172.31.36.0-255,66,126052,1,216337
4544,0.02119,172.217.194.0-255,5738,131790,1,216337
4545,0.021197,172.31.36.0-255,66,131856,1,216337
4546,0.023263,172.217.194.0-255,5738,137594,1,216337
4547,0.02327,172.31.36.0-255,66,137660,1,216337
4548,0.025338,172.217.194.0-255,5738,143398,1,216337
4549,0.025347,172.31.36.0-255,66,143464,1,216337
4550,0.027414,172.217.194.0-255,5738,149202,1,216337
4551,0.027422,172.31.36.0-255,66,149268,1,216337
4552,0.029537,172.217.194.0-255,5738,155006,1,216337
4553,0.029544,172.31.36.0-255,66,155072,1,216337
4554,0.031633,172.217.194.0-255,5738,160810,1,216337
4555,0.031639,172.31.36.0-255,66,160876,1,216337
4556,0.033738,172.217.194.0-255,5738,166614,1,216337
4557,0.033745,172.31.36.0-255,66,166680,1,216337
4558,0.035817,172.217.194.0-255,5738,172418,1,216337
4559,0.035825,172.31.36.0-255,66,172484,1,216337
4560,0.037211,172.31.36.0-255,172,172656,1,216337
4561,0.037243,172.31.36.0-255,1113,173769,1,216337
4562,0.037323,172.31.36.0-255,1514,175283,1,216337
4563,0.037325,172.31.36.0-255,1514,176797,1,216337
4564,0.037331,172.31.36.0-255,1514,178311,1,216337
4565,0.037332,172.31.36.0-255,1514,179825,1,216337
4566,0.037354,172.31.36.0-255,1490,181315,1,216337
4567,0.037901,172.217.194.0-255,5738,187053,1,216337
4568,0.037908,172.31.36.0-255,66,187119,1,216337
4569,0.038758,104.244.42.0-255,66,187185,1,216337
4570,0.038765,104.244.42.0-255,66,187251,1,216337
4571,0.038913,104.244.42.0-255,66,187317,1,216337
4572,0.039996,172.217.194.0-255,5738,193055,1,216337
4573,0.040005,172.31.36.0-255,66,193121,1,216337
4574,0.042106,172.217.194.0-255,5738,198859,1,216337
4575,0.042114,172.31.36.0-255,66,198925,1,216337
4576,0.044225,172.217.194.0-255,5738,204663,1,216337
4577,0.044231,172.31.36.0-255,66,204729,1,216337
4578,0.046358,172.217.194.0-255,5738,210467,1,216337
4579,0.046365,172.31.36.0-255,66,210533,1,216337
4580,0.048477,172.217.194.0-255,5738,216271,1,216337
4581,0.048484,172.31.36.0-255,66,216337,1,216337
4582,0.0,74.125.24.0-255,146,146,1,186249
4583,3.4e-05,172.31.36.0-255,66,212,1,186249
4584,4.1e-05,74.125.24.0-255,1484,1696,1,186249
4585,4.5e-05,172.31.36.0-255,66,1762,1,186249
4586,5e-05,74.125.24.0-255,2902,4664,1,186249
4587,5.9e-05,172.31.36.0-255,66,4730,1,186249
4588,6.6e-05,74.125.24.0-255,5738,10468,1,186249
4589,7e-05,172.31.36.0-255,66,10534,1,186249
4590,9.4e-05,74.125.24.0-255,3484,14018,1,186249
4591,9.8e-05,172.31.36.0-255,66,14084,1,186249
4592,0.000637,74.125.24.0-255,1484,15568,1,186249
4593,0.000643,172.31.36.0-255,66,15634,1,186249
4594,0.000653,74.125.24.0-255,2902,18536,1,186249
4595,0.000663,172.31.36.0-255,66,18602,1,186249
4596,0.000669,74.125.24.0-255,4320,22922,1,186249
4597,0.000671,172.31.36.0-255,66,22988,1,186249
4598,0.000695,74.125.24.0-255,1484,24472,1,186249
4599,0.000697,172.31.36.0-255,66,24538,1,186249
4600,0.000703,74.125.24.0-255,4320,28858,1,186249
4601,0.000705,172.31.36.0-255,66,28924,1,186249
4602,0.000738,74.125.24.0-255,2543,31467,1,186249
4603,0.000742,172.31.36.0-255,66,31533,1,186249
4604,0.001527,74.125.24.0-255,1484,33017,1,186249
4605,0.001534,172.31.36.0-255,66,33083,1,186249
4606,0.00154,74.125.24.0-255,2902,35985,1,186249
4607,0.001544,172.31.36.0-255,66,36051,1,186249
4608,0.001581,74.125.24.0-255,5738,41789,1,186249
4609,0.001584,172.31.36.0-255,66,41855,1,186249
4610,0.001587,74.125.24.0-255,1484,43339,1,186249
4611,0.001589,172.31.36.0-255,66,43405,1,186249
4612,0.001629,172.31.36.0-255,66,43471,1,186249
4613,0.001632,74.125.24.0-255,1484,44955,1,186249
4614,0.002273,74.125.24.0-255,645,45600,1,186249
4615,0.002378,74.125.24.0-255,1484,47084,1,186249
4616,0.002381,74.125.24.0-255,1484,48568,1,186249
4617,0.002392,74.125.24.0-255,1484,50052,1,186249
4618,0.002409,74.125.24.0-255,5738,55790,1,186249
4619,0.002412,74.125.24.0-255,1484,57274,1,186249
4620,0.00243,74.125.24.0-255,5379,62653,1,186249
4621,0.002464,74.125.24.0-255,1484,64137,1,186249
4622,0.002467,74.125.24.0-255,1484,65621,1,186249
4623,0.002483,74.125.24.0-255,1484,67105,1,186249
4624,0.002487,74.125.24.0-255,2902,70007,1,186249
4625,0.002503,74.125.24.0-255,2902,72909,1,186249
4626,0.002534,74.125.24.0-255,2902,75811,1,186249
4627,0.002546,74.125.24.0-255,3961,79772,1,186249
4628,0.003225,172.31.36.0-255,66,79838,1,186249
4629,0.005873,74.125.24.0-255,5738,85576,1,186249
4630,0.005881,172.31.36.0-255,66,85642,1,186249
4631,0.008569,74.125.24.0-255,5738,91380,1,186249
4632,0.008578,172.31.36.0-255,66,91446,1,186249
4633,0.011261,74.125.24.0-255,5738,97184,1,186249
4634,0.011269,172.31.36.0-255,66,97250,1,186249
4635,0.013953,74.125.24.0-255,5738,102988,1,186249
4636,0.013964,172.31.36.0-255,66,103054,1,186249
4637,0.016644,74.125.24.0-255,5738,108792,1,186249
4638,0.016655,172.31.36.0-255,66,108858,1,186249
4639,0.019319,74.125.24.0-255,5738,114596,1,186249
4640,0.019328,172.31.36.0-255,66,114662,1,186249
4641,0.021999,74.125.24.0-255,5738,120400,1,186249
4642,0.022008,172.31.36.0-255,66,120466,1,186249
4643,0.024707,74.125.24.0-255,5738,126204,1,186249
4644,0.024716,172.31.36.0-255,66,126270,1,186249
4645,0.025752,172.31.36.0-255,172,126442,1,186249
4646,0.025801,172.31.36.0-255,1114,127556,1,186249
4647,0.025877,172.31.36.0-255,1514,129070,1,186249
4648,0.025907,172.31.36.0-255,1514,130584,1,186249
4649,0.025908,172.31.36.0-255,1514,132098,1,186249
4650,0.025931,172.31.36.0-255,1514,133612,1,186249
4651,0.025932,172.31.36.0-255,1489,135101,1,186249
4652,0.027268,104.244.42.0-255,66,135167,1,186249
4653,0.027335,74.125.24.0-255,4320,139487,1,186249
4654,0.02734,172.31.36.0-255,66,139553,1,186249
4655,0.027368,74.125.24.0-255,1484,141037,1,186249
4656,0.027383,104.244.42.0-255,66,141103,1,186249
4657,0.027482,104.244.42.0-255,66,141169,1,186249
4658,0.027488,104.244.42.0-255,66,141235,1,186249
4659,0.029949,74.125.24.0-255,4320,145555,1,186249
4660,0.029954,172.31.36.0-255,66,145621,1,186249
4661,0.032629,74.125.24.0-255,5738,151359,1,186249
4662,0.032684,172.31.36.0-255,66,151425,1,186249
4663,0.035351,74.125.24.0-255,5738,157163,1,186249
4664,0.035357,172.31.36.0-255,66,157229,1,186249
4665,0.038011,74.125.24.0-255,5738,162967,1,186249
4666,0.038017,172.31.36.0-255,66,163033,1,186249
4667,0.040681,74.125.24.0-255,5738,168771,1,186249
4668,0.040686,172.31.36.0-255,66,168837,1,186249
4669,0.043328,74.125.24.0-255,5738,174575,1,186249
4670,0.043334,172.31.36.0-255,66,174641,1,186249
4671,0.045987,74.125.24.0-255,5738,180379,1,186249
4672,0.045993,172.31.36.0-255,66,180445,1,186249
4673,0.048634,74.125.24.0-255,5738,186183,1,186249
4674,0.04864,172.31.36.0-255,66,186249,1,186249
4675,0.0,74.125.24.0-255,295,295,1,217576
4676,3.1e-05,172.31.36.0-255,66,361,1,217576
4677,3.7e-05,74.125.24.0-255,1484,1845,1,217576
4678,4.1e-05,172.31.36.0-255,66,1911,1,217576
4679,4.6e-05,74.125.24.0-255,4320,6231,1,217576
4680,4.8e-05,172.31.36.0-255,66,6297,1,217576
4681,6.6e-05,172.31.36.0-255,66,6363,1,217576
4682,7.7e-05,172.31.36.0-255,66,6429,1,217576
4683,0.000105,74.125.24.0-255,3961,10390,1,217576
4684,0.000108,172.31.36.0-255,66,10456,1,217576
4685,0.000268,74.125.24.0-255,1484,11940,1,217576
4686,0.000272,172.31.36.0-255,66,12006,1,217576
4687,0.000279,74.125.24.0-255,2902,14908,1,217576
4688,0.000282,172.31.36.0-255,66,14974,1,217576
4689,0.000287,74.125.24.0-255,2902,17876,1,217576
4690,0.000296,172.31.36.0-255,66,17942,1,217576
4691,0.000327,74.125.24.0-255,2902,20844,1,217576
4692,0.000331,172.31.36.0-255,66,20910,1,217576
4693,0.000343,172.31.36.0-255,66,20976,1,217576
4694,0.000353,172.31.36.0-255,66,21042,1,217576
4695,0.000356,74.125.24.0-255,1484,22526,1,217576
4696,0.000358,172.31.36.0-255,66,22592,1,217576
4697,0.000385,74.125.24.0-255,5656,28248,1,217576
4698,0.00039,172.31.36.0-255,66,28314,1,217576
4699,0.000577,74.125.24.0-255,130,28444,1,217576
4700,0.000581,172.31.36.0-255,66,28510,1,217576
4701,0.000705,74.125.24.0-255,1484,29994,1,217576
4702,0.000709,172.31.36.0-255,66,30060,1,217576
4703,0.000714,74.125.24.0-255,2902,32962,1,217576
4704,0.000717,74.125.24.0-255,1484,34446,1,217576
4705,0.00072,172.31.36.0-255,66,34512,1,217576
4706,0.000748,74.125.24.0-255,4320,38832,1,217576
4707,0.000758,172.31.36.0-255,66,38898,1,217576
4708,0.000763,172.31.36.0-255,66,38964,1,217576
4709,0.000771,74.125.24.0-255,2543,41507,1,217576
4710,0.000776,172.31.36.0-255,66,41573,1,217576
4711,0.000783,74.125.24.0-255,7156,48729,1,217576
4712,0.000793,172.31.36.0-255,66,48795,1,217576
4713,0.000818,74.125.24.0-255,2543,51338,1,217576
4714,0.000821,172.31.36.0-255,66,51404,1,217576
4715,0.001224,74.125.24.0-255,1484,52888,1,217576
4716,0.001234,74.125.24.0-255,2902,55790,1,217576
4717,0.001237,172.31.36.0-255,66,55856,1,217576
4718,0.001244,74.125.24.0-255,2902,58758,1,217576
4719,0.001265,74.125.24.0-255,2902,61660,1,217576
4720,0.001279,74.125.24.0-255,4320,65980,1,217576
4721,0.001298,74.125.24.0-255,4320,70300,1,217576
4722,0.001323,74.125.24.0-255,2184,72484,1,217576
4723,0.001348,74.125.24.0-255,2902,75386,1,217576
4724,0.001371,74.125.24.0-255,7156,82542,1,217576
4725,0.001376,74.125.24.0-255,4320,86862,1,217576
4726,0.001385,74.125.24.0-255,1484,88346,1,217576
4727,0.001434,74.125.24.0-255,6438,94784,1,217576
4728,0.001472,74.125.24.0-255,1484,96268,1,217576
4729,0.001477,74.125.24.0-255,2902,99170,1,217576
4730,0.001496,74.125.24.0-255,5738,104908,1,217576
4731,0.001554,74.125.24.0-255,7156,112064,1,217576
4732,0.001576,74.125.24.0-255,5738,117802,1,217576
4733,0.001641,74.125.24.0-255,2902,120704,1,217576
4734,0.001652,74.125.24.0-255,2184,122888,1,217576
4735,0.001766,74.125.24.0-255,1484,124372,1,217576
4736,0.001772,74.125.24.0-255,2902,127274,1,217576
4737,0.001792,74.125.24.0-255,5738,133012,1,217576
4738,0.001797,74.125.24.0-255,2902,135914,1,217576
4739,0.001799,74.125.24.0-255,1484,137398,1,217576
4740,0.001836,74.125.24.0-255,1484,138882,1,217576
4741,0.001886,74.125.24.0-255,1484,140366,1,217576
4742,0.0019,74.125.24.0-255,2902,143268,1,217576
4743,0.001906,74.125.24.0-255,5738,149006,1,217576
4744,0.001922,74.125.24.0-255,1484,150490,1,217576
4745,0.001962,74.125.24.0-255,7156,157646,1,217576
4746,0.001992,74.125.24.0-255,3602,161248,1,217576
4747,0.00205,74.125.24.0-255,4320,165568,1,217576
4748,0.002056,74.125.24.0-255,5738,171306,1,217576
4749,0.002095,74.125.24.0-255,5738,177044,1,217576
4750,0.002111,74.125.24.0-255,4320,181364,1,217576
4751,0.002141,74.125.24.0-255,2184,183548,1,217576
4752,0.002181,74.125.24.0-255,2902,186450,1,217576
4753,0.002198,74.125.24.0-255,5738,192188,1,217576
4754,0.002213,74.125.24.0-255,2902,195090,1,217576
4755,0.002232,74.125.24.0-255,7156,202246,1,217576
4756,0.002286,74.125.24.0-255,4320,206566,1,217576
4757,0.002353,74.125.24.0-255,1484,208050,1,217576
4758,0.006762,172.31.36.0-255,66,208116,1,217576
4759,0.009111,74.125.24.0-255,105,208221,1,217576
4760,0.009232,172.31.36.0-255,66,208287,1,217576
4761,0.009259,172.31.36.0-255,105,208392,1,217576
4762,0.011551,74.125.24.0-255,66,208458,1,217576
4763,0.045445,172.31.36.0-255,193,208651,1,217576
4764,0.045543,172.31.36.0-255,1113,209764,1,217576
4765,0.045619,172.31.36.0-255,1514,211278,1,217576
4766,0.045621,172.31.36.0-255,1514,212792,1,217576
4767,0.045623,172.31.36.0-255,1514,214306,1,217576
4768,0.045624,172.31.36.0-255,1514,215820,1,217576
4769,0.045657,172.31.36.0-255,1492,217312,1,217576
4770,0.046964,104.244.42.0-255,66,217378,1,217576
4771,0.047105,104.244.42.0-255,66,217444,1,217576
4772,0.047152,104.244.42.0-255,66,217510,1,217576
4773,0.047204,104.244.42.0-255,66,217576,1,217576
4774,0.0,172.217.194.0-255,153,153,1,270079
4775,2e-05,172.31.36.0-255,66,219,1,270079
4776,2.7e-05,172.217.194.0-255,1484,1703,1,270079
4777,3.3e-05,172.31.36.0-255,66,1769,1,270079
4778,3.9e-05,172.217.194.0-255,2902,4671,1,270079
4779,4.3e-05,172.31.36.0-255,66,4737,1,270079
4780,5.1e-05,172.217.194.0-255,7156,11893,1,270079
4781,5.4e-05,172.31.36.0-255,66,11959,1,270079
4782,6.2e-05,172.217.194.0-255,7156,19115,1,270079
4783,6.5e-05,172.31.36.0-255,66,19181,1,270079
4784,9.9e-05,172.217.194.0-255,595,19776,1,270079
4785,0.000101,172.31.36.0-255,66,19842,1,270079
4786,0.000113,172.31.36.0-255,66,19908,1,270079
4787,0.000126,172.31.36.0-255,66,19974,1,270079
4788,0.000159,172.217.194.0-255,5738,25712,1,270079
4789,0.000161,172.31.36.0-255,66,25778,1,270079
4790,0.000181,172.217.194.0-255,3602,29380,1,270079
4791,0.000183,172.31.36.0-255,66,29446,1,270079
4792,0.000438,172.217.194.0-255,1484,30930,1,270079
4793,0.000443,172.31.36.0-255,66,30996,1,270079
4794,0.00045,172.217.194.0-255,2902,33898,1,270079
4795,0.000453,172.31.36.0-255,66,33964,1,270079
4796,0.000458,172.217.194.0-255,2902,36866,1,270079
4797,0.00046,172.31.36.0-255,66,36932,1,270079
4798,0.000485,172.217.194.0-255,2902,39834,1,270079
4799,0.000488,172.31.36.0-255,66,39900,1,270079
4800,0.000541,172.217.194.0-255,4320,44220,1,270079
4801,0.000545,172.31.36.0-255,66,44286,1,270079
4802,0.000563,172.217.194.0-255,2847,47133,1,270079
4803,0.000565,172.31.36.0-255,66,47199,1,270079
4804,0.000613,172.217.194.0-255,1484,48683,1,270079
4805,0.000618,172.217.194.0-255,2902,51585,1,270079
4806,0.000629,172.31.36.0-255,66,51651,1,270079
4807,0.000636,172.217.194.0-255,5738,57389,1,270079
4808,0.000639,172.31.36.0-255,66,57455,1,270079
4809,0.000674,172.31.36.0-255,66,57521,1,270079
4810,0.000694,172.217.194.0-255,1484,59005,1,270079
4811,0.000707,172.31.36.0-255,66,59071,1,270079
4812,0.000893,172.217.194.0-255,1484,60555,1,270079
4813,0.000898,172.217.194.0-255,1484,62039,1,270079
4814,0.000901,172.31.36.0-255,66,62105,1,270079
4815,0.000923,172.217.194.0-255,1484,63589,1,270079
4816,0.000926,172.217.194.0-255,1484,65073,1,270079
4817,0.000928,172.31.36.0-255,66,65139,1,270079
4818,0.000955,172.217.194.0-255,4320,69459,1,270079
4819,0.000958,172.31.36.0-255,66,69525,1,270079
4820,0.000969,172.31.36.0-255,66,69591,1,270079
4821,0.000992,172.217.194.0-255,4320,73911,1,270079
4822,0.000995,172.31.36.0-255,66,73977,1,270079
4823,0.001003,172.217.194.0-255,7156,81133,1,270079
4824,0.001006,172.31.36.0-255,66,81199,1,270079
4825,0.00104,172.31.36.0-255,66,81265,1,270079
4826,0.001088,172.31.36.0-255,66,81331,1,270079
4827,0.001127,172.31.36.0-255,66,81397,1,270079
4828,0.001131,172.217.194.0-255,2184,83581,1,270079
4829,0.001133,172.31.36.0-255,66,83647,1,270079
4830,0.001148,172.31.36.0-255,66,83713,1,270079
4831,0.001164,172.31.36.0-255,66,83779,1,270079
4832,0.001169,172.217.194.0-255,3602,87381,1,270079
4833,0.001172,172.31.36.0-255,66,87447,1,270079
4834,0.001175,172.217.194.0-255,1484,88931,1,270079
4835,0.001194,172.217.194.0-255,2902,91833,1,270079
4836,0.001197,172.31.36.0-255,66,91899,1,270079
4837,0.001202,172.217.194.0-255,2902,94801,1,270079
4838,0.001204,172.31.36.0-255,66,94867,1,270079
4839,0.001223,172.217.194.0-255,2902,97769,1,270079
4840,0.001225,172.31.36.0-255,66,97835,1,270079
4841,0.00124,172.31.36.0-255,66,97901,1,270079
4842,0.001271,172.217.194.0-255,1484,99385,1,270079
4843,0.001285,172.31.36.0-255,66,99451,1,270079
4844,0.00144,172.217.194.0-255,1484,100935,1,270079
4845,0.001447,172.217.194.0-255,2902,103837,1,270079
4846,0.00145,172.31.36.0-255,66,103903,1,270079
4847,0.001472,172.217.194.0-255,5738,109641,1,270079
4848,0.001474,172.31.36.0-255,66,109707,1,270079
4849,0.00148,172.217.194.0-255,4320,114027,1,270079
4850,0.001482,172.31.36.0-255,66,114093,1,270079
4851,0.001513,172.217.194.0-255,5738,119831,1,270079
4852,0.001517,172.31.36.0-255,66,119897,1,270079
4853,0.001521,172.31.36.0-255,66,119963,1,270079
4854,0.001544,172.217.194.0-255,4320,124283,1,270079
4855,0.001547,172.31.36.0-255,66,124349,1,270079
4856,0.00155,172.217.194.0-255,766,125115,1,270079
4857,0.001636,172.217.194.0-255,1484,126599,1,270079
4858,0.00164,172.31.36.0-255,66,126665,1,270079
4859,0.001669,172.217.194.0-255,2902,129567,1,270079
4860,0.001674,172.31.36.0-255,66,129633,1,270079
4861,0.00168,172.217.194.0-255,5738,135371,1,270079
4862,0.001682,172.31.36.0-255,66,135437,1,270079
4863,0.001686,172.217.194.0-255,1484,136921,1,270079
4864,0.001719,172.31.36.0-255,66,136987,1,270079
4865,0.001726,172.217.194.0-255,5738,142725,1,270079
4866,0.001728,172.31.36.0-255,66,142791,1,270079
4867,0.001734,172.217.194.0-255,5020,147811,1,270079
4868,0.001737,172.31.36.0-255,66,147877,1,270079
4869,0.003966,172.217.194.0-255,5738,153615,1,270079
4870,0.003974,172.31.36.0-255,66,153681,1,270079
4871,0.006211,172.217.194.0-255,5738,159419,1,270079
4872,0.006218,172.31.36.0-255,66,159485,1,270079
4873,0.008481,172.217.194.0-255,5738,165223,1,270079
4874,0.008486,172.31.36.0-255,66,165289,1,270079
4875,0.010737,172.217.194.0-255,5738,171027,1,270079
4876,0.010744,172.31.36.0-255,66,171093,1,270079
4877,0.01301,172.217.194.0-255,5738,176831,1,270079
4878,0.013018,172.31.36.0-255,66,176897,1,270079
4879,0.015283,172.217.194.0-255,5738,182635,1,270079
4880,0.01529,172.31.36.0-255,66,182701,1,270079
4881,0.017592,172.217.194.0-255,5738,188439,1,270079
4882,0.0176,172.31.36.0-255,66,188505,1,270079
4883,0.019838,172.217.194.0-255,5738,194243,1,270079
4884,0.019846,172.31.36.0-255,66,194309,1,270079
4885,0.02211,172.217.194.0-255,5738,200047,1,270079
4886,0.022117,172.31.36.0-255,66,200113,1,270079
4887,0.024395,172.217.194.0-255,5738,205851,1,270079
4888,0.024405,172.31.36.0-255,66,205917,1,270079
4889,0.026656,172.217.194.0-255,5738,211655,1,270079
4890,0.026663,172.31.36.0-255,66,211721,1,270079
4891,0.028922,172.217.194.0-255,5738,217459,1,270079
4892,0.028929,172.31.36.0-255,66,217525,1,270079
4893,0.031201,172.217.194.0-255,5738,223263,1,270079
4894,0.031209,172.31.36.0-255,66,223329,1,270079
4895,0.033427,172.217.194.0-255,5738,229067,1,270079
4896,0.033435,172.31.36.0-255,66,229133,1,270079
4897,0.035694,172.217.194.0-255,5738,234871,1,270079
4898,0.035701,172.31.36.0-255,66,234937,1,270079
4899,0.038009,172.217.194.0-255,5738,240675,1,270079
4900,0.038016,172.31.36.0-255,66,240741,1,270079
4901,0.040265,172.217.194.0-255,5738,246479,1,270079
4902,0.040277,172.31.36.0-255,66,246545,1,270079
4903,0.042553,172.217.194.0-255,5738,252283,1,270079
4904,0.04256,172.31.36.0-255,66,252349,1,270079
4905,0.043895,172.31.36.0-255,188,252537,1,270079
4906,0.043928,172.31.36.0-255,958,253495,1,270079
4907,0.043994,172.31.36.0-255,1514,255009,1,270079
4908,0.043996,172.31.36.0-255,1514,256523,1,270079
4909,0.044001,172.31.36.0-255,1514,258037,1,270079
4910,0.044003,172.31.36.0-255,1514,259551,1,270079
4911,0.044022,172.31.36.0-255,1514,261065,1,270079
4912,0.044023,172.31.36.0-255,198,261263,1,270079
4913,0.044796,172.217.194.0-255,5738,267001,1,270079
4914,0.044803,172.31.36.0-255,66,267067,1,270079
4915,0.045411,104.244.42.0-255,66,267133,1,270079
4916,0.045456,104.244.42.0-255,66,267199,1,270079
4917,0.045594,104.244.42.0-255,66,267265,1,270079
4918,0.0456,104.244.42.0-255,66,267331,1,270079
4919,0.047029,172.217.194.0-255,2511,269842,1,270079
4920,0.047035,172.31.36.0-255,66,269908,1,270079
4921,0.047203,172.31.36.0-255,105,270013,1,270079
4922,0.049378,172.217.194.0-255,66,270079,1,270079
4923,0.0,172.31.36.0-255,66,66,1,66
4924,0.0,172.217.194.0-255,153,153,1,207367
4925,2.3e-05,172.31.36.0-255,66,219,1,207367
4926,3.1e-05,172.217.194.0-255,1484,1703,1,207367
4927,3.5e-05,172.31.36.0-255,66,1769,1,207367
4928,4.1e-05,172.217.194.0-255,2902,4671,1,207367
4929,4.5e-05,172.31.36.0-255,66,4737,1,207367
4930,5.4e-05,172.217.194.0-255,7156,11893,1,207367
4931,5.7e-05,172.31.36.0-255,66,11959,1,207367
4932,7e-05,172.31.36.0-255,66,12025,1,207367
4933,0.000106,172.31.36.0-255,66,12091,1,207367
4934,0.000151,172.217.194.0-255,4320,16411,1,207367
4935,0.000154,172.31.36.0-255,66,16477,1,207367
4936,0.000161,172.217.194.0-255,5738,22215,1,207367
4937,0.000163,172.31.36.0-255,66,22281,1,207367
4938,0.000208,172.217.194.0-255,4320,26601,1,207367
4939,0.000211,172.31.36.0-255,66,26667,1,207367
4940,0.000233,172.31.36.0-255,66,26733,1,207367
4941,0.000246,172.31.36.0-255,66,26799,1,207367
4942,0.000449,172.217.194.0-255,99,26898,1,207367
4943,0.000455,172.31.36.0-255,66,26964,1,207367
4944,0.000577,172.217.194.0-255,1484,28448,1,207367
4945,0.000581,172.31.36.0-255,66,28514,1,207367
4946,0.000587,172.217.194.0-255,2902,31416,1,207367
4947,0.00059,172.31.36.0-255,66,31482,1,207367
4948,0.000621,172.217.194.0-255,5738,37220,1,207367
4949,0.000623,172.31.36.0-255,66,37286,1,207367
4950,0.000631,172.217.194.0-255,5738,43024,1,207367
4951,0.000633,172.31.36.0-255,66,43090,1,207367
4952,0.000649,172.217.194.0-255,1484,44574,1,207367
4953,0.000664,172.217.194.0-255,4320,48894,1,207367
4954,0.000676,172.217.194.0-255,2902,51796,1,207367
4955,0.00069,172.217.194.0-255,5379,57175,1,207367
4956,0.000707,172.217.194.0-255,3961,61136,1,207367
4957,0.000713,172.31.36.0-255,66,61202,1,207367
4958,0.002754,172.217.194.0-255,5738,66940,1,207367
4959,0.002759,172.31.36.0-255,66,67006,1,207367
4960,0.004822,172.217.194.0-255,5738,72744,1,207367
4961,0.004828,172.31.36.0-255,66,72810,1,207367
4962,0.006846,172.217.194.0-255,5738,78548,1,207367
4963,0.006853,172.31.36.0-255,66,78614,1,207367
4964,0.008855,172.217.194.0-255,5738,84352,1,207367
4965,0.008861,172.31.36.0-255,66,84418,1,207367
4966,0.010874,172.217.194.0-255,5738,90156,1,207367
4967,0.010882,172.31.36.0-255,66,90222,1,207367
4968,0.012905,172.217.194.0-255,5738,95960,1,207367
4969,0.012911,172.31.36.0-255,66,96026,1,207367
4970,0.014926,172.217.194.0-255,5738,101764,1,207367
4971,0.014933,172.31.36.0-255,66,101830,1,207367
4972,0.016967,172.217.194.0-255,5738,107568,1,207367
4973,0.016974,172.31.36.0-255,66,107634,1,207367
4974,0.018995,172.217.194.0-255,5738,113372,1,207367
4975,0.019002,172.31.36.0-255,66,113438,1,207367
4976,0.021038,172.217.194.0-255,5738,119176,1,207367
4977,0.021045,172.31.36.0-255,66,119242,1,207367
4978,0.023059,172.217.194.0-255,4320,123562,1,207367
4979,0.023066,172.31.36.0-255,66,123628,1,207367
4980,0.023093,172.217.194.0-255,1484,125112,1,207367
4981,0.025072,172.217.194.0-255,2902,128014,1,207367
4982,0.025081,172.31.36.0-255,66,128080,1,207367
4983,0.027102,172.217.194.0-255,5738,133818,1,207367
4984,0.02711,172.31.36.0-255,66,133884,1,207367
4985,0.02913,172.217.194.0-255,5738,139622,1,207367
4986,0.029135,172.31.36.0-255,66,139688,1,207367
4987,0.031152,172.217.194.0-255,5738,145426,1,207367
4988,0.031158,172.31.36.0-255,66,145492,1,207367
4989,0.033188,172.217.194.0-255,5738,151230,1,207367
4990,0.033195,172.31.36.0-255,66,151296,1,207367
4991,0.033726,172.31.36.0-255,188,151484,1,207367
4992,0.033759,172.31.36.0-255,958,152442,1,207367
4993,0.033821,172.31.36.0-255,1514,153956,1,207367
4994,0.033824,172.31.36.0-255,1514,155470,1,207367
4995,0.033825,172.31.36.0-255,1514,156984,1,207367
4996,0.03383,172.31.36.0-255,1514,158498,1,207367
4997,0.033831,172.31.36.0-255,1514,160012,1,207367
4998,0.033832,172.31.36.0-255,197,160209,1,207367
4999,0.035199,172.217.194.0-255,5738,165947,1,207367
5000,0.035205,172.31.36.0-255,66,166013,1,207367
5001,0.035284,104.244.42.0-255,66,166079,1,207367
5002,0.035384,104.244.42.0-255,66,166145,1,207367
5003,0.035436,104.244.42.0-255,66,166211,1,207367
5004,0.035442,104.244.42.0-255,66,166277,1,207367
5005,0.037201,172.217.194.0-255,5738,172015,1,207367
5006,0.037207,172.31.36.0-255,66,172081,1,207367
5007,0.039212,172.217.194.0-255,5738,177819,1,207367
5008,0.039218,172.31.36.0-255,66,177885,1,207367
5009,0.041229,172.217.194.0-255,2902,180787,1,207367
5010,0.041234,172.31.36.0-255,66,180853,1,207367
5011,0.041262,172.217.194.0-255,2902,183755,1,207367
5012,0.041266,172.31.36.0-255,66,183821,1,207367
5013,0.043252,172.217.194.0-255,2902,186723,1,207367
5014,0.043257,172.31.36.0-255,66,186789,1,207367
5015,0.043294,172.217.194.0-255,2902,189691,1,207367
5016,0.043297,172.31.36.0-255,66,189757,1,207367
5017,0.045278,172.217.194.0-255,2902,192659,1,207367
5018,0.045284,172.31.36.0-255,66,192725,1,207367
5019,0.045313,172.217.194.0-255,2902,195627,1,207367
5020,0.045316,172.31.36.0-255,66,195693,1,207367
5021,0.047284,172.217.194.0-255,1484,197177,1,207367
5022,0.047317,172.217.194.0-255,4320,201497,1,207367
5023,0.047322,172.31.36.0-255,66,201563,1,207367
5024,0.049324,172.217.194.0-255,5738,207301,1,207367
5025,0.049329,172.31.36.0-255,66,207367,1,207367
5026,0.0,172.217.26.0-255,297,297,1,179834
5027,3.4e-05,172.31.36.0-255,66,363,1,179834
5028,4e-05,172.217.26.0-255,1484,1847,1,179834
5029,4.3e-05,172.31.36.0-255,66,1913,1,179834
5030,0.000119,172.217.26.0-255,4320,6233,1,179834
5031,0.000123,172.31.36.0-255,66,6299,1,179834
5032,0.000465,172.217.26.0-255,5738,12037,1,179834
5033,0.00047,172.31.36.0-255,66,12103,1,179834
5034,0.000945,172.31.36.0-255,66,12169,1,179834
5035,0.001852,172.31.36.0-255,66,12235,1,179834
5036,0.001882,172.217.26.0-255,2902,15137,1,179834
5037,0.001885,172.31.36.0-255,66,15203,1,179834
5038,0.002745,172.217.26.0-255,7156,22359,1,179834
5039,0.002749,172.31.36.0-255,66,22425,1,179834
5040,0.002776,172.217.26.0-255,4320,26745,1,179834
5041,0.002778,172.31.36.0-255,66,26811,1,179834
5042,0.00371,172.217.26.0-255,4320,31131,1,179834
5043,0.003717,172.31.36.0-255,66,31197,1,179834
5044,0.003746,172.217.26.0-255,2902,34099,1,179834
5045,0.00375,172.31.36.0-255,66,34165,1,179834
5046,0.005693,172.217.26.0-255,1484,35649,1,179834
5047,0.005701,172.31.36.0-255,66,35715,1,179834
5048,0.005738,172.217.26.0-255,4320,40035,1,179834
5049,0.005741,172.31.36.0-255,66,40101,1,179834
5050,0.007604,172.217.26.0-255,1484,41585,1,179834
5051,0.00761,172.31.36.0-255,66,41651,1,179834
5052,0.007657,172.217.26.0-255,4320,45971,1,179834
5053,0.00766,172.31.36.0-255,66,46037,1,179834
5054,0.009499,172.217.26.0-255,1484,47521,1,179834
5055,0.009506,172.31.36.0-255,66,47587,1,179834
5056,0.009551,172.217.26.0-255,4320,51907,1,179834
5057,0.009579,172.31.36.0-255,66,51973,1,179834
5058,0.011426,172.217.26.0-255,1484,53457,1,179834
5059,0.011468,172.217.26.0-255,4320,57777,1,179834
5060,0.011493,172.31.36.0-255,66,57843,1,179834
5061,0.013384,172.217.26.0-255,5738,63581,1,179834
5062,0.01339,172.31.36.0-255,66,63647,1,179834
5063,0.015288,172.217.26.0-255,5738,69385,1,179834
5064,0.015295,172.31.36.0-255,66,69451,1,179834
5065,0.017196,172.217.26.0-255,5738,75189,1,179834
5066,0.017202,172.31.36.0-255,66,75255,1,179834
5067,0.019113,172.217.26.0-255,5738,80993,1,179834
5068,0.019121,172.31.36.0-255,66,81059,1,179834
5069,0.021047,172.217.26.0-255,5738,86797,1,179834
5070,0.021053,172.31.36.0-255,66,86863,1,179834
5071,0.022969,172.217.26.0-255,5738,92601,1,179834
5072,0.022976,172.31.36.0-255,66,92667,1,179834
5073,0.024871,172.217.26.0-255,5738,98405,1,179834
5074,0.024879,172.31.36.0-255,66,98471,1,179834
5075,0.026797,172.217.26.0-255,5738,104209,1,179834
5076,0.026805,172.31.36.0-255,66,104275,1,179834
5077,0.028707,172.217.26.0-255,5738,110013,1,179834
5078,0.028714,172.31.36.0-255,66,110079,1,179834
5079,0.030609,172.217.26.0-255,5738,115817,1,179834
5080,0.030616,172.31.36.0-255,66,115883,1,179834
5081,0.032513,172.217.26.0-255,5738,121621,1,179834
5082,0.03252,172.31.36.0-255,66,121687,1,179834
5083,0.032738,172.31.36.0-255,171,121858,1,179834
5084,0.032793,172.31.36.0-255,1139,122997,1,179834
5085,0.032872,172.31.36.0-255,1514,124511,1,179834
5086,0.032874,172.31.36.0-255,1514,126025,1,179834
5087,0.032875,172.31.36.0-255,1514,127539,1,179834
5088,0.032905,172.31.36.0-255,1514,129053,1,179834
5089,0.032907,172.31.36.0-255,325,129378,1,179834
5090,0.034276,104.244.42.0-255,66,129444,1,179834
5091,0.034356,104.244.42.0-255,66,129510,1,179834
5092,0.034415,172.217.26.0-255,5738,135248,1,179834
5093,0.03442,172.31.36.0-255,66,135314,1,179834
5094,0.034445,104.244.42.0-255,66,135380,1,179834
5095,0.034499,104.244.42.0-255,66,135446,1,179834
5096,0.03631,172.217.26.0-255,5738,141184,1,179834
5097,0.036316,172.31.36.0-255,66,141250,1,179834
5098,0.038219,172.217.26.0-255,2902,144152,1,179834
5099,0.038225,172.31.36.0-255,66,144218,1,179834
5100,0.038263,172.217.26.0-255,2902,147120,1,179834
5101,0.038282,172.31.36.0-255,66,147186,1,179834
5102,0.040112,172.217.26.0-255,2902,150088,1,179834
5103,0.040118,172.31.36.0-255,66,150154,1,179834
5104,0.040219,172.217.26.0-255,2902,153056,1,179834
5105,0.040224,172.31.36.0-255,66,153122,1,179834
5106,0.042003,172.217.26.0-255,2902,156024,1,179834
5107,0.042009,172.31.36.0-255,66,156090,1,179834
5108,0.042105,172.217.26.0-255,2902,158992,1,179834
5109,0.042116,172.31.36.0-255,66,159058,1,179834
5110,0.043898,172.217.26.0-255,2902,161960,1,179834
5111,0.043904,172.31.36.0-255,66,162026,1,179834
5112,0.044002,172.217.26.0-255,2902,164928,1,179834
5113,0.044007,172.31.36.0-255,66,164994,1,179834
5114,0.045787,172.217.26.0-255,2902,167896,1,179834
5115,0.045792,172.31.36.0-255,66,167962,1,179834
5116,0.045899,172.217.26.0-255,2902,170864,1,179834
5117,0.045904,172.31.36.0-255,66,170930,1,179834
5118,0.047673,172.217.26.0-255,2902,173832,1,179834
5119,0.04768,172.31.36.0-255,66,173898,1,179834
5120,0.047835,172.217.26.0-255,2902,176800,1,179834
5121,0.048475,172.31.36.0-255,66,176866,1,179834
5122,0.049578,172.217.26.0-255,2902,179768,1,179834
5123,0.049584,172.31.36.0-255,66,179834,1,179834
5124,0.0,74.125.24.0-255,291,291,1,200841
5125,2.6e-05,172.31.36.0-255,66,357,1,200841
5126,3.2e-05,74.125.24.0-255,1484,1841,1,200841
5127,3.6e-05,172.31.36.0-255,66,1907,1,200841
5128,4.3e-05,74.125.24.0-255,4320,6227,1,200841
5129,5.5e-05,172.31.36.0-255,66,6293,1,200841
5130,7e-05,172.31.36.0-255,66,6359,1,200841
5131,0.000108,172.31.36.0-255,66,6425,1,200841
5132,0.000152,74.125.24.0-255,1484,7909,1,200841
5133,0.000155,172.31.36.0-255,66,7975,1,200841
5134,0.000183,74.125.24.0-255,2902,10877,1,200841
5135,0.000185,172.31.36.0-255,66,10943,1,200841
5136,0.000192,74.125.24.0-255,5738,16681,1,200841
5137,0.000195,172.31.36.0-255,66,16747,1,200841
5138,0.000216,74.125.24.0-255,1484,18231,1,200841
5139,0.000218,172.31.36.0-255,66,18297,1,200841
5140,0.000253,172.31.36.0-255,66,18363,1,200841
5141,0.00029,74.125.24.0-255,2902,21265,1,200841
5142,0.000293,172.31.36.0-255,66,21331,1,200841
5143,0.000324,74.125.24.0-255,7104,28435,1,200841
5144,0.000326,172.31.36.0-255,66,28501,1,200841
5145,0.000758,74.125.24.0-255,113,28614,1,200841
5146,0.000763,172.31.36.0-255,66,28680,1,200841
5147,0.000927,74.125.24.0-255,1484,30164,1,200841
5148,0.000931,172.31.36.0-255,66,30230,1,200841
5149,0.000937,74.125.24.0-255,2902,33132,1,200841
5150,0.000939,172.31.36.0-255,66,33198,1,200841
5151,0.000945,74.125.24.0-255,4320,37518,1,200841
5152,0.000947,172.31.36.0-255,66,37584,1,200841
5153,0.000975,74.125.24.0-255,1484,39068,1,200841
5154,0.00099,172.31.36.0-255,66,39134,1,200841
5155,0.001014,74.125.24.0-255,2543,41677,1,200841
5156,0.001017,172.31.36.0-255,66,41743,1,200841
5157,0.00105,172.31.36.0-255,66,41809,1,200841
5158,0.001232,74.125.24.0-255,1484,43293,1,200841
5159,0.001238,74.125.24.0-255,2902,46195,1,200841
5160,0.001241,172.31.36.0-255,66,46261,1,200841
5161,0.001246,74.125.24.0-255,2902,49163,1,200841
5162,0.001248,172.31.36.0-255,66,49229,1,200841
5163,0.001281,74.125.24.0-255,2902,52131,1,200841
5164,0.001284,172.31.36.0-255,66,52197,1,200841
5165,0.001298,172.31.36.0-255,66,52263,1,200841
5166,0.001305,74.125.24.0-255,7156,59419,1,200841
5167,0.001309,172.31.36.0-255,66,59485,1,200841
5168,0.001335,74.125.24.0-255,3602,63087,1,200841
5169,0.001338,172.31.36.0-255,66,63153,1,200841
5170,0.001528,74.125.24.0-255,1484,64637,1,200841
5171,0.001532,74.125.24.0-255,1484,66121,1,200841
5172,0.001535,172.31.36.0-255,66,66187,1,200841
5173,0.001557,74.125.24.0-255,1484,67671,1,200841
5174,0.001564,74.125.24.0-255,5738,73409,1,200841
5175,0.001567,172.31.36.0-255,66,73475,1,200841
5176,0.001598,172.31.36.0-255,66,73541,1,200841
5177,0.001604,74.125.24.0-255,4320,77861,1,200841
5178,0.001606,172.31.36.0-255,66,77927,1,200841
5179,0.001643,74.125.24.0-255,2902,80829,1,200841
5180,0.001646,172.31.36.0-255,66,80895,1,200841
5181,0.001673,74.125.24.0-255,3602,84497,1,200841
5182,0.001676,172.31.36.0-255,66,84563,1,200841
5183,0.002194,74.125.24.0-255,1484,86047,1,200841
5184,0.002201,74.125.24.0-255,2902,88949,1,200841
5185,0.002204,172.31.36.0-255,66,89015,1,200841
5186,0.002209,74.125.24.0-255,2902,91917,1,200841
5187,0.002211,172.31.36.0-255,66,91983,1,200841
5188,0.002241,74.125.24.0-255,2902,94885,1,200841
5189,0.002243,172.31.36.0-255,66,94951,1,200841
5190,0.002254,172.31.36.0-255,66,95017,1,200841
5191,0.002287,74.125.24.0-255,1484,96501,1,200841
5192,0.002298,172.31.36.0-255,66,96567,1,200841
5193,0.002485,74.125.24.0-255,1484,98051,1,200841
5194,0.002505,74.125.24.0-255,2902,100953,1,200841
5195,0.002508,172.31.36.0-255,66,101019,1,200841
5196,0.002511,74.125.24.0-255,1484,102503,1,200841
5197,0.002532,74.125.24.0-255,4320,106823,1,200841
5198,0.002534,172.31.36.0-255,66,106889,1,200841
5199,0.002586,172.31.36.0-255,66,106955,1,200841
5200,0.002616,74.125.24.0-255,1484,108439,1,200841
5201,0.00262,74.125.24.0-255,2902,111341,1,200841
5202,0.002622,172.31.36.0-255,66,111407,1,200841
5203,0.002632,172.31.36.0-255,66,111473,1,200841
5204,0.002663,74.125.24.0-255,6438,117911,1,200841
5205,0.002665,172.31.36.0-255,66,117977,1,200841
5206,0.002672,74.125.24.0-255,7156,125133,1,200841
5207,0.002674,172.31.36.0-255,66,125199,1,200841
5208,0.002712,172.31.36.0-255,66,125265,1,200841
5209,0.002715,74.125.24.0-255,1484,126749,1,200841
5210,0.002718,74.125.24.0-255,1484,128233,1,200841
5211,0.00272,172.31.36.0-255,66,128299,1,200841
5212,0.002726,74.125.24.0-255,5020,133319,1,200841
5213,0.00273,172.31.36.0-255,66,133385,1,200841
5214,0.002805,74.125.24.0-255,1484,134869,1,200841
5215,0.002821,74.125.24.0-255,2902,137771,1,200841
5216,0.002824,172.31.36.0-255,66,137837,1,200841
5217,0.002842,74.125.24.0-255,5738,143575,1,200841
5218,0.002845,172.31.36.0-255,66,143641,1,200841
5219,0.002872,74.125.24.0-255,7156,150797,1,200841
5220,0.002875,172.31.36.0-255,66,150863,1,200841
5221,0.002892,74.125.24.0-255,5738,156601,1,200841
5222,0.002894,172.31.36.0-255,66,156667,1,200841
5223,0.002897,74.125.24.0-255,1484,158151,1,200841
5224,0.002926,172.31.36.0-255,66,158217,1,200841
5225,0.002928,74.125.24.0-255,766,158983,1,200841
5226,0.002954,74.125.24.0-255,1484,160467,1,200841
5227,0.002956,172.31.36.0-255,66,160533,1,200841
5228,0.002961,74.125.24.0-255,2902,163435,1,200841
5229,0.002963,172.31.36.0-255,66,163501,1,200841
5230,0.002989,74.125.24.0-255,1484,164985,1,200841
5231,0.002994,74.125.24.0-255,4320,169305,1,200841
5232,0.002997,172.31.36.0-255,66,169371,1,200841
5233,0.003018,74.125.24.0-255,5738,175109,1,200841
5234,0.003021,172.31.36.0-255,66,175175,1,200841
5235,0.003053,74.125.24.0-255,4320,179495,1,200841
5236,0.003056,172.31.36.0-255,66,179561,1,200841
5237,0.003067,172.31.36.0-255,66,179627,1,200841
5238,0.003076,172.31.36.0-255,66,179693,1,200841
5239,0.003106,74.125.24.0-255,3602,183295,1,200841
5240,0.003108,172.31.36.0-255,66,183361,1,200841
5241,0.003135,172.31.36.0-255,66,183427,1,200841
5242,0.00314,74.125.24.0-255,4320,187747,1,200841
5243,0.003142,172.31.36.0-255,66,187813,1,200841
5244,0.003186,172.31.36.0-255,66,187879,1,200841
5245,0.0032,172.31.36.0-255,66,187945,1,200841
5246,0.003225,172.31.36.0-255,66,188011,1,200841
5247,0.003272,172.31.36.0-255,66,188077,1,200841
5248,0.003295,74.125.24.0-255,2902,190979,1,200841
5249,0.003297,172.31.36.0-255,66,191045,1,200841
5250,0.0033,74.125.24.0-255,359,191404,1,200841
5251,0.003302,74.125.24.0-255,105,191509,1,200841
5252,0.009616,172.31.36.0-255,66,191575,1,200841
5253,0.009659,172.31.36.0-255,105,191680,1,200841
5254,0.012199,74.125.24.0-255,66,191746,1,200841
5255,0.038191,172.31.36.0-255,172,191918,1,200841
5256,0.038221,172.31.36.0-255,1115,193033,1,200841
5257,0.038293,172.31.36.0-255,1514,194547,1,200841
5258,0.038312,172.31.36.0-255,1514,196061,1,200841
5259,0.038316,172.31.36.0-255,1514,197575,1,200841
5260,0.038331,172.31.36.0-255,1514,199089,1,200841
5261,0.038334,172.31.36.0-255,1488,200577,1,200841
5262,0.039776,104.244.42.0-255,66,200643,1,200841
5263,0.039801,104.244.42.0-255,66,200709,1,200841
5264,0.039864,104.244.42.0-255,66,200775,1,200841
5265,0.039916,104.244.42.0-255,66,200841,1,200841
5266,0.0,74.125.24.0-255,153,153,1,176460
5267,3.2e-05,172.31.36.0-255,66,219,1,176460
5268,4e-05,74.125.24.0-255,1484,1703,1,176460
5269,4.4e-05,172.31.36.0-255,66,1769,1,176460
5270,4.9e-05,74.125.24.0-255,2902,4671,1,176460
5271,5.1e-05,172.31.36.0-255,66,4737,1,176460
5272,6.6e-05,74.125.24.0-255,4320,9057,1,176460
5273,6.8e-05,172.31.36.0-255,66,9123,1,176460
5274,9.9e-05,74.125.24.0-255,2902,12025,1,176460
5275,0.000102,172.31.36.0-255,66,12091,1,176460
5276,0.000123,74.125.24.0-255,5738,17829,1,176460
5277,0.000125,172.31.36.0-255,66,17895,1,176460
5278,0.000143,74.125.24.0-255,2077,19972,1,176460
5279,0.000147,172.31.36.0-255,66,20038,1,176460
5280,0.000151,74.125.24.0-255,2902,22940,1,176460
5281,0.000154,172.31.36.0-255,66,23006,1,176460
5282,0.000197,172.31.36.0-255,66,23072,1,176460
5283,0.000201,74.125.24.0-255,1484,24556,1,176460
5284,0.000203,172.31.36.0-255,66,24622,1,176460
5285,0.000208,74.125.24.0-255,2902,27524,1,176460
5286,0.000213,172.31.36.0-255,66,27590,1,176460
5287,0.000239,74.125.24.0-255,5738,33328,1,176460
5288,0.000243,74.125.24.0-255,1484,34812,1,176460
5289,0.000248,172.31.36.0-255,66,34878,1,176460
5290,0.00025,172.31.36.0-255,66,34944,1,176460
5291,0.000289,172.31.36.0-255,66,35010,1,176460
5292,0.000302,172.31.36.0-255,66,35076,1,176460
5293,0.000304,74.125.24.0-255,1399,36475,1,176460
5294,0.000307,172.31.36.0-255,66,36541,1,176460
5295,0.000311,74.125.24.0-255,134,36675,1,176460
5296,0.000397,74.125.24.0-255,1484,38159,1,176460
5297,0.000401,172.31.36.0-255,66,38225,1,176460
5298,0.000406,74.125.24.0-255,2902,41127,1,176460
5299,0.000409,172.31.36.0-255,66,41193,1,176460
5300,0.000422,74.125.24.0-255,5738,46931,1,176460
5301,0.000425,172.31.36.0-255,66,46997,1,176460
5302,0.000454,74.125.24.0-255,6797,53794,1,176460
5303,0.000457,172.31.36.0-255,66,53860,1,176460
5304,0.000483,74.125.24.0-255,7156,61016,1,176460
5305,0.000489,172.31.36.0-255,66,61082,1,176460
5306,0.000521,172.31.36.0-255,66,61148,1,176460
5307,0.00055,74.125.24.0-255,5738,66886,1,176460
5308,0.000553,172.31.36.0-255,66,66952,1,176460
5309,0.000573,74.125.24.0-255,4320,71272,1,176460
5310,0.000576,172.31.36.0-255,66,71338,1,176460
5311,0.000589,172.31.36.0-255,66,71404,1,176460
5312,0.000632,172.31.36.0-255,66,71470,1,176460
5313,0.000675,172.31.36.0-255,66,71536,1,176460
5314,0.00068,74.125.24.0-255,4320,75856,1,176460
5315,0.000683,172.31.36.0-255,66,75922,1,176460
5316,0.000712,74.125.24.0-255,4320,80242,1,176460
5317,0.000716,172.31.36.0-255,66,80308,1,176460
5318,0.000753,172.31.36.0-255,66,80374,1,176460
5319,0.000756,74.125.24.0-255,1484,81858,1,176460
5320,0.00076,74.125.24.0-255,1484,83342,1,176460
5321,0.000761,172.31.36.0-255,66,83408,1,176460
5322,0.000789,74.125.24.0-255,1484,84892,1,176460
5323,0.000795,74.125.24.0-255,5738,90630,1,176460
5324,0.000798,172.31.36.0-255,66,90696,1,176460
5325,0.000855,172.31.36.0-255,66,90762,1,176460
5326,0.000877,74.125.24.0-255,4320,95082,1,176460
5327,0.00088,172.31.36.0-255,66,95148,1,176460
5328,0.000886,74.125.24.0-255,7156,102304,1,176460
5329,0.000891,74.125.24.0-255,3602,105906,1,176460
5330,0.000891,172.31.36.0-255,66,105972,1,176460
5331,0.000895,172.31.36.0-255,66,106038,1,176460
5332,0.000926,74.125.24.0-255,4320,110358,1,176460
5333,0.000929,172.31.36.0-255,66,110424,1,176460
5334,0.000935,74.125.24.0-255,5738,116162,1,176460
5335,0.000938,172.31.36.0-255,66,116228,1,176460
5336,0.000971,74.125.24.0-255,2902,119130,1,176460
5337,0.000975,172.31.36.0-255,66,119196,1,176460
5338,0.000988,172.31.36.0-255,66,119262,1,176460
5339,0.000995,74.125.24.0-255,7156,126418,1,176460
5340,0.000997,172.31.36.0-255,66,126484,1,176460
5341,0.001027,74.125.24.0-255,3602,130086,1,176460
5342,0.00103,172.31.36.0-255,66,130152,1,176460
5343,0.001033,74.125.24.0-255,1484,131636,1,176460
5344,0.001059,74.125.24.0-255,2902,134538,1,176460
5345,0.001063,172.31.36.0-255,66,134604,1,176460
5346,0.001069,74.125.24.0-255,5738,140342,1,176460
5347,0.001071,172.31.36.0-255,66,140408,1,176460
5348,0.001074,74.125.24.0-255,1484,141892,1,176460
5349,0.001121,172.31.36.0-255,66,141958,1,176460
5350,0.001133,172.31.36.0-255,66,142024,1,176460
5351,0.001213,74.125.24.0-255,1484,143508,1,176460
5352,0.001219,74.125.24.0-255,2902,146410,1,176460
5353,0.001224,74.125.24.0-255,4320,150730,1,176460
5354,0.001224,172.31.36.0-255,66,150796,1,176460
5355,0.001229,172.31.36.0-255,66,150862,1,176460
5356,0.001253,74.125.24.0-255,1484,152346,1,176460
5357,0.001261,74.125.24.0-255,5738,158084,1,176460
5358,0.001264,172.31.36.0-255,66,158150,1,176460
5359,0.001306,74.125.24.0-255,7156,165306,1,176460
5360,0.00131,172.31.36.0-255,66,165372,1,176460
5361,0.001322,172.31.36.0-255,66,165438,1,176460
5362,0.001333,172.31.36.0-255,66,165504,1,176460
5363,0.001385,172.31.36.0-255,66,165570,1,176460
5364,0.001395,172.31.36.0-255,66,165636,1,176460
5365,0.001411,172.31.36.0-255,66,165702,1,176460
5366,0.001469,172.31.36.0-255,66,165768,1,176460
5367,0.001493,74.125.24.0-255,5738,171506,1,176460
5368,0.001496,172.31.36.0-255,66,171572,1,176460
5369,0.00156,172.31.36.0-255,66,171638,1,176460
5370,0.001564,74.125.24.0-255,105,171743,1,176460
5371,0.001577,172.31.36.0-255,66,171809,1,176460
5372,0.003735,172.31.36.0-255,105,171914,1,176460
5373,0.006098,74.125.24.0-255,66,171980,1,176460
5374,0.041725,172.31.36.0-255,193,172173,1,176460
5375,0.041756,172.31.36.0-255,1114,173287,1,176460
5376,0.041798,172.31.36.0-255,1514,174801,1,176460
5377,0.041818,172.31.36.0-255,1287,176088,1,176460
5378,0.043261,104.244.42.0-255,66,176154,1,176460
5379,0.04329,104.244.42.0-255,66,176220,1,176460
5380,0.043344,104.244.42.0-255,66,176286,1,176460
5381,0.044141,104.244.42.0-255,108,176394,1,176460
5382,0.044165,172.31.36.0-255,66,176460,1,176460
5383,0.0,74.125.200.0-255,153,153,1,213372
5384,8.8e-05,172.31.36.0-255,66,219,1,213372
5385,9.5e-05,74.125.200.0-255,1484,1703,1,213372
5386,0.000101,172.31.36.0-255,66,1769,1,213372
5387,0.000107,74.125.200.0-255,2902,4671,1,213372
5388,0.000109,172.31.36.0-255,66,4737,1,213372
5389,0.000116,74.125.200.0-255,5738,10475,1,213372
5390,0.000119,172.31.36.0-255,66,10541,1,213372
5391,0.000124,74.125.200.0-255,3472,14013,1,213372
5392,0.000126,172.31.36.0-255,66,14079,1,213372
5393,0.000131,74.125.200.0-255,4320,18399,1,213372
5394,0.000134,172.31.36.0-255,66,18465,1,213372
5395,0.000145,74.125.200.0-255,2543,21008,1,213372
5396,0.000147,172.31.36.0-255,66,21074,1,213372
5397,0.00015,172.31.36.0-255,66,21140,1,213372
5398,0.000201,74.125.200.0-255,1484,22624,1,213372
5399,0.000205,172.31.36.0-255,66,22690,1,213372
5400,0.000225,74.125.200.0-255,2902,25592,1,213372
5401,0.000227,172.31.36.0-255,66,25658,1,213372
5402,0.000232,74.125.200.0-255,1484,27142,1,213372
5403,0.000234,172.31.36.0-255,66,27208,1,213372
5404,0.000256,74.125.200.0-255,2902,30110,1,213372
5405,0.000258,172.31.36.0-255,66,30176,1,213372
5406,0.000269,74.125.200.0-255,1484,31660,1,213372
5407,0.000272,172.31.36.0-255,66,31726,1,213372
5408,0.000294,74.125.200.0-255,6797,38523,1,213372
5409,0.000296,172.31.36.0-255,66,38589,1,213372
5410,0.000311,74.125.200.0-255,7156,45745,1,213372
5411,0.000314,172.31.36.0-255,66,45811,1,213372
5412,0.000326,74.125.200.0-255,1484,47295,1,213372
5413,0.000329,74.125.200.0-255,2902,50197,1,213372
5414,0.000329,172.31.36.0-255,66,50263,1,213372
5415,0.000332,172.31.36.0-255,66,50329,1,213372
5416,0.000359,74.125.200.0-255,4320,54649,1,213372
5417,0.000364,172.31.36.0-255,66,54715,1,213372
5418,0.000367,74.125.200.0-255,1436,56151,1,213372
5419,0.000407,74.125.200.0-255,108,56259,1,213372
5420,0.000434,74.125.200.0-255,333,56592,1,213372
5421,0.000439,172.31.36.0-255,66,56658,1,213372
5422,0.001229,74.125.200.0-255,1484,58142,1,213372
5423,0.001238,74.125.200.0-255,2902,61044,1,213372
5424,0.001244,172.31.36.0-255,66,61110,1,213372
5425,0.00125,74.125.200.0-255,2902,64012,1,213372
5426,0.001252,172.31.36.0-255,66,64078,1,213372
5427,0.001266,74.125.200.0-255,2902,66980,1,213372
5428,0.001269,172.31.36.0-255,66,67046,1,213372
5429,0.001272,74.125.200.0-255,1484,68530,1,213372
5430,0.001292,172.31.36.0-255,66,68596,1,213372
5431,0.001313,74.125.200.0-255,2902,71498,1,213372
5432,0.001315,172.31.36.0-255,66,71564,1,213372
5433,0.001334,74.125.200.0-255,4320,75884,1,213372
5434,0.001337,172.31.36.0-255,66,75950,1,213372
5435,0.001359,74.125.200.0-255,6438,82388,1,213372
5436,0.001362,172.31.36.0-255,66,82454,1,213372
5437,0.003647,74.125.200.0-255,5738,88192,1,213372
5438,0.003653,172.31.36.0-255,66,88258,1,213372
5439,0.005927,74.125.200.0-255,5738,93996,1,213372
5440,0.005931,172.31.36.0-255,66,94062,1,213372
5441,0.008209,74.125.200.0-255,5738,99800,1,213372
5442,0.008217,172.31.36.0-255,66,99866,1,213372
5443,0.010499,74.125.200.0-255,5738,105604,1,213372
5444,0.010509,172.31.36.0-255,66,105670,1,213372
5445,0.012798,74.125.200.0-255,5738,111408,1,213372
5446,0.012813,172.31.36.0-255,66,111474,1,213372
5447,0.015102,74.125.200.0-255,5738,117212,1,213372
5448,0.015114,172.31.36.0-255,66,117278,1,213372
5449,0.017412,74.125.200.0-255,5738,123016,1,213372
5450,0.017429,172.31.36.0-255,66,123082,1,213372
5451,0.019719,74.125.200.0-255,5738,128820,1,213372
5452,0.019732,172.31.36.0-255,66,128886,1,213372
5453,0.022022,74.125.200.0-255,5738,134624,1,213372
5454,0.022035,172.31.36.0-255,66,134690,1,213372
5455,0.024327,74.125.200.0-255,5738,140428,1,213372
5456,0.02435,172.31.36.0-255,66,140494,1,213372
5457,0.026634,74.125.200.0-255,5738,146232,1,213372
5458,0.026643,172.31.36.0-255,66,146298,1,213372
5459,0.027337,172.31.36.0-255,176,146474,1,213372
5460,0.027368,172.31.36.0-255,1115,147589,1,213372
5461,0.027447,172.31.36.0-255,1514,149103,1,213372
5462,0.027449,172.31.36.0-255,1514,150617,1,213372
5463,0.027451,172.31.36.0-255,1514,152131,1,213372
5464,0.027455,172.31.36.0-255,1514,153645,1,213372
5465,0.027456,172.31.36.0-255,1489,155134,1,213372
5466,0.028872,104.244.42.0-255,66,155200,1,213372
5467,0.028914,74.125.200.0-255,5738,160938,1,213372
5468,0.028919,172.31.36.0-255,66,161004,1,213372
5469,0.028999,104.244.42.0-255,66,161070,1,213372
5470,0.029049,104.244.42.0-255,66,161136,1,213372
5471,0.031203,74.125.200.0-255,5738,166874,1,213372
5472,0.031211,172.31.36.0-255,66,166940,1,213372
5473,0.033504,74.125.200.0-255,5738,172678,1,213372
5474,0.033511,172.31.36.0-255,66,172744,1,213372
5475,0.035799,74.125.200.0-255,5738,178482,1,213372
5476,0.035807,172.31.36.0-255,66,178548,1,213372
5477,0.03809,74.125.200.0-255,5738,184286,1,213372
5478,0.038097,172.31.36.0-255,66,184352,1,213372
5479,0.040376,74.125.200.0-255,5738,190090,1,213372
5480,0.040386,172.31.36.0-255,66,190156,1,213372
5481,0.042668,74.125.200.0-255,5738,195894,1,213372
5482,0.042676,172.31.36.0-255,66,195960,1,213372
5483,0.044974,74.125.200.0-255,5738,201698,1,213372
5484,0.044981,172.31.36.0-255,66,201764,1,213372
5485,0.047283,74.125.200.0-255,5738,207502,1,213372
5486,0.04729,172.31.36.0-255,66,207568,1,213372
5487,0.049568,74.125.200.0-255,5738,213306,1,213372
5488,0.049576,172.31.36.0-255,66,213372,1,213372
5489,0.0,74.125.24.0-255,152,152,1,218627
5490,1.6e-05,172.31.36.0-255,66,218,1,218627
5491,2.2e-05,74.125.24.0-255,1484,1702,1,218627
5492,2.7e-05,172.31.36.0-255,66,1768,1,218627
5493,3.2e-05,74.125.24.0-255,2902,4670,1,218627
5494,3.5e-05,172.31.36.0-255,66,4736,1,218627
5495,4.3e-05,74.125.24.0-255,5738,10474,1,218627
5496,4.6e-05,172.31.36.0-255,66,10540,1,218627
5497,6.8e-05,74.125.24.0-255,1484,12024,1,218627
5498,7.1e-05,172.31.36.0-255,66,12090,1,218627
5499,0.000145,74.125.24.0-255,2110,14200,1,218627
5500,0.000148,172.31.36.0-255,66,14266,1,218627
5501,0.000177,74.125.24.0-255,5738,20004,1,218627
5502,0.00018,172.31.36.0-255,66,20070,1,218627
5503,0.000227,74.125.24.0-255,5738,25808,1,218627
5504,0.00023,172.31.36.0-255,66,25874,1,218627
5505,0.000246,74.125.24.0-255,4320,30194,1,218627
5506,0.000248,172.31.36.0-255,66,30260,1,218627
5507,0.000351,74.125.24.0-255,7156,37416,1,218627
5508,0.000356,172.31.36.0-255,66,37482,1,218627
5509,0.000385,172.31.36.0-255,66,37548,1,218627
5510,0.000546,172.31.36.0-255,66,37614,1,218627
5511,0.000598,172.31.36.0-255,66,37680,1,218627
5512,0.000785,74.125.24.0-255,4320,42000,1,218627
5513,0.00079,172.31.36.0-255,66,42066,1,218627
5514,0.000824,172.31.36.0-255,66,42132,1,218627
5515,0.001043,172.31.36.0-255,66,42198,1,218627
5516,0.001063,74.125.24.0-255,3961,46159,1,218627
5517,0.001075,172.31.36.0-255,66,46225,1,218627
5518,0.00128,74.125.24.0-255,1484,47709,1,218627
5519,0.001287,74.125.24.0-255,2902,50611,1,218627
5520,0.00129,172.31.36.0-255,66,50677,1,218627
5521,0.001307,74.125.24.0-255,1484,52161,1,218627
5522,0.001323,74.125.24.0-255,4320,56481,1,218627
5523,0.001329,172.31.36.0-255,66,56547,1,218627
5524,0.001386,74.125.24.0-255,7156,63703,1,218627
5525,0.001405,172.31.36.0-255,66,63769,1,218627
5526,0.001471,74.125.24.0-255,7156,70925,1,218627
5527,0.001475,172.31.36.0-255,66,70991,1,218627
5528,0.001498,74.125.24.0-255,7156,78147,1,218627
5529,0.00151,172.31.36.0-255,66,78213,1,218627
5530,0.001648,74.125.24.0-255,2184,80397,1,218627
5531,0.001668,172.31.36.0-255,66,80463,1,218627
5532,0.002228,74.125.24.0-255,1484,81947,1,218627
5533,0.002237,74.125.24.0-255,2902,84849,1,218627
5534,0.002241,172.31.36.0-255,66,84915,1,218627
5535,0.002262,74.125.24.0-255,4320,89235,1,218627
5536,0.002272,74.125.24.0-255,1484,90719,1,218627
5537,0.002334,74.125.24.0-255,7156,97875,1,218627
5538,0.002351,74.125.24.0-255,2902,100777,1,218627
5539,0.002454,74.125.24.0-255,4320,105097,1,218627
5540,0.003509,172.31.36.0-255,66,105163,1,218627
5541,0.005825,74.125.24.0-255,5738,110901,1,218627
5542,0.00583,172.31.36.0-255,66,110967,1,218627
5543,0.008156,74.125.24.0-255,5738,116705,1,218627
5544,0.008164,172.31.36.0-255,66,116771,1,218627
5545,0.010512,74.125.24.0-255,5738,122509,1,218627
5546,0.01052,172.31.36.0-255,66,122575,1,218627
5547,0.01286,74.125.24.0-255,5738,128313,1,218627
5548,0.012869,172.31.36.0-255,66,128379,1,218627
5549,0.015187,74.125.24.0-255,5738,134117,1,218627
5550,0.015195,172.31.36.0-255,66,134183,1,218627
5551,0.017555,74.125.24.0-255,5738,139921,1,218627
5552,0.017563,172.31.36.0-255,66,139987,1,218627
5553,0.019911,74.125.24.0-255,5738,145725,1,218627
5554,0.019918,172.31.36.0-255,66,145791,1,218627
5555,0.022258,74.125.24.0-255,5738,151529,1,218627
5556,0.022264,172.31.36.0-255,66,151595,1,218627
5557,0.022405,172.31.36.0-255,167,151762,1,218627
5558,0.022442,172.31.36.0-255,1114,152876,1,218627
5559,0.022543,172.31.36.0-255,1514,154390,1,218627
5560,0.022545,172.31.36.0-255,327,154717,1,218627
5561,0.024137,104.244.42.0-255,66,154783,1,218627
5562,0.02458,74.125.24.0-255,5738,160521,1,218627
5563,0.024585,172.31.36.0-255,66,160587,1,218627
5564,0.026938,74.125.24.0-255,5738,166325,1,218627
5565,0.026945,172.31.36.0-255,66,166391,1,218627
5566,0.029268,74.125.24.0-255,5738,172129,1,218627
5567,0.029275,172.31.36.0-255,66,172195,1,218627
5568,0.03162,74.125.24.0-255,5738,177933,1,218627
5569,0.031626,172.31.36.0-255,66,177999,1,218627
5570,0.033937,74.125.24.0-255,5738,183737,1,218627
5571,0.033944,172.31.36.0-255,66,183803,1,218627
5572,0.036316,74.125.24.0-255,5738,189541,1,218627
5573,0.036323,172.31.36.0-255,66,189607,1,218627
5574,0.038663,74.125.24.0-255,5738,195345,1,218627
5575,0.038669,172.31.36.0-255,66,195411,1,218627
5576,0.041023,74.125.24.0-255,5738,201149,1,218627
5577,0.041032,172.31.36.0-255,66,201215,1,218627
5578,0.043365,74.125.24.0-255,5738,206953,1,218627
5579,0.043371,172.31.36.0-255,66,207019,1,218627
5580,0.045698,74.125.24.0-255,5738,212757,1,218627
5581,0.045705,172.31.36.0-255,66,212823,1,218627
5582,0.048029,74.125.24.0-255,5738,218561,1,218627
5583,0.048035,172.31.36.0-255,66,218627,1,218627
5584,0.0,74.125.68.0-255,150,150,1,251548
5585,2.4e-05,172.31.36.0-255,66,216,1,251548
5586,3.2e-05,74.125.68.0-255,1484,1700,1,251548
5587,3.6e-05,172.31.36.0-255,66,1766,1,251548
5588,4.2e-05,74.125.68.0-255,2902,4668,1,251548
5589,4.6e-05,172.31.36.0-255,66,4734,1,251548
5590,5.2e-05,74.125.68.0-255,4320,9054,1,251548
5591,5.6e-05,172.31.36.0-255,66,9120,1,251548
5592,8.8e-05,74.125.68.0-255,4830,13950,1,251548
5593,9.2e-05,172.31.36.0-255,66,14016,1,251548
5594,0.000382,74.125.68.0-255,1484,15500,1,251548
5595,0.000387,172.31.36.0-255,66,15566,1,251548
5596,0.000394,74.125.68.0-255,2902,18468,1,251548
5597,0.000396,172.31.36.0-255,66,18534,1,251548
5598,0.000404,74.125.68.0-255,5738,24272,1,251548
5599,0.000407,172.31.36.0-255,66,24338,1,251548
5600,0.00045,74.125.68.0-255,6797,31135,1,251548
5601,0.000453,172.31.36.0-255,66,31201,1,251548
5602,0.000458,74.125.68.0-255,2902,34103,1,251548
5603,0.00046,172.31.36.0-255,66,34169,1,251548
5604,0.000493,74.125.68.0-255,4320,38489,1,251548
5605,0.000497,172.31.36.0-255,66,38555,1,251548
5606,0.000509,172.31.36.0-255,66,38621,1,251548
5607,0.000515,74.125.68.0-255,4320,42941,1,251548
5608,0.000517,172.31.36.0-255,66,43007,1,251548
5609,0.000569,74.125.68.0-255,5738,48745,1,251548
5610,0.000573,172.31.36.0-255,66,48811,1,251548
5611,0.000593,172.31.36.0-255,66,48877,1,251548
5612,0.000882,74.125.68.0-255,646,49523,1,251548
5613,0.000887,172.31.36.0-255,66,49589,1,251548
5614,0.001457,74.125.68.0-255,1484,51073,1,251548
5615,0.001469,74.125.68.0-255,2902,53975,1,251548
5616,0.001473,172.31.36.0-255,66,54041,1,251548
5617,0.001479,74.125.68.0-255,2902,56943,1,251548
5618,0.001481,172.31.36.0-255,66,57009,1,251548
5619,0.001487,74.125.68.0-255,2902,59911,1,251548
5620,0.001489,172.31.36.0-255,66,59977,1,251548
5621,0.001505,74.125.68.0-255,1484,61461,1,251548
5622,0.001517,172.31.36.0-255,66,61527,1,251548
5623,0.001523,74.125.68.0-255,2902,64429,1,251548
5624,0.001525,172.31.36.0-255,66,64495,1,251548
5625,0.001555,74.125.68.0-255,2902,67397,1,251548
5626,0.001558,172.31.36.0-255,66,67463,1,251548
5627,0.001565,74.125.68.0-255,7156,74619,1,251548
5628,0.001567,172.31.36.0-255,66,74685,1,251548
5629,0.001571,74.125.68.0-255,766,75451,1,251548
5630,0.001844,74.125.68.0-255,1484,76935,1,251548
5631,0.00185,172.31.36.0-255,66,77001,1,251548
5632,0.001857,74.125.68.0-255,2902,79903,1,251548
5633,0.00186,172.31.36.0-255,66,79969,1,251548
5634,0.001881,74.125.68.0-255,2902,82871,1,251548
5635,0.001883,172.31.36.0-255,66,82937,1,251548
5636,0.001902,74.125.68.0-255,2902,85839,1,251548
5637,0.001904,172.31.36.0-255,66,85905,1,251548
5638,0.001929,74.125.68.0-255,7156,93061,1,251548
5639,0.001931,172.31.36.0-255,66,93127,1,251548
5640,0.001951,74.125.68.0-255,2902,96029,1,251548
5641,0.001953,172.31.36.0-255,66,96095,1,251548
5642,0.00196,74.125.68.0-255,4320,100415,1,251548
5643,0.001961,172.31.36.0-255,66,100481,1,251548
5644,0.001999,74.125.68.0-255,7156,107637,1,251548
5645,0.002001,172.31.36.0-255,66,107703,1,251548
5646,0.002024,74.125.68.0-255,2184,109887,1,251548
5647,0.002026,172.31.36.0-255,66,109953,1,251548
5648,0.004001,74.125.68.0-255,2902,112855,1,251548
5649,0.004005,172.31.36.0-255,66,112921,1,251548
5650,0.004024,74.125.68.0-255,2902,115823,1,251548
5651,0.004027,172.31.36.0-255,66,115889,1,251548
5652,0.00602,74.125.68.0-255,5738,121627,1,251548
5653,0.006026,172.31.36.0-255,66,121693,1,251548
5654,0.008028,74.125.68.0-255,5738,127431,1,251548
5655,0.008036,172.31.36.0-255,66,127497,1,251548
5656,0.010049,74.125.68.0-255,5738,133235,1,251548
5657,0.010056,172.31.36.0-255,66,133301,1,251548
5658,0.012061,74.125.68.0-255,5738,139039,1,251548
5659,0.012069,172.31.36.0-255,66,139105,1,251548
5660,0.01408,74.125.68.0-255,5738,144843,1,251548
5661,0.014088,172.31.36.0-255,66,144909,1,251548
5662,0.016109,74.125.68.0-255,5738,150647,1,251548
5663,0.016122,172.31.36.0-255,66,150713,1,251548
5664,0.018132,74.125.68.0-255,5738,156451,1,251548
5665,0.018141,172.31.36.0-255,66,156517,1,251548
5666,0.020153,74.125.68.0-255,5738,162255,1,251548
5667,0.02016,172.31.36.0-255,66,162321,1,251548
5668,0.022171,74.125.68.0-255,5738,168059,1,251548
5669,0.02218,172.31.36.0-255,66,168125,1,251548
5670,0.024182,74.125.68.0-255,5738,173863,1,251548
5671,0.024191,172.31.36.0-255,66,173929,1,251548
5672,0.026193,74.125.68.0-255,5738,179667,1,251548
5673,0.0262,172.31.36.0-255,66,179733,1,251548
5674,0.028248,74.125.68.0-255,5738,185471,1,251548
5675,0.028255,172.31.36.0-255,66,185537,1,251548
5676,0.030252,74.125.68.0-255,5738,191275,1,251548
5677,0.030259,172.31.36.0-255,66,191341,1,251548
5678,0.032283,74.125.68.0-255,5738,197079,1,251548
5679,0.032291,172.31.36.0-255,66,197145,1,251548
5680,0.034311,74.125.68.0-255,5738,202883,1,251548
5681,0.03432,172.31.36.0-255,66,202949,1,251548
5682,0.036354,74.125.68.0-255,5738,208687,1,251548
5683,0.03637,172.31.36.0-255,66,208753,1,251548
5684,0.038377,74.125.68.0-255,5738,214491,1,251548
5685,0.038386,172.31.36.0-255,66,214557,1,251548
5686,0.040397,74.125.68.0-255,5738,220295,1,251548
5687,0.040405,172.31.36.0-255,66,220361,1,251548
5688,0.042421,74.125.68.0-255,5738,226099,1,251548
5689,0.04243,172.31.36.0-255,66,226165,1,251548
5690,0.043199,172.31.36.0-255,187,226352,1,251548
5691,0.043236,172.31.36.0-255,982,227334,1,251548
5692,0.043313,172.31.36.0-255,1514,228848,1,251548
5693,0.043315,172.31.36.0-255,1514,230362,1,251548
5694,0.043316,172.31.36.0-255,1514,231876,1,251548
5695,0.043342,172.31.36.0-255,1514,233390,1,251548
5696,0.043348,172.31.36.0-255,482,233872,1,251548
5697,0.044444,74.125.68.0-255,5738,239610,1,251548
5698,0.044453,172.31.36.0-255,66,239676,1,251548
5699,0.044758,104.244.42.0-255,66,239742,1,251548
5700,0.044806,104.244.42.0-255,66,239808,1,251548
5701,0.044897,104.244.42.0-255,66,239874,1,251548
5702,0.044905,104.244.42.0-255,66,239940,1,251548
5703,0.046467,74.125.68.0-255,5738,245678,1,251548
5704,0.04648,172.31.36.0-255,66,245744,1,251548
5705,0.048535,74.125.68.0-255,5738,251482,1,251548
5706,0.048547,172.31.36.0-255,66,251548,1,251548
5707,0.0,74.125.130.0-255,148,148,1,236293
5708,2.2e-05,172.31.36.0-255,66,214,1,236293
5709,2.9e-05,74.125.130.0-255,1484,1698,1,236293
5710,3.4e-05,172.31.36.0-255,66,1764,1,236293
5711,4.7e-05,74.125.130.0-255,2902,4666,1,236293
5712,5e-05,172.31.36.0-255,66,4732,1,236293
5713,5.3e-05,74.125.130.0-255,1484,6216,1,236293
5714,5.6e-05,172.31.36.0-255,66,6282,1,236293
5715,6.1e-05,74.125.130.0-255,2902,9184,1,236293
5716,6.3e-05,172.31.36.0-255,66,9250,1,236293
5717,7.1e-05,74.125.130.0-255,6302,15552,1,236293
5718,7.4e-05,172.31.36.0-255,66,15618,1,236293
5719,8.1e-05,74.125.130.0-255,4320,19938,1,236293
5720,8.3e-05,172.31.36.0-255,66,20004,1,236293
5721,9e-05,74.125.130.0-255,5738,25742,1,236293
5722,9.3e-05,172.31.36.0-255,66,25808,1,236293
5723,0.000139,74.125.130.0-255,5379,31187,1,236293
5724,0.000143,172.31.36.0-255,66,31253,1,236293
5725,0.000248,74.125.130.0-255,1484,32737,1,236293
5726,0.000252,172.31.36.0-255,66,32803,1,236293
5727,0.000258,74.125.130.0-255,2902,35705,1,236293
5728,0.00026,172.31.36.0-255,66,35771,1,236293
5729,0.000286,74.125.130.0-255,4320,40091,1,236293
5730,0.000289,172.31.36.0-255,66,40157,1,236293
5731,0.000292,74.125.130.0-255,1484,41641,1,236293
5732,0.000293,172.31.36.0-255,66,41707,1,236293
5733,0.000344,74.125.130.0-255,4320,46027,1,236293
5734,0.000347,172.31.36.0-255,66,46093,1,236293
5735,0.000353,74.125.130.0-255,3961,50054,1,236293
5736,0.000356,172.31.36.0-255,66,50120,1,236293
5737,0.000368,74.125.130.0-255,4320,54440,1,236293
5738,0.00037,172.31.36.0-255,66,54506,1,236293
5739,0.000383,172.31.36.0-255,66,54572,1,236293
5740,0.000386,74.125.130.0-255,1415,55987,1,236293
5741,0.000976,74.125.130.0-255,101,56088,1,236293
5742,0.001061,172.31.36.0-255,66,56154,1,236293
5743,0.001138,74.125.130.0-255,1484,57638,1,236293
5744,0.001144,74.125.130.0-255,1484,59122,1,236293
5745,0.001147,172.31.36.0-255,66,59188,1,236293
5746,0.001175,74.125.130.0-255,1484,60672,1,236293
5747,0.001182,74.125.130.0-255,5738,66410,1,236293
5748,0.001185,172.31.36.0-255,66,66476,1,236293
5749,0.001193,74.125.130.0-255,6797,73273,1,236293
5750,0.001195,172.31.36.0-255,66,73339,1,236293
5751,0.001202,74.125.130.0-255,1484,74823,1,236293
5752,0.001233,74.125.130.0-255,5738,80561,1,236293
5753,0.001236,172.31.36.0-255,66,80627,1,236293
5754,0.001247,172.31.36.0-255,66,80693,1,236293
5755,0.001284,74.125.130.0-255,1125,81818,1,236293
5756,0.001952,74.125.130.0-255,1484,83302,1,236293
5757,0.001959,172.31.36.0-255,66,83368,1,236293
5758,0.001966,74.125.130.0-255,2902,86270,1,236293
5759,0.001969,172.31.36.0-255,66,86336,1,236293
5760,0.001975,74.125.130.0-255,4320,90656,1,236293
5761,0.001976,172.31.36.0-255,66,90722,1,236293
5762,0.002005,74.125.130.0-255,1484,92206,1,236293
5763,0.002012,74.125.130.0-255,5738,97944,1,236293
5764,0.002014,172.31.36.0-255,66,98010,1,236293
5765,0.002026,74.125.130.0-255,7156,105166,1,236293
5766,0.002028,172.31.36.0-255,66,105232,1,236293
5767,0.002079,172.31.36.0-255,66,105298,1,236293
5768,0.004308,74.125.130.0-255,5738,111036,1,236293
5769,0.004311,172.31.36.0-255,66,111102,1,236293
5770,0.006547,74.125.130.0-255,5738,116840,1,236293
5771,0.006552,172.31.36.0-255,66,116906,1,236293
5772,0.008785,74.125.130.0-255,5738,122644,1,236293
5773,0.008793,172.31.36.0-255,66,122710,1,236293
5774,0.011035,74.125.130.0-255,5738,128448,1,236293
5775,0.011042,172.31.36.0-255,66,128514,1,236293
5776,0.01331,74.125.130.0-255,5738,134252,1,236293
5777,0.013318,172.31.36.0-255,66,134318,1,236293
5778,0.015571,74.125.130.0-255,5738,140056,1,236293
5779,0.01558,172.31.36.0-255,66,140122,1,236293
5780,0.017836,74.125.130.0-255,5738,145860,1,236293
5781,0.017845,172.31.36.0-255,66,145926,1,236293
5782,0.020092,74.125.130.0-255,5738,151664,1,236293
5783,0.0201,172.31.36.0-255,66,151730,1,236293
5784,0.022336,74.125.130.0-255,5738,157468,1,236293
5785,0.022342,172.31.36.0-255,66,157534,1,236293
5786,0.02459,74.125.130.0-255,5738,163272,1,236293
5787,0.024596,172.31.36.0-255,66,163338,1,236293
5788,0.026834,74.125.130.0-255,5738,169076,1,236293
5789,0.026843,172.31.36.0-255,66,169142,1,236293
5790,0.029097,74.125.130.0-255,5738,174880,1,236293
5791,0.029105,172.31.36.0-255,66,174946,1,236293
5792,0.031394,74.125.130.0-255,5738,180684,1,236293
5793,0.0314,172.31.36.0-255,66,180750,1,236293
5794,0.033637,74.125.130.0-255,5738,186488,1,236293
5795,0.033645,172.31.36.0-255,66,186554,1,236293
5796,0.033976,172.31.36.0-255,172,186726,1,236293
5797,0.034002,172.31.36.0-255,1112,187838,1,236293
5798,0.034067,172.31.36.0-255,1514,189352,1,236293
5799,0.034069,172.31.36.0-255,1514,190866,1,236293
5800,0.034074,172.31.36.0-255,1514,192380,1,236293
5801,0.034075,172.31.36.0-255,1514,193894,1,236293
5802,0.034093,172.31.36.0-255,1507,195401,1,236293
5803,0.0355,104.244.42.0-255,66,195467,1,236293
5804,0.035508,104.244.42.0-255,66,195533,1,236293
5805,0.035612,104.244.42.0-255,66,195599,1,236293
5806,0.035705,104.244.42.0-255,66,195665,1,236293
5807,0.035899,74.125.130.0-255,5738,201403,1,236293
5808,0.035906,172.31.36.0-255,66,201469,1,236293
5809,0.038158,74.125.130.0-255,5738,207207,1,236293
5810,0.038165,172.31.36.0-255,66,207273,1,236293
5811,0.040424,74.125.130.0-255,5738,213011,1,236293
5812,0.040433,172.31.36.0-255,66,213077,1,236293
5813,0.042682,74.125.130.0-255,5738,218815,1,236293
5814,0.042688,172.31.36.0-255,66,218881,1,236293
5815,0.044938,74.125.130.0-255,5738,224619,1,236293
5816,0.044944,172.31.36.0-255,66,224685,1,236293
5817,0.04719,74.125.130.0-255,5738,230423,1,236293
5818,0.047199,172.31.36.0-255,66,230489,1,236293
5819,0.049441,74.125.130.0-255,5738,236227,1,236293
5820,0.049448,172.31.36.0-255,66,236293,1,236293
5821,0.0,74.125.24.0-255,153,153,1,279107
5822,2.2e-05,172.31.36.0-255,66,219,1,279107
5823,3e-05,74.125.24.0-255,1484,1703,1,279107
5824,3.4e-05,172.31.36.0-255,66,1769,1,279107
5825,4.9e-05,74.125.24.0-255,2902,4671,1,279107
5826,5.3e-05,172.31.36.0-255,66,4737,1,279107
5827,6.1e-05,74.125.24.0-255,7156,11893,1,279107
5828,6.5e-05,172.31.36.0-255,66,11959,1,279107
5829,6.9e-05,74.125.24.0-255,2034,13993,1,279107
5830,7.3e-05,172.31.36.0-255,66,14059,1,279107
5831,0.000342,74.125.24.0-255,1484,15543,1,279107
5832,0.000348,172.31.36.0-255,66,15609,1,279107
5833,0.000355,74.125.24.0-255,2902,18511,1,279107
5834,0.000358,172.31.36.0-255,66,18577,1,279107
5835,0.000363,74.125.24.0-255,2902,21479,1,279107
5836,0.000371,172.31.36.0-255,66,21545,1,279107
5837,0.000397,74.125.24.0-255,2902,24447,1,279107
5838,0.000399,172.31.36.0-255,66,24513,1,279107
5839,0.000426,74.125.24.0-255,4320,28833,1,279107
5840,0.000428,172.31.36.0-255,66,28899,1,279107
5841,0.000463,74.125.24.0-255,6797,35696,1,279107
5842,0.000466,172.31.36.0-255,66,35762,1,279107
5843,0.000501,172.31.36.0-255,66,35828,1,279107
5844,0.000538,172.31.36.0-255,66,35894,1,279107
5845,0.000545,74.125.24.0-255,6732,42626,1,279107
5846,0.000548,172.31.36.0-255,66,42692,1,279107
5847,0.000551,74.125.24.0-255,131,42823,1,279107
5848,0.000553,172.31.36.0-255,66,42889,1,279107
5849,0.000556,74.125.24.0-255,349,43238,1,279107
5850,0.000558,172.31.36.0-255,66,43304,1,279107
5851,0.000784,74.125.24.0-255,1484,44788,1,279107
5852,0.00079,74.125.24.0-255,1484,46272,1,279107
5853,0.000795,172.31.36.0-255,66,46338,1,279107
5854,0.000815,74.125.24.0-255,1484,47822,1,279107
5855,0.000821,74.125.24.0-255,5738,53560,1,279107
5856,0.000839,74.125.24.0-255,4320,57880,1,279107
5857,0.000853,74.125.24.0-255,5738,63618,1,279107
5858,0.000857,172.31.36.0-255,66,63684,1,279107
5859,0.000862,172.31.36.0-255,66,63750,1,279107
5860,0.000885,74.125.24.0-255,2902,66652,1,279107
5861,0.00089,74.125.24.0-255,2902,69554,1,279107
5862,0.000915,172.31.36.0-255,66,69620,1,279107
5863,0.00093,172.31.36.0-255,66,69686,1,279107
5864,0.001625,74.125.24.0-255,1484,71170,1,279107
5865,0.001635,74.125.24.0-255,2902,74072,1,279107
5866,0.001638,172.31.36.0-255,66,74138,1,279107
5867,0.001643,74.125.24.0-255,1484,75622,1,279107
5868,0.001672,74.125.24.0-255,4320,79942,1,279107
5869,0.001675,172.31.36.0-255,66,80008,1,279107
5870,0.001682,74.125.24.0-255,5738,85746,1,279107
5871,0.001685,172.31.36.0-255,66,85812,1,279107
5872,0.001712,74.125.24.0-255,4320,90132,1,279107
5873,0.001732,74.125.24.0-255,1484,91616,1,279107
5874,0.001752,74.125.24.0-255,7156,98772,1,279107
5875,0.001771,74.125.24.0-255,4320,103092,1,279107
5876,0.001774,74.125.24.0-255,766,103858,1,279107
5877,0.001953,74.125.24.0-255,1484,105342,1,279107
5878,0.001959,74.125.24.0-255,2902,108244,1,279107
5879,0.001978,74.125.24.0-255,5738,113982,1,279107
5880,0.002019,74.125.24.0-255,4320,118302,1,279107
5881,0.00206,74.125.24.0-255,5738,124040,1,279107
5882,0.002071,74.125.24.0-255,766,124806,1,279107
5883,0.002206,74.125.24.0-255,1484,126290,1,279107
5884,0.002214,74.125.24.0-255,2902,129192,1,279107
5885,0.002217,74.125.24.0-255,1484,130676,1,279107
5886,0.002237,74.125.24.0-255,4320,134996,1,279107
5887,0.002242,74.125.24.0-255,2902,137898,1,279107
5888,0.002294,74.125.24.0-255,2184,140082,1,279107
5889,0.002332,74.125.24.0-255,7156,147238,1,279107
5890,0.002372,74.125.24.0-255,5738,152976,1,279107
5891,0.002424,74.125.24.0-255,4320,157296,1,279107
5892,0.002451,74.125.24.0-255,4320,161616,1,279107
5893,0.002539,74.125.24.0-255,2902,164518,1,279107
5894,0.002543,74.125.24.0-255,4320,168838,1,279107
5895,0.002569,74.125.24.0-255,4320,173158,1,279107
5896,0.002608,74.125.24.0-255,1484,174642,1,279107
5897,0.00263,74.125.24.0-255,2184,176826,1,279107
5898,0.005503,172.31.36.0-255,66,176892,1,279107
5899,0.008293,74.125.24.0-255,5738,182630,1,279107
5900,0.0083,172.31.36.0-255,66,182696,1,279107
5901,0.010929,74.125.24.0-255,5738,188434,1,279107
5902,0.010935,172.31.36.0-255,66,188500,1,279107
5903,0.01354,74.125.24.0-255,5738,194238,1,279107
5904,0.013549,172.31.36.0-255,66,194304,1,279107
5905,0.016142,74.125.24.0-255,5738,200042,1,279107
5906,0.01615,172.31.36.0-255,66,200108,1,279107
5907,0.018763,74.125.24.0-255,5738,205846,1,279107
5908,0.018774,172.31.36.0-255,66,205912,1,279107
5909,0.021391,74.125.24.0-255,5738,211650,1,279107
5910,0.021401,172.31.36.0-255,66,211716,1,279107
5911,0.024029,74.125.24.0-255,5738,217454,1,279107
5912,0.02404,172.31.36.0-255,66,217520,1,279107
5913,0.026653,74.125.24.0-255,5738,223258,1,279107
5914,0.026661,172.31.36.0-255,66,223324,1,279107
5915,0.029272,74.125.24.0-255,5738,229062,1,279107
5916,0.02928,172.31.36.0-255,66,229128,1,279107
5917,0.031886,74.125.24.0-255,5738,234866,1,279107
5918,0.031894,172.31.36.0-255,66,234932,1,279107
5919,0.034511,74.125.24.0-255,5738,240670,1,279107
5920,0.03452,172.31.36.0-255,66,240736,1,279107
5921,0.037149,74.125.24.0-255,5738,246474,1,279107
5922,0.03716,172.31.36.0-255,66,246540,1,279107
5923,0.039763,74.125.24.0-255,5738,252278,1,279107
5924,0.039773,172.31.36.0-255,66,252344,1,279107
5925,0.040793,172.31.36.0-255,188,252532,1,279107
5926,0.040823,172.31.36.0-255,958,253490,1,279107
5927,0.040892,172.31.36.0-255,1514,255004,1,279107
5928,0.040894,172.31.36.0-255,1514,256518,1,279107
5929,0.040895,172.31.36.0-255,1514,258032,1,279107
5930,0.040896,172.31.36.0-255,1514,259546,1,279107
5931,0.040925,172.31.36.0-255,1514,261060,1,279107
5932,0.040931,172.31.36.0-255,197,261257,1,279107
5933,0.042319,104.244.42.0-255,66,261323,1,279107
5934,0.042372,74.125.24.0-255,5738,267061,1,279107
5935,0.042385,172.31.36.0-255,66,267127,1,279107
5936,0.04239,104.244.42.0-255,66,267193,1,279107
5937,0.042492,104.244.42.0-255,66,267259,1,279107
5938,0.042497,104.244.42.0-255,66,267325,1,279107
5939,0.043632,104.244.42.0-255,108,267433,1,279107
5940,0.043641,172.31.36.0-255,66,267499,1,279107
5941,0.045004,74.125.24.0-255,5738,273237,1,279107
5942,0.04501,172.31.36.0-255,66,273303,1,279107
5943,0.047647,74.125.24.0-255,5738,279041,1,279107
5944,0.047654,172.31.36.0-255,66,279107,1,279107
5945,0.0,74.125.24.0-255,290,290,1,270726
5946,3.3e-05,172.31.36.0-255,66,356,1,270726
5947,3.9e-05,74.125.24.0-255,1484,1840,1,270726
5948,4.2e-05,172.31.36.0-255,66,1906,1,270726
5949,4.9e-05,74.125.24.0-255,4320,6226,1,270726
5950,6e-05,172.31.36.0-255,66,6292,1,270726
5951,6.6e-05,74.125.24.0-255,5738,12030,1,270726
5952,6.9e-05,172.31.36.0-255,66,12096,1,270726
5953,9.9e-05,74.125.24.0-255,3231,15327,1,270726
5954,0.000103,172.31.36.0-255,66,15393,1,270726
5955,0.000116,74.125.24.0-255,7156,22549,1,270726
5956,0.000119,172.31.36.0-255,66,22615,1,270726
5957,0.000146,74.125.24.0-255,7156,29771,1,270726
5958,0.000149,172.31.36.0-255,66,29837,1,270726
5959,0.000171,74.125.24.0-255,1125,30962,1,270726
5960,0.000174,172.31.36.0-255,66,31028,1,270726
5961,0.000652,74.125.24.0-255,1484,32512,1,270726
5962,0.000658,172.31.36.0-255,66,32578,1,270726
5963,0.000668,74.125.24.0-255,2902,35480,1,270726
5964,0.000676,172.31.36.0-255,66,35546,1,270726
5965,0.000706,74.125.24.0-255,5738,41284,1,270726
5966,0.00071,172.31.36.0-255,66,41350,1,270726
5967,0.000715,74.125.24.0-255,2902,44252,1,270726
5968,0.000717,172.31.36.0-255,66,44318,1,270726
5969,0.000737,74.125.24.0-255,4320,48638,1,270726
5970,0.000745,172.31.36.0-255,66,48704,1,270726
5971,0.000751,74.125.24.0-255,4320,53024,1,270726
5972,0.000754,172.31.36.0-255,66,53090,1,270726
5973,0.000794,172.31.36.0-255,66,53156,1,270726
5974,0.000802,74.125.24.0-255,7156,60312,1,270726
5975,0.000806,172.31.36.0-255,66,60378,1,270726
5976,0.000835,74.125.24.0-255,6438,66816,1,270726
5977,0.00084,172.31.36.0-255,66,66882,1,270726
5978,0.000854,172.31.36.0-255,66,66948,1,270726
5979,0.000864,172.31.36.0-255,66,67014,1,270726
5980,0.000918,74.125.24.0-255,1347,68361,1,270726
5981,0.000944,74.125.24.0-255,1484,69845,1,270726
5982,0.000947,172.31.36.0-255,66,69911,1,270726
5983,0.000952,74.125.24.0-255,2902,72813,1,270726
5984,0.000955,172.31.36.0-255,66,72879,1,270726
5985,0.000982,74.125.24.0-255,5738,78617,1,270726
5986,0.000985,172.31.36.0-255,66,78683,1,270726
5987,0.001023,172.31.36.0-255,66,78749,1,270726
5988,0.001059,172.31.36.0-255,66,78815,1,270726
5989,0.001063,74.125.24.0-255,2184,80999,1,270726
5990,0.001065,172.31.36.0-255,66,81065,1,270726
5991,0.001703,74.125.24.0-255,1484,82549,1,270726
5992,0.001724,74.125.24.0-255,2902,85451,1,270726
5993,0.001729,172.31.36.0-255,66,85517,1,270726
5994,0.001736,74.125.24.0-255,5738,91255,1,270726
5995,0.001738,172.31.36.0-255,66,91321,1,270726
5996,0.00175,74.125.24.0-255,7156,98477,1,270726
5997,0.001753,172.31.36.0-255,66,98543,1,270726
5998,0.001782,74.125.24.0-255,5738,104281,1,270726
5999,0.001789,172.31.36.0-255,66,104347,1,270726
6000,0.0018,172.31.36.0-255,66,104413,1,270726
6001,0.001829,74.125.24.0-255,1484,105897,1,270726
6002,0.001833,74.125.24.0-255,2902,108799,1,270726
6003,0.001836,172.31.36.0-255,66,108865,1,270726
6004,0.001839,74.125.24.0-255,1484,110349,1,270726
6005,0.001866,74.125.24.0-255,4320,114669,1,270726
6006,0.001869,172.31.36.0-255,66,114735,1,270726
6007,0.001876,74.125.24.0-255,5738,120473,1,270726
6008,0.001878,172.31.36.0-255,66,120539,1,270726
6009,0.001916,172.31.36.0-255,66,120605,1,270726
6010,0.001923,74.125.24.0-255,5020,125625,1,270726
6011,0.001925,172.31.36.0-255,66,125691,1,270726
6012,0.00198,74.125.24.0-255,1484,127175,1,270726
6013,0.00201,74.125.24.0-255,2902,130077,1,270726
6014,0.002014,172.31.36.0-255,66,130143,1,270726
6015,0.002019,74.125.24.0-255,2902,133045,1,270726
6016,0.002022,172.31.36.0-255,66,133111,1,270726
6017,0.00203,74.125.24.0-255,1484,134595,1,270726
6018,0.002052,74.125.24.0-255,5738,140333,1,270726
6019,0.002056,172.31.36.0-255,66,140399,1,270726
6020,0.002098,172.31.36.0-255,66,140465,1,270726
6021,0.00211,74.125.24.0-255,1484,141949,1,270726
6022,0.002121,74.125.24.0-255,3602,145551,1,270726
6023,0.002125,172.31.36.0-255,66,145617,1,270726
6024,0.004447,74.125.24.0-255,5738,151355,1,270726
6025,0.004452,172.31.36.0-255,66,151421,1,270726
6026,0.006757,74.125.24.0-255,5738,157159,1,270726
6027,0.006765,172.31.36.0-255,66,157225,1,270726
6028,0.009088,74.125.24.0-255,5738,162963,1,270726
6029,0.009105,172.31.36.0-255,66,163029,1,270726
6030,0.011401,74.125.24.0-255,5738,168767,1,270726
6031,0.011409,172.31.36.0-255,66,168833,1,270726
6032,0.013734,74.125.24.0-255,5738,174571,1,270726
6033,0.013746,172.31.36.0-255,66,174637,1,270726
6034,0.016056,74.125.24.0-255,5738,180375,1,270726
6035,0.016068,172.31.36.0-255,66,180441,1,270726
6036,0.018375,74.125.24.0-255,5738,186179,1,270726
6037,0.018384,172.31.36.0-255,66,186245,1,270726
6038,0.020702,74.125.24.0-255,5738,191983,1,270726
6039,0.020714,172.31.36.0-255,66,192049,1,270726
6040,0.023023,74.125.24.0-255,5738,197787,1,270726
6041,0.023033,172.31.36.0-255,66,197853,1,270726
6042,0.025316,74.125.24.0-255,5738,203591,1,270726
6043,0.025326,172.31.36.0-255,66,203657,1,270726
6044,0.027628,74.125.24.0-255,5738,209395,1,270726
6045,0.027636,172.31.36.0-255,66,209461,1,270726
6046,0.029927,74.125.24.0-255,5738,215199,1,270726
6047,0.029937,172.31.36.0-255,66,215265,1,270726
6048,0.032223,74.125.24.0-255,5738,221003,1,270726
6049,0.032231,172.31.36.0-255,66,221069,1,270726
6050,0.034536,74.125.24.0-255,5738,226807,1,270726
6051,0.034543,172.31.36.0-255,66,226873,1,270726
6052,0.034884,172.31.36.0-255,172,227045,1,270726
6053,0.034913,172.31.36.0-255,1116,228161,1,270726
6054,0.034967,172.31.36.0-255,1514,229675,1,270726
6055,0.03497,172.31.36.0-255,1514,231189,1,270726
6056,0.034971,172.31.36.0-255,1514,232703,1,270726
6057,0.034976,172.31.36.0-255,1514,234217,1,270726
6058,0.034977,172.31.36.0-255,1487,235704,1,270726
6059,0.036435,104.244.42.0-255,66,235770,1,270726
6060,0.036477,104.244.42.0-255,66,235836,1,270726
6061,0.036517,104.244.42.0-255,66,235902,1,270726
6062,0.036856,74.125.24.0-255,5738,241640,1,270726
6063,0.036861,172.31.36.0-255,66,241706,1,270726
6064,0.039166,74.125.24.0-255,5738,247444,1,270726
6065,0.039172,172.31.36.0-255,66,247510,1,270726
6066,0.041458,74.125.24.0-255,5738,253248,1,270726
6067,0.041481,172.31.36.0-255,66,253314,1,270726
6068,0.04378,74.125.24.0-255,5738,259052,1,270726
6069,0.043785,172.31.36.0-255,66,259118,1,270726
6070,0.046095,74.125.24.0-255,5738,264856,1,270726
6071,0.0461,172.31.36.0-255,66,264922,1,270726
6072,0.048411,74.125.24.0-255,5738,270660,1,270726
6073,0.048417,172.31.36.0-255,66,270726,1,270726
6074,0.0,74.125.24.0-255,153,153,1,270783
6075,1.7e-05,172.31.36.0-255,66,219,1,270783
6076,2.4e-05,74.125.24.0-255,1484,1703,1,270783
6077,2.9e-05,172.31.36.0-255,66,1769,1,270783
6078,3.7e-05,74.125.24.0-255,2902,4671,1,270783
6079,4e-05,172.31.36.0-255,66,4737,1,270783
6080,4.8e-05,74.125.24.0-255,7156,11893,1,270783
6081,5.3e-05,172.31.36.0-255,66,11959,1,270783
6082,7.3e-05,74.125.24.0-255,2013,13972,1,270783
6083,7.6e-05,172.31.36.0-255,66,14038,1,270783
6084,0.000192,74.125.24.0-255,1484,15522,1,270783
6085,0.000196,172.31.36.0-255,66,15588,1,270783
6086,0.000202,74.125.24.0-255,2902,18490,1,270783
6087,0.000205,172.31.36.0-255,66,18556,1,270783
6088,0.000222,74.125.24.0-255,5738,24294,1,270783
6089,0.000225,172.31.36.0-255,66,24360,1,270783
6090,0.000269,74.125.24.0-255,5738,30098,1,270783
6091,0.000272,172.31.36.0-255,66,30164,1,270783
6092,0.000289,74.125.24.0-255,5379,35543,1,270783
6093,0.000292,172.31.36.0-255,66,35609,1,270783
6094,0.000298,74.125.24.0-255,4320,39929,1,270783
6095,0.0003,172.31.36.0-255,66,39995,1,270783
6096,0.00032,74.125.24.0-255,4320,44315,1,270783
6097,0.000323,172.31.36.0-255,66,44381,1,270783
6098,0.000346,74.125.24.0-255,3961,48342,1,270783
6099,0.000349,172.31.36.0-255,66,48408,1,270783
6100,0.000355,74.125.24.0-255,4320,52728,1,270783
6101,0.000357,172.31.36.0-255,66,52794,1,270783
6102,0.000373,74.125.24.0-255,4320,57114,1,270783
6103,0.000376,172.31.36.0-255,66,57180,1,270783
6104,0.000383,74.125.24.0-255,5738,62918,1,270783
6105,0.000386,172.31.36.0-255,66,62984,1,270783
6106,0.000402,74.125.24.0-255,2852,65836,1,270783
6107,0.000406,74.125.24.0-255,109,65945,1,270783
6108,0.000464,172.31.36.0-255,66,66011,1,270783
6109,0.000504,74.125.24.0-255,1484,67495,1,270783
6110,0.000509,74.125.24.0-255,2902,70397,1,270783
6111,0.000529,74.125.24.0-255,2902,73299,1,270783
6112,0.000536,74.125.24.0-255,7156,80455,1,270783
6113,0.000549,172.31.36.0-255,66,80521,1,270783
6114,0.000577,74.125.24.0-255,2902,83423,1,270783
6115,0.000582,172.31.36.0-255,66,83489,1,270783
6116,0.000591,74.125.24.0-255,2543,86032,1,270783
6117,0.000596,74.125.24.0-255,5738,91770,1,270783
6118,0.000619,172.31.36.0-255,66,91836,1,270783
6119,0.000656,172.31.36.0-255,66,91902,1,270783
6120,0.000785,74.125.24.0-255,1484,93386,1,270783
6121,0.000791,74.125.24.0-255,2902,96288,1,270783
6122,0.000811,74.125.24.0-255,5738,102026,1,270783
6123,0.000819,172.31.36.0-255,66,102092,1,270783
6124,0.000829,74.125.24.0-255,4320,106412,1,270783
6125,0.000834,172.31.36.0-255,66,106478,1,270783
6126,0.000869,172.31.36.0-255,66,106544,1,270783
6127,0.000879,74.125.24.0-255,2902,109446,1,270783
6128,0.00091,172.31.36.0-255,66,109512,1,270783
6129,0.000915,172.31.36.0-255,66,109578,1,270783
6130,0.001174,74.125.24.0-255,1484,111062,1,270783
6131,0.001179,74.125.24.0-255,1484,112546,1,270783
6132,0.001182,172.31.36.0-255,66,112612,1,270783
6133,0.001203,74.125.24.0-255,1484,114096,1,270783
6134,0.00121,74.125.24.0-255,5738,119834,1,270783
6135,0.001242,172.31.36.0-255,66,119900,1,270783
6136,0.001271,74.125.24.0-255,5738,125638,1,270783
6137,0.001277,74.125.24.0-255,5020,130658,1,270783
6138,0.001297,172.31.36.0-255,66,130724,1,270783
6139,0.003625,74.125.24.0-255,1484,132208,1,270783
6140,0.003634,74.125.24.0-255,2902,135110,1,270783
6141,0.003639,172.31.36.0-255,66,135176,1,270783
6142,0.003644,74.125.24.0-255,1484,136660,1,270783
6143,0.005712,74.125.24.0-255,4320,140980,1,270783
6144,0.005717,172.31.36.0-255,66,141046,1,270783
6145,0.007787,74.125.24.0-255,5738,146784,1,270783
6146,0.007795,172.31.36.0-255,66,146850,1,270783
6147,0.009864,74.125.24.0-255,5738,152588,1,270783
6148,0.009872,172.31.36.0-255,66,152654,1,270783
6149,0.011925,74.125.24.0-255,5738,158392,1,270783
6150,0.011934,172.31.36.0-255,66,158458,1,270783
6151,0.014004,74.125.24.0-255,5738,164196,1,270783
6152,0.014014,172.31.36.0-255,66,164262,1,270783
6153,0.01609,74.125.24.0-255,5738,170000,1,270783
6154,0.016101,172.31.36.0-255,66,170066,1,270783
6155,0.018164,74.125.24.0-255,5738,175804,1,270783
6156,0.018174,172.31.36.0-255,66,175870,1,270783
6157,0.02025,74.125.24.0-255,5738,181608,1,270783
6158,0.020259,172.31.36.0-255,66,181674,1,270783
6159,0.022304,74.125.24.0-255,5738,187412,1,270783
6160,0.022312,172.31.36.0-255,66,187478,1,270783
6161,0.024375,74.125.24.0-255,5738,193216,1,270783
6162,0.024383,172.31.36.0-255,66,193282,1,270783
6163,0.026444,74.125.24.0-255,5738,199020,1,270783
6164,0.026451,172.31.36.0-255,66,199086,1,270783
6165,0.028508,74.125.24.0-255,5738,204824,1,270783
6166,0.028516,172.31.36.0-255,66,204890,1,270783
6167,0.030569,74.125.24.0-255,5738,210628,1,270783
6168,0.030578,172.31.36.0-255,66,210694,1,270783
6169,0.032662,74.125.24.0-255,5738,216432,1,270783
6170,0.03267,172.31.36.0-255,66,216498,1,270783
6171,0.034727,74.125.24.0-255,5738,222236,1,270783
6172,0.034734,172.31.36.0-255,66,222302,1,270783
6173,0.036803,74.125.24.0-255,5738,228040,1,270783
6174,0.036812,172.31.36.0-255,66,228106,1,270783
6175,0.038807,172.31.36.0-255,172,228278,1,270783
6176,0.038841,74.125.24.0-255,4320,232598,1,270783
6177,0.038847,172.31.36.0-255,66,232664,1,270783
6178,0.038863,74.125.24.0-255,1484,234148,1,270783
6179,0.038879,172.31.36.0-255,1116,235264,1,270783
6180,0.039023,172.31.36.0-255,1514,236778,1,270783
6181,0.039025,172.31.36.0-255,1514,238292,1,270783
6182,0.039026,172.31.36.0-255,1514,239806,1,270783
6183,0.039031,172.31.36.0-255,1514,241320,1,270783
6184,0.039032,172.31.36.0-255,1489,242809,1,270783
6185,0.040351,104.244.42.0-255,66,242875,1,270783
6186,0.040437,104.244.42.0-255,66,242941,1,270783
6187,0.040701,104.244.42.0-255,66,243007,1,270783
6188,0.040918,74.125.24.0-255,4320,247327,1,270783
6189,0.040924,172.31.36.0-255,66,247393,1,270783
6190,0.041248,104.244.42.0-255,108,247501,1,270783
6191,0.041257,172.31.36.0-255,66,247567,1,270783
6192,0.04299,74.125.24.0-255,5738,253305,1,270783
6193,0.042996,172.31.36.0-255,66,253371,1,270783
6194,0.045074,74.125.24.0-255,5738,259109,1,270783
6195,0.045081,172.31.36.0-255,66,259175,1,270783
6196,0.047156,74.125.24.0-255,5738,264913,1,270783
6197,0.047162,172.31.36.0-255,66,264979,1,270783
6198,0.049215,74.125.24.0-255,5738,270717,1,270783
6199,0.049222,172.31.36.0-255,66,270783,1,270783
6200,0.0,74.125.24.0-255,146,146,1,281001
6201,2.6e-05,172.31.36.0-255,66,212,1,281001
6202,3.3e-05,74.125.24.0-255,1484,1696,1,281001
6203,3.7e-05,172.31.36.0-255,66,1762,1,281001
6204,4.2e-05,74.125.24.0-255,2902,4664,1,281001
6205,4.4e-05,172.31.36.0-255,66,4730,1,281001
6206,4.7e-05,74.125.24.0-255,1484,6214,1,281001
6207,4.9e-05,172.31.36.0-255,66,6280,1,281001
6208,7.7e-05,74.125.24.0-255,5738,12018,1,281001
6209,8e-05,172.31.36.0-255,66,12084,1,281001
6210,9e-05,172.31.36.0-255,66,12150,1,281001
6211,9.3e-05,74.125.24.0-255,1484,13634,1,281001
6212,9.4e-05,172.31.36.0-255,66,13700,1,281001
6213,0.000117,172.31.36.0-255,66,13766,1,281001
6214,0.000212,74.125.24.0-255,1484,15250,1,281001
6215,0.000216,172.31.36.0-255,66,15316,1,281001
6216,0.00022,74.125.24.0-255,1484,16800,1,281001
6217,0.000221,172.31.36.0-255,66,16866,1,281001
6218,0.000232,74.125.24.0-255,1484,18350,1,281001
6219,0.000234,172.31.36.0-255,66,18416,1,281001
6220,0.000246,74.125.24.0-255,2902,21318,1,281001
6221,0.000249,172.31.36.0-255,66,21384,1,281001
6222,0.000265,74.125.24.0-255,2902,24286,1,281001
6223,0.000268,172.31.36.0-255,66,24352,1,281001
6224,0.000272,74.125.24.0-255,2902,27254,1,281001
6225,0.000274,172.31.36.0-255,66,27320,1,281001
6226,0.000307,74.125.24.0-255,2902,30222,1,281001
6227,0.000311,172.31.36.0-255,66,30288,1,281001
6228,0.000342,172.31.36.0-255,66,30354,1,281001
6229,0.000347,74.125.24.0-255,4320,34674,1,281001
6230,0.000349,172.31.36.0-255,66,34740,1,281001
6231,0.000396,74.125.24.0-255,4320,39060,1,281001
6232,0.000399,172.31.36.0-255,66,39126,1,281001
6233,0.000417,74.125.24.0-255,1401,40527,1,281001
6234,0.000421,74.125.24.0-255,132,40659,1,281001
6235,0.000478,74.125.24.0-255,1484,42143,1,281001
6236,0.000483,172.31.36.0-255,66,42209,1,281001
6237,0.000493,74.125.24.0-255,2902,45111,1,281001
6238,0.000495,172.31.36.0-255,66,45177,1,281001
6239,0.000521,74.125.24.0-255,5738,50915,1,281001
6240,0.000525,172.31.36.0-255,66,50981,1,281001
6241,0.000559,74.125.24.0-255,1484,52465,1,281001
6242,0.000575,74.125.24.0-255,5077,57542,1,281001
6243,0.000579,172.31.36.0-255,66,57608,1,281001
6244,0.000617,74.125.24.0-255,1484,59092,1,281001
6245,0.000623,74.125.24.0-255,2902,61994,1,281001
6246,0.000627,172.31.36.0-255,66,62060,1,281001
6247,0.000643,74.125.24.0-255,4320,66380,1,281001
6248,0.000646,172.31.36.0-255,66,66446,1,281001
6249,0.000665,74.125.24.0-255,1484,67930,1,281001
6250,0.000672,74.125.24.0-255,7156,75086,1,281001
6251,0.000675,172.31.36.0-255,66,75152,1,281001
6252,0.000682,74.125.24.0-255,5738,80890,1,281001
6253,0.000685,172.31.36.0-255,66,80956,1,281001
6254,0.000705,172.31.36.0-255,66,81022,1,281001
6255,0.000715,74.125.24.0-255,2184,83206,1,281001
6256,0.000717,172.31.36.0-255,66,83272,1,281001
6257,0.00104,74.125.24.0-255,1484,84756,1,281001
6258,0.001046,74.125.24.0-255,2902,87658,1,281001
6259,0.001049,172.31.36.0-255,66,87724,1,281001
6260,0.001053,74.125.24.0-255,2902,90626,1,281001
6261,0.001055,172.31.36.0-255,66,90692,1,281001
6262,0.00107,74.125.24.0-255,2902,93594,1,281001
6263,0.001073,172.31.36.0-255,66,93660,1,281001
6264,0.001076,74.125.24.0-255,1484,95144,1,281001
6265,0.001113,172.31.36.0-255,66,95210,1,281001
6266,0.001116,74.125.24.0-255,1484,96694,1,281001
6267,0.001142,172.31.36.0-255,66,96760,1,281001
6268,0.001815,74.125.24.0-255,1484,98244,1,281001
6269,0.001827,74.125.24.0-255,2902,101146,1,281001
6270,0.001831,172.31.36.0-255,66,101212,1,281001
6271,0.001837,74.125.24.0-255,5738,106950,1,281001
6272,0.001839,172.31.36.0-255,66,107016,1,281001
6273,0.001858,74.125.24.0-255,5738,112754,1,281001
6274,0.00186,172.31.36.0-255,66,112820,1,281001
6275,0.00188,74.125.24.0-255,7156,119976,1,281001
6276,0.001882,172.31.36.0-255,66,120042,1,281001
6277,0.001888,74.125.24.0-255,5738,125780,1,281001
6278,0.001889,172.31.36.0-255,66,125846,1,281001
6279,0.001907,74.125.24.0-255,2902,128748,1,281001
6280,0.00191,172.31.36.0-255,66,128814,1,281001
6281,0.001914,74.125.24.0-255,2184,130998,1,281001
6282,0.001916,172.31.36.0-255,66,131064,1,281001
6283,0.002066,74.125.24.0-255,1484,132548,1,281001
6284,0.002072,74.125.24.0-255,2902,135450,1,281001
6285,0.002077,172.31.36.0-255,66,135516,1,281001
6286,0.00208,74.125.24.0-255,1484,137000,1,281001
6287,0.002099,74.125.24.0-255,4320,141320,1,281001
6288,0.002101,172.31.36.0-255,66,141386,1,281001
6289,0.002123,74.125.24.0-255,7156,148542,1,281001
6290,0.002125,172.31.36.0-255,66,148608,1,281001
6291,0.002148,74.125.24.0-255,5738,154346,1,281001
6292,0.002151,172.31.36.0-255,66,154412,1,281001
6293,0.002191,172.31.36.0-255,66,154478,1,281001
6294,0.002388,74.125.24.0-255,1484,155962,1,281001
6295,0.002402,74.125.24.0-255,2902,158864,1,281001
6296,0.002405,172.31.36.0-255,66,158930,1,281001
6297,0.002422,74.125.24.0-255,2902,161832,1,281001
6298,0.002424,172.31.36.0-255,66,161898,1,281001
6299,0.002443,74.125.24.0-255,2902,164800,1,281001
6300,0.002446,172.31.36.0-255,66,164866,1,281001
6301,0.002452,74.125.24.0-255,7156,172022,1,281001
6302,0.002455,172.31.36.0-255,66,172088,1,281001
6303,0.002485,172.31.36.0-255,66,172154,1,281001
6304,0.002504,74.125.24.0-255,4320,176474,1,281001
6305,0.002506,172.31.36.0-255,66,176540,1,281001
6306,0.002527,74.125.24.0-255,2184,178724,1,281001
6307,0.002531,172.31.36.0-255,66,178790,1,281001
6308,0.002545,74.125.24.0-255,1484,180274,1,281001
6309,0.002548,74.125.24.0-255,1484,181758,1,281001
6310,0.00255,172.31.36.0-255,66,181824,1,281001
6311,0.002574,74.125.24.0-255,1484,183308,1,281001
6312,0.00258,74.125.24.0-255,5738,189046,1,281001
6313,0.002583,172.31.36.0-255,66,189112,1,281001
6314,0.002586,74.125.24.0-255,1484,190596,1,281001
6315,0.00259,74.125.24.0-255,1484,192080,1,281001
6316,0.002592,172.31.36.0-255,66,192146,1,281001
6317,0.002595,74.125.24.0-255,1484,193630,1,281001
6318,0.002615,74.125.24.0-255,7156,200786,1,281001
6319,0.002619,172.31.36.0-255,66,200852,1,281001
6320,0.002648,74.125.24.0-255,5738,206590,1,281001
6321,0.002652,172.31.36.0-255,66,206656,1,281001
6322,0.002674,74.125.24.0-255,6438,213094,1,281001
6323,0.002677,172.31.36.0-255,66,213160,1,281001
6324,0.002929,74.125.24.0-255,1484,214644,1,281001
6325,0.002943,74.125.24.0-255,2902,217546,1,281001
6326,0.002947,172.31.36.0-255,66,217612,1,281001
6327,0.002952,74.125.24.0-255,2902,220514,1,281001
6328,0.002955,172.31.36.0-255,66,220580,1,281001
6329,0.002978,74.125.24.0-255,2902,223482,1,281001
6330,0.002982,172.31.36.0-255,66,223548,1,281001
6331,0.002995,172.31.36.0-255,66,223614,1,281001
6332,0.003001,74.125.24.0-255,7156,230770,1,281001
6333,0.003004,172.31.36.0-255,66,230836,1,281001
6334,0.003027,74.125.24.0-255,3602,234438,1,281001
6335,0.00303,172.31.36.0-255,66,234504,1,281001
6336,0.003033,74.125.24.0-255,1484,235988,1,281001
6337,0.003052,74.125.24.0-255,2902,238890,1,281001
6338,0.003055,172.31.36.0-255,66,238956,1,281001
6339,0.003078,74.125.24.0-255,5738,244694,1,281001
6340,0.003082,172.31.36.0-255,66,244760,1,281001
6341,0.003093,172.31.36.0-255,66,244826,1,281001
6342,0.003113,74.125.24.0-255,2902,247728,1,281001
6343,0.003115,172.31.36.0-255,66,247794,1,281001
6344,0.003122,74.125.24.0-255,5738,253532,1,281001
6345,0.003124,172.31.36.0-255,66,253598,1,281001
6346,0.003134,172.31.36.0-255,66,253664,1,281001
6347,0.003174,172.31.36.0-255,66,253730,1,281001
6348,0.003177,74.125.24.0-255,1484,255214,1,281001
6349,0.003205,172.31.36.0-255,66,255280,1,281001
6350,0.00323,172.31.36.0-255,66,255346,1,281001
6351,0.00325,74.125.24.0-255,1484,256830,1,281001
6352,0.003266,74.125.24.0-255,4320,261150,1,281001
6353,0.00327,172.31.36.0-255,66,261216,1,281001
6354,0.003275,74.125.24.0-255,5738,266954,1,281001
6355,0.003277,172.31.36.0-255,66,267020,1,281001
6356,0.003291,74.125.24.0-255,1484,268504,1,281001
6357,0.003337,172.31.36.0-255,66,268570,1,281001
6358,0.003356,74.125.24.0-255,2928,271498,1,281001
6359,0.00336,172.31.36.0-255,66,271564,1,281001
6360,0.003363,74.125.24.0-255,105,271669,1,281001
6361,0.004898,172.31.36.0-255,66,271735,1,281001
6362,0.004926,172.31.36.0-255,105,271840,1,281001
6363,0.007442,74.125.24.0-255,66,271906,1,281001
6364,0.034324,172.31.36.0-255,172,272078,1,281001
6365,0.034358,172.31.36.0-255,1113,273191,1,281001
6366,0.0344,172.31.36.0-255,1514,274705,1,281001
6367,0.034402,172.31.36.0-255,1514,276219,1,281001
6368,0.034408,172.31.36.0-255,1514,277733,1,281001
6369,0.034409,172.31.36.0-255,1514,279247,1,281001
6370,0.034428,172.31.36.0-255,1490,280737,1,281001
6371,0.035881,104.244.42.0-255,66,280803,1,281001
6372,0.03592,104.244.42.0-255,66,280869,1,281001
6373,0.036001,104.244.42.0-255,66,280935,1,281001
6374,0.036048,104.244.42.0-255,66,281001,1,281001
6375,0.0,74.125.68.0-255,153,153,1,362235
6376,1.5e-05,172.31.36.0-255,66,219,1,362235
6377,5.4e-05,74.125.68.0-255,1484,1703,1,362235
6378,5.8e-05,172.31.36.0-255,66,1769,1,362235
6379,6.3e-05,74.125.68.0-255,2902,4671,1,362235
6380,6.6e-05,172.31.36.0-255,66,4737,1,362235
6381,6.9e-05,74.125.68.0-255,1484,6221,1,362235
6382,7.1e-05,172.31.36.0-255,66,6287,1,362235
6383,9.4e-05,74.125.68.0-255,4320,10607,1,362235
6384,9.6e-05,172.31.36.0-255,66,10673,1,362235
6385,0.000102,74.125.68.0-255,3446,14119,1,362235
6386,0.000104,172.31.36.0-255,66,14185,1,362235
6387,0.000109,74.125.68.0-255,4320,18505,1,362235
6388,0.000112,172.31.36.0-255,66,18571,1,362235
6389,0.000136,74.125.68.0-255,2902,21473,1,362235
6390,0.000139,172.31.36.0-255,66,21539,1,362235
6391,0.000168,74.125.68.0-255,7156,28695,1,362235
6392,0.00017,172.31.36.0-255,66,28761,1,362235
6393,0.000174,74.125.68.0-255,2543,31304,1,362235
6394,0.000176,172.31.36.0-255,66,31370,1,362235
6395,0.000281,74.125.68.0-255,1484,32854,1,362235
6396,0.000284,172.31.36.0-255,66,32920,1,362235
6397,0.000296,74.125.68.0-255,1484,34404,1,362235
6398,0.000298,172.31.36.0-255,66,34470,1,362235
6399,0.000306,74.125.68.0-255,2902,37372,1,362235
6400,0.000308,172.31.36.0-255,66,37438,1,362235
6401,0.000336,74.125.68.0-255,5738,43176,1,362235
6402,0.000338,172.31.36.0-255,66,43242,1,362235
6403,0.000365,74.125.68.0-255,4320,47562,1,362235
6404,0.000367,172.31.36.0-255,66,47628,1,362235
6405,0.000372,74.125.68.0-255,2902,50530,1,362235
6406,0.000373,172.31.36.0-255,66,50596,1,362235
6407,0.0004,74.125.68.0-255,2543,53139,1,362235
6408,0.000403,172.31.36.0-255,66,53205,1,362235
6409,0.000408,74.125.68.0-255,4320,57525,1,362235
6410,0.000409,172.31.36.0-255,66,57591,1,362235
6411,0.000432,74.125.68.0-255,5738,63329,1,362235
6412,0.000434,172.31.36.0-255,66,63395,1,362235
6413,0.000456,74.125.68.0-255,2857,66252,1,362235
6414,0.000458,172.31.36.0-255,66,66318,1,362235
6415,0.000475,74.125.68.0-255,374,66692,1,362235
6416,0.000477,172.31.36.0-255,66,66758,1,362235
6417,0.00067,74.125.68.0-255,1484,68242,1,362235
6418,0.000672,172.31.36.0-255,66,68308,1,362235
6419,0.000677,74.125.68.0-255,2902,71210,1,362235
6420,0.000679,172.31.36.0-255,66,71276,1,362235
6421,0.000723,74.125.68.0-255,5738,77014,1,362235
6422,0.000725,172.31.36.0-255,66,77080,1,362235
6423,0.000732,74.125.68.0-255,7156,84236,1,362235
6424,0.000734,172.31.36.0-255,66,84302,1,362235
6425,0.000776,74.125.68.0-255,5738,90040,1,362235
6426,0.000778,172.31.36.0-255,66,90106,1,362235
6427,0.000805,74.125.68.0-255,7156,97262,1,362235
6428,0.000807,172.31.36.0-255,66,97328,1,362235
6429,0.000811,74.125.68.0-255,2902,100230,1,362235
6430,0.000813,172.31.36.0-255,66,100296,1,362235
6431,0.000844,74.125.68.0-255,766,101062,1,362235
6432,0.000847,172.31.36.0-255,66,101128,1,362235
6433,0.000904,74.125.68.0-255,1484,102612,1,362235
6434,0.000906,172.31.36.0-255,66,102678,1,362235
6435,0.000919,74.125.68.0-255,2902,105580,1,362235
6436,0.000925,172.31.36.0-255,66,105646,1,362235
6437,0.000964,74.125.68.0-255,2902,108548,1,362235
6438,0.000966,172.31.36.0-255,66,108614,1,362235
6439,0.000997,74.125.68.0-255,4320,112934,1,362235
6440,0.001018,74.125.68.0-255,7156,120090,1,362235
6441,0.001065,74.125.68.0-255,1484,121574,1,362235
6442,0.001085,74.125.68.0-255,2902,124476,1,362235
6443,0.001111,74.125.68.0-255,2184,126660,1,362235
6444,0.00119,74.125.68.0-255,1484,128144,1,362235
6445,0.001216,74.125.68.0-255,1484,129628,1,362235
6446,0.001268,74.125.68.0-255,2902,132530,1,362235
6447,0.001289,74.125.68.0-255,4320,136850,1,362235
6448,0.001314,74.125.68.0-255,2902,139752,1,362235
6449,0.001327,74.125.68.0-255,1484,141236,1,362235
6450,0.001369,74.125.68.0-255,4320,145556,1,362235
6451,0.001389,74.125.68.0-255,6438,151994,1,362235
6452,0.001555,74.125.68.0-255,1484,153478,1,362235
6453,0.001591,74.125.68.0-255,1484,154962,1,362235
6454,0.001603,74.125.68.0-255,2902,157864,1,362235
6455,0.00162,74.125.68.0-255,2902,160766,1,362235
6456,0.001623,74.125.68.0-255,1484,162250,1,362235
6457,0.001634,74.125.68.0-255,2902,165152,1,362235
6458,0.00167,74.125.68.0-255,2902,168054,1,362235
6459,0.001684,74.125.68.0-255,2902,170956,1,362235
6460,0.001697,74.125.68.0-255,2902,173858,1,362235
6461,0.001716,74.125.68.0-255,4320,178178,1,362235
6462,0.001718,74.125.68.0-255,1484,179662,1,362235
6463,0.001733,74.125.68.0-255,2902,182564,1,362235
6464,0.001771,74.125.68.0-255,3602,186166,1,362235
6465,0.001988,74.125.68.0-255,1484,187650,1,362235
6466,0.001999,74.125.68.0-255,2902,190552,1,362235
6467,0.002016,74.125.68.0-255,2902,193454,1,362235
6468,0.002027,74.125.68.0-255,2902,196356,1,362235
6469,0.002041,74.125.68.0-255,4320,200676,1,362235
6470,0.002055,74.125.68.0-255,2902,203578,1,362235
6471,0.002073,74.125.68.0-255,2902,206480,1,362235
6472,0.002124,74.125.68.0-255,4320,210800,1,362235
6473,0.002138,74.125.68.0-255,2184,212984,1,362235
6474,0.002156,74.125.68.0-255,4320,217304,1,362235
6475,0.002167,74.125.68.0-255,2902,220206,1,362235
6476,0.002199,74.125.68.0-255,5738,225944,1,362235
6477,0.002224,74.125.68.0-255,2902,228846,1,362235
6478,0.002239,74.125.68.0-255,5020,233866,1,362235
6479,0.002289,74.125.68.0-255,5738,239604,1,362235
6480,0.002298,74.125.68.0-255,7156,246760,1,362235
6481,0.002302,74.125.68.0-255,2902,249662,1,362235
6482,0.002324,74.125.68.0-255,5738,255400,1,362235
6483,0.002329,74.125.68.0-255,2902,258302,1,362235
6484,0.002379,74.125.68.0-255,1484,259786,1,362235
6485,0.002435,74.125.68.0-255,4320,264106,1,362235
6486,0.002478,74.125.68.0-255,2902,267008,1,362235
6487,0.002503,74.125.68.0-255,6438,273446,1,362235
6488,0.002506,74.125.68.0-255,1484,274930,1,362235
6489,0.002625,172.31.36.0-255,66,274996,1,362235
6490,0.005141,74.125.68.0-255,5738,280734,1,362235
6491,0.005149,172.31.36.0-255,66,280800,1,362235
6492,0.007625,74.125.68.0-255,1484,282284,1,362235
6493,0.00764,74.125.68.0-255,4320,286604,1,362235
6494,0.008557,172.31.36.0-255,66,286670,1,362235
6495,0.011043,74.125.68.0-255,5738,292408,1,362235
6496,0.01105,172.31.36.0-255,66,292474,1,362235
6497,0.013545,74.125.68.0-255,5738,298212,1,362235
6498,0.013552,172.31.36.0-255,66,298278,1,362235
6499,0.016034,74.125.68.0-255,5738,304016,1,362235
6500,0.01604,172.31.36.0-255,66,304082,1,362235
6501,0.018512,74.125.68.0-255,5738,309820,1,362235
6502,0.018517,172.31.36.0-255,66,309886,1,362235
6503,0.021004,74.125.68.0-255,5738,315624,1,362235
6504,0.021012,172.31.36.0-255,66,315690,1,362235
6505,0.023493,74.125.68.0-255,5738,321428,1,362235
6506,0.023502,172.31.36.0-255,66,321494,1,362235
6507,0.025976,74.125.68.0-255,5738,327232,1,362235
6508,0.025984,172.31.36.0-255,66,327298,1,362235
6509,0.028473,74.125.68.0-255,5738,333036,1,362235
6510,0.02848,172.31.36.0-255,66,333102,1,362235
6511,0.030972,74.125.68.0-255,1484,334586,1,362235
6512,0.030979,172.31.36.0-255,66,334652,1,362235
6513,0.031021,74.125.68.0-255,4320,338972,1,362235
6514,0.031039,172.31.36.0-255,66,339038,1,362235
6515,0.033459,74.125.68.0-255,1484,340522,1,362235
6516,0.033467,172.31.36.0-255,66,340588,1,362235
6517,0.033508,74.125.68.0-255,4320,344908,1,362235
6518,0.033528,172.31.36.0-255,66,344974,1,362235
6519,0.035952,74.125.68.0-255,1484,346458,1,362235
6520,0.03596,172.31.36.0-255,66,346524,1,362235
6521,0.036003,74.125.68.0-255,4320,350844,1,362235
6522,0.03602,172.31.36.0-255,66,350910,1,362235
6523,0.03844,74.125.68.0-255,1484,352394,1,362235
6524,0.038464,74.125.68.0-255,509,352903,1,362235
6525,0.038469,172.31.36.0-255,66,352969,1,362235
6526,0.038791,172.31.36.0-255,105,353074,1,362235
6527,0.040051,172.31.36.0-255,172,353246,1,362235
6528,0.040079,172.31.36.0-255,1115,354361,1,362235
6529,0.040114,172.31.36.0-255,1514,355875,1,362235
6530,0.040134,172.31.36.0-255,1514,357389,1,362235
6531,0.040137,172.31.36.0-255,1514,358903,1,362235
6532,0.040152,172.31.36.0-255,1514,360417,1,362235
6533,0.040154,172.31.36.0-255,1488,361905,1,362235
6534,0.041235,74.125.68.0-255,66,361971,1,362235
6535,0.041567,104.244.42.0-255,66,362037,1,362235
6536,0.041617,104.244.42.0-255,66,362103,1,362235
6537,0.041675,104.244.42.0-255,66,362169,1,362235
6538,0.041722,104.244.42.0-255,66,362235,1,362235
6539,0.0,172.217.194.0-255,153,153,1,196127
6540,2e-05,172.31.36.0-255,66,219,1,196127
6541,2.8e-05,172.217.194.0-255,1484,1703,1,196127
6542,3.3e-05,172.31.36.0-255,66,1769,1,196127
6543,4.8e-05,172.217.194.0-255,2902,4671,1,196127
6544,5.2e-05,172.31.36.0-255,66,4737,1,196127
6545,5.9e-05,172.217.194.0-255,5738,10475,1,196127
6546,6.2e-05,172.31.36.0-255,66,10541,1,196127
6547,8.3e-05,172.217.194.0-255,1484,12025,1,196127
6548,8.6e-05,172.31.36.0-255,66,12091,1,196127
6549,9.7e-05,172.217.194.0-255,2100,14191,1,196127
6550,9.9e-05,172.31.36.0-255,66,14257,1,196127
6551,0.00013,172.31.36.0-255,66,14323,1,196127
6552,0.000152,172.217.194.0-255,2902,17225,1,196127
6553,0.000155,172.31.36.0-255,66,17291,1,196127
6554,0.000191,172.217.194.0-255,5379,22670,1,196127
6555,0.000194,172.31.36.0-255,66,22736,1,196127
6556,0.001216,172.217.194.0-255,1484,24220,1,196127
6557,0.001224,172.31.36.0-255,66,24286,1,196127
6558,0.001235,172.217.194.0-255,2902,27188,1,196127
6559,0.001238,172.31.36.0-255,66,27254,1,196127
6560,0.001251,172.217.194.0-255,5738,32992,1,196127
6561,0.001253,172.31.36.0-255,66,33058,1,196127
6562,0.001257,172.217.194.0-255,1484,34542,1,196127
6563,0.001259,172.31.36.0-255,66,34608,1,196127
6564,0.001299,172.217.194.0-255,5738,40346,1,196127
6565,0.001301,172.31.36.0-255,66,40412,1,196127
6566,0.00133,172.217.194.0-255,5738,46150,1,196127
6567,0.001333,172.31.36.0-255,66,46216,1,196127
6568,0.001341,172.217.194.0-255,7156,53372,1,196127
6569,0.001343,172.31.36.0-255,66,53438,1,196127
6570,0.001353,172.217.194.0-255,3602,57040,1,196127
6571,0.001356,172.31.36.0-255,66,57106,1,196127
6572,0.001954,172.217.194.0-255,343,57449,1,196127
6573,0.001968,172.217.194.0-255,120,57569,1,196127
6574,0.003385,172.217.194.0-255,2902,60471,1,196127
6575,0.003389,172.31.36.0-255,66,60537,1,196127
6576,0.005419,172.217.194.0-255,5738,66275,1,196127
6577,0.005426,172.31.36.0-255,66,66341,1,196127
6578,0.007424,172.217.194.0-255,5738,72079,1,196127
6579,0.007432,172.31.36.0-255,66,72145,1,196127
6580,0.00948,172.217.194.0-255,5738,77883,1,196127
6581,0.009488,172.31.36.0-255,66,77949,1,196127
6582,0.011506,172.217.194.0-255,5738,83687,1,196127
6583,0.011514,172.31.36.0-255,66,83753,1,196127
6584,0.013519,172.217.194.0-255,5738,89491,1,196127
6585,0.013527,172.31.36.0-255,66,89557,1,196127
6586,0.015527,172.217.194.0-255,5738,95295,1,196127
6587,0.015535,172.31.36.0-255,66,95361,1,196127
6588,0.017518,172.217.194.0-255,5738,101099,1,196127
6589,0.017523,172.31.36.0-255,66,101165,1,196127
6590,0.019534,172.217.194.0-255,5738,106903,1,196127
6591,0.019544,172.31.36.0-255,66,106969,1,196127
6592,0.021544,172.217.194.0-255,5738,112707,1,196127
6593,0.021551,172.31.36.0-255,66,112773,1,196127
6594,0.023525,172.217.194.0-255,5738,118511,1,196127
6595,0.023533,172.31.36.0-255,66,118577,1,196127
6596,0.025508,172.217.194.0-255,5738,124315,1,196127
6597,0.025515,172.31.36.0-255,66,124381,1,196127
6598,0.027493,172.217.194.0-255,5738,130119,1,196127
6599,0.027501,172.31.36.0-255,66,130185,1,196127
6600,0.029502,172.217.194.0-255,5738,135923,1,196127
6601,0.029511,172.31.36.0-255,66,135989,1,196127
6602,0.031554,172.217.194.0-255,5738,141727,1,196127
6603,0.031562,172.31.36.0-255,66,141793,1,196127
6604,0.033586,172.217.194.0-255,5738,147531,1,196127
6605,0.033594,172.31.36.0-255,66,147597,1,196127
6606,0.034534,172.31.36.0-255,221,147818,1,196127
6607,0.034567,172.31.36.0-255,1114,148932,1,196127
6608,0.034628,172.31.36.0-255,565,149497,1,196127
6609,0.03558,172.217.194.0-255,5738,155235,1,196127
6610,0.035587,172.31.36.0-255,66,155301,1,196127
6611,0.036122,104.244.42.0-255,66,155367,1,196127
6612,0.036131,104.244.42.0-255,66,155433,1,196127
6613,0.036167,104.244.42.0-255,66,155499,1,196127
6614,0.03758,172.217.194.0-255,5738,161237,1,196127
6615,0.037588,172.31.36.0-255,66,161303,1,196127
6616,0.0396,172.217.194.0-255,5738,167041,1,196127
6617,0.039608,172.31.36.0-255,66,167107,1,196127
6618,0.041613,172.217.194.0-255,5738,172845,1,196127
6619,0.041623,172.31.36.0-255,66,172911,1,196127
6620,0.043616,172.217.194.0-255,5738,178649,1,196127
6621,0.043623,172.31.36.0-255,66,178715,1,196127
6622,0.045633,172.217.194.0-255,5738,184453,1,196127
6623,0.04564,172.31.36.0-255,66,184519,1,196127
6624,0.047661,172.217.194.0-255,5738,190257,1,196127
6625,0.047668,172.31.36.0-255,66,190323,1,196127
6626,0.049674,172.217.194.0-255,5738,196061,1,196127
6627,0.049681,172.31.36.0-255,66,196127,1,196127
6628,0.0,172.253.118.0-255,150,150,1,213185
6629,2.1e-05,172.31.36.0-255,66,216,1,213185
6630,2.9e-05,172.253.118.0-255,1484,1700,1,213185
6631,3.3e-05,172.31.36.0-255,66,1766,1,213185
6632,4.8e-05,172.253.118.0-255,2902,4668,1,213185
6633,5.2e-05,172.31.36.0-255,66,4734,1,213185
6634,6e-05,172.253.118.0-255,7156,11890,1,213185
6635,6.3e-05,172.31.36.0-255,66,11956,1,213185
6636,6.9e-05,172.253.118.0-255,3522,15478,1,213185
6637,7.2e-05,172.31.36.0-255,66,15544,1,213185
6638,7.8e-05,172.253.118.0-255,4320,19864,1,213185
6639,8.2e-05,172.31.36.0-255,66,19930,1,213185
6640,9.5e-05,172.31.36.0-255,66,19996,1,213185
6641,0.000149,172.31.36.0-255,66,20062,1,213185
6642,0.000155,172.253.118.0-255,3602,23664,1,213185
6643,0.000157,172.31.36.0-255,66,23730,1,213185
6644,0.000209,172.253.118.0-255,1484,25214,1,213185
6645,0.000213,172.31.36.0-255,66,25280,1,213185
6646,0.000218,172.253.118.0-255,2902,28182,1,213185
6647,0.00022,172.31.36.0-255,66,28248,1,213185
6648,0.000249,172.253.118.0-255,5738,33986,1,213185
6649,0.000252,172.31.36.0-255,66,34052,1,213185
6650,0.000257,172.253.118.0-255,4320,38372,1,213185
6651,0.000259,172.31.36.0-255,66,38438,1,213185
6652,0.000303,172.253.118.0-255,2850,41288,1,213185
6653,0.000308,172.31.36.0-255,66,41354,1,213185
6654,0.000362,172.253.118.0-255,1484,42838,1,213185
6655,0.000365,172.31.36.0-255,66,42904,1,213185
6656,0.000385,172.253.118.0-255,2902,45806,1,213185
6657,0.000388,172.31.36.0-255,66,45872,1,213185
6658,0.000395,172.253.118.0-255,5738,51610,1,213185
6659,0.000398,172.31.36.0-255,66,51676,1,213185
6660,0.000435,172.253.118.0-255,6797,58473,1,213185
6661,0.000438,172.31.36.0-255,66,58539,1,213185
6662,0.000441,172.253.118.0-255,1484,60023,1,213185
6663,0.000496,172.253.118.0-255,7156,67179,1,213185
6664,0.000499,172.31.36.0-255,66,67245,1,213185
6665,0.000524,172.253.118.0-255,5738,72983,1,213185
6666,0.000526,172.31.36.0-255,66,73049,1,213185
6667,0.000531,172.253.118.0-255,2543,75592,1,213185
6668,0.000533,172.31.36.0-255,66,75658,1,213185
6669,0.000536,172.253.118.0-255,347,76005,1,213185
6670,0.001485,172.31.36.0-255,66,76071,1,213185
6671,0.001646,172.253.118.0-255,1484,77555,1,213185
6672,0.00167,172.253.118.0-255,2902,80457,1,213185
6673,0.001674,172.31.36.0-255,66,80523,1,213185
6674,0.001681,172.253.118.0-255,4320,84843,1,213185
6675,0.001683,172.31.36.0-255,66,84909,1,213185
6676,0.001738,172.253.118.0-255,1484,86393,1,213185
6677,0.001744,172.253.118.0-255,1484,87877,1,213185
6678,0.001747,172.31.36.0-255,66,87943,1,213185
6679,0.001758,172.31.36.0-255,66,88009,1,213185
6680,0.001773,172.31.36.0-255,66,88075,1,213185
6681,0.004069,172.253.118.0-255,5738,93813,1,213185
6682,0.004077,172.31.36.0-255,66,93879,1,213185
6683,0.006386,172.253.118.0-255,5738,99617,1,213185
6684,0.006393,172.31.36.0-255,66,99683,1,213185
6685,0.008701,172.253.118.0-255,5738,105421,1,213185
6686,0.008708,172.31.36.0-255,66,105487,1,213185
6687,0.010997,172.253.118.0-255,5738,111225,1,213185
6688,0.011005,172.31.36.0-255,66,111291,1,213185
6689,0.013305,172.253.118.0-255,5738,117029,1,213185
6690,0.013313,172.31.36.0-255,66,117095,1,213185
6691,0.015618,172.253.118.0-255,5738,122833,1,213185
6692,0.015628,172.31.36.0-255,66,122899,1,213185
6693,0.01793,172.253.118.0-255,5738,128637,1,213185
6694,0.017938,172.31.36.0-255,66,128703,1,213185
6695,0.020244,172.253.118.0-255,5738,134441,1,213185
6696,0.020252,172.31.36.0-255,66,134507,1,213185
6697,0.022561,172.253.118.0-255,5738,140245,1,213185
6698,0.022569,172.31.36.0-255,66,140311,1,213185
6699,0.024877,172.253.118.0-255,5738,146049,1,213185
6700,0.024887,172.31.36.0-255,66,146115,1,213185
6701,0.027186,172.253.118.0-255,5738,151853,1,213185
6702,0.027194,172.31.36.0-255,66,151919,1,213185
6703,0.029476,172.253.118.0-255,5738,157657,1,213185
6704,0.029483,172.31.36.0-255,66,157723,1,213185
6705,0.031783,172.253.118.0-255,5738,163461,1,213185
6706,0.031791,172.31.36.0-255,66,163527,1,213185
6707,0.034094,172.253.118.0-255,5738,169265,1,213185
6708,0.034109,172.31.36.0-255,66,169331,1,213185
6709,0.036423,172.253.118.0-255,5738,175069,1,213185
6710,0.036432,172.31.36.0-255,66,175135,1,213185
6711,0.038726,172.253.118.0-255,5738,180873,1,213185
6712,0.038732,172.31.36.0-255,66,180939,1,213185
6713,0.038998,172.31.36.0-255,172,181111,1,213185
6714,0.039028,172.31.36.0-255,1114,182225,1,213185
6715,0.03915,172.31.36.0-255,1514,183739,1,213185
6716,0.039152,172.31.36.0-255,1514,185253,1,213185
6717,0.039157,172.31.36.0-255,1514,186767,1,213185
6718,0.039158,172.31.36.0-255,1514,188281,1,213185
6719,0.039179,172.31.36.0-255,1490,189771,1,213185
6720,0.040585,104.244.42.0-255,66,189837,1,213185
6721,0.040593,104.244.42.0-255,66,189903,1,213185
6722,0.04078,104.244.42.0-255,66,189969,1,213185
6723,0.041033,172.253.118.0-255,5738,195707,1,213185
6724,0.041039,172.31.36.0-255,66,195773,1,213185
6725,0.043334,172.253.118.0-255,5738,201511,1,213185
6726,0.043345,172.31.36.0-255,66,201577,1,213185
6727,0.045634,172.253.118.0-255,5738,207315,1,213185
6728,0.045642,172.31.36.0-255,66,207381,1,213185
6729,0.047951,172.253.118.0-255,5738,213119,1,213185
6730,0.047958,172.31.36.0-255,66,213185,1,213185
6731,0.0,74.125.200.0-255,215,215,1,336713
6732,2.2e-05,172.31.36.0-255,66,281,1,336713
6733,4.2e-05,74.125.200.0-255,1484,1765,1,336713
6734,4.7e-05,172.31.36.0-255,66,1831,1,336713
6735,5.3e-05,74.125.200.0-255,4320,6151,1,336713
6736,5.6e-05,172.31.36.0-255,66,6217,1,336713
6737,6e-05,74.125.200.0-255,2902,9119,1,336713
6738,6.3e-05,172.31.36.0-255,66,9185,1,336713
6739,6.7e-05,74.125.200.0-255,2902,12087,1,336713
6740,7e-05,172.31.36.0-255,66,12153,1,336713
6741,9.3e-05,74.125.200.0-255,1484,13637,1,336713
6742,9.6e-05,172.31.36.0-255,66,13703,1,336713
6743,0.000107,74.125.200.0-255,7156,20859,1,336713
6744,0.00011,172.31.36.0-255,66,20925,1,336713
6745,0.000133,74.125.200.0-255,1839,22764,1,336713
6746,0.000137,172.31.36.0-255,66,22830,1,336713
6747,0.000142,74.125.200.0-255,2902,25732,1,336713
6748,0.000144,172.31.36.0-255,66,25798,1,336713
6749,0.000183,74.125.200.0-255,5379,31177,1,336713
6750,0.000186,172.31.36.0-255,66,31243,1,336713
6751,0.000211,74.125.200.0-255,1484,32727,1,336713
6752,0.000214,172.31.36.0-255,66,32793,1,336713
6753,0.000242,74.125.200.0-255,2902,35695,1,336713
6754,0.000245,172.31.36.0-255,66,35761,1,336713
6755,0.000248,74.125.200.0-255,1484,37245,1,336713
6756,0.00025,172.31.36.0-255,66,37311,1,336713
6757,0.000289,74.125.200.0-255,4320,41631,1,336713
6758,0.000293,172.31.36.0-255,66,41697,1,336713
6759,0.0003,74.125.200.0-255,7156,48853,1,336713
6760,0.000302,172.31.36.0-255,66,48919,1,336713
6761,0.000315,74.125.200.0-255,1484,50403,1,336713
6762,0.000319,172.31.36.0-255,66,50469,1,336713
6763,0.000345,74.125.200.0-255,6438,56907,1,336713
6764,0.000349,172.31.36.0-255,66,56973,1,336713
6765,0.000351,74.125.200.0-255,443,57416,1,336713
6766,0.0005,74.125.200.0-255,1484,58900,1,336713
6767,0.000503,172.31.36.0-255,66,58966,1,336713
6768,0.000527,74.125.200.0-255,2902,61868,1,336713
6769,0.000532,74.125.200.0-255,4320,66188,1,336713
6770,0.000532,172.31.36.0-255,66,66254,1,336713
6771,0.000536,172.31.36.0-255,66,66320,1,336713
6772,0.000573,172.31.36.0-255,66,66386,1,336713
6773,0.000579,74.125.200.0-255,4320,70706,1,336713
6774,0.000581,172.31.36.0-255,66,70772,1,336713
6775,0.000586,74.125.200.0-255,4320,75092,1,336713
6776,0.000589,172.31.36.0-255,66,75158,1,336713
6777,0.000601,74.125.200.0-255,1484,76642,1,336713
6778,0.00062,74.125.200.0-255,2902,79544,1,336713
6779,0.000622,172.31.36.0-255,66,79610,1,336713
6780,0.000642,74.125.200.0-255,3602,83212,1,336713
6781,0.000645,172.31.36.0-255,66,83278,1,336713
6782,0.000688,74.125.200.0-255,1484,84762,1,336713
6783,0.000708,74.125.200.0-255,2902,87664,1,336713
6784,0.000711,172.31.36.0-255,66,87730,1,336713
6785,0.000714,74.125.200.0-255,1484,89214,1,336713
6786,0.000737,74.125.200.0-255,2902,92116,1,336713
6787,0.000739,172.31.36.0-255,66,92182,1,336713
6788,0.000743,74.125.200.0-255,1484,93666,1,336713
6789,0.000767,74.125.200.0-255,4320,97986,1,336713
6790,0.00077,172.31.36.0-255,66,98052,1,336713
6791,0.000778,74.125.200.0-255,7156,105208,1,336713
6792,0.000781,172.31.36.0-255,66,105274,1,336713
6793,0.000815,74.125.200.0-255,1484,106758,1,336713
6794,0.000826,172.31.36.0-255,66,106824,1,336713
6795,0.000829,74.125.200.0-255,766,107590,1,336713
6796,0.000851,74.125.200.0-255,1484,109074,1,336713
6797,0.000854,172.31.36.0-255,66,109140,1,336713
6798,0.000895,74.125.200.0-255,1484,110624,1,336713
6799,0.000909,74.125.200.0-255,2902,113526,1,336713
6800,0.000912,172.31.36.0-255,66,113592,1,336713
6801,0.000915,74.125.200.0-255,1484,115076,1,336713
6802,0.000941,74.125.200.0-255,2902,117978,1,336713
6803,0.000944,172.31.36.0-255,66,118044,1,336713
6804,0.00095,74.125.200.0-255,5738,123782,1,336713
6805,0.000952,172.31.36.0-255,66,123848,1,336713
6806,0.000993,172.31.36.0-255,66,123914,1,336713
6807,0.00104,172.31.36.0-255,66,123980,1,336713
6808,0.001075,74.125.200.0-255,4320,128300,1,336713
6809,0.001078,172.31.36.0-255,66,128366,1,336713
6810,0.001115,74.125.200.0-255,2902,131268,1,336713
6811,0.001118,172.31.36.0-255,66,131334,1,336713
6812,0.001129,172.31.36.0-255,66,131400,1,336713
6813,0.001141,172.31.36.0-255,66,131466,1,336713
6814,0.001146,74.125.200.0-255,4320,135786,1,336713
6815,0.001148,172.31.36.0-255,66,135852,1,336713
6816,0.001181,74.125.200.0-255,5738,141590,1,336713
6817,0.001201,172.31.36.0-255,66,141656,1,336713
6818,0.001214,172.31.36.0-255,66,141722,1,336713
6819,0.001282,74.125.200.0-255,3602,145324,1,336713
6820,0.001287,172.31.36.0-255,66,145390,1,336713
6821,0.001291,74.125.200.0-255,2902,148292,1,336713
6822,0.001296,74.125.200.0-255,4320,152612,1,336713
6823,0.001296,172.31.36.0-255,66,152678,1,336713
6824,0.0013,172.31.36.0-255,66,152744,1,336713
6825,0.001326,74.125.200.0-255,4320,157064,1,336713
6826,0.001326,172.31.36.0-255,66,157130,1,336713
6827,0.001329,172.31.36.0-255,66,157196,1,336713
6828,0.001353,74.125.200.0-255,1484,158680,1,336713
6829,0.001361,74.125.200.0-255,7156,165836,1,336713
6830,0.001364,172.31.36.0-255,66,165902,1,336713
6831,0.001396,74.125.200.0-255,5020,170922,1,336713
6832,0.001399,172.31.36.0-255,66,170988,1,336713
6833,0.001576,74.125.200.0-255,1484,172472,1,336713
6834,0.001581,74.125.200.0-255,1484,173956,1,336713
6835,0.001584,172.31.36.0-255,66,174022,1,336713
6836,0.001612,74.125.200.0-255,1484,175506,1,336713
6837,0.001619,74.125.200.0-255,5738,181244,1,336713
6838,0.001622,172.31.36.0-255,66,181310,1,336713
6839,0.001631,74.125.200.0-255,4320,185630,1,336713
6840,0.001633,172.31.36.0-255,66,185696,1,336713
6841,0.001655,74.125.200.0-255,4320,190016,1,336713
6842,0.001658,172.31.36.0-255,66,190082,1,336713
6843,0.001675,172.31.36.0-255,66,190148,1,336713
6844,0.001681,74.125.200.0-255,5020,195168,1,336713
6845,0.001684,172.31.36.0-255,66,195234,1,336713
6846,0.001909,74.125.200.0-255,1484,196718,1,336713
6847,0.001915,74.125.200.0-255,2902,199620,1,336713
6848,0.001919,172.31.36.0-255,66,199686,1,336713
6849,0.001952,74.125.200.0-255,5738,205424,1,336713
6850,0.001957,172.31.36.0-255,66,205490,1,336713
6851,0.001957,74.125.200.0-255,4320,209810,1,336713
6852,0.00196,172.31.36.0-255,66,209876,1,336713
6853,0.001983,74.125.200.0-255,2902,212778,1,336713
6854,0.001986,172.31.36.0-255,66,212844,1,336713
6855,0.001994,74.125.200.0-255,7156,220000,1,336713
6856,0.001996,172.31.36.0-255,66,220066,1,336713
6857,0.002031,74.125.200.0-255,7156,227222,1,336713
6858,0.002035,172.31.36.0-255,66,227288,1,336713
6859,0.002052,74.125.200.0-255,2184,229472,1,336713
6860,0.002054,172.31.36.0-255,66,229538,1,336713
6861,0.004056,74.125.200.0-255,5738,235276,1,336713
6862,0.004062,172.31.36.0-255,66,235342,1,336713
6863,0.006094,74.125.200.0-255,5738,241080,1,336713
6864,0.006101,172.31.36.0-255,66,241146,1,336713
6865,0.008114,74.125.200.0-255,5738,246884,1,336713
6866,0.008119,172.31.36.0-255,66,246950,1,336713
6867,0.010135,74.125.200.0-255,5738,252688,1,336713
6868,0.010142,172.31.36.0-255,66,252754,1,336713
6869,0.01216,74.125.200.0-255,5738,258492,1,336713
6870,0.012167,172.31.36.0-255,66,258558,1,336713
6871,0.014357,74.125.200.0-255,5738,264296,1,336713
6872,0.014414,172.31.36.0-255,66,264362,1,336713
6873,0.016456,74.125.200.0-255,5738,270100,1,336713
6874,0.016463,172.31.36.0-255,66,270166,1,336713
6875,0.018502,74.125.200.0-255,5738,275904,1,336713
6876,0.018508,172.31.36.0-255,66,275970,1,336713
6877,0.020532,74.125.200.0-255,5738,281708,1,336713
6878,0.02054,172.31.36.0-255,66,281774,1,336713
6879,0.022555,74.125.200.0-255,5738,287512,1,336713
6880,0.022563,172.31.36.0-255,66,287578,1,336713
6881,0.024586,74.125.200.0-255,5738,293316,1,336713
6882,0.024595,172.31.36.0-255,66,293382,1,336713
6883,0.026634,74.125.200.0-255,5738,299120,1,336713
6884,0.026644,172.31.36.0-255,66,299186,1,336713
6885,0.028676,74.125.200.0-255,5738,304924,1,336713
6886,0.028684,172.31.36.0-255,66,304990,1,336713
6887,0.030744,74.125.200.0-255,5738,310728,1,336713
6888,0.030751,172.31.36.0-255,66,310794,1,336713
6889,0.032775,74.125.200.0-255,5738,316532,1,336713
6890,0.032783,172.31.36.0-255,66,316598,1,336713
6891,0.034804,74.125.200.0-255,5738,322336,1,336713
6892,0.034811,172.31.36.0-255,66,322402,1,336713
6893,0.036831,74.125.200.0-255,4977,327379,1,336713
6894,0.036837,172.31.36.0-255,66,327445,1,336713
6895,0.03704,172.31.36.0-255,105,327550,1,336713
6896,0.039015,74.125.200.0-255,66,327616,1,336713
6897,0.043094,172.31.36.0-255,172,327788,1,336713
6898,0.043123,172.31.36.0-255,1115,328903,1,336713
6899,0.043186,172.31.36.0-255,1514,330417,1,336713
6900,0.043188,172.31.36.0-255,1514,331931,1,336713
6901,0.043194,172.31.36.0-255,1514,333445,1,336713
6902,0.043195,172.31.36.0-255,1514,334959,1,336713
6903,0.043216,172.31.36.0-255,1490,336449,1,336713
6904,0.044637,104.244.42.0-255,66,336515,1,336713
6905,0.04468,104.244.42.0-255,66,336581,1,336713
6906,0.044728,104.244.42.0-255,66,336647,1,336713
6907,0.044772,104.244.42.0-255,66,336713,1,336713
6908,0.0,74.125.24.0-255,143,143,1,281638
6909,2.3e-05,172.31.36.0-255,66,209,1,281638
6910,3.1e-05,74.125.24.0-255,1484,1693,1,281638
6911,3.5e-05,172.31.36.0-255,66,1759,1,281638
6912,4.1e-05,74.125.24.0-255,2902,4661,1,281638
6913,4.3e-05,172.31.36.0-255,66,4727,1,281638
6914,4.8e-05,74.125.24.0-255,2902,7629,1,281638
6915,5.1e-05,172.31.36.0-255,66,7695,1,281638
6916,5.7e-05,74.125.24.0-255,4320,12015,1,281638
6917,5.9e-05,172.31.36.0-255,66,12081,1,281638
6918,7.2e-05,172.31.36.0-255,66,12147,1,281638
6919,7.9e-05,74.125.24.0-255,7156,19303,1,281638
6920,8.2e-05,172.31.36.0-255,66,19369,1,281638
6921,0.000127,74.125.24.0-255,2543,21912,1,281638
6922,0.00013,172.31.36.0-255,66,21978,1,281638
6923,0.000177,74.125.24.0-255,1484,23462,1,281638
6924,0.00018,172.31.36.0-255,66,23528,1,281638
6925,0.000201,74.125.24.0-255,2902,26430,1,281638
6926,0.000204,172.31.36.0-255,66,26496,1,281638
6927,0.00021,74.125.24.0-255,5738,32234,1,281638
6928,0.000212,172.31.36.0-255,66,32300,1,281638
6929,0.000234,74.125.24.0-255,7156,39456,1,281638
6930,0.000236,172.31.36.0-255,66,39522,1,281638
6931,0.00026,74.125.24.0-255,1125,40647,1,281638
6932,0.000262,172.31.36.0-255,66,40713,1,281638
6933,0.000273,172.31.36.0-255,66,40779,1,281638
6934,0.00028,74.125.24.0-255,7072,47851,1,281638
6935,0.000283,172.31.36.0-255,66,47917,1,281638
6936,0.000429,74.125.24.0-255,129,48046,1,281638
6937,0.000435,172.31.36.0-255,66,48112,1,281638
6938,0.00054,74.125.24.0-255,1484,49596,1,281638
6939,0.000548,74.125.24.0-255,2902,52498,1,281638
6940,0.000551,74.125.24.0-255,1484,53982,1,281638
6941,0.000565,74.125.24.0-255,4320,58302,1,281638
6942,0.000569,74.125.24.0-255,2902,61204,1,281638
6943,0.000574,172.31.36.0-255,66,61270,1,281638
6944,0.000584,74.125.24.0-255,1484,62754,1,281638
6945,0.000618,74.125.24.0-255,1484,64238,1,281638
6946,0.000654,74.125.24.0-255,350,64588,1,281638
6947,0.000658,172.31.36.0-255,66,64654,1,281638
6948,0.000669,172.31.36.0-255,66,64720,1,281638
6949,0.000808,74.125.24.0-255,1484,66204,1,281638
6950,0.000814,74.125.24.0-255,2902,69106,1,281638
6951,0.000832,172.31.36.0-255,66,69172,1,281638
6952,0.000839,74.125.24.0-255,5738,74910,1,281638
6953,0.000843,74.125.24.0-255,2902,77812,1,281638
6954,0.000848,172.31.36.0-255,66,77878,1,281638
6955,0.00088,74.125.24.0-255,1484,79362,1,281638
6956,0.000901,172.31.36.0-255,66,79428,1,281638
6957,0.000906,172.31.36.0-255,66,79494,1,281638
6958,0.00102,74.125.24.0-255,1484,80978,1,281638
6959,0.001026,74.125.24.0-255,2902,83880,1,281638
6960,0.001073,74.125.24.0-255,5738,89618,1,281638
6961,0.001102,172.31.36.0-255,66,89684,1,281638
6962,0.001131,74.125.24.0-255,2184,91868,1,281638
6963,0.001137,172.31.36.0-255,66,91934,1,281638
6964,0.001448,74.125.24.0-255,1484,93418,1,281638
6965,0.001455,74.125.24.0-255,2902,96320,1,281638
6966,0.001458,172.31.36.0-255,66,96386,1,281638
6967,0.001463,74.125.24.0-255,1484,97870,1,281638
6968,0.001485,74.125.24.0-255,4320,102190,1,281638
6969,0.001491,74.125.24.0-255,4320,106510,1,281638
6970,0.001493,74.125.24.0-255,1484,107994,1,281638
6971,0.001499,172.31.36.0-255,66,108060,1,281638
6972,0.001525,74.125.24.0-255,2902,110962,1,281638
6973,0.001564,74.125.24.0-255,5020,115982,1,281638
6974,0.001587,172.31.36.0-255,66,116048,1,281638
6975,0.001659,74.125.24.0-255,1484,117532,1,281638
6976,0.001663,74.125.24.0-255,1484,119016,1,281638
6977,0.00167,172.31.36.0-255,66,119082,1,281638
6978,0.001678,74.125.24.0-255,1484,120566,1,281638
6979,0.001685,74.125.24.0-255,5738,126304,1,281638
6980,0.00169,172.31.36.0-255,66,126370,1,281638
6981,0.001705,74.125.24.0-255,1484,127854,1,281638
6982,0.001709,74.125.24.0-255,2902,130756,1,281638
6983,0.001723,74.125.24.0-255,1484,132240,1,281638
6984,0.001735,172.31.36.0-255,66,132306,1,281638
6985,0.001746,74.125.24.0-255,4320,136626,1,281638
6986,0.001754,74.125.24.0-255,7156,143782,1,281638
6987,0.00176,172.31.36.0-255,66,143848,1,281638
6988,0.001777,74.125.24.0-255,1484,145332,1,281638
6989,0.001807,74.125.24.0-255,5020,150352,1,281638
6990,0.001818,172.31.36.0-255,66,150418,1,281638
6991,0.002075,74.125.24.0-255,1484,151902,1,281638
6992,0.002081,74.125.24.0-255,2902,154804,1,281638
6993,0.002084,172.31.36.0-255,66,154870,1,281638
6994,0.002092,74.125.24.0-255,5738,160608,1,281638
6995,0.002103,172.31.36.0-255,66,160674,1,281638
6996,0.002126,74.125.24.0-255,7156,167830,1,281638
6997,0.002152,74.125.24.0-255,5738,173568,1,281638
6998,0.002294,74.125.24.0-255,1484,175052,1,281638
6999,0.008157,172.31.36.0-255,66,175118,1,281638
7000,0.010484,74.125.24.0-255,5738,180856,1,281638
7001,0.010495,172.31.36.0-255,66,180922,1,281638
7002,0.012821,74.125.24.0-255,5738,186660,1,281638
7003,0.012838,172.31.36.0-255,66,186726,1,281638
7004,0.015139,74.125.24.0-255,5738,192464,1,281638
7005,0.015152,172.31.36.0-255,66,192530,1,281638
7006,0.017446,74.125.24.0-255,5738,198268,1,281638
7007,0.017465,172.31.36.0-255,66,198334,1,281638
7008,0.019765,74.125.24.0-255,5738,204072,1,281638
7009,0.019783,172.31.36.0-255,66,204138,1,281638
7010,0.02208,74.125.24.0-255,5738,209876,1,281638
7011,0.022098,172.31.36.0-255,66,209942,1,281638
7012,0.024436,74.125.24.0-255,5738,215680,1,281638
7013,0.024454,172.31.36.0-255,66,215746,1,281638
7014,0.026737,74.125.24.0-255,5738,221484,1,281638
7015,0.026752,172.31.36.0-255,66,221550,1,281638
7016,0.029088,74.125.24.0-255,5738,227288,1,281638
7017,0.0291,172.31.36.0-255,66,227354,1,281638
7018,0.03139,74.125.24.0-255,5738,233092,1,281638
7019,0.031409,172.31.36.0-255,66,233158,1,281638
7020,0.033683,74.125.24.0-255,5738,238896,1,281638
7021,0.033695,172.31.36.0-255,66,238962,1,281638
7022,0.035986,74.125.24.0-255,5738,244700,1,281638
7023,0.036003,172.31.36.0-255,66,244766,1,281638
7024,0.038302,74.125.24.0-255,5738,250504,1,281638
7025,0.038318,172.31.36.0-255,66,250570,1,281638
7026,0.040614,74.125.24.0-255,5738,256308,1,281638
7027,0.040623,172.31.36.0-255,66,256374,1,281638
7028,0.040877,172.31.36.0-255,172,256546,1,281638
7029,0.040918,172.31.36.0-255,1116,257662,1,281638
7030,0.041043,172.31.36.0-255,562,258224,1,281638
7031,0.042432,104.244.42.0-255,66,258290,1,281638
7032,0.042457,104.244.42.0-255,66,258356,1,281638
7033,0.042574,104.244.42.0-255,66,258422,1,281638
7034,0.04295,74.125.24.0-255,5738,264160,1,281638
7035,0.042961,172.31.36.0-255,66,264226,1,281638
7036,0.045237,74.125.24.0-255,5738,269964,1,281638
7037,0.045245,172.31.36.0-255,66,270030,1,281638
7038,0.04752,74.125.24.0-255,5738,275768,1,281638
7039,0.047528,172.31.36.0-255,66,275834,1,281638
7040,0.049843,74.125.24.0-255,5738,281572,1,281638
7041,0.049854,172.31.36.0-255,66,281638,1,281638
7042,0.0,74.125.68.0-255,219,219,1,272655
7043,2e-05,172.31.36.0-255,66,285,1,272655
7044,2.6e-05,74.125.68.0-255,1484,1769,1,272655
7045,2.9e-05,172.31.36.0-255,66,1835,1,272655
7046,5e-05,74.125.68.0-255,4320,6155,1,272655
7047,5.2e-05,172.31.36.0-255,66,6221,1,272655
7048,5.7e-05,74.125.68.0-255,2902,9123,1,272655
7049,5.9e-05,172.31.36.0-255,66,9189,1,272655
7050,6.4e-05,74.125.68.0-255,4320,13509,1,272655
7051,6.7e-05,172.31.36.0-255,66,13575,1,272655
7052,8.9e-05,74.125.68.0-255,1484,15059,1,272655
7053,9.2e-05,172.31.36.0-255,66,15125,1,272655
7054,0.000117,172.31.36.0-255,66,15191,1,272655
7055,0.000123,74.125.68.0-255,5738,20929,1,272655
7056,0.000125,172.31.36.0-255,66,20995,1,272655
7057,0.000156,74.125.68.0-255,2543,23538,1,272655
7058,0.000158,172.31.36.0-255,66,23604,1,272655
7059,0.000206,74.125.68.0-255,2902,26506,1,272655
7060,0.000209,172.31.36.0-255,66,26572,1,272655
7061,0.00023,74.125.68.0-255,4320,30892,1,272655
7062,0.000233,172.31.36.0-255,66,30958,1,272655
7063,0.000238,74.125.68.0-255,4320,35278,1,272655
7064,0.00024,172.31.36.0-255,66,35344,1,272655
7065,0.000277,74.125.68.0-255,4320,39664,1,272655
7066,0.00028,172.31.36.0-255,66,39730,1,272655
7067,0.000288,74.125.68.0-255,7156,46886,1,272655
7068,0.000291,172.31.36.0-255,66,46952,1,272655
7069,0.000302,172.31.36.0-255,66,47018,1,272655
7070,0.000306,74.125.68.0-255,2184,49202,1,272655
7071,0.000308,172.31.36.0-255,66,49268,1,272655
7072,0.000335,74.125.68.0-255,444,49712,1,272655
7073,0.000388,74.125.68.0-255,331,50043,1,272655
7074,0.000509,74.125.68.0-255,1484,51527,1,272655
7075,0.000516,74.125.68.0-255,2902,54429,1,272655
7076,0.000539,74.125.68.0-255,5738,60167,1,272655
7077,0.000554,172.31.36.0-255,66,60233,1,272655
7078,0.000646,172.31.36.0-255,66,60299,1,272655
7079,0.00074,74.125.68.0-255,1484,61783,1,272655
7080,0.000748,74.125.68.0-255,2902,64685,1,272655
7081,0.000766,74.125.68.0-255,4320,69005,1,272655
7082,0.000782,74.125.68.0-255,1484,70489,1,272655
7083,0.000788,74.125.68.0-255,4320,74809,1,272655
7084,0.0008,172.31.36.0-255,66,74875,1,272655
7085,0.00081,74.125.68.0-255,1484,76359,1,272655
7086,0.000817,74.125.68.0-255,7156,83515,1,272655
7087,0.000835,172.31.36.0-255,66,83581,1,272655
7088,0.000855,74.125.68.0-255,2184,85765,1,272655
7089,0.000893,172.31.36.0-255,66,85831,1,272655
7090,0.001241,74.125.68.0-255,1484,87315,1,272655
7091,0.001249,74.125.68.0-255,2902,90217,1,272655
7092,0.001267,74.125.68.0-255,4320,94537,1,272655
7093,0.001275,172.31.36.0-255,66,94603,1,272655
7094,0.001285,74.125.68.0-255,1484,96087,1,272655
7095,0.001288,74.125.68.0-255,1484,97571,1,272655
7096,0.001295,172.31.36.0-255,66,97637,1,272655
7097,0.001378,74.125.68.0-255,2902,100539,1,272655
7098,0.001382,74.125.68.0-255,2184,102723,1,272655
7099,0.001401,74.125.68.0-255,1484,104207,1,272655
7100,0.001404,74.125.68.0-255,1484,105691,1,272655
7101,0.001416,74.125.68.0-255,1484,107175,1,272655
7102,0.001426,172.31.36.0-255,66,107241,1,272655
7103,0.001441,74.125.68.0-255,5738,112979,1,272655
7104,0.001445,74.125.68.0-255,4320,117299,1,272655
7105,0.001449,74.125.68.0-255,1484,118783,1,272655
7106,0.001465,74.125.68.0-255,4320,123103,1,272655
7107,0.001483,74.125.68.0-255,7156,130259,1,272655
7108,0.001508,74.125.68.0-255,4320,134579,1,272655
7109,0.001517,74.125.68.0-255,2184,136763,1,272655
7110,0.001523,172.31.36.0-255,66,136829,1,272655
7111,0.001651,74.125.68.0-255,1484,138313,1,272655
7112,0.001657,74.125.68.0-255,2902,141215,1,272655
7113,0.001686,74.125.68.0-255,5738,146953,1,272655
7114,0.001689,74.125.68.0-255,1484,148437,1,272655
7115,0.0017,172.31.36.0-255,66,148503,1,272655
7116,0.001715,74.125.68.0-255,5738,154241,1,272655
7117,0.001736,172.31.36.0-255,66,154307,1,272655
7118,0.001752,74.125.68.0-255,5738,160045,1,272655
7119,0.001767,74.125.68.0-255,2184,162229,1,272655
7120,0.00179,172.31.36.0-255,66,162295,1,272655
7121,0.001841,74.125.68.0-255,1484,163779,1,272655
7122,0.001857,74.125.68.0-255,2902,166681,1,272655
7123,0.00187,74.125.68.0-255,1484,168165,1,272655
7124,0.001883,74.125.68.0-255,4320,172485,1,272655
7125,0.001889,172.31.36.0-255,66,172551,1,272655
7126,0.001899,74.125.68.0-255,2902,175453,1,272655
7127,0.001922,74.125.68.0-255,7156,182609,1,272655
7128,0.001928,74.125.68.0-255,7156,189765,1,272655
7129,0.001944,74.125.68.0-255,4320,194085,1,272655
7130,0.001947,74.125.68.0-255,2184,196269,1,272655
7131,0.001949,74.125.68.0-255,1484,197753,1,272655
7132,0.001962,74.125.68.0-255,1484,199237,1,272655
7133,0.001974,172.31.36.0-255,66,199303,1,272655
7134,0.001985,74.125.68.0-255,7156,206459,1,272655
7135,0.00199,172.31.36.0-255,66,206525,1,272655
7136,0.002001,74.125.68.0-255,5738,212263,1,272655
7137,0.002016,74.125.68.0-255,4320,216583,1,272655
7138,0.002018,74.125.68.0-255,1484,218067,1,272655
7139,0.002029,172.31.36.0-255,66,218133,1,272655
7140,0.002046,172.31.36.0-255,66,218199,1,272655
7141,0.00207,74.125.68.0-255,2184,220383,1,272655
7142,0.002077,172.31.36.0-255,66,220449,1,272655
7143,0.00209,74.125.68.0-255,2902,223351,1,272655
7144,0.002103,172.31.36.0-255,66,223417,1,272655
7145,0.002117,74.125.68.0-255,7156,230573,1,272655
7146,0.002122,74.125.68.0-255,4320,234893,1,272655
7147,0.00214,74.125.68.0-255,4320,239213,1,272655
7148,0.002146,172.31.36.0-255,66,239279,1,272655
7149,0.002161,74.125.68.0-255,5738,245017,1,272655
7150,0.002189,172.31.36.0-255,66,245083,1,272655
7151,0.002194,172.31.36.0-255,66,245149,1,272655
7152,0.002208,74.125.68.0-255,1484,246633,1,272655
7153,0.002295,74.125.68.0-255,6438,253071,1,272655
7154,0.002303,172.31.36.0-255,66,253137,1,272655
7155,0.002317,74.125.68.0-255,5738,258875,1,272655
7156,0.00233,172.31.36.0-255,66,258941,1,272655
7157,0.002389,74.125.68.0-255,2184,261125,1,272655
7158,0.002393,172.31.36.0-255,66,261191,1,272655
7159,0.002398,172.31.36.0-255,66,261257,1,272655
7160,0.002412,74.125.68.0-255,1484,262741,1,272655
7161,0.002441,74.125.68.0-255,415,263156,1,272655
7162,0.00245,172.31.36.0-255,66,263222,1,272655
7163,0.002481,74.125.68.0-255,105,263327,1,272655
7164,0.009711,172.31.36.0-255,66,263393,1,272655
7165,0.009739,172.31.36.0-255,105,263498,1,272655
7166,0.012268,74.125.68.0-255,66,263564,1,272655
7167,0.036055,172.31.36.0-255,167,263731,1,272655
7168,0.036087,172.31.36.0-255,1115,264846,1,272655
7169,0.036134,172.31.36.0-255,1514,266360,1,272655
7170,0.036136,172.31.36.0-255,1514,267874,1,272655
7171,0.036137,172.31.36.0-255,1514,269388,1,272655
7172,0.036138,172.31.36.0-255,1514,270902,1,272655
7173,0.036165,172.31.36.0-255,1489,272391,1,272655
7174,0.037573,104.244.42.0-255,66,272457,1,272655
7175,0.037592,104.244.42.0-255,66,272523,1,272655
7176,0.037695,104.244.42.0-255,66,272589,1,272655
7177,0.037744,104.244.42.0-255,66,272655,1,272655
7178,0.0,172.217.194.0-255,153,153,1,261896
7179,2.4e-05,172.31.36.0-255,66,219,1,261896
7180,3.3e-05,172.217.194.0-255,1484,1703,1,261896
7181,3.7e-05,172.31.36.0-255,66,1769,1,261896
7182,5.1e-05,172.217.194.0-255,2902,4671,1,261896
7183,5.5e-05,172.31.36.0-255,66,4737,1,261896
7184,6.1e-05,172.217.194.0-255,4320,9057,1,261896
7185,6.4e-05,172.31.36.0-255,66,9123,1,261896
7186,7.2e-05,172.217.194.0-255,6266,15389,1,261896
7187,7.5e-05,172.31.36.0-255,66,15455,1,261896
7188,7.9e-05,172.217.194.0-255,1484,16939,1,261896
7189,8.1e-05,172.31.36.0-255,66,17005,1,261896
7190,0.000111,172.217.194.0-255,5738,22743,1,261896
7191,0.000119,172.31.36.0-255,66,22809,1,261896
7192,0.000125,172.217.194.0-255,4320,27129,1,261896
7193,0.000127,172.31.36.0-255,66,27195,1,261896
7194,0.000152,172.217.194.0-255,3961,31156,1,261896
7195,0.00016,172.31.36.0-255,66,31222,1,261896
7196,0.000193,172.217.194.0-255,2902,34124,1,261896
7197,0.000195,172.31.36.0-255,66,34190,1,261896
7198,0.000201,172.217.194.0-255,4320,38510,1,261896
7199,0.000204,172.31.36.0-255,66,38576,1,261896
7200,0.000214,172.31.36.0-255,66,38642,1,261896
7201,0.000259,172.31.36.0-255,66,38708,1,261896
7202,0.000295,172.217.194.0-255,1436,40144,1,261896
7203,0.000297,172.31.36.0-255,66,40210,1,261896
7204,0.0003,172.217.194.0-255,99,40309,1,261896
7205,0.000302,172.31.36.0-255,66,40375,1,261896
7206,0.000641,172.217.194.0-255,364,40739,1,261896
7207,0.000647,172.31.36.0-255,66,40805,1,261896
7208,0.00097,172.217.194.0-255,1484,42289,1,261896
7209,0.000977,172.217.194.0-255,2902,45191,1,261896
7210,0.000981,172.31.36.0-255,66,45257,1,261896
7211,0.000988,172.217.194.0-255,5738,50995,1,261896
7212,0.000991,172.31.36.0-255,66,51061,1,261896
7213,0.001033,172.31.36.0-255,66,51127,1,261896
7214,0.001041,172.217.194.0-255,5738,56865,1,261896
7215,0.001042,172.31.36.0-255,66,56931,1,261896
7216,0.001068,172.217.194.0-255,5020,61951,1,261896
7217,0.00107,172.31.36.0-255,66,62017,1,261896
7218,0.001296,172.217.194.0-255,1484,63501,1,261896
7219,0.001304,172.217.194.0-255,2902,66403,1,261896
7220,0.001307,172.31.36.0-255,66,66469,1,261896
7221,0.00132,172.217.194.0-255,1484,67953,1,261896
7222,0.001343,172.217.194.0-255,4320,72273,1,261896
7223,0.001345,172.31.36.0-255,66,72339,1,261896
7224,0.001353,172.217.194.0-255,7156,79495,1,261896
7225,0.001355,172.31.36.0-255,66,79561,1,261896
7226,0.001371,172.31.36.0-255,66,79627,1,261896
7227,0.001439,172.31.36.0-255,66,79693,1,261896
7228,0.001464,172.217.194.0-255,1484,81177,1,261896
7229,0.001468,172.217.194.0-255,2902,84079,1,261896
7230,0.001471,172.31.36.0-255,66,84145,1,261896
7231,0.001477,172.217.194.0-255,5738,89883,1,261896
7232,0.001479,172.31.36.0-255,66,89949,1,261896
7233,0.001497,172.217.194.0-255,2902,92851,1,261896
7234,0.0015,172.31.36.0-255,66,92917,1,261896
7235,0.001532,172.31.36.0-255,66,92983,1,261896
7236,0.001546,172.31.36.0-255,66,93049,1,261896
7237,0.001654,172.217.194.0-255,1484,94533,1,261896
7238,0.001659,172.217.194.0-255,1484,96017,1,261896
7239,0.001661,172.31.36.0-255,66,96083,1,261896
7240,0.001676,172.217.194.0-255,1484,97567,1,261896
7241,0.001686,172.217.194.0-255,5738,103305,1,261896
7242,0.001691,172.217.194.0-255,4320,107625,1,261896
7243,0.001706,172.31.36.0-255,66,107691,1,261896
7244,0.00171,172.31.36.0-255,66,107757,1,261896
7245,0.001721,172.31.36.0-255,66,107823,1,261896
7246,0.001733,172.217.194.0-255,7156,114979,1,261896
7247,0.001736,172.31.36.0-255,66,115045,1,261896
7248,0.001771,172.217.194.0-255,3602,118647,1,261896
7249,0.001775,172.31.36.0-255,66,118713,1,261896
7250,0.002228,172.217.194.0-255,1484,120197,1,261896
7251,0.002233,172.217.194.0-255,2902,123099,1,261896
7252,0.002236,172.217.194.0-255,1484,124583,1,261896
7253,0.002241,172.31.36.0-255,66,124649,1,261896
7254,0.002253,172.217.194.0-255,4320,128969,1,261896
7255,0.002255,172.31.36.0-255,66,129035,1,261896
7256,0.00226,172.217.194.0-255,2902,131937,1,261896
7257,0.002261,172.31.36.0-255,66,132003,1,261896
7258,0.002302,172.31.36.0-255,66,132069,1,261896
7259,0.002316,172.217.194.0-255,2902,134971,1,261896
7260,0.002318,172.31.36.0-255,66,135037,1,261896
7261,0.002353,172.31.36.0-255,66,135103,1,261896
7262,0.002356,172.217.194.0-255,1484,136587,1,261896
7263,0.002398,172.31.36.0-255,66,136653,1,261896
7264,0.002426,172.31.36.0-255,66,136719,1,261896
7265,0.004744,172.217.194.0-255,5738,142457,1,261896
7266,0.004754,172.31.36.0-255,66,142523,1,261896
7267,0.007104,172.217.194.0-255,5738,148261,1,261896
7268,0.007109,172.31.36.0-255,66,148327,1,261896
7269,0.00943,172.217.194.0-255,5738,154065,1,261896
7270,0.009438,172.31.36.0-255,66,154131,1,261896
7271,0.011756,172.217.194.0-255,5738,159869,1,261896
7272,0.011767,172.31.36.0-255,66,159935,1,261896
7273,0.014121,172.217.194.0-255,5738,165673,1,261896
7274,0.014135,172.31.36.0-255,66,165739,1,261896
7275,0.016462,172.217.194.0-255,5738,171477,1,261896
7276,0.016477,172.31.36.0-255,66,171543,1,261896
7277,0.01884,172.217.194.0-255,5738,177281,1,261896
7278,0.018852,172.31.36.0-255,66,177347,1,261896
7279,0.021203,172.217.194.0-255,5738,183085,1,261896
7280,0.021212,172.31.36.0-255,66,183151,1,261896
7281,0.023564,172.217.194.0-255,5738,188889,1,261896
7282,0.023579,172.31.36.0-255,66,188955,1,261896
7283,0.025949,172.217.194.0-255,5738,194693,1,261896
7284,0.025961,172.31.36.0-255,66,194759,1,261896
7285,0.028279,172.217.194.0-255,5738,200497,1,261896
7286,0.02829,172.31.36.0-255,66,200563,1,261896
7287,0.030614,172.217.194.0-255,5738,206301,1,261896
7288,0.030625,172.31.36.0-255,66,206367,1,261896
7289,0.033006,172.217.194.0-255,5738,212105,1,261896
7290,0.033018,172.31.36.0-255,66,212171,1,261896
7291,0.035383,172.217.194.0-255,5738,217909,1,261896
7292,0.035397,172.31.36.0-255,66,217975,1,261896
7293,0.037275,172.31.36.0-255,172,218147,1,261896
7294,0.037308,172.31.36.0-255,1116,219263,1,261896
7295,0.037383,172.31.36.0-255,1514,220777,1,261896
7296,0.037385,172.31.36.0-255,1514,222291,1,261896
7297,0.03739,172.31.36.0-255,1514,223805,1,261896
7298,0.037391,172.31.36.0-255,1514,225319,1,261896
7299,0.037412,172.31.36.0-255,1489,226808,1,261896
7300,0.037761,172.217.194.0-255,5738,232546,1,261896
7301,0.037769,172.31.36.0-255,66,232612,1,261896
7302,0.038843,104.244.42.0-255,66,232678,1,261896
7303,0.038888,104.244.42.0-255,66,232744,1,261896
7304,0.038943,104.244.42.0-255,66,232810,1,261896
7305,0.038977,104.244.42.0-255,66,232876,1,261896
7306,0.040084,172.217.194.0-255,5738,238614,1,261896
7307,0.040096,172.31.36.0-255,66,238680,1,261896
7308,0.042458,172.217.194.0-255,5738,244418,1,261896
7309,0.042465,172.31.36.0-255,66,244484,1,261896
7310,0.044805,172.217.194.0-255,5738,250222,1,261896
7311,0.044812,172.31.36.0-255,66,250288,1,261896
7312,0.047171,172.217.194.0-255,5738,256026,1,261896
7313,0.047178,172.31.36.0-255,66,256092,1,261896
7314,0.049534,172.217.194.0-255,5738,261830,1,261896
7315,0.04954,172.31.36.0-255,66,261896,1,261896
7316,0.0,172.217.160.0-255,153,153,1,263578
7317,3.5e-05,172.31.36.0-255,66,219,1,263578
7318,4.2e-05,172.217.160.0-255,1484,1703,1,263578
7319,4.7e-05,172.31.36.0-255,66,1769,1,263578
7320,5.2e-05,172.217.160.0-255,2902,4671,1,263578
7321,5.4e-05,172.31.36.0-255,66,4737,1,263578
7322,6.1e-05,172.217.160.0-255,7156,11893,1,263578
7323,6.4e-05,172.31.36.0-255,66,11959,1,263578
7324,7.5e-05,172.31.36.0-255,66,12025,1,263578
7325,8.6e-05,172.31.36.0-255,66,12091,1,263578
7326,0.000161,172.217.160.0-255,1484,13575,1,263578
7327,0.000165,172.31.36.0-255,66,13641,1,263578
7328,0.000171,172.217.160.0-255,2902,16543,1,263578
7329,0.000173,172.31.36.0-255,66,16609,1,263578
7330,0.000176,172.217.160.0-255,1484,18093,1,263578
7331,0.000177,172.31.36.0-255,66,18159,1,263578
7332,0.000203,172.217.160.0-255,4320,22479,1,263578
7333,0.000206,172.31.36.0-255,66,22545,1,263578
7334,0.000217,172.31.36.0-255,66,22611,1,263578
7335,0.000231,172.217.160.0-255,3961,26572,1,263578
7336,0.000235,172.31.36.0-255,66,26638,1,263578
7337,0.000256,172.217.160.0-255,1484,28122,1,263578
7338,0.000259,172.31.36.0-255,66,28188,1,263578
7339,0.000287,172.31.36.0-255,66,28254,1,263578
7340,0.000963,172.217.160.0-255,371,28625,1,263578
7341,0.00097,172.31.36.0-255,66,28691,1,263578
7342,0.001048,172.217.160.0-255,1484,30175,1,263578
7343,0.001053,172.31.36.0-255,66,30241,1,263578
7344,0.001059,172.217.160.0-255,2902,33143,1,263578
7345,0.001066,172.217.160.0-255,4320,37463,1,263578
7346,0.001071,172.31.36.0-255,66,37529,1,263578
7347,0.001082,172.217.160.0-255,1484,39013,1,263578
7348,0.001091,172.217.160.0-255,5738,44751,1,263578
7349,0.001109,172.217.160.0-255,5379,50130,1,263578
7350,0.001113,172.31.36.0-255,66,50196,1,263578
7351,0.001125,172.217.160.0-255,2902,53098,1,263578
7352,0.00118,172.217.160.0-255,2902,56000,1,263578
7353,0.001191,172.217.160.0-255,1484,57484,1,263578
7354,0.001197,172.217.160.0-255,5738,63222,1,263578
7355,0.001201,172.217.160.0-255,2902,66124,1,263578
7356,0.001226,172.217.160.0-255,2902,69026,1,263578
7357,0.001243,172.31.36.0-255,66,69092,1,263578
7358,0.001258,172.31.36.0-255,66,69158,1,263578
7359,0.001275,172.217.160.0-255,766,69924,1,263578
7360,0.001443,172.217.160.0-255,1484,71408,1,263578
7361,0.001452,172.217.160.0-255,2902,74310,1,263578
7362,0.001457,172.217.160.0-255,5738,80048,1,263578
7363,0.001472,172.31.36.0-255,66,80114,1,263578
7364,0.00151,172.217.160.0-255,1484,81598,1,263578
7365,0.001574,172.31.36.0-255,66,81664,1,263578
7366,0.001725,172.217.160.0-255,1484,83148,1,263578
7367,0.001733,172.217.160.0-255,2902,86050,1,263578
7368,0.001764,172.217.160.0-255,5738,91788,1,263578
7369,0.001772,172.217.160.0-255,5738,97526,1,263578
7370,0.001784,172.31.36.0-255,66,97592,1,263578
7371,0.001805,172.217.160.0-255,7156,104748,1,263578
7372,0.001834,172.217.160.0-255,766,105514,1,263578
7373,0.001836,172.217.160.0-255,1484,106998,1,263578
7374,0.001853,172.217.160.0-255,4320,111318,1,263578
7375,0.001868,172.31.36.0-255,66,111384,1,263578
7376,0.00188,172.217.160.0-255,7156,118540,1,263578
7377,0.001896,172.217.160.0-255,2902,121442,1,263578
7378,0.001939,172.31.36.0-255,66,121508,1,263578
7379,0.003835,172.217.160.0-255,5738,127246,1,263578
7380,0.00384,172.31.36.0-255,66,127312,1,263578
7381,0.005727,172.217.160.0-255,5738,133050,1,263578
7382,0.005732,172.31.36.0-255,66,133116,1,263578
7383,0.007613,172.217.160.0-255,5738,138854,1,263578
7384,0.007619,172.31.36.0-255,66,138920,1,263578
7385,0.009513,172.217.160.0-255,5738,144658,1,263578
7386,0.009522,172.31.36.0-255,66,144724,1,263578
7387,0.011406,172.217.160.0-255,5738,150462,1,263578
7388,0.011413,172.31.36.0-255,66,150528,1,263578
7389,0.013294,172.217.160.0-255,5738,156266,1,263578
7390,0.01478,172.31.36.0-255,66,156332,1,263578
7391,0.016664,172.217.160.0-255,5738,162070,1,263578
7392,0.016676,172.31.36.0-255,66,162136,1,263578
7393,0.018562,172.217.160.0-255,5738,167874,1,263578
7394,0.01857,172.31.36.0-255,66,167940,1,263578
7395,0.020457,172.217.160.0-255,5738,173678,1,263578
7396,0.020465,172.31.36.0-255,66,173744,1,263578
7397,0.022361,172.217.160.0-255,5738,179482,1,263578
7398,0.022369,172.31.36.0-255,66,179548,1,263578
7399,0.024271,172.217.160.0-255,5738,185286,1,263578
7400,0.024286,172.31.36.0-255,66,185352,1,263578
7401,0.026167,172.217.160.0-255,5738,191090,1,263578
7402,0.026176,172.31.36.0-255,66,191156,1,263578
7403,0.028061,172.217.160.0-255,5738,196894,1,263578
7404,0.02807,172.31.36.0-255,66,196960,1,263578
7405,0.029954,172.217.160.0-255,5738,202698,1,263578
7406,0.029962,172.31.36.0-255,66,202764,1,263578
7407,0.031861,172.217.160.0-255,5738,208502,1,263578
7408,0.031874,172.31.36.0-255,66,208568,1,263578
7409,0.033766,172.217.160.0-255,5738,214306,1,263578
7410,0.033775,172.31.36.0-255,66,214372,1,263578
7411,0.035657,172.217.160.0-255,5738,220110,1,263578
7412,0.035666,172.31.36.0-255,66,220176,1,263578
7413,0.037547,172.217.160.0-255,5738,225914,1,263578
7414,0.037556,172.31.36.0-255,66,225980,1,263578
7415,0.038676,172.31.36.0-255,172,226152,1,263578
7416,0.038797,172.31.36.0-255,1116,227268,1,263578
7417,0.039019,172.31.36.0-255,562,227830,1,263578
7418,0.039445,172.217.160.0-255,5738,233568,1,263578
7419,0.039453,172.31.36.0-255,66,233634,1,263578
7420,0.040257,104.244.42.0-255,66,233700,1,263578
7421,0.040348,104.244.42.0-255,66,233766,1,263578
7422,0.040529,104.244.42.0-255,66,233832,1,263578
7423,0.041324,172.217.160.0-255,2902,236734,1,263578
7424,0.041328,172.31.36.0-255,66,236800,1,263578
7425,0.041357,172.217.160.0-255,2902,239702,1,263578
7426,0.041394,172.31.36.0-255,66,239768,1,263578
7427,0.043227,172.217.160.0-255,2902,242670,1,263578
7428,0.043233,172.31.36.0-255,66,242736,1,263578
7429,0.043263,172.217.160.0-255,2902,245638,1,263578
7430,0.043284,172.31.36.0-255,66,245704,1,263578
7431,0.04511,172.217.160.0-255,2902,248606,1,263578
7432,0.045116,172.31.36.0-255,66,248672,1,263578
7433,0.045144,172.217.160.0-255,1484,250156,1,263578
7434,0.045162,172.217.160.0-255,1484,251640,1,263578
7435,0.045259,172.31.36.0-255,66,251706,1,263578
7436,0.046993,172.217.160.0-255,2902,254608,1,263578
7437,0.047,172.31.36.0-255,66,254674,1,263578
7438,0.04713,172.217.160.0-255,2902,257576,1,263578
7439,0.047139,172.31.36.0-255,66,257642,1,263578
7440,0.048883,172.217.160.0-255,2902,260544,1,263578
7441,0.048888,172.31.36.0-255,66,260610,1,263578
7442,0.049008,172.217.160.0-255,2902,263512,1,263578
7443,0.049023,172.31.36.0-255,66,263578,1,263578
7444,0.0,172.217.194.0-255,150,150,1,157715
7445,1.5e-05,172.31.36.0-255,66,216,1,157715
7446,2.3e-05,172.217.194.0-255,1484,1700,1,157715
7447,2.8e-05,172.31.36.0-255,66,1766,1,157715
7448,3.3e-05,172.217.194.0-255,2902,4668,1,157715
7449,3.7e-05,172.31.36.0-255,66,4734,1,157715
7450,4.4e-05,172.217.194.0-255,5738,10472,1,157715
7451,4.8e-05,172.31.36.0-255,66,10538,1,157715
7452,6e-05,172.31.36.0-255,66,10604,1,157715
7453,8.2e-05,172.217.194.0-255,2054,12658,1,157715
7454,8.5e-05,172.31.36.0-255,66,12724,1,157715
7455,9.2e-05,172.217.194.0-255,7156,19880,1,157715
7456,9.5e-05,172.31.36.0-255,66,19946,1,157715
7457,0.000123,172.217.194.0-255,2543,22489,1,157715
7458,0.000126,172.31.36.0-255,66,22555,1,157715
7459,0.000131,172.217.194.0-255,4320,26875,1,157715
7460,0.000133,172.31.36.0-255,66,26941,1,157715
7461,0.000139,172.217.194.0-255,5738,32679,1,157715
7462,0.000141,172.31.36.0-255,66,32745,1,157715
7463,0.000145,172.217.194.0-255,1484,34229,1,157715
7464,0.000147,172.31.36.0-255,66,34295,1,157715
7465,0.000191,172.31.36.0-255,66,34361,1,157715
7466,0.000203,172.31.36.0-255,66,34427,1,157715
7467,0.000221,172.217.194.0-255,378,34805,1,157715
7468,0.000223,172.31.36.0-255,66,34871,1,157715
7469,0.000326,172.217.194.0-255,98,34969,1,157715
7470,0.00033,172.31.36.0-255,66,35035,1,157715
7471,0.000452,172.217.194.0-255,364,35399,1,157715
7472,0.000456,172.31.36.0-255,66,35465,1,157715
7473,0.000684,172.217.194.0-255,1484,36949,1,157715
7474,0.000691,172.217.194.0-255,2902,39851,1,157715
7475,0.000694,172.31.36.0-255,66,39917,1,157715
7476,0.000702,172.217.194.0-255,5738,45655,1,157715
7477,0.000704,172.31.36.0-255,66,45721,1,157715
7478,0.000726,172.217.194.0-255,1484,47205,1,157715
7479,0.00076,172.31.36.0-255,66,47271,1,157715
7480,0.000792,172.31.36.0-255,66,47337,1,157715
7481,0.000948,172.217.194.0-255,1484,48821,1,157715
7482,0.000954,172.217.194.0-255,2902,51723,1,157715
7483,0.000957,172.31.36.0-255,66,51789,1,157715
7484,0.000961,172.217.194.0-255,1484,53273,1,157715
7485,0.00098,172.217.194.0-255,4320,57593,1,157715
7486,0.000983,172.31.36.0-255,66,57659,1,157715
7487,0.000993,172.31.36.0-255,66,57725,1,157715
7488,0.001037,172.217.194.0-255,4320,62045,1,157715
7489,0.001042,172.31.36.0-255,66,62111,1,157715
7490,0.001074,172.31.36.0-255,66,62177,1,157715
7491,0.001092,172.217.194.0-255,7156,69333,1,157715
7492,0.001095,172.31.36.0-255,66,69399,1,157715
7493,0.001129,172.31.36.0-255,66,69465,1,157715
7494,0.001144,172.31.36.0-255,66,69531,1,157715
7495,0.001146,172.217.194.0-255,766,70297,1,157715
7496,0.001418,172.217.194.0-255,1484,71781,1,157715
7497,0.001423,172.31.36.0-255,66,71847,1,157715
7498,0.001429,172.217.194.0-255,2902,74749,1,157715
7499,0.001431,172.31.36.0-255,66,74815,1,157715
7500,0.001437,172.217.194.0-255,5738,80553,1,157715
7501,0.00144,172.31.36.0-255,66,80619,1,157715
7502,0.001478,172.31.36.0-255,66,80685,1,157715
7503,0.001483,172.217.194.0-255,2902,83587,1,157715
7504,0.001485,172.31.36.0-255,66,83653,1,157715
7505,0.00154,172.31.36.0-255,66,83719,1,157715
7506,0.00156,172.217.194.0-255,1484,85203,1,157715
7507,0.001565,172.217.194.0-255,2902,88105,1,157715
7508,0.001568,172.31.36.0-255,66,88171,1,157715
7509,0.001575,172.217.194.0-255,5738,93909,1,157715
7510,0.001577,172.31.36.0-255,66,93975,1,157715
7511,0.001601,172.217.194.0-255,4320,98295,1,157715
7512,0.001603,172.31.36.0-255,66,98361,1,157715
7513,0.001631,172.31.36.0-255,66,98427,1,157715
7514,0.001652,172.217.194.0-255,2902,101329,1,157715
7515,0.001655,172.31.36.0-255,66,101395,1,157715
7516,0.001683,172.31.36.0-255,66,101461,1,157715
7517,0.001695,172.31.36.0-255,66,101527,1,157715
7518,0.001711,172.31.36.0-255,66,101593,1,157715
7519,0.001736,172.217.194.0-255,7156,108749,1,157715
7520,0.001738,172.31.36.0-255,66,108815,1,157715
7521,0.001744,172.217.194.0-255,4320,113135,1,157715
7522,0.001746,172.31.36.0-255,66,113201,1,157715
7523,0.001759,172.217.194.0-255,766,113967,1,157715
7524,0.001772,172.217.194.0-255,2902,116869,1,157715
7525,0.001775,172.31.36.0-255,66,116935,1,157715
7526,0.001795,172.217.194.0-255,2902,119837,1,157715
7527,0.001798,172.31.36.0-255,66,119903,1,157715
7528,0.001811,172.31.36.0-255,66,119969,1,157715
7529,0.001844,172.217.194.0-255,1484,121453,1,157715
7530,0.001869,172.31.36.0-255,66,121519,1,157715
7531,0.001931,172.217.194.0-255,1484,123003,1,157715
7532,0.001952,172.217.194.0-255,2902,125905,1,157715
7533,0.001956,172.31.36.0-255,66,125971,1,157715
7534,0.001962,172.217.194.0-255,5738,131709,1,157715
7535,0.001965,172.31.36.0-255,66,131775,1,157715
7536,0.001969,172.217.194.0-255,1484,133259,1,157715
7537,0.002003,172.31.36.0-255,66,133325,1,157715
7538,0.002009,172.217.194.0-255,5738,139063,1,157715
7539,0.002012,172.31.36.0-255,66,139129,1,157715
7540,0.002032,172.217.194.0-255,5020,144149,1,157715
7541,0.002035,172.31.36.0-255,66,144215,1,157715
7542,0.002048,172.31.36.0-255,66,144281,1,157715
7543,0.002073,172.217.194.0-255,2902,147183,1,157715
7544,0.002076,172.31.36.0-255,66,147249,1,157715
7545,0.002088,172.31.36.0-255,66,147315,1,157715
7546,0.002166,172.31.36.0-255,66,147381,1,157715
7547,0.002181,172.31.36.0-255,66,147447,1,157715
7548,0.002199,172.31.36.0-255,66,147513,1,157715
7549,0.002213,172.217.194.0-255,830,148343,1,157715
7550,0.002216,172.217.194.0-255,105,148448,1,157715
7551,0.008328,172.31.36.0-255,66,148514,1,157715
7552,0.008368,172.31.36.0-255,105,148619,1,157715
7553,0.010724,172.217.194.0-255,66,148685,1,157715
7554,0.036135,172.31.36.0-255,172,148857,1,157715
7555,0.036167,172.31.36.0-255,1115,149972,1,157715
7556,0.036235,172.31.36.0-255,1514,151486,1,157715
7557,0.036237,172.31.36.0-255,1514,153000,1,157715
7558,0.036239,172.31.36.0-255,1514,154514,1,157715
7559,0.03624,172.31.36.0-255,1514,156028,1,157715
7560,0.036268,172.31.36.0-255,1489,157517,1,157715
7561,0.037663,104.244.42.0-255,66,157583,1,157715
7562,0.037718,104.244.42.0-255,66,157649,1,157715
7563,0.037867,104.244.42.0-255,66,157715,1,157715
7564,0.0,74.125.24.0-255,156,156,1,292549
7565,3.6e-05,172.31.36.0-255,66,222,1,292549
7566,4.3e-05,74.125.24.0-255,1484,1706,1,292549
7567,4.8e-05,172.31.36.0-255,66,1772,1,292549
7568,5.2e-05,74.125.24.0-255,2902,4674,1,292549
7569,6.4e-05,172.31.36.0-255,66,4740,1,292549
7570,7.1e-05,74.125.24.0-255,7156,11896,1,292549
7571,7.4e-05,172.31.36.0-255,66,11962,1,292549
7572,7.8e-05,74.125.24.0-255,2086,14048,1,292549
7573,8e-05,172.31.36.0-255,66,14114,1,292549
7574,0.000152,74.125.24.0-255,1484,15598,1,292549
7575,0.000156,172.31.36.0-255,66,15664,1,292549
7576,0.000192,74.125.24.0-255,2902,18566,1,292549
7577,0.000196,172.31.36.0-255,66,18632,1,292549
7578,0.000203,74.125.24.0-255,5738,24370,1,292549
7579,0.000205,172.31.36.0-255,66,24436,1,292549
7580,0.000227,74.125.24.0-255,4320,28756,1,292549
7581,0.000234,172.31.36.0-255,66,28822,1,292549
7582,0.000262,74.125.24.0-255,2543,31365,1,292549
7583,0.000265,172.31.36.0-255,66,31431,1,292549
7584,0.000272,74.125.24.0-255,7156,38587,1,292549
7585,0.000276,172.31.36.0-255,66,38653,1,292549
7586,0.000293,172.31.36.0-255,66,38719,1,292549
7587,0.000321,74.125.24.0-255,1125,39844,1,292549
7588,0.000324,172.31.36.0-255,66,39910,1,292549
7589,0.000554,74.125.24.0-255,1484,41394,1,292549
7590,0.000558,172.31.36.0-255,66,41460,1,292549
7591,0.000562,74.125.24.0-255,1484,42944,1,292549
7592,0.000565,172.31.36.0-255,66,43010,1,292549
7593,0.000599,74.125.24.0-255,1484,44494,1,292549
7594,0.000602,172.31.36.0-255,66,44560,1,292549
7595,0.000609,74.125.24.0-255,5738,50298,1,292549
7596,0.000612,172.31.36.0-255,66,50364,1,292549
7597,0.000642,74.125.24.0-255,6797,57161,1,292549
7598,0.000645,172.31.36.0-255,66,57227,1,292549
7599,0.001026,74.125.24.0-255,1484,58711,1,292549
7600,0.001038,74.125.24.0-255,2902,61613,1,292549
7601,0.001041,172.31.36.0-255,66,61679,1,292549
7602,0.001049,74.125.24.0-255,5738,67417,1,292549
7603,0.001052,172.31.36.0-255,66,67483,1,292549
7604,0.001085,74.125.24.0-255,6797,74280,1,292549
7605,0.001089,172.31.36.0-255,66,74346,1,292549
7606,0.001113,74.125.24.0-255,7156,81502,1,292549
7607,0.001117,172.31.36.0-255,66,81568,1,292549
7608,0.001121,74.125.24.0-255,1484,83052,1,292549
7609,0.00116,172.31.36.0-255,66,83118,1,292549
7610,0.001307,74.125.24.0-255,1484,84602,1,292549
7611,0.00133,74.125.24.0-255,2902,87504,1,292549
7612,0.001335,172.31.36.0-255,66,87570,1,292549
7613,0.001339,74.125.24.0-255,1484,89054,1,292549
7614,0.001357,74.125.24.0-255,4320,93374,1,292549
7615,0.001359,172.31.36.0-255,66,93440,1,292549
7616,0.001386,74.125.24.0-255,2902,96342,1,292549
7617,0.001389,172.31.36.0-255,66,96408,1,292549
7618,0.001417,74.125.24.0-255,3846,100254,1,292549
7619,0.00142,172.31.36.0-255,66,100320,1,292549
7620,0.001555,74.125.24.0-255,1484,101804,1,292549
7621,0.001561,74.125.24.0-255,1484,103288,1,292549
7622,0.001563,172.31.36.0-255,66,103354,1,292549
7623,0.00159,74.125.24.0-255,1484,104838,1,292549
7624,0.001594,74.125.24.0-255,2902,107740,1,292549
7625,0.001596,172.31.36.0-255,66,107806,1,292549
7626,0.00163,74.125.24.0-255,7156,114962,1,292549
7627,0.001634,172.31.36.0-255,66,115028,1,292549
7628,0.001657,74.125.24.0-255,2902,117930,1,292549
7629,0.001659,172.31.36.0-255,66,117996,1,292549
7630,0.001697,172.31.36.0-255,66,118062,1,292549
7631,0.001704,74.125.24.0-255,6570,124632,1,292549
7632,0.001706,172.31.36.0-255,66,124698,1,292549
7633,0.001834,74.125.24.0-255,1484,126182,1,292549
7634,0.001848,74.125.24.0-255,2902,129084,1,292549
7635,0.001851,172.31.36.0-255,66,129150,1,292549
7636,0.001863,74.125.24.0-255,1484,130634,1,292549
7637,0.001882,74.125.24.0-255,4320,134954,1,292549
7638,0.001884,172.31.36.0-255,66,135020,1,292549
7639,0.001891,74.125.24.0-255,7156,142176,1,292549
7640,0.001893,172.31.36.0-255,66,142242,1,292549
7641,0.001925,74.125.24.0-255,5738,147980,1,292549
7642,0.001928,172.31.36.0-255,66,148046,1,292549
7643,0.00194,172.31.36.0-255,66,148112,1,292549
7644,0.002217,74.125.24.0-255,1484,149596,1,292549
7645,0.002235,74.125.24.0-255,1484,151080,1,292549
7646,0.002237,172.31.36.0-255,66,151146,1,292549
7647,0.002251,74.125.24.0-255,1484,152630,1,292549
7648,0.002261,74.125.24.0-255,5738,158368,1,292549
7649,0.002264,172.31.36.0-255,66,158434,1,292549
7650,0.002268,74.125.24.0-255,2902,161336,1,292549
7651,0.00227,172.31.36.0-255,66,161402,1,292549
7652,0.002287,74.125.24.0-255,4320,165722,1,292549
7653,0.002289,172.31.36.0-255,66,165788,1,292549
7654,0.002314,74.125.24.0-255,1484,167272,1,292549
7655,0.002342,172.31.36.0-255,66,167338,1,292549
7656,0.002345,74.125.24.0-255,766,168104,1,292549
7657,0.002566,74.125.24.0-255,1484,169588,1,292549
7658,0.002568,172.31.36.0-255,66,169654,1,292549
7659,0.002594,74.125.24.0-255,2902,172556,1,292549
7660,0.002597,172.31.36.0-255,66,172622,1,292549
7661,0.002602,74.125.24.0-255,5738,178360,1,292549
7662,0.002604,172.31.36.0-255,66,178426,1,292549
7663,0.002645,74.125.24.0-255,1484,179910,1,292549
7664,0.002649,74.125.24.0-255,1484,181394,1,292549
7665,0.002651,172.31.36.0-255,66,181460,1,292549
7666,0.002658,74.125.24.0-255,5738,187198,1,292549
7667,0.00266,172.31.36.0-255,66,187264,1,292549
7668,0.002662,74.125.24.0-255,1484,188748,1,292549
7669,0.00267,74.125.24.0-255,1484,190232,1,292549
7670,0.002671,172.31.36.0-255,66,190298,1,292549
7671,0.002702,74.125.24.0-255,5738,196036,1,292549
7672,0.002705,172.31.36.0-255,66,196102,1,292549
7673,0.002725,74.125.24.0-255,4320,200422,1,292549
7674,0.002728,172.31.36.0-255,66,200488,1,292549
7675,0.002731,74.125.24.0-255,2184,202672,1,292549
7676,0.002733,172.31.36.0-255,66,202738,1,292549
7677,0.002898,74.125.24.0-255,1484,204222,1,292549
7678,0.00291,74.125.24.0-255,2902,207124,1,292549
7679,0.002913,172.31.36.0-255,66,207190,1,292549
7680,0.002942,74.125.24.0-255,5738,212928,1,292549
7681,0.002945,172.31.36.0-255,66,212994,1,292549
7682,0.00295,74.125.24.0-255,4320,217314,1,292549
7683,0.002951,172.31.36.0-255,66,217380,1,292549
7684,0.002986,172.31.36.0-255,66,217446,1,292549
7685,0.002999,172.31.36.0-255,66,217512,1,292549
7686,0.003004,74.125.24.0-255,4320,221832,1,292549
7687,0.003007,172.31.36.0-255,66,221898,1,292549
7688,0.003045,172.31.36.0-255,66,221964,1,292549
7689,0.003063,172.31.36.0-255,66,222030,1,292549
7690,0.003065,74.125.24.0-255,1484,223514,1,292549
7691,0.0031,74.125.24.0-255,5738,229252,1,292549
7692,0.003102,172.31.36.0-255,66,229318,1,292549
7693,0.003107,74.125.24.0-255,4320,233638,1,292549
7694,0.003109,172.31.36.0-255,66,233704,1,292549
7695,0.003123,172.31.36.0-255,66,233770,1,292549
7696,0.00313,74.125.24.0-255,7156,240926,1,292549
7697,0.003132,172.31.36.0-255,66,240992,1,292549
7698,0.003159,74.125.24.0-255,4320,245312,1,292549
7699,0.003161,172.31.36.0-255,66,245378,1,292549
7700,0.00318,74.125.24.0-255,2184,247562,1,292549
7701,0.003183,172.31.36.0-255,66,247628,1,292549
7702,0.003187,74.125.24.0-255,2902,250530,1,292549
7703,0.003189,172.31.36.0-255,66,250596,1,292549
7704,0.003191,74.125.24.0-255,1484,252080,1,292549
7705,0.003194,74.125.24.0-255,1484,253564,1,292549
7706,0.003196,172.31.36.0-255,66,253630,1,292549
7707,0.0032,74.125.24.0-255,2902,256532,1,292549
7708,0.003202,172.31.36.0-255,66,256598,1,292549
7709,0.003216,74.125.24.0-255,4320,260918,1,292549
7710,0.003218,172.31.36.0-255,66,260984,1,292549
7711,0.003245,74.125.24.0-255,7156,268140,1,292549
7712,0.003248,172.31.36.0-255,66,268206,1,292549
7713,0.003262,172.31.36.0-255,66,268272,1,292549
7714,0.003265,74.125.24.0-255,1484,269756,1,292549
7715,0.003301,74.125.24.0-255,5020,274776,1,292549
7716,0.003304,172.31.36.0-255,66,274842,1,292549
7717,0.003314,172.31.36.0-255,66,274908,1,292549
7718,0.00332,74.125.24.0-255,7156,282064,1,292549
7719,0.003322,172.31.36.0-255,66,282130,1,292549
7720,0.00334,172.31.36.0-255,66,282196,1,292549
7721,0.003343,74.125.24.0-255,916,283112,1,292549
7722,0.00337,74.125.24.0-255,105,283217,1,292549
7723,0.009847,172.31.36.0-255,66,283283,1,292549
7724,0.00988,172.31.36.0-255,105,283388,1,292549
7725,0.011939,74.125.24.0-255,66,283454,1,292549
7726,0.043174,172.31.36.0-255,172,283626,1,292549
7727,0.043207,172.31.36.0-255,1114,284740,1,292549
7728,0.043255,172.31.36.0-255,1514,286254,1,292549
7729,0.043257,172.31.36.0-255,1514,287768,1,292549
7730,0.043258,172.31.36.0-255,1514,289282,1,292549
7731,0.043263,172.31.36.0-255,1514,290796,1,292549
7732,0.043264,172.31.36.0-255,1489,292285,1,292549
7733,0.044728,104.244.42.0-255,66,292351,1,292549
7734,0.044893,104.244.42.0-255,66,292417,1,292549
7735,0.044896,104.244.42.0-255,66,292483,1,292549
7736,0.044899,104.244.42.0-255,66,292549,1,292549
7737,0.0,172.217.194.0-255,289,289,1,197582
7738,2.5e-05,172.31.36.0-255,66,355,1,197582
7739,3.2e-05,172.217.194.0-255,1484,1839,1,197582
7740,3.6e-05,172.31.36.0-255,66,1905,1,197582
7741,4.4e-05,172.217.194.0-255,4320,6225,1,197582
7742,4.8e-05,172.31.36.0-255,66,6291,1,197582
7743,5.5e-05,172.217.194.0-255,7156,13447,1,197582
7744,5.8e-05,172.31.36.0-255,66,13513,1,197582
7745,6.2e-05,172.217.194.0-255,1484,14997,1,197582
7746,6.4e-05,172.31.36.0-255,66,15063,1,197582
7747,0.000101,172.31.36.0-255,66,15129,1,197582
7748,0.000115,172.31.36.0-255,66,15195,1,197582
7749,0.00012,172.217.194.0-255,2902,18097,1,197582
7750,0.000122,172.31.36.0-255,66,18163,1,197582
7751,0.000142,172.217.194.0-255,5020,23183,1,197582
7752,0.000146,172.31.36.0-255,66,23249,1,197582
7753,0.000153,172.217.194.0-255,4320,27569,1,197582
7754,0.000155,172.31.36.0-255,66,27635,1,197582
7755,0.000183,172.217.194.0-255,4320,31955,1,197582
7756,0.000186,172.31.36.0-255,66,32021,1,197582
7757,0.000198,172.31.36.0-255,66,32087,1,197582
7758,0.000352,172.217.194.0-255,100,32187,1,197582
7759,0.000357,172.31.36.0-255,66,32253,1,197582
7760,0.000396,172.217.194.0-255,1484,33737,1,197582
7761,0.000398,172.31.36.0-255,66,33803,1,197582
7762,0.000404,172.217.194.0-255,2902,36705,1,197582
7763,0.000407,172.31.36.0-255,66,36771,1,197582
7764,0.000413,172.217.194.0-255,4320,41091,1,197582
7765,0.000415,172.31.36.0-255,66,41157,1,197582
7766,0.000432,172.217.194.0-255,2902,44059,1,197582
7767,0.000434,172.31.36.0-255,66,44125,1,197582
7768,0.000445,172.31.36.0-255,66,44191,1,197582
7769,0.000485,172.217.194.0-255,5738,49929,1,197582
7770,0.000489,172.31.36.0-255,66,49995,1,197582
7771,0.00052,172.31.36.0-255,66,50061,1,197582
7772,0.000533,172.31.36.0-255,66,50127,1,197582
7773,0.000541,172.217.194.0-255,7156,57283,1,197582
7774,0.000543,172.31.36.0-255,66,57349,1,197582
7775,0.000579,172.31.36.0-255,66,57415,1,197582
7776,0.000648,172.31.36.0-255,66,57481,1,197582
7777,0.000665,172.31.36.0-255,66,57547,1,197582
7778,0.000668,172.217.194.0-255,766,58313,1,197582
7779,0.000734,172.217.194.0-255,1484,59797,1,197582
7780,0.000737,172.31.36.0-255,66,59863,1,197582
7781,0.000742,172.217.194.0-255,2902,62765,1,197582
7782,0.000744,172.31.36.0-255,66,62831,1,197582
7783,0.000773,172.217.194.0-255,5738,68569,1,197582
7784,0.000777,172.31.36.0-255,66,68635,1,197582
7785,0.000808,172.31.36.0-255,66,68701,1,197582
7786,0.000821,172.217.194.0-255,1484,70185,1,197582
7787,0.000839,172.217.194.0-255,4320,74505,1,197582
7788,0.000842,172.31.36.0-255,66,74571,1,197582
7789,0.000867,172.217.194.0-255,6438,81009,1,197582
7790,0.00087,172.31.36.0-255,66,81075,1,197582
7791,0.0009,172.217.194.0-255,1484,82559,1,197582
7792,0.000914,172.217.194.0-255,2902,85461,1,197582
7793,0.000917,172.31.36.0-255,66,85527,1,197582
7794,0.000941,172.217.194.0-255,5738,91265,1,197582
7795,0.000944,172.31.36.0-255,66,91331,1,197582
7796,0.00095,172.217.194.0-255,5738,97069,1,197582
7797,0.000952,172.31.36.0-255,66,97135,1,197582
7798,0.000993,172.31.36.0-255,66,97201,1,197582
7799,0.001,172.217.194.0-255,5020,102221,1,197582
7800,0.001002,172.31.36.0-255,66,102287,1,197582
7801,0.00105,172.217.194.0-255,5738,108025,1,197582
7802,0.001054,172.31.36.0-255,66,108091,1,197582
7803,0.00109,172.31.36.0-255,66,108157,1,197582
7804,0.001102,172.217.194.0-255,5738,113895,1,197582
7805,0.001105,172.31.36.0-255,66,113961,1,197582
7806,0.001126,172.217.194.0-255,5738,119699,1,197582
7807,0.001129,172.217.194.0-255,1484,121183,1,197582
7808,0.001133,172.31.36.0-255,66,121249,1,197582
7809,0.001159,172.31.36.0-255,66,121315,1,197582
7810,0.001195,172.31.36.0-255,66,121381,1,197582
7811,0.001211,172.31.36.0-255,66,121447,1,197582
7812,0.001233,172.217.194.0-255,1484,122931,1,197582
7813,0.001251,172.217.194.0-255,2902,125833,1,197582
7814,0.001254,172.31.36.0-255,66,125899,1,197582
7815,0.00128,172.217.194.0-255,5738,131637,1,197582
7816,0.001283,172.31.36.0-255,66,131703,1,197582
7817,0.001319,172.217.194.0-255,2902,134605,1,197582
7818,0.001321,172.31.36.0-255,66,134671,1,197582
7819,0.00134,172.31.36.0-255,66,134737,1,197582
7820,0.001348,172.217.194.0-255,7156,141893,1,197582
7821,0.00135,172.31.36.0-255,66,141959,1,197582
7822,0.001353,172.217.194.0-255,1484,143443,1,197582
7823,0.001368,172.217.194.0-255,2184,145627,1,197582
7824,0.001371,172.31.36.0-255,66,145693,1,197582
7825,0.001411,172.217.194.0-255,1484,147177,1,197582
7826,0.001417,172.217.194.0-255,2902,150079,1,197582
7827,0.00142,172.31.36.0-255,66,150145,1,197582
7828,0.001443,172.217.194.0-255,5738,155883,1,197582
7829,0.001448,172.31.36.0-255,66,155949,1,197582
7830,0.001455,172.217.194.0-255,1484,157433,1,197582
7831,0.001478,172.31.36.0-255,66,157499,1,197582
7832,0.001497,172.217.194.0-255,1484,158983,1,197582
7833,0.001501,172.217.194.0-255,2902,161885,1,197582
7834,0.001507,172.31.36.0-255,66,161951,1,197582
7835,0.001525,172.217.194.0-255,4320,166271,1,197582
7836,0.001528,172.31.36.0-255,66,166337,1,197582
7837,0.001552,172.217.194.0-255,3602,169939,1,197582
7838,0.001555,172.31.36.0-255,66,170005,1,197582
7839,0.001597,172.217.194.0-255,4320,174325,1,197582
7840,0.001601,172.31.36.0-255,66,174391,1,197582
7841,0.001623,172.217.194.0-255,4320,178711,1,197582
7842,0.001626,172.31.36.0-255,66,178777,1,197582
7843,0.001638,172.31.36.0-255,66,178843,1,197582
7844,0.001656,172.31.36.0-255,66,178909,1,197582
7845,0.001676,172.217.194.0-255,3602,182511,1,197582
7846,0.001679,172.31.36.0-255,66,182577,1,197582
7847,0.001685,172.217.194.0-255,5567,188144,1,197582
7848,0.001687,172.31.36.0-255,66,188210,1,197582
7849,0.00169,172.217.194.0-255,105,188315,1,197582
7850,0.004338,172.31.36.0-255,66,188381,1,197582
7851,0.004374,172.31.36.0-255,105,188486,1,197582
7852,0.006949,172.217.194.0-255,66,188552,1,197582
7853,0.043475,172.31.36.0-255,172,188724,1,197582
7854,0.043526,172.31.36.0-255,1115,189839,1,197582
7855,0.043593,172.31.36.0-255,1514,191353,1,197582
7856,0.043595,172.31.36.0-255,1514,192867,1,197582
7857,0.043599,172.31.36.0-255,1514,194381,1,197582
7858,0.043601,172.31.36.0-255,1514,195895,1,197582
7859,0.043623,172.31.36.0-255,1489,197384,1,197582
7860,0.045012,104.244.42.0-255,66,197450,1,197582
7861,0.045107,104.244.42.0-255,66,197516,1,197582
7862,0.045159,104.244.42.0-255,66,197582,1,197582
7863,0.0,74.125.24.0-255,143,143,1,257092
7864,1.7e-05,172.31.36.0-255,66,209,1,257092
7865,2.4e-05,74.125.24.0-255,1484,1693,1,257092
7866,3e-05,172.31.36.0-255,66,1759,1,257092
7867,3.6e-05,74.125.24.0-255,2902,4661,1,257092
7868,3.9e-05,172.31.36.0-255,66,4727,1,257092
7869,4.4e-05,74.125.24.0-255,2902,7629,1,257092
7870,4.7e-05,172.31.36.0-255,66,7695,1,257092
7871,6.6e-05,74.125.24.0-255,2902,10597,1,257092
7872,6.9e-05,172.31.36.0-255,66,10663,1,257092
7873,9e-05,74.125.24.0-255,1484,12147,1,257092
7874,9.2e-05,172.31.36.0-255,66,12213,1,257092
7875,0.000114,74.125.24.0-255,4813,17026,1,257092
7876,0.000117,172.31.36.0-255,66,17092,1,257092
7877,0.000124,74.125.24.0-255,7156,24248,1,257092
7878,0.000127,172.31.36.0-255,66,24314,1,257092
7879,0.000159,74.125.24.0-255,4320,28634,1,257092
7880,0.000162,172.31.36.0-255,66,28700,1,257092
7881,0.00018,74.125.24.0-255,2543,31243,1,257092
7882,0.000182,172.31.36.0-255,66,31309,1,257092
7883,0.000918,74.125.24.0-255,1484,32793,1,257092
7884,0.000925,172.31.36.0-255,66,32859,1,257092
7885,0.000931,74.125.24.0-255,2902,35761,1,257092
7886,0.000934,172.31.36.0-255,66,35827,1,257092
7887,0.000941,74.125.24.0-255,5738,41565,1,257092
7888,0.000943,172.31.36.0-255,66,41631,1,257092
7889,0.000964,74.125.24.0-255,4320,45951,1,257092
7890,0.000967,172.31.36.0-255,66,46017,1,257092
7891,0.000995,74.125.24.0-255,6797,52814,1,257092
7892,0.000998,172.31.36.0-255,66,52880,1,257092
7893,0.001012,172.31.36.0-255,66,52946,1,257092
7894,0.001015,74.125.24.0-255,1125,54071,1,257092
7895,0.001049,74.125.24.0-255,649,54720,1,257092
7896,0.001052,172.31.36.0-255,66,54786,1,257092
7897,0.00113,74.125.24.0-255,1484,56270,1,257092
7898,0.001135,74.125.24.0-255,2902,59172,1,257092
7899,0.001138,172.31.36.0-255,66,59238,1,257092
7900,0.001146,74.125.24.0-255,5738,64976,1,257092
7901,0.001148,172.31.36.0-255,66,65042,1,257092
7902,0.001155,74.125.24.0-255,5738,70780,1,257092
7903,0.001157,172.31.36.0-255,66,70846,1,257092
7904,0.001209,74.125.24.0-255,5738,76584,1,257092
7905,0.001213,172.31.36.0-255,66,76650,1,257092
7906,0.001234,74.125.24.0-255,2543,79193,1,257092
7907,0.001237,172.31.36.0-255,66,79259,1,257092
7908,0.001247,172.31.36.0-255,66,79325,1,257092
7909,0.001269,74.125.24.0-255,1125,80450,1,257092
7910,0.001414,74.125.24.0-255,1484,81934,1,257092
7911,0.001419,172.31.36.0-255,66,82000,1,257092
7912,0.001425,74.125.24.0-255,2902,84902,1,257092
7913,0.001427,172.31.36.0-255,66,84968,1,257092
7914,0.001432,74.125.24.0-255,2902,87870,1,257092
7915,0.001434,172.31.36.0-255,66,87936,1,257092
7916,0.001453,74.125.24.0-255,2902,90838,1,257092
7917,0.001455,172.31.36.0-255,66,90904,1,257092
7918,0.001461,74.125.24.0-255,4320,95224,1,257092
7919,0.001464,172.31.36.0-255,66,95290,1,257092
7920,0.001502,172.31.36.0-255,66,95356,1,257092
7921,0.001513,172.31.36.0-255,66,95422,1,257092
7922,0.001578,172.31.36.0-255,66,95488,1,257092
7923,0.001593,74.125.24.0-255,6438,101926,1,257092
7924,0.001597,172.31.36.0-255,66,101992,1,257092
7925,0.001602,74.125.24.0-255,4320,106312,1,257092
7926,0.001605,172.31.36.0-255,66,106378,1,257092
7927,0.001639,172.31.36.0-255,66,106444,1,257092
7928,0.001646,74.125.24.0-255,5738,112182,1,257092
7929,0.001649,172.31.36.0-255,66,112248,1,257092
7930,0.001656,74.125.24.0-255,7156,119404,1,257092
7931,0.001659,172.31.36.0-255,66,119470,1,257092
7932,0.001663,74.125.24.0-255,2902,122372,1,257092
7933,0.001665,172.31.36.0-255,66,122438,1,257092
7934,0.001684,74.125.24.0-255,4320,126758,1,257092
7935,0.001687,172.31.36.0-255,66,126824,1,257092
7936,0.001714,74.125.24.0-255,7156,133980,1,257092
7937,0.001721,74.125.24.0-255,4320,138300,1,257092
7938,0.001731,172.31.36.0-255,66,138366,1,257092
7939,0.001741,74.125.24.0-255,2184,140550,1,257092
7940,0.001753,172.31.36.0-255,66,140616,1,257092
7941,0.00402,74.125.24.0-255,2902,143518,1,257092
7942,0.004026,172.31.36.0-255,66,143584,1,257092
7943,0.00409,74.125.24.0-255,2902,146486,1,257092
7944,0.004093,172.31.36.0-255,66,146552,1,257092
7945,0.006364,74.125.24.0-255,2902,149454,1,257092
7946,0.006367,172.31.36.0-255,66,149520,1,257092
7947,0.006434,74.125.24.0-255,2902,152422,1,257092
7948,0.006436,172.31.36.0-255,66,152488,1,257092
7949,0.008661,74.125.24.0-255,2902,155390,1,257092
7950,0.008667,172.31.36.0-255,66,155456,1,257092
7951,0.008718,74.125.24.0-255,2902,158358,1,257092
7952,0.008721,172.31.36.0-255,66,158424,1,257092
7953,0.011049,74.125.24.0-255,5738,164162,1,257092
7954,0.011057,172.31.36.0-255,66,164228,1,257092
7955,0.013397,74.125.24.0-255,5738,169966,1,257092
7956,0.013405,172.31.36.0-255,66,170032,1,257092
7957,0.015722,74.125.24.0-255,5738,175770,1,257092
7958,0.015733,172.31.36.0-255,66,175836,1,257092
7959,0.018094,74.125.24.0-255,5738,181574,1,257092
7960,0.018106,172.31.36.0-255,66,181640,1,257092
7961,0.020403,74.125.24.0-255,5738,187378,1,257092
7962,0.02041,172.31.36.0-255,66,187444,1,257092
7963,0.022723,74.125.24.0-255,5738,193182,1,257092
7964,0.022731,172.31.36.0-255,66,193248,1,257092
7965,0.02505,74.125.24.0-255,5738,198986,1,257092
7966,0.025057,172.31.36.0-255,66,199052,1,257092
7967,0.027389,74.125.24.0-255,5738,204790,1,257092
7968,0.027397,172.31.36.0-255,66,204856,1,257092
7969,0.029699,74.125.24.0-255,5738,210594,1,257092
7970,0.029706,172.31.36.0-255,66,210660,1,257092
7971,0.032037,74.125.24.0-255,5738,216398,1,257092
7972,0.032045,172.31.36.0-255,66,216464,1,257092
7973,0.034379,74.125.24.0-255,5738,222202,1,257092
7974,0.034388,172.31.36.0-255,66,222268,1,257092
7975,0.036739,74.125.24.0-255,5738,228006,1,257092
7976,0.036747,172.31.36.0-255,66,228072,1,257092
7977,0.039096,74.125.24.0-255,5738,233810,1,257092
7978,0.039104,172.31.36.0-255,66,233876,1,257092
7979,0.041394,74.125.24.0-255,5738,239614,1,257092
7980,0.041405,172.31.36.0-255,66,239680,1,257092
7981,0.04376,74.125.24.0-255,5738,245418,1,257092
7982,0.043772,172.31.36.0-255,66,245484,1,257092
7983,0.046067,74.125.24.0-255,5738,251222,1,257092
7984,0.046074,172.31.36.0-255,66,251288,1,257092
7985,0.048441,74.125.24.0-255,5738,257026,1,257092
7986,0.04845,172.31.36.0-255,66,257092,1,257092
7987,0.0,74.125.68.0-255,146,146,1,281920
7988,2.5e-05,172.31.36.0-255,66,212,1,281920
7989,3.2e-05,74.125.68.0-255,1484,1696,1,281920
7990,3.6e-05,172.31.36.0-255,66,1762,1,281920
7991,4.3e-05,74.125.68.0-255,2902,4664,1,281920
7992,5.5e-05,172.31.36.0-255,66,4730,1,281920
7993,6.2e-05,74.125.68.0-255,4320,9050,1,281920
7994,6.5e-05,172.31.36.0-255,66,9116,1,281920
7995,0.000102,74.125.68.0-255,4889,14005,1,281920
7996,0.000106,172.31.36.0-255,66,14071,1,281920
7997,0.000191,74.125.68.0-255,1484,15555,1,281920
7998,0.000195,172.31.36.0-255,66,15621,1,281920
7999,0.0002,74.125.68.0-255,2902,18523,1,281920
8000,0.000203,172.31.36.0-255,66,18589,1,281920
8001,0.000235,74.125.68.0-255,5738,24327,1,281920
8002,0.000238,172.31.36.0-255,66,24393,1,281920
8003,0.000267,74.125.68.0-255,6797,31190,1,281920
8004,0.00027,172.31.36.0-255,66,31256,1,281920
8005,0.000286,74.125.68.0-255,1484,32740,1,281920
8006,0.000289,172.31.36.0-255,66,32806,1,281920
8007,0.000293,74.125.68.0-255,2902,35708,1,281920
8008,0.000296,172.31.36.0-255,66,35774,1,281920
8009,0.000326,74.125.68.0-255,5738,41512,1,281920
8010,0.000329,172.31.36.0-255,66,41578,1,281920
8011,0.000335,74.125.68.0-255,5738,47316,1,281920
8012,0.000338,172.31.36.0-255,66,47382,1,281920
8013,0.000374,74.125.68.0-255,1125,48507,1,281920
8014,0.000376,172.31.36.0-255,66,48573,1,281920
8015,0.000417,74.125.68.0-255,1484,50057,1,281920
8016,0.00042,172.31.36.0-255,66,50123,1,281920
8017,0.000423,74.125.68.0-255,1484,51607,1,281920
8018,0.000426,172.31.36.0-255,66,51673,1,281920
8019,0.000445,74.125.68.0-255,2902,54575,1,281920
8020,0.000451,172.31.36.0-255,66,54641,1,281920
8021,0.000458,74.125.68.0-255,5738,60379,1,281920
8022,0.000461,172.31.36.0-255,66,60445,1,281920
8023,0.000493,74.125.68.0-255,5694,66139,1,281920
8024,0.000496,172.31.36.0-255,66,66205,1,281920
8025,0.000519,74.125.68.0-255,108,66313,1,281920
8026,0.000565,74.125.68.0-255,1484,67797,1,281920
8027,0.000568,172.31.36.0-255,66,67863,1,281920
8028,0.000573,74.125.68.0-255,2902,70765,1,281920
8029,0.000575,172.31.36.0-255,66,70831,1,281920
8030,0.000608,74.125.68.0-255,4320,75151,1,281920
8031,0.000611,172.31.36.0-255,66,75217,1,281920
8032,0.000639,74.125.68.0-255,5738,80955,1,281920
8033,0.000642,172.31.36.0-255,66,81021,1,281920
8034,0.000671,74.125.68.0-255,7156,88177,1,281920
8035,0.000674,172.31.36.0-255,66,88243,1,281920
8036,0.000701,172.31.36.0-255,66,88309,1,281920
8037,0.000732,74.125.68.0-255,329,88638,1,281920
8038,0.000782,74.125.68.0-255,1484,90122,1,281920
8039,0.000817,172.31.36.0-255,66,90188,1,281920
8040,0.000844,74.125.68.0-255,2902,93090,1,281920
8041,0.000847,172.31.36.0-255,66,93156,1,281920
8042,0.000853,74.125.68.0-255,5738,98894,1,281920
8043,0.000856,172.31.36.0-255,66,98960,1,281920
8044,0.000862,74.125.68.0-255,5738,104698,1,281920
8045,0.000865,172.31.36.0-255,66,104764,1,281920
8046,0.000872,74.125.68.0-255,7156,111920,1,281920
8047,0.000875,172.31.36.0-255,66,111986,1,281920
8048,0.000923,172.31.36.0-255,66,112052,1,281920
8049,0.001161,74.125.68.0-255,1484,113536,1,281920
8050,0.001167,74.125.68.0-255,2902,116438,1,281920
8051,0.001171,172.31.36.0-255,66,116504,1,281920
8052,0.001199,74.125.68.0-255,5738,122242,1,281920
8053,0.001202,172.31.36.0-255,66,122308,1,281920
8054,0.001238,172.31.36.0-255,66,122374,1,281920
8055,0.001242,74.125.68.0-255,1484,123858,1,281920
8056,0.001275,172.31.36.0-255,66,123924,1,281920
8057,0.001283,74.125.68.0-255,4320,128244,1,281920
8058,0.001285,172.31.36.0-255,66,128310,1,281920
8059,0.001293,74.125.68.0-255,766,129076,1,281920
8060,0.002273,172.31.36.0-255,66,129142,1,281920
8061,0.003216,74.125.68.0-255,4320,133462,1,281920
8062,0.003223,172.31.36.0-255,66,133528,1,281920
8063,0.004186,74.125.68.0-255,1484,135012,1,281920
8064,0.005151,74.125.68.0-255,4320,139332,1,281920
8065,0.005156,172.31.36.0-255,66,139398,1,281920
8066,0.007076,74.125.68.0-255,5738,145136,1,281920
8067,0.00708,172.31.36.0-255,66,145202,1,281920
8068,0.009013,74.125.68.0-255,5738,150940,1,281920
8069,0.00902,172.31.36.0-255,66,151006,1,281920
8070,0.010954,74.125.68.0-255,5738,156744,1,281920
8071,0.010962,172.31.36.0-255,66,156810,1,281920
8072,0.012908,74.125.68.0-255,5738,162548,1,281920
8073,0.012916,172.31.36.0-255,66,162614,1,281920
8074,0.014857,74.125.68.0-255,5738,168352,1,281920
8075,0.014865,172.31.36.0-255,66,168418,1,281920
8076,0.016807,74.125.68.0-255,5738,174156,1,281920
8077,0.016815,172.31.36.0-255,66,174222,1,281920
8078,0.018749,74.125.68.0-255,5738,179960,1,281920
8079,0.018756,172.31.36.0-255,66,180026,1,281920
8080,0.020688,74.125.68.0-255,5738,185764,1,281920
8081,0.020693,172.31.36.0-255,66,185830,1,281920
8082,0.022629,74.125.68.0-255,5738,191568,1,281920
8083,0.022636,172.31.36.0-255,66,191634,1,281920
8084,0.024569,74.125.68.0-255,5738,197372,1,281920
8085,0.024576,172.31.36.0-255,66,197438,1,281920
8086,0.026514,74.125.68.0-255,5738,203176,1,281920
8087,0.026522,172.31.36.0-255,66,203242,1,281920
8088,0.028461,74.125.68.0-255,5738,208980,1,281920
8089,0.02847,172.31.36.0-255,66,209046,1,281920
8090,0.030438,74.125.68.0-255,5738,214784,1,281920
8091,0.030446,172.31.36.0-255,66,214850,1,281920
8092,0.032376,74.125.68.0-255,5738,220588,1,281920
8093,0.032384,172.31.36.0-255,66,220654,1,281920
8094,0.034323,74.125.68.0-255,5738,226392,1,281920
8095,0.034331,172.31.36.0-255,66,226458,1,281920
8096,0.036264,74.125.68.0-255,5738,232196,1,281920
8097,0.036272,172.31.36.0-255,66,232262,1,281920
8098,0.03787,172.31.36.0-255,172,232434,1,281920
8099,0.037901,172.31.36.0-255,1115,233549,1,281920
8100,0.037967,172.31.36.0-255,1514,235063,1,281920
8101,0.037969,172.31.36.0-255,1514,236577,1,281920
8102,0.037976,172.31.36.0-255,1514,238091,1,281920
8103,0.037977,172.31.36.0-255,1514,239605,1,281920
8104,0.037995,172.31.36.0-255,1489,241094,1,281920
8105,0.0382,74.125.68.0-255,5738,246832,1,281920
8106,0.038207,172.31.36.0-255,66,246898,1,281920
8107,0.039429,104.244.42.0-255,66,246964,1,281920
8108,0.039466,104.244.42.0-255,66,247030,1,281920
8109,0.039526,104.244.42.0-255,66,247096,1,281920
8110,0.04015,74.125.68.0-255,5738,252834,1,281920
8111,0.040157,172.31.36.0-255,66,252900,1,281920
8112,0.042144,74.125.68.0-255,5738,258638,1,281920
8113,0.042151,172.31.36.0-255,66,258704,1,281920
8114,0.044093,74.125.68.0-255,5738,264442,1,281920
8115,0.044102,172.31.36.0-255,66,264508,1,281920
8116,0.046034,74.125.68.0-255,5738,270246,1,281920
8117,0.046041,172.31.36.0-255,66,270312,1,281920
8118,0.047981,74.125.68.0-255,5738,276050,1,281920
8119,0.047989,172.31.36.0-255,66,276116,1,281920
8120,0.049932,74.125.68.0-255,5738,281854,1,281920
8121,0.049939,172.31.36.0-255,66,281920,1,281920
8122,0.0,74.125.24.0-255,150,150,1,233283
8123,1.8e-05,172.31.36.0-255,66,216,1,233283
8124,2.5e-05,74.125.24.0-255,1484,1700,1,233283
8125,2.9e-05,172.31.36.0-255,66,1766,1,233283
8126,3.6e-05,74.125.24.0-255,2902,4668,1,233283
8127,4e-05,172.31.36.0-255,66,4734,1,233283
8128,4.8e-05,74.125.24.0-255,7156,11890,1,233283
8129,5.1e-05,172.31.36.0-255,66,11956,1,233283
8130,9.4e-05,74.125.24.0-255,2019,13975,1,233283
8131,9.7e-05,172.31.36.0-255,66,14041,1,233283
8132,0.000252,74.125.24.0-255,1484,15525,1,233283
8133,0.000257,172.31.36.0-255,66,15591,1,233283
8134,0.000263,74.125.24.0-255,2902,18493,1,233283
8135,0.000266,172.31.36.0-255,66,18559,1,233283
8136,0.000295,74.125.24.0-255,5738,24297,1,233283
8137,0.000297,172.31.36.0-255,66,24363,1,233283
8138,0.000329,74.125.24.0-255,6797,31160,1,233283
8139,0.000333,172.31.36.0-255,66,31226,1,233283
8140,0.000525,74.125.24.0-255,1484,32710,1,233283
8141,0.000529,172.31.36.0-255,66,32776,1,233283
8142,0.000535,74.125.24.0-255,2902,35678,1,233283
8143,0.000537,172.31.36.0-255,66,35744,1,233283
8144,0.000552,74.125.24.0-255,2902,38646,1,233283
8145,0.000555,172.31.36.0-255,66,38712,1,233283
8146,0.000568,74.125.24.0-255,2902,41614,1,233283
8147,0.00057,172.31.36.0-255,66,41680,1,233283
8148,0.000647,74.125.24.0-255,7156,48836,1,233283
8149,0.000651,172.31.36.0-255,66,48902,1,233283
8150,0.000673,74.125.24.0-255,5379,54281,1,233283
8151,0.000676,172.31.36.0-255,66,54347,1,233283
8152,0.00071,172.31.36.0-255,66,54413,1,233283
8153,0.000727,74.125.24.0-255,1437,55850,1,233283
8154,0.000777,74.125.24.0-255,376,56226,1,233283
8155,0.000795,172.31.36.0-255,66,56292,1,233283
8156,0.001056,74.125.24.0-255,1484,57776,1,233283
8157,0.001062,74.125.24.0-255,2902,60678,1,233283
8158,0.001066,172.31.36.0-255,66,60744,1,233283
8159,0.001091,74.125.24.0-255,5738,66482,1,233283
8160,0.001102,172.31.36.0-255,66,66548,1,233283
8161,0.001153,172.31.36.0-255,66,66614,1,233283
8162,0.00126,172.31.36.0-255,66,66680,1,233283
8163,0.001336,172.31.36.0-255,66,66746,1,233283
8164,0.001418,172.31.36.0-255,66,66812,1,233283
8165,0.00143,74.125.24.0-255,1484,68296,1,233283
8166,0.001479,74.125.24.0-255,2902,71198,1,233283
8167,0.0015,74.125.24.0-255,7156,78354,1,233283
8168,0.001509,172.31.36.0-255,66,78420,1,233283
8169,0.001521,74.125.24.0-255,5020,83440,1,233283
8170,0.001541,172.31.36.0-255,66,83506,1,233283
8171,0.00167,74.125.24.0-255,1484,84990,1,233283
8172,0.001689,74.125.24.0-255,2902,87892,1,233283
8173,0.001692,172.31.36.0-255,66,87958,1,233283
8174,0.001698,74.125.24.0-255,4320,92278,1,233283
8175,0.001711,74.125.24.0-255,1484,93762,1,233283
8176,0.001729,172.31.36.0-255,66,93828,1,233283
8177,0.001747,74.125.24.0-255,4320,98148,1,233283
8178,0.001757,172.31.36.0-255,66,98214,1,233283
8179,0.001785,172.31.36.0-255,66,98280,1,233283
8180,0.001849,74.125.24.0-255,4320,102600,1,233283
8181,0.001853,172.31.36.0-255,66,102666,1,233283
8182,0.001869,74.125.24.0-255,4320,106986,1,233283
8183,0.001889,172.31.36.0-255,66,107052,1,233283
8184,0.001923,74.125.24.0-255,2184,109236,1,233283
8185,0.001932,172.31.36.0-255,66,109302,1,233283
8186,0.001968,74.125.24.0-255,1484,110786,1,233283
8187,0.001978,172.31.36.0-255,66,110852,1,233283
8188,0.002049,74.125.24.0-255,5738,116590,1,233283
8189,0.002082,74.125.24.0-255,6438,123028,1,233283
8190,0.002096,172.31.36.0-255,66,123094,1,233283
8191,0.002233,74.125.24.0-255,4320,127414,1,233283
8192,0.002237,172.31.36.0-255,66,127480,1,233283
8193,0.002325,172.31.36.0-255,66,127546,1,233283
8194,0.002509,74.125.24.0-255,4320,131866,1,233283
8195,0.002514,172.31.36.0-255,66,131932,1,233283
8196,0.002569,74.125.24.0-255,5020,136952,1,233283
8197,0.008341,172.31.36.0-255,66,137018,1,233283
8198,0.01061,74.125.24.0-255,5738,142756,1,233283
8199,0.010618,172.31.36.0-255,66,142822,1,233283
8200,0.01286,74.125.24.0-255,5738,148560,1,233283
8201,0.01556,172.31.36.0-255,66,148626,1,233283
8202,0.017834,74.125.24.0-255,5738,154364,1,233283
8203,0.017843,172.31.36.0-255,66,154430,1,233283
8204,0.020126,74.125.24.0-255,5738,160168,1,233283
8205,0.023164,172.31.36.0-255,66,160234,1,233283
8206,0.025428,74.125.24.0-255,5738,165972,1,233283
8207,0.025438,172.31.36.0-255,66,166038,1,233283
8208,0.027692,74.125.24.0-255,5738,171776,1,233283
8209,0.027699,172.31.36.0-255,66,171842,1,233283
8210,0.029969,74.125.24.0-255,5738,177580,1,233283
8211,0.029976,172.31.36.0-255,66,177646,1,233283
8212,0.03223,74.125.24.0-255,5738,183384,1,233283
8213,0.032237,172.31.36.0-255,66,183450,1,233283
8214,0.034523,74.125.24.0-255,5738,189188,1,233283
8215,0.034532,172.31.36.0-255,66,189254,1,233283
8216,0.036811,74.125.24.0-255,5738,194992,1,233283
8217,0.036819,172.31.36.0-255,66,195058,1,233283
8218,0.038124,172.31.36.0-255,172,195230,1,233283
8219,0.038157,172.31.36.0-255,1113,196343,1,233283
8220,0.038239,172.31.36.0-255,1514,197857,1,233283
8221,0.038241,172.31.36.0-255,1514,199371,1,233283
8222,0.038242,172.31.36.0-255,1514,200885,1,233283
8223,0.038243,172.31.36.0-255,1514,202399,1,233283
8224,0.038271,172.31.36.0-255,1492,203891,1,233283
8225,0.039119,74.125.24.0-255,5738,209629,1,233283
8226,0.039127,172.31.36.0-255,66,209695,1,233283
8227,0.039616,104.244.42.0-255,66,209761,1,233283
8228,0.039638,104.244.42.0-255,66,209827,1,233283
8229,0.039774,104.244.42.0-255,66,209893,1,233283
8230,0.040315,104.244.42.0-255,108,210001,1,233283
8231,0.040324,172.31.36.0-255,66,210067,1,233283
8232,0.0414,74.125.24.0-255,5738,215805,1,233283
8233,0.041408,172.31.36.0-255,66,215871,1,233283
8234,0.04373,74.125.24.0-255,5738,221609,1,233283
8235,0.043737,172.31.36.0-255,66,221675,1,233283
8236,0.046042,74.125.24.0-255,5738,227413,1,233283
8237,0.046049,172.31.36.0-255,66,227479,1,233283
8238,0.048343,74.125.24.0-255,5738,233217,1,233283
8239,0.04835,172.31.36.0-255,66,233283,1,233283
8240,0.0,172.217.194.0-255,148,148,1,185485
8241,2.6e-05,172.31.36.0-255,66,214,1,185485
8242,3.3e-05,172.217.194.0-255,1484,1698,1,185485
8243,3.7e-05,172.31.36.0-255,66,1764,1,185485
8244,7e-05,172.217.194.0-255,2902,4666,1,185485
8245,7.3e-05,172.31.36.0-255,66,4732,1,185485
8246,8.1e-05,172.217.194.0-255,7156,11888,1,185485
8247,8.3e-05,172.31.36.0-255,66,11954,1,185485
8248,8.7e-05,172.217.194.0-255,2048,14002,1,185485
8249,9e-05,172.31.36.0-255,66,14068,1,185485
8250,0.000135,172.31.36.0-255,66,14134,1,185485
8251,0.000141,172.217.194.0-255,5379,19513,1,185485
8252,0.000144,172.31.36.0-255,66,19579,1,185485
8253,0.000231,172.217.194.0-255,1484,21063,1,185485
8254,0.000235,172.31.36.0-255,66,21129,1,185485
8255,0.000255,172.217.194.0-255,2902,24031,1,185485
8256,0.000258,172.31.36.0-255,66,24097,1,185485
8257,0.000261,172.217.194.0-255,1484,25581,1,185485
8258,0.000265,172.31.36.0-255,66,25647,1,185485
8259,0.000299,172.217.194.0-255,4320,29967,1,185485
8260,0.000303,172.31.36.0-255,66,30033,1,185485
8261,0.000307,172.217.194.0-255,2902,32935,1,185485
8262,0.000309,172.31.36.0-255,66,33001,1,185485
8263,0.000344,172.217.194.0-255,4320,37321,1,185485
8264,0.000346,172.31.36.0-255,66,37387,1,185485
8265,0.000351,172.31.36.0-255,66,37453,1,185485
8266,0.000399,172.217.194.0-255,5968,43421,1,185485
8267,0.000403,172.31.36.0-255,66,43487,1,185485
8268,0.000567,172.217.194.0-255,1484,44971,1,185485
8269,0.000571,172.31.36.0-255,66,45037,1,185485
8270,0.000574,172.217.194.0-255,1484,46521,1,185485
8271,0.000605,172.217.194.0-255,1484,48005,1,185485
8272,0.000608,172.31.36.0-255,66,48071,1,185485
8273,0.000615,172.217.194.0-255,5738,53809,1,185485
8274,0.000617,172.31.36.0-255,66,53875,1,185485
8275,0.000654,172.31.36.0-255,66,53941,1,185485
8276,0.000681,172.217.194.0-255,1125,55066,1,185485
8277,0.000687,172.217.194.0-255,5738,60804,1,185485
8278,0.00069,172.31.36.0-255,66,60870,1,185485
8279,0.000711,172.217.194.0-255,6248,67118,1,185485
8280,0.000714,172.31.36.0-255,66,67184,1,185485
8281,0.000794,172.217.194.0-255,1484,68668,1,185485
8282,0.000798,172.217.194.0-255,2902,71570,1,185485
8283,0.000801,172.31.36.0-255,66,71636,1,185485
8284,0.000833,172.217.194.0-255,5738,77374,1,185485
8285,0.000838,172.31.36.0-255,66,77440,1,185485
8286,0.00085,172.31.36.0-255,66,77506,1,185485
8287,0.000871,172.217.194.0-255,1484,78990,1,185485
8288,0.000886,172.217.194.0-255,766,79756,1,185485
8289,0.000888,172.31.36.0-255,66,79822,1,185485
8290,0.001058,172.217.194.0-255,1484,81306,1,185485
8291,0.001062,172.31.36.0-255,66,81372,1,185485
8292,0.001067,172.217.194.0-255,2902,84274,1,185485
8293,0.001069,172.31.36.0-255,66,84340,1,185485
8294,0.001072,172.217.194.0-255,1484,85824,1,185485
8295,0.001094,172.217.194.0-255,4320,90144,1,185485
8296,0.001098,172.31.36.0-255,66,90210,1,185485
8297,0.001118,172.31.36.0-255,66,90276,1,185485
8298,0.001128,172.31.36.0-255,66,90342,1,185485
8299,0.001159,172.217.194.0-255,3602,93944,1,185485
8300,0.001163,172.31.36.0-255,66,94010,1,185485
8301,0.001168,172.217.194.0-255,4320,98330,1,185485
8302,0.001171,172.31.36.0-255,66,98396,1,185485
8303,0.00121,172.31.36.0-255,66,98462,1,185485
8304,0.001213,172.217.194.0-255,1484,99946,1,185485
8305,0.001228,172.217.194.0-255,5738,105684,1,185485
8306,0.001236,172.31.36.0-255,66,105750,1,185485
8307,0.001269,172.31.36.0-255,66,105816,1,185485
8308,0.001273,172.217.194.0-255,2184,108000,1,185485
8309,0.001275,172.31.36.0-255,66,108066,1,185485
8310,0.001412,172.217.194.0-255,1484,109550,1,185485
8311,0.001418,172.217.194.0-255,2902,112452,1,185485
8312,0.001421,172.31.36.0-255,66,112518,1,185485
8313,0.001458,172.217.194.0-255,5738,118256,1,185485
8314,0.001461,172.31.36.0-255,66,118322,1,185485
8315,0.001521,172.31.36.0-255,66,118388,1,185485
8316,0.001548,172.217.194.0-255,4320,122708,1,185485
8317,0.001551,172.31.36.0-255,66,122774,1,185485
8318,0.00156,172.31.36.0-255,66,122840,1,185485
8319,0.00157,172.217.194.0-255,2184,125024,1,185485
8320,0.001572,172.31.36.0-255,66,125090,1,185485
8321,0.002017,172.217.194.0-255,1484,126574,1,185485
8322,0.002034,172.217.194.0-255,2902,129476,1,185485
8323,0.002037,172.31.36.0-255,66,129542,1,185485
8324,0.002044,172.217.194.0-255,5738,135280,1,185485
8325,0.002046,172.31.36.0-255,66,135346,1,185485
8326,0.002106,172.31.36.0-255,66,135412,1,185485
8327,0.002123,172.31.36.0-255,66,135478,1,185485
8328,0.002203,172.217.194.0-255,1484,136962,1,185485
8329,0.002208,172.217.194.0-255,2902,139864,1,185485
8330,0.002211,172.31.36.0-255,66,139930,1,185485
8331,0.002245,172.217.194.0-255,5738,145668,1,185485
8332,0.002247,172.31.36.0-255,66,145734,1,185485
8333,0.002253,172.217.194.0-255,4320,150054,1,185485
8334,0.002255,172.31.36.0-255,66,150120,1,185485
8335,0.002286,172.31.36.0-255,66,150186,1,185485
8336,0.002304,172.31.36.0-255,66,150252,1,185485
8337,0.002339,172.217.194.0-255,6438,156690,1,185485
8338,0.002343,172.31.36.0-255,66,156756,1,185485
8339,0.00236,172.31.36.0-255,66,156822,1,185485
8340,0.002371,172.31.36.0-255,66,156888,1,185485
8341,0.002413,172.31.36.0-255,66,156954,1,185485
8342,0.00242,172.217.194.0-255,7156,164110,1,185485
8343,0.002423,172.31.36.0-255,66,164176,1,185485
8344,0.002449,172.217.194.0-255,5738,169914,1,185485
8345,0.002452,172.31.36.0-255,66,169980,1,185485
8346,0.002465,172.31.36.0-255,66,170046,1,185485
8347,0.002475,172.31.36.0-255,66,170112,1,185485
8348,0.002506,172.31.36.0-255,66,170178,1,185485
8349,0.002546,172.31.36.0-255,66,170244,1,185485
8350,0.002596,172.217.194.0-255,5738,175982,1,185485
8351,0.002601,172.31.36.0-255,66,176048,1,185485
8352,0.002645,172.31.36.0-255,66,176114,1,185485
8353,0.005136,172.217.194.0-255,105,176219,1,185485
8354,0.008976,172.31.36.0-255,66,176285,1,185485
8355,0.009003,172.31.36.0-255,105,176390,1,185485
8356,0.011488,172.217.194.0-255,66,176456,1,185485
8357,0.028365,172.31.36.0-255,172,176628,1,185485
8358,0.028411,172.31.36.0-255,1114,177742,1,185485
8359,0.028442,172.31.36.0-255,1514,179256,1,185485
8360,0.028443,172.31.36.0-255,1514,180770,1,185485
8361,0.028445,172.31.36.0-255,1514,182284,1,185485
8362,0.02845,172.31.36.0-255,1514,183798,1,185485
8363,0.028451,172.31.36.0-255,1489,185287,1,185485
8364,0.029923,104.244.42.0-255,66,185353,1,185485
8365,0.029968,104.244.42.0-255,66,185419,1,185485
8366,0.030064,104.244.42.0-255,66,185485,1,185485
8367,0.0,172.217.194.0-255,153,153,1,284041
8368,3.4e-05,172.31.36.0-255,66,219,1,284041
8369,4.2e-05,172.217.194.0-255,1484,1703,1,284041
8370,4.7e-05,172.31.36.0-255,66,1769,1,284041
8371,5.3e-05,172.217.194.0-255,2902,4671,1,284041
8372,6.3e-05,172.31.36.0-255,66,4737,1,284041
8373,6.9e-05,172.217.194.0-255,5738,10475,1,284041
8374,7.1e-05,172.31.36.0-255,66,10541,1,284041
8375,7.6e-05,172.217.194.0-255,3466,14007,1,284041
8376,7.9e-05,172.31.36.0-255,66,14073,1,284041
8377,0.000107,172.217.194.0-255,4320,18393,1,284041
8378,0.000118,172.31.36.0-255,66,18459,1,284041
8379,0.000156,172.31.36.0-255,66,18525,1,284041
8380,0.00016,172.217.194.0-255,1484,20009,1,284041
8381,0.000162,172.31.36.0-255,66,20075,1,284041
8382,0.000166,172.217.194.0-255,1484,21559,1,284041
8383,0.000168,172.31.36.0-255,66,21625,1,284041
8384,0.000206,172.31.36.0-255,66,21691,1,284041
8385,0.000211,172.217.194.0-255,3961,25652,1,284041
8386,0.000213,172.31.36.0-255,66,25718,1,284041
8387,0.000311,172.217.194.0-255,1484,27202,1,284041
8388,0.000317,172.31.36.0-255,66,27268,1,284041
8389,0.000322,172.217.194.0-255,2902,30170,1,284041
8390,0.000325,172.31.36.0-255,66,30236,1,284041
8391,0.000359,172.217.194.0-255,5738,35974,1,284041
8392,0.000362,172.31.36.0-255,66,36040,1,284041
8393,0.00041,172.217.194.0-255,4320,40360,1,284041
8394,0.000414,172.31.36.0-255,66,40426,1,284041
8395,0.000445,172.217.194.0-255,2841,43267,1,284041
8396,0.000447,172.31.36.0-255,66,43333,1,284041
8397,0.000721,172.217.194.0-255,379,43712,1,284041
8398,0.000815,172.217.194.0-255,1484,45196,1,284041
8399,0.000818,172.31.36.0-255,66,45262,1,284041
8400,0.000823,172.217.194.0-255,2902,48164,1,284041
8401,0.000826,172.31.36.0-255,66,48230,1,284041
8402,0.000829,172.217.194.0-255,1484,49714,1,284041
8403,0.00086,172.217.194.0-255,4320,54034,1,284041
8404,0.000863,172.31.36.0-255,66,54100,1,284041
8405,0.00087,172.217.194.0-255,6797,60897,1,284041
8406,0.000872,172.31.36.0-255,66,60963,1,284041
8407,0.000903,172.217.194.0-255,7156,68119,1,284041
8408,0.000906,172.31.36.0-255,66,68185,1,284041
8409,0.000914,172.217.194.0-255,7156,75341,1,284041
8410,0.000916,172.31.36.0-255,66,75407,1,284041
8411,0.000945,172.217.194.0-255,2543,77950,1,284041
8412,0.000947,172.31.36.0-255,66,78016,1,284041
8413,0.001872,172.217.194.0-255,1484,79500,1,284041
8414,0.001883,172.217.194.0-255,2902,82402,1,284041
8415,0.001887,172.31.36.0-255,66,82468,1,284041
8416,0.001895,172.217.194.0-255,5738,88206,1,284041
8417,0.001897,172.31.36.0-255,66,88272,1,284041
8418,0.001962,172.31.36.0-255,66,88338,1,284041
8419,0.001974,172.31.36.0-255,66,88404,1,284041
8420,0.002001,172.217.194.0-255,1484,89888,1,284041
8421,0.002004,172.217.194.0-255,1484,91372,1,284041
8422,0.002006,172.31.36.0-255,66,91438,1,284041
8423,0.00203,172.217.194.0-255,1484,92922,1,284041
8424,0.002036,172.217.194.0-255,5738,98660,1,284041
8425,0.002038,172.31.36.0-255,66,98726,1,284041
8426,0.002049,172.217.194.0-255,5738,104464,1,284041
8427,0.002051,172.31.36.0-255,66,104530,1,284041
8428,0.002055,172.217.194.0-255,2902,107432,1,284041
8429,0.002057,172.31.36.0-255,66,107498,1,284041
8430,0.002102,172.31.36.0-255,66,107564,1,284041
8431,0.002151,172.217.194.0-255,5738,113302,1,284041
8432,0.002157,172.217.194.0-255,5020,118322,1,284041
8433,0.002169,172.31.36.0-255,66,118388,1,284041
8434,0.002198,172.217.194.0-255,5738,124126,1,284041
8435,0.002205,172.217.194.0-255,7156,131282,1,284041
8436,0.00224,172.31.36.0-255,66,131348,1,284041
8437,0.002258,172.217.194.0-255,5738,137086,1,284041
8438,0.002264,172.217.194.0-255,6438,143524,1,284041
8439,0.002277,172.31.36.0-255,66,143590,1,284041
8440,0.002289,172.217.194.0-255,4320,147910,1,284041
8441,0.002348,172.217.194.0-255,7156,155066,1,284041
8442,0.002353,172.217.194.0-255,3602,158668,1,284041
8443,0.002361,172.31.36.0-255,66,158734,1,284041
8444,0.004661,172.217.194.0-255,5738,164472,1,284041
8445,0.004667,172.31.36.0-255,66,164538,1,284041
8446,0.006954,172.217.194.0-255,5738,170276,1,284041
8447,0.006959,172.31.36.0-255,66,170342,1,284041
8448,0.009278,172.217.194.0-255,5738,176080,1,284041
8449,0.009286,172.31.36.0-255,66,176146,1,284041
8450,0.011611,172.217.194.0-255,5738,181884,1,284041
8451,0.011619,172.31.36.0-255,66,181950,1,284041
8452,0.013968,172.217.194.0-255,5738,187688,1,284041
8453,0.013979,172.31.36.0-255,66,187754,1,284041
8454,0.016275,172.217.194.0-255,5738,193492,1,284041
8455,0.016283,172.31.36.0-255,66,193558,1,284041
8456,0.018587,172.217.194.0-255,5738,199296,1,284041
8457,0.018595,172.31.36.0-255,66,199362,1,284041
8458,0.020884,172.217.194.0-255,5738,205100,1,284041
8459,0.020893,172.31.36.0-255,66,205166,1,284041
8460,0.023175,172.217.194.0-255,5738,210904,1,284041
8461,0.023183,172.31.36.0-255,66,210970,1,284041
8462,0.025477,172.217.194.0-255,5738,216708,1,284041
8463,0.025483,172.31.36.0-255,66,216774,1,284041
8464,0.027781,172.217.194.0-255,5738,222512,1,284041
8465,0.027788,172.31.36.0-255,66,222578,1,284041
8466,0.030076,172.217.194.0-255,5738,228316,1,284041
8467,0.030086,172.31.36.0-255,66,228382,1,284041
8468,0.032056,172.31.36.0-255,172,228554,1,284041
8469,0.032103,172.31.36.0-255,1113,229667,1,284041
8470,0.032189,172.31.36.0-255,1514,231181,1,284041
8471,0.032191,172.31.36.0-255,1514,232695,1,284041
8472,0.032196,172.31.36.0-255,1514,234209,1,284041
8473,0.032198,172.31.36.0-255,1514,235723,1,284041
8474,0.032219,172.31.36.0-255,1490,237213,1,284041
8475,0.032391,172.217.194.0-255,5738,242951,1,284041
8476,0.032399,172.31.36.0-255,66,243017,1,284041
8477,0.0336,104.244.42.0-255,66,243083,1,284041
8478,0.033639,104.244.42.0-255,66,243149,1,284041
8479,0.033757,104.244.42.0-255,66,243215,1,284041
8480,0.033801,104.244.42.0-255,66,243281,1,284041
8481,0.034697,172.217.194.0-255,2902,246183,1,284041
8482,0.034702,172.31.36.0-255,66,246249,1,284041
8483,0.034736,172.217.194.0-255,2902,249151,1,284041
8484,0.034739,172.31.36.0-255,66,249217,1,284041
8485,0.037019,172.217.194.0-255,5738,254955,1,284041
8486,0.037025,172.31.36.0-255,66,255021,1,284041
8487,0.03932,172.217.194.0-255,5738,260759,1,284041
8488,0.039326,172.31.36.0-255,66,260825,1,284041
8489,0.041625,172.217.194.0-255,5738,266563,1,284041
8490,0.041645,172.31.36.0-255,66,266629,1,284041
8491,0.043952,172.217.194.0-255,5738,272367,1,284041
8492,0.043957,172.31.36.0-255,66,272433,1,284041
8493,0.046224,172.217.194.0-255,5738,278171,1,284041
8494,0.04623,172.31.36.0-255,66,278237,1,284041
8495,0.048507,172.217.194.0-255,5738,283975,1,284041
8496,0.048512,172.31.36.0-255,66,284041,1,284041
8497,0.0,172.217.194.0-255,153,153,1,272425
8498,2.6e-05,172.31.36.0-255,66,219,1,272425
8499,3.4e-05,172.217.194.0-255,1484,1703,1,272425
8500,4e-05,172.31.36.0-255,66,1769,1,272425
8501,4.6e-05,172.217.194.0-255,2902,4671,1,272425
8502,5.7e-05,172.31.36.0-255,66,4737,1,272425
8503,6.4e-05,172.217.194.0-255,5738,10475,1,272425
8504,6.8e-05,172.31.36.0-255,66,10541,1,272425
8505,7.4e-05,172.217.194.0-255,3444,13985,1,272425
8506,7.7e-05,172.31.36.0-255,66,14051,1,272425
8507,0.000126,172.217.194.0-255,2902,16953,1,272425
8508,0.00013,172.31.36.0-255,66,17019,1,272425
8509,0.000136,172.217.194.0-255,4320,21339,1,272425
8510,0.000138,172.31.36.0-255,66,21405,1,272425
8511,0.000158,172.217.194.0-255,1484,22889,1,272425
8512,0.00016,172.31.36.0-255,66,22955,1,272425
8513,0.000186,172.217.194.0-255,2902,25857,1,272425
8514,0.000193,172.31.36.0-255,66,25923,1,272425
8515,0.000245,172.217.194.0-255,5738,31661,1,272425
8516,0.000249,172.31.36.0-255,66,31727,1,272425
8517,0.000256,172.217.194.0-255,7156,38883,1,272425
8518,0.000259,172.31.36.0-255,66,38949,1,272425
8519,0.000274,172.31.36.0-255,66,39015,1,272425
8520,0.000277,172.217.194.0-255,766,39781,1,272425
8521,0.000279,172.31.36.0-255,66,39847,1,272425
8522,0.000736,172.217.194.0-255,1484,41331,1,272425
8523,0.000741,172.31.36.0-255,66,41397,1,272425
8524,0.000747,172.217.194.0-255,2902,44299,1,272425
8525,0.00075,172.31.36.0-255,66,44365,1,272425
8526,0.000762,172.217.194.0-255,5738,50103,1,272425
8527,0.000764,172.31.36.0-255,66,50169,1,272425
8528,0.000798,172.217.194.0-255,7090,57259,1,272425
8529,0.000801,172.31.36.0-255,66,57325,1,272425
8530,0.001441,172.217.194.0-255,1484,58809,1,272425
8531,0.001453,172.217.194.0-255,2902,61711,1,272425
8532,0.001458,172.31.36.0-255,66,61777,1,272425
8533,0.001466,172.217.194.0-255,5738,67515,1,272425
8534,0.001469,172.31.36.0-255,66,67581,1,272425
8535,0.001503,172.217.194.0-255,7156,74737,1,272425
8536,0.001505,172.31.36.0-255,66,74803,1,272425
8537,0.001533,172.217.194.0-255,2902,77705,1,272425
8538,0.001535,172.31.36.0-255,66,77771,1,272425
8539,0.001572,172.217.194.0-255,5738,83509,1,272425
8540,0.001574,172.31.36.0-255,66,83575,1,272425
8541,0.001607,172.217.194.0-255,5738,89313,1,272425
8542,0.00161,172.31.36.0-255,66,89379,1,272425
8543,0.001615,172.217.194.0-255,2184,91563,1,272425
8544,0.001617,172.31.36.0-255,66,91629,1,272425
8545,0.001829,172.217.194.0-255,1484,93113,1,272425
8546,0.001838,172.217.194.0-255,2902,96015,1,272425
8547,0.001842,172.31.36.0-255,66,96081,1,272425
8548,0.00185,172.217.194.0-255,5738,101819,1,272425
8549,0.001852,172.31.36.0-255,66,101885,1,272425
8550,0.00186,172.217.194.0-255,1484,103369,1,272425
8551,0.001888,172.31.36.0-255,66,103435,1,272425
8552,0.001928,172.217.194.0-255,2902,106337,1,272425
8553,0.001933,172.31.36.0-255,66,106403,1,272425
8554,0.00195,172.31.36.0-255,66,106469,1,272425
8555,0.001957,172.217.194.0-255,5738,112207,1,272425
8556,0.00196,172.31.36.0-255,66,112273,1,272425
8557,0.001991,172.217.194.0-255,1484,113757,1,272425
8558,0.002013,172.217.194.0-255,5738,119495,1,272425
8559,0.002016,172.31.36.0-255,66,119561,1,272425
8560,0.002021,172.217.194.0-255,2902,122463,1,272425
8561,0.002023,172.31.36.0-255,66,122529,1,272425
8562,0.002061,172.31.36.0-255,66,122595,1,272425
8563,0.002093,172.217.194.0-255,5738,128333,1,272425
8564,0.002097,172.31.36.0-255,66,128399,1,272425
8565,0.002099,172.217.194.0-255,766,129165,1,272425
8566,0.002216,172.217.194.0-255,1484,130649,1,272425
8567,0.00222,172.31.36.0-255,66,130715,1,272425
8568,0.002226,172.217.194.0-255,2902,133617,1,272425
8569,0.002229,172.31.36.0-255,66,133683,1,272425
8570,0.002255,172.217.194.0-255,2902,136585,1,272425
8571,0.002258,172.31.36.0-255,66,136651,1,272425
8572,0.002288,172.217.194.0-255,2902,139553,1,272425
8573,0.00229,172.31.36.0-255,66,139619,1,272425
8574,0.002298,172.217.194.0-255,7156,146775,1,272425
8575,0.002301,172.31.36.0-255,66,146841,1,272425
8576,0.002308,172.217.194.0-255,1484,148325,1,272425
8577,0.002336,172.217.194.0-255,5738,154063,1,272425
8578,0.00234,172.31.36.0-255,66,154129,1,272425
8579,0.004597,172.217.194.0-255,5738,159867,1,272425
8580,0.004605,172.31.36.0-255,66,159933,1,272425
8581,0.00688,172.217.194.0-255,5738,165671,1,272425
8582,0.00689,172.31.36.0-255,66,165737,1,272425
8583,0.00769,172.31.36.0-255,101,165838,1,272425
8584,0.00922,172.217.194.0-255,5738,171576,1,272425
8585,0.00923,172.31.36.0-255,66,171642,1,272425
8586,0.009959,172.217.194.0-255,66,171708,1,272425
8587,0.011552,172.217.194.0-255,5738,177446,1,272425
8588,0.011569,172.31.36.0-255,66,177512,1,272425
8589,0.013881,172.217.194.0-255,5738,183250,1,272425
8590,0.013896,172.31.36.0-255,66,183316,1,272425
8591,0.016217,172.217.194.0-255,5738,189054,1,272425
8592,0.016234,172.31.36.0-255,66,189120,1,272425
8593,0.018508,172.217.194.0-255,5738,194858,1,272425
8594,0.018521,172.31.36.0-255,66,194924,1,272425
8595,0.020811,172.217.194.0-255,5738,200662,1,272425
8596,0.020823,172.31.36.0-255,66,200728,1,272425
8597,0.023121,172.217.194.0-255,5738,206466,1,272425
8598,0.023135,172.31.36.0-255,66,206532,1,272425
8599,0.025441,172.217.194.0-255,5738,212270,1,272425
8600,0.025458,172.31.36.0-255,66,212336,1,272425
8601,0.027746,172.217.194.0-255,5738,218074,1,272425
8602,0.027757,172.31.36.0-255,66,218140,1,272425
8603,0.027896,172.31.36.0-255,172,218312,1,272425
8604,0.027925,172.31.36.0-255,1115,219427,1,272425
8605,0.027983,172.31.36.0-255,564,219991,1,272425
8606,0.029483,104.244.42.0-255,66,220057,1,272425
8607,0.029496,104.244.42.0-255,66,220123,1,272425
8608,0.029559,104.244.42.0-255,66,220189,1,272425
8609,0.030041,172.217.194.0-255,5738,225927,1,272425
8610,0.03005,172.31.36.0-255,66,225993,1,272425
8611,0.032369,172.217.194.0-255,5738,231731,1,272425
8612,0.03238,172.31.36.0-255,66,231797,1,272425
8613,0.034696,172.217.194.0-255,5738,237535,1,272425
8614,0.034704,172.31.36.0-255,66,237601,1,272425
8615,0.036992,172.217.194.0-255,5738,243339,1,272425
8616,0.037002,172.31.36.0-255,66,243405,1,272425
8617,0.039317,172.217.194.0-255,5738,249143,1,272425
8618,0.039327,172.31.36.0-255,66,249209,1,272425
8619,0.041597,172.217.194.0-255,5738,254947,1,272425
8620,0.041606,172.31.36.0-255,66,255013,1,272425
8621,0.043887,172.217.194.0-255,5738,260751,1,272425
8622,0.043895,172.31.36.0-255,66,260817,1,272425
8623,0.046215,172.217.194.0-255,5738,266555,1,272425
8624,0.046221,172.31.36.0-255,66,266621,1,272425
8625,0.048525,172.217.194.0-255,5738,272359,1,272425
8626,0.048536,172.31.36.0-255,66,272425,1,272425
8627,0.0,74.125.24.0-255,146,146,1,272897
8628,2.3e-05,172.31.36.0-255,66,212,1,272897
8629,2.9e-05,74.125.24.0-255,1484,1696,1,272897
8630,3.4e-05,172.31.36.0-255,66,1762,1,272897
8631,3.9e-05,74.125.24.0-255,2902,4664,1,272897
8632,4.2e-05,172.31.36.0-255,66,4730,1,272897
8633,5.8e-05,74.125.24.0-255,7156,11886,1,272897
8634,6.1e-05,172.31.36.0-255,66,11952,1,272897
8635,6.5e-05,74.125.24.0-255,2041,13993,1,272897
8636,6.7e-05,172.31.36.0-255,66,14059,1,272897
8637,0.00016,74.125.24.0-255,1484,15543,1,272897
8638,0.000164,172.31.36.0-255,66,15609,1,272897
8639,0.00017,74.125.24.0-255,2902,18511,1,272897
8640,0.000173,172.31.36.0-255,66,18577,1,272897
8641,0.000178,74.125.24.0-255,4320,22897,1,272897
8642,0.000186,172.31.36.0-255,66,22963,1,272897
8643,0.000212,74.125.24.0-255,1484,24447,1,272897
8644,0.000215,172.31.36.0-255,66,24513,1,272897
8645,0.000223,74.125.24.0-255,6797,31310,1,272897
8646,0.000225,172.31.36.0-255,66,31376,1,272897
8647,0.00046,74.125.24.0-255,1484,32860,1,272897
8648,0.000466,172.31.36.0-255,66,32926,1,272897
8649,0.000472,74.125.24.0-255,2902,35828,1,272897
8650,0.000475,172.31.36.0-255,66,35894,1,272897
8651,0.000479,74.125.24.0-255,2902,38796,1,272897
8652,0.00048,172.31.36.0-255,66,38862,1,272897
8653,0.000502,74.125.24.0-255,2902,41764,1,272897
8654,0.000505,172.31.36.0-255,66,41830,1,272897
8655,0.00051,74.125.24.0-255,4320,46150,1,272897
8656,0.000518,172.31.36.0-255,66,46216,1,272897
8657,0.000563,172.31.36.0-255,66,46282,1,272897
8658,0.00057,74.125.24.0-255,7156,53438,1,272897
8659,0.000572,172.31.36.0-255,66,53504,1,272897
8660,0.000577,74.125.24.0-255,2817,56321,1,272897
8661,0.000579,172.31.36.0-255,66,56387,1,272897
8662,0.000611,74.125.24.0-255,382,56769,1,272897
8663,0.000771,74.125.24.0-255,1484,58253,1,272897
8664,0.000777,74.125.24.0-255,2902,61155,1,272897
8665,0.00079,74.125.24.0-255,2902,64057,1,272897
8666,0.000802,74.125.24.0-255,2902,66959,1,272897
8667,0.000814,172.31.36.0-255,66,67025,1,272897
8668,0.000846,74.125.24.0-255,5738,72763,1,272897
8669,0.000866,74.125.24.0-255,6797,79560,1,272897
8670,0.000891,74.125.24.0-255,7156,86716,1,272897
8671,0.0009,172.31.36.0-255,66,86782,1,272897
8672,0.000918,74.125.24.0-255,3411,90193,1,272897
8673,0.000934,74.125.24.0-255,5738,95931,1,272897
8674,0.000961,74.125.24.0-255,7156,103087,1,272897
8675,0.000975,74.125.24.0-255,3961,107048,1,272897
8676,0.000987,172.31.36.0-255,66,107114,1,272897
8677,0.001229,74.125.24.0-255,1484,108598,1,272897
8678,0.001235,74.125.24.0-255,1484,110082,1,272897
8679,0.001239,172.31.36.0-255,66,110148,1,272897
8680,0.001252,74.125.24.0-255,1484,111632,1,272897
8681,0.001263,74.125.24.0-255,5738,117370,1,272897
8682,0.001273,74.125.24.0-255,1484,118854,1,272897
8683,0.001296,74.125.24.0-255,1484,120338,1,272897
8684,0.001302,172.31.36.0-255,66,120404,1,272897
8685,0.001329,74.125.24.0-255,5738,126142,1,272897
8686,0.001347,74.125.24.0-255,3602,129744,1,272897
8687,0.001353,172.31.36.0-255,66,129810,1,272897
8688,0.001379,74.125.24.0-255,4320,134130,1,272897
8689,0.001382,172.31.36.0-255,66,134196,1,272897
8690,0.001449,74.125.24.0-255,1484,135680,1,272897
8691,0.00146,172.31.36.0-255,66,135746,1,272897
8692,0.001512,172.31.36.0-255,66,135812,1,272897
8693,0.001993,74.125.24.0-255,1484,137296,1,272897
8694,0.001999,74.125.24.0-255,2902,140198,1,272897
8695,0.002002,172.31.36.0-255,66,140264,1,272897
8696,0.002032,74.125.24.0-255,5738,146002,1,272897
8697,0.002041,172.31.36.0-255,66,146068,1,272897
8698,0.00205,74.125.24.0-255,1484,147552,1,272897
8699,0.002071,74.125.24.0-255,5379,152931,1,272897
8700,0.002083,172.31.36.0-255,66,152997,1,272897
8701,0.002391,74.125.24.0-255,1484,154481,1,272897
8702,0.002396,74.125.24.0-255,2902,157383,1,272897
8703,0.002399,172.31.36.0-255,66,157449,1,272897
8704,0.002437,74.125.24.0-255,5738,163187,1,272897
8705,0.00244,172.31.36.0-255,66,163253,1,272897
8706,0.002457,172.31.36.0-255,66,163319,1,272897
8707,0.0025,172.31.36.0-255,66,163385,1,272897
8708,0.005063,74.125.24.0-255,4320,167705,1,272897
8709,0.005067,172.31.36.0-255,66,167771,1,272897
8710,0.00509,74.125.24.0-255,1484,169255,1,272897
8711,0.007623,74.125.24.0-255,4320,173575,1,272897
8712,0.007633,172.31.36.0-255,66,173641,1,272897
8713,0.010221,74.125.24.0-255,5738,179379,1,272897
8714,0.010253,172.31.36.0-255,66,179445,1,272897
8715,0.012858,74.125.24.0-255,5738,185183,1,272897
8716,0.012879,172.31.36.0-255,66,185249,1,272897
8717,0.015428,74.125.24.0-255,5738,190987,1,272897
8718,0.015441,172.31.36.0-255,66,191053,1,272897
8719,0.017997,74.125.24.0-255,5738,196791,1,272897
8720,0.018005,172.31.36.0-255,66,196857,1,272897
8721,0.020569,74.125.24.0-255,5738,202595,1,272897
8722,0.020576,172.31.36.0-255,66,202661,1,272897
8723,0.02314,74.125.24.0-255,5738,208399,1,272897
8724,0.023147,172.31.36.0-255,66,208465,1,272897
8725,0.025724,74.125.24.0-255,4320,212785,1,272897
8726,0.025731,172.31.36.0-255,66,212851,1,272897
8727,0.025759,74.125.24.0-255,1484,214335,1,272897
8728,0.02829,74.125.24.0-255,4320,218655,1,272897
8729,0.028297,172.31.36.0-255,66,218721,1,272897
8730,0.030851,74.125.24.0-255,5738,224459,1,272897
8731,0.030859,172.31.36.0-255,66,224525,1,272897
8732,0.033423,74.125.24.0-255,5738,230263,1,272897
8733,0.033432,172.31.36.0-255,66,230329,1,272897
8734,0.033632,172.31.36.0-255,172,230501,1,272897
8735,0.033677,172.31.36.0-255,1113,231614,1,272897
8736,0.033807,172.31.36.0-255,1514,233128,1,272897
8737,0.03381,172.31.36.0-255,1514,234642,1,272897
8738,0.033814,172.31.36.0-255,1514,236156,1,272897
8739,0.033815,172.31.36.0-255,1514,237670,1,272897
8740,0.033836,172.31.36.0-255,1491,239161,1,272897
8741,0.035165,104.244.42.0-255,66,239227,1,272897
8742,0.035246,104.244.42.0-255,66,239293,1,272897
8743,0.035433,104.244.42.0-255,66,239359,1,272897
8744,0.035989,74.125.24.0-255,5738,245097,1,272897
8745,0.035996,172.31.36.0-255,66,245163,1,272897
8746,0.038577,74.125.24.0-255,5738,250901,1,272897
8747,0.038585,172.31.36.0-255,66,250967,1,272897
8748,0.041149,74.125.24.0-255,5738,256705,1,272897
8749,0.041158,172.31.36.0-255,66,256771,1,272897
8750,0.043701,74.125.24.0-255,4320,261091,1,272897
8751,0.043706,172.31.36.0-255,66,261157,1,272897
8752,0.043744,74.125.24.0-255,1484,262641,1,272897
8753,0.046285,74.125.24.0-255,4320,266961,1,272897
8754,0.046291,172.31.36.0-255,66,267027,1,272897
8755,0.048852,74.125.24.0-255,4320,271347,1,272897
8756,0.048858,172.31.36.0-255,66,271413,1,272897
8757,0.048894,74.125.24.0-255,1484,272897,1,272897
8758,0.0,74.125.24.0-255,146,146,1,169077
8759,1.5e-05,172.31.36.0-255,66,212,1,169077
8760,2.1e-05,74.125.24.0-255,1484,1696,1,169077
8761,2.6e-05,172.31.36.0-255,66,1762,1,169077
8762,3.4e-05,74.125.24.0-255,2902,4664,1,169077
8763,3.9e-05,172.31.36.0-255,66,4730,1,169077
8764,4.5e-05,74.125.24.0-255,4320,9050,1,169077
8765,4.8e-05,172.31.36.0-255,66,9116,1,169077
8766,8.3e-05,74.125.24.0-255,5738,14854,1,169077
8767,8.7e-05,172.31.36.0-255,66,14920,1,169077
8768,0.000107,74.125.24.0-255,3392,18312,1,169077
8769,0.000109,172.31.36.0-255,66,18378,1,169077
8770,0.000157,74.125.24.0-255,5738,24116,1,169077
8771,0.000161,172.31.36.0-255,66,24182,1,169077
8772,0.000185,74.125.24.0-255,1484,25666,1,169077
8773,0.000187,172.31.36.0-255,66,25732,1,169077
8774,0.000212,74.125.24.0-255,5379,31111,1,169077
8775,0.000216,172.31.36.0-255,66,31177,1,169077
8776,0.000311,74.125.24.0-255,1484,32661,1,169077
8777,0.000316,172.31.36.0-255,66,32727,1,169077
8778,0.000323,74.125.24.0-255,2902,35629,1,169077
8779,0.000325,172.31.36.0-255,66,35695,1,169077
8780,0.00033,74.125.24.0-255,5738,41433,1,169077
8781,0.000333,172.31.36.0-255,66,41499,1,169077
8782,0.000352,74.125.24.0-255,1484,42983,1,169077
8783,0.000354,172.31.36.0-255,66,43049,1,169077
8784,0.000391,172.31.36.0-255,66,43115,1,169077
8785,0.000451,74.125.24.0-255,5738,48853,1,169077
8786,0.000455,172.31.36.0-255,66,48919,1,169077
8787,0.000477,74.125.24.0-255,5738,54657,1,169077
8788,0.00048,172.31.36.0-255,66,54723,1,169077
8789,0.000545,74.125.24.0-255,1434,56157,1,169077
8790,0.001094,74.125.24.0-255,114,56271,1,169077
8791,0.0011,74.125.24.0-255,331,56602,1,169077
8792,0.001104,172.31.36.0-255,66,56668,1,169077
8793,0.001784,74.125.24.0-255,1484,58152,1,169077
8794,0.001792,74.125.24.0-255,2902,61054,1,169077
8795,0.001797,172.31.36.0-255,66,61120,1,169077
8796,0.001803,74.125.24.0-255,2902,64022,1,169077
8797,0.001805,172.31.36.0-255,66,64088,1,169077
8798,0.001829,74.125.24.0-255,2902,66990,1,169077
8799,0.001832,172.31.36.0-255,66,67056,1,169077
8800,0.00185,74.125.24.0-255,4320,71376,1,169077
8801,0.001852,172.31.36.0-255,66,71442,1,169077
8802,0.001899,74.125.24.0-255,4320,75762,1,169077
8803,0.001901,172.31.36.0-255,66,75828,1,169077
8804,0.001924,74.125.24.0-255,7156,82984,1,169077
8805,0.001926,172.31.36.0-255,66,83050,1,169077
8806,0.001983,74.125.24.0-255,2902,85952,1,169077
8807,0.001985,172.31.36.0-255,66,86018,1,169077
8808,0.002002,74.125.24.0-255,5020,91038,1,169077
8809,0.002005,172.31.36.0-255,66,91104,1,169077
8810,0.002722,74.125.24.0-255,1484,92588,1,169077
8811,0.00274,74.125.24.0-255,2902,95490,1,169077
8812,0.002743,172.31.36.0-255,66,95556,1,169077
8813,0.002747,74.125.24.0-255,2902,98458,1,169077
8814,0.002748,172.31.36.0-255,66,98524,1,169077
8815,0.002766,74.125.24.0-255,2902,101426,1,169077
8816,0.002769,172.31.36.0-255,66,101492,1,169077
8817,0.002809,172.31.36.0-255,66,101558,1,169077
8818,0.002884,74.125.24.0-255,2902,104460,1,169077
8819,0.002886,172.31.36.0-255,66,104526,1,169077
8820,0.002912,172.31.36.0-255,66,104592,1,169077
8821,0.003075,74.125.24.0-255,1484,106076,1,169077
8822,0.003079,74.125.24.0-255,1484,107560,1,169077
8823,0.003082,172.31.36.0-255,66,107626,1,169077
8824,0.003093,74.125.24.0-255,1484,109110,1,169077
8825,0.003096,74.125.24.0-255,1484,110594,1,169077
8826,0.003098,172.31.36.0-255,66,110660,1,169077
8827,0.003128,172.31.36.0-255,66,110726,1,169077
8828,0.003189,74.125.24.0-255,2902,113628,1,169077
8829,0.003191,172.31.36.0-255,66,113694,1,169077
8830,0.003219,172.31.36.0-255,66,113760,1,169077
8831,0.00323,74.125.24.0-255,1484,115244,1,169077
8832,0.003325,74.125.24.0-255,766,116010,1,169077
8833,0.003328,172.31.36.0-255,66,116076,1,169077
8834,0.00338,172.31.36.0-255,66,116142,1,169077
8835,0.003402,74.125.24.0-255,7156,123298,1,169077
8836,0.003405,172.31.36.0-255,66,123364,1,169077
8837,0.003519,74.125.24.0-255,4320,127684,1,169077
8838,0.003521,172.31.36.0-255,66,127750,1,169077
8839,0.003544,172.31.36.0-255,66,127816,1,169077
8840,0.003615,74.125.24.0-255,1484,129300,1,169077
8841,0.003685,172.31.36.0-255,66,129366,1,169077
8842,0.00394,74.125.24.0-255,2902,132268,1,169077
8843,0.004044,74.125.24.0-255,766,133034,1,169077
8844,0.004435,172.31.36.0-255,66,133100,1,169077
8845,0.004444,74.125.24.0-255,766,133866,1,169077
8846,0.004462,74.125.24.0-255,2902,136768,1,169077
8847,0.00447,172.31.36.0-255,66,136834,1,169077
8848,0.004517,172.31.36.0-255,66,136900,1,169077
8849,0.004746,74.125.24.0-255,4320,141220,1,169077
8850,0.004751,172.31.36.0-255,66,141286,1,169077
8851,0.004771,74.125.24.0-255,7156,148442,1,169077
8852,0.004777,172.31.36.0-255,66,148508,1,169077
8853,0.004806,172.31.36.0-255,66,148574,1,169077
8854,0.004816,74.125.24.0-255,5738,154312,1,169077
8855,0.004819,172.31.36.0-255,66,154378,1,169077
8856,0.004859,172.31.36.0-255,66,154444,1,169077
8857,0.004861,74.125.24.0-255,766,155210,1,169077
8858,0.005126,74.125.24.0-255,4320,159530,1,169077
8859,0.00513,172.31.36.0-255,66,159596,1,169077
8860,0.005191,172.31.36.0-255,66,159662,1,169077
8861,0.005222,172.31.36.0-255,66,159728,1,169077
8862,0.006909,172.31.36.0-255,105,159833,1,169077
8863,0.009479,74.125.24.0-255,66,159899,1,169077
8864,0.037396,172.31.36.0-255,188,160087,1,169077
8865,0.037435,172.31.36.0-255,958,161045,1,169077
8866,0.037491,172.31.36.0-255,1514,162559,1,169077
8867,0.037493,172.31.36.0-255,1514,164073,1,169077
8868,0.037498,172.31.36.0-255,1514,165587,1,169077
8869,0.0375,172.31.36.0-255,1514,167101,1,169077
8870,0.037525,172.31.36.0-255,1514,168615,1,169077
8871,0.037527,172.31.36.0-255,198,168813,1,169077
8872,0.038918,104.244.42.0-255,66,168879,1,169077
8873,0.038965,104.244.42.0-255,66,168945,1,169077
8874,0.039105,104.244.42.0-255,66,169011,1,169077
8875,0.039109,104.244.42.0-255,66,169077,1,169077
8876,0.0,74.125.24.0-255,153,153,1,275778
8877,3.4e-05,172.31.36.0-255,66,219,1,275778
8878,4e-05,74.125.24.0-255,1484,1703,1,275778
8879,4.5e-05,172.31.36.0-255,66,1769,1,275778
8880,4.9e-05,74.125.24.0-255,2902,4671,1,275778
8881,6.1e-05,172.31.36.0-255,66,4737,1,275778
8882,6.8e-05,74.125.24.0-255,5738,10475,1,275778
8883,7.2e-05,172.31.36.0-255,66,10541,1,275778
8884,0.000121,172.31.36.0-255,66,10607,1,275778
8885,0.000214,74.125.24.0-255,6797,17404,1,275778
8886,0.000219,172.31.36.0-255,66,17470,1,275778
8887,0.000268,74.125.24.0-255,7156,24626,1,275778
8888,0.000272,172.31.36.0-255,66,24692,1,275778
8889,0.000333,74.125.24.0-255,4320,29012,1,275778
8890,0.000338,172.31.36.0-255,66,29078,1,275778
8891,0.000379,172.31.36.0-255,66,29144,1,275778
8892,0.000459,172.31.36.0-255,66,29210,1,275778
8893,0.000575,74.125.24.0-255,1484,30694,1,275778
8894,0.00058,172.31.36.0-255,66,30760,1,275778
8895,0.000585,74.125.24.0-255,2902,33662,1,275778
8896,0.000588,172.31.36.0-255,66,33728,1,275778
8897,0.000619,74.125.24.0-255,5738,39466,1,275778
8898,0.000623,172.31.36.0-255,66,39532,1,275778
8899,0.000651,74.125.24.0-255,5738,45270,1,275778
8900,0.000654,172.31.36.0-255,66,45336,1,275778
8901,0.000684,74.125.24.0-255,7156,52492,1,275778
8902,0.000688,172.31.36.0-255,66,52558,1,275778
8903,0.000768,74.125.24.0-255,2902,55460,1,275778
8904,0.000773,172.31.36.0-255,66,55526,1,275778
8905,0.000797,172.31.36.0-255,66,55592,1,275778
8906,0.001166,74.125.24.0-255,1484,57076,1,275778
8907,0.001175,74.125.24.0-255,2902,59978,1,275778
8908,0.001178,172.31.36.0-255,66,60044,1,275778
8909,0.001208,74.125.24.0-255,5738,65782,1,275778
8910,0.001212,172.31.36.0-255,66,65848,1,275778
8911,0.001243,74.125.24.0-255,4320,70168,1,275778
8912,0.001246,172.31.36.0-255,66,70234,1,275778
8913,0.001273,74.125.24.0-255,2902,73136,1,275778
8914,0.001277,172.31.36.0-255,66,73202,1,275778
8915,0.00131,172.31.36.0-255,66,73268,1,275778
8916,0.001383,74.125.24.0-255,5738,79006,1,275778
8917,0.001387,172.31.36.0-255,66,79072,1,275778
8918,0.001419,74.125.24.0-255,2184,81256,1,275778
8919,0.001422,172.31.36.0-255,66,81322,1,275778
8920,0.001695,74.125.24.0-255,1484,82806,1,275778
8921,0.001702,74.125.24.0-255,2902,85708,1,275778
8922,0.001706,172.31.36.0-255,66,85774,1,275778
8923,0.00174,74.125.24.0-255,5738,91512,1,275778
8924,0.001743,172.31.36.0-255,66,91578,1,275778
8925,0.001752,74.125.24.0-255,1484,93062,1,275778
8926,0.00178,172.31.36.0-255,66,93128,1,275778
8927,0.001874,74.125.24.0-255,4320,97448,1,275778
8928,0.001877,172.31.36.0-255,66,97514,1,275778
8929,0.001904,74.125.24.0-255,6438,103952,1,275778
8930,0.001906,172.31.36.0-255,66,104018,1,275778
8931,0.001959,74.125.24.0-255,1484,105502,1,275778
8932,0.001975,74.125.24.0-255,1484,106986,1,275778
8933,0.001979,172.31.36.0-255,66,107052,1,275778
8934,0.001989,74.125.24.0-255,1484,108536,1,275778
8935,0.002008,74.125.24.0-255,2902,111438,1,275778
8936,0.00201,172.31.36.0-255,66,111504,1,275778
8937,0.002033,74.125.24.0-255,2902,114406,1,275778
8938,0.002035,172.31.36.0-255,66,114472,1,275778
8939,0.00207,172.31.36.0-255,66,114538,1,275778
8940,0.002168,74.125.24.0-255,4320,118858,1,275778
8941,0.002171,172.31.36.0-255,66,118924,1,275778
8942,0.002196,74.125.24.0-255,6438,125362,1,275778
8943,0.002199,172.31.36.0-255,66,125428,1,275778
8944,0.002293,74.125.24.0-255,4320,129748,1,275778
8945,0.002297,172.31.36.0-255,66,129814,1,275778
8946,0.002324,74.125.24.0-255,4320,134134,1,275778
8947,0.002327,172.31.36.0-255,66,134200,1,275778
8948,0.002332,74.125.24.0-255,5738,139938,1,275778
8949,0.002335,172.31.36.0-255,66,140004,1,275778
8950,0.002354,74.125.24.0-255,4320,144324,1,275778
8951,0.002356,172.31.36.0-255,66,144390,1,275778
8952,0.002423,74.125.24.0-255,5738,150128,1,275778
8953,0.002426,172.31.36.0-255,66,150194,1,275778
8954,0.002458,172.31.36.0-255,66,150260,1,275778
8955,0.004693,74.125.24.0-255,5738,155998,1,275778
8956,0.004698,172.31.36.0-255,66,156064,1,275778
8957,0.006935,74.125.24.0-255,5738,161802,1,275778
8958,0.006942,172.31.36.0-255,66,161868,1,275778
8959,0.00771,172.31.36.0-255,101,161969,1,275778
8960,0.009188,74.125.24.0-255,5738,167707,1,275778
8961,0.009196,172.31.36.0-255,66,167773,1,275778
8962,0.009944,74.125.24.0-255,66,167839,1,275778
8963,0.011458,74.125.24.0-255,5738,173577,1,275778
8964,0.011466,172.31.36.0-255,66,173643,1,275778
8965,0.013727,74.125.24.0-255,5738,179381,1,275778
8966,0.013733,172.31.36.0-255,66,179447,1,275778
8967,0.016,74.125.24.0-255,5738,185185,1,275778
8968,0.016006,172.31.36.0-255,66,185251,1,275778
8969,0.018453,74.125.24.0-255,5738,190989,1,275778
8970,0.018503,172.31.36.0-255,66,191055,1,275778
8971,0.020761,74.125.24.0-255,5738,196793,1,275778
8972,0.020771,172.31.36.0-255,66,196859,1,275778
8973,0.023025,74.125.24.0-255,5738,202597,1,275778
8974,0.023033,172.31.36.0-255,66,202663,1,275778
8975,0.025308,74.125.24.0-255,5738,208401,1,275778
8976,0.025317,172.31.36.0-255,66,208467,1,275778
8977,0.027595,74.125.24.0-255,5738,214205,1,275778
8978,0.027603,172.31.36.0-255,66,214271,1,275778
8979,0.029854,74.125.24.0-255,5738,220009,1,275778
8980,0.029862,172.31.36.0-255,66,220075,1,275778
8981,0.032098,74.125.24.0-255,5738,225813,1,275778
8982,0.032106,172.31.36.0-255,66,225879,1,275778
8983,0.034352,74.125.24.0-255,5738,231617,1,275778
8984,0.034363,172.31.36.0-255,66,231683,1,275778
8985,0.036646,74.125.24.0-255,5738,237421,1,275778
8986,0.036654,172.31.36.0-255,66,237487,1,275778
8987,0.038897,74.125.24.0-255,5738,243225,1,275778
8988,0.038918,172.31.36.0-255,66,243291,1,275778
8989,0.041199,74.125.24.0-255,5738,249029,1,275778
8990,0.041216,172.31.36.0-255,66,249095,1,275778
8991,0.043498,74.125.24.0-255,5738,254833,1,275778
8992,0.043516,172.31.36.0-255,66,254899,1,275778
8993,0.045784,74.125.24.0-255,5738,260637,1,275778
8994,0.0458,172.31.36.0-255,66,260703,1,275778
8995,0.046819,172.31.36.0-255,172,260875,1,275778
8996,0.046849,172.31.36.0-255,1115,261990,1,275778
8997,0.046897,172.31.36.0-255,1514,263504,1,275778
8998,0.046898,172.31.36.0-255,1514,265018,1,275778
8999,0.046899,172.31.36.0-255,1514,266532,1,275778
9000,0.046901,172.31.36.0-255,1514,268046,1,275778
9001,0.046925,172.31.36.0-255,1490,269536,1,275778
9002,0.048061,74.125.24.0-255,5738,275274,1,275778
9003,0.048068,172.31.36.0-255,66,275340,1,275778
9004,0.04834,104.244.42.0-255,66,275406,1,275778
9005,0.04838,104.244.42.0-255,66,275472,1,275778
9006,0.048468,104.244.42.0-255,66,275538,1,275778
9007,0.048523,104.244.42.0-255,66,275604,1,275778
9008,0.049073,104.244.42.0-255,108,275712,1,275778
9009,0.049081,172.31.36.0-255,66,275778,1,275778
9010,0.0,74.125.24.0-255,146,146,1,253720
9011,3e-05,172.31.36.0-255,66,212,1,253720
9012,3.6e-05,74.125.24.0-255,1484,1696,1,253720
9013,4.1e-05,172.31.36.0-255,66,1762,1,253720
9014,4.6e-05,74.125.24.0-255,2902,4664,1,253720
9015,4.8e-05,172.31.36.0-255,66,4730,1,253720
9016,5.4e-05,74.125.24.0-255,4320,9050,1,253720
9017,5.6e-05,172.31.36.0-255,66,9116,1,253720
9018,6.3e-05,74.125.24.0-255,4927,14043,1,253720
9019,6.6e-05,172.31.36.0-255,66,14109,1,253720
9020,0.000135,74.125.24.0-255,1484,15593,1,253720
9021,0.000138,172.31.36.0-255,66,15659,1,253720
9022,0.000143,74.125.24.0-255,2902,18561,1,253720
9023,0.000145,172.31.36.0-255,66,18627,1,253720
9024,0.000148,74.125.24.0-255,1484,20111,1,253720
9025,0.00015,172.31.36.0-255,66,20177,1,253720
9026,0.000183,74.125.24.0-255,4320,24497,1,253720
9027,0.000187,172.31.36.0-255,66,24563,1,253720
9028,0.000193,74.125.24.0-255,6797,31360,1,253720
9029,0.000195,172.31.36.0-255,66,31426,1,253720
9030,0.0004,74.125.24.0-255,1484,32910,1,253720
9031,0.000405,172.31.36.0-255,66,32976,1,253720
9032,0.000409,74.125.24.0-255,1484,34460,1,253720
9033,0.000412,172.31.36.0-255,66,34526,1,253720
9034,0.000427,74.125.24.0-255,1484,36010,1,253720
9035,0.00043,172.31.36.0-255,66,36076,1,253720
9036,0.000437,74.125.24.0-255,5738,41814,1,253720
9037,0.000439,172.31.36.0-255,66,41880,1,253720
9038,0.000477,74.125.24.0-255,1484,43364,1,253720
9039,0.00048,172.31.36.0-255,66,43430,1,253720
9040,0.000498,74.125.24.0-255,5379,48809,1,253720
9041,0.000501,172.31.36.0-255,66,48875,1,253720
9042,0.000559,74.125.24.0-255,1484,50359,1,253720
9043,0.000562,172.31.36.0-255,66,50425,1,253720
9044,0.000567,74.125.24.0-255,2902,53327,1,253720
9045,0.000569,172.31.36.0-255,66,53393,1,253720
9046,0.000586,74.125.24.0-255,5738,59131,1,253720
9047,0.000588,172.31.36.0-255,66,59197,1,253720
9048,0.000614,74.125.24.0-255,2902,62099,1,253720
9049,0.000616,172.31.36.0-255,66,62165,1,253720
9050,0.000639,74.125.24.0-255,4290,66455,1,253720
9051,0.000642,172.31.36.0-255,66,66521,1,253720
9052,0.000645,74.125.24.0-255,347,66868,1,253720
9053,0.000646,172.31.36.0-255,66,66934,1,253720
9054,0.000785,74.125.24.0-255,1484,68418,1,253720
9055,0.000789,172.31.36.0-255,66,68484,1,253720
9056,0.000794,74.125.24.0-255,2902,71386,1,253720
9057,0.000796,172.31.36.0-255,66,71452,1,253720
9058,0.0008,74.125.24.0-255,2902,74354,1,253720
9059,0.000802,172.31.36.0-255,66,74420,1,253720
9060,0.000819,74.125.24.0-255,2902,77322,1,253720
9061,0.000822,172.31.36.0-255,66,77388,1,253720
9062,0.000825,74.125.24.0-255,1484,78872,1,253720
9063,0.000827,172.31.36.0-255,66,78938,1,253720
9064,0.000847,74.125.24.0-255,1484,80422,1,253720
9065,0.00085,172.31.36.0-255,66,80488,1,253720
9066,0.00087,74.125.24.0-255,3961,84449,1,253720
9067,0.000874,172.31.36.0-255,66,84515,1,253720
9068,0.000924,74.125.24.0-255,1484,85999,1,253720
9069,0.000927,172.31.36.0-255,66,86065,1,253720
9070,0.000933,74.125.24.0-255,2902,88967,1,253720
9071,0.000935,172.31.36.0-255,66,89033,1,253720
9072,0.000958,74.125.24.0-255,5738,94771,1,253720
9073,0.000961,172.31.36.0-255,66,94837,1,253720
9074,0.00098,74.125.24.0-255,6797,101634,1,253720
9075,0.000983,172.31.36.0-255,66,101700,1,253720
9076,0.001821,74.125.24.0-255,1484,103184,1,253720
9077,0.001829,172.31.36.0-255,66,103250,1,253720
9078,0.001837,74.125.24.0-255,2902,106152,1,253720
9079,0.00184,172.31.36.0-255,66,106218,1,253720
9080,0.001846,74.125.24.0-255,5738,111956,1,253720
9081,0.001848,172.31.36.0-255,66,112022,1,253720
9082,0.001872,74.125.24.0-255,2902,114924,1,253720
9083,0.001874,172.31.36.0-255,66,114990,1,253720
9084,0.001899,172.31.36.0-255,66,115056,1,253720
9085,0.001911,172.31.36.0-255,66,115122,1,253720
9086,0.002445,74.125.24.0-255,1484,116606,1,253720
9087,0.002453,74.125.24.0-255,2902,119508,1,253720
9088,0.002455,172.31.36.0-255,66,119574,1,253720
9089,0.002469,74.125.24.0-255,4320,123894,1,253720
9090,0.002471,172.31.36.0-255,66,123960,1,253720
9091,0.002483,74.125.24.0-255,1484,125444,1,253720
9092,0.002498,74.125.24.0-255,7156,132600,1,253720
9093,0.0025,172.31.36.0-255,66,132666,1,253720
9094,0.002515,74.125.24.0-255,5738,138404,1,253720
9095,0.002517,172.31.36.0-255,66,138470,1,253720
9096,0.002522,74.125.24.0-255,2902,141372,1,253720
9097,0.002524,172.31.36.0-255,66,141438,1,253720
9098,0.002554,172.31.36.0-255,66,141504,1,253720
9099,0.005105,74.125.24.0-255,5738,147242,1,253720
9100,0.005108,172.31.36.0-255,66,147308,1,253720
9101,0.007689,74.125.24.0-255,5738,153046,1,253720
9102,0.007695,172.31.36.0-255,66,153112,1,253720
9103,0.010265,74.125.24.0-255,5738,158850,1,253720
9104,0.010274,172.31.36.0-255,66,158916,1,253720
9105,0.012842,74.125.24.0-255,5738,164654,1,253720
9106,0.01285,172.31.36.0-255,66,164720,1,253720
9107,0.015406,74.125.24.0-255,5738,170458,1,253720
9108,0.015419,172.31.36.0-255,66,170524,1,253720
9109,0.018021,74.125.24.0-255,5738,176262,1,253720
9110,0.01803,172.31.36.0-255,66,176328,1,253720
9111,0.0206,74.125.24.0-255,5738,182066,1,253720
9112,0.020607,172.31.36.0-255,66,182132,1,253720
9113,0.023188,74.125.24.0-255,5738,187870,1,253720
9114,0.023195,172.31.36.0-255,66,187936,1,253720
9115,0.025788,74.125.24.0-255,5738,193674,1,253720
9116,0.025796,172.31.36.0-255,66,193740,1,253720
9117,0.028424,74.125.24.0-255,5738,199478,1,253720
9118,0.028432,172.31.36.0-255,66,199544,1,253720
9119,0.030978,74.125.24.0-255,5738,205282,1,253720
9120,0.030985,172.31.36.0-255,66,205348,1,253720
9121,0.031371,172.31.36.0-255,172,205520,1,253720
9122,0.031412,172.31.36.0-255,1115,206635,1,253720
9123,0.031491,172.31.36.0-255,1514,208149,1,253720
9124,0.031493,172.31.36.0-255,1514,209663,1,253720
9125,0.031498,172.31.36.0-255,1514,211177,1,253720
9126,0.031499,172.31.36.0-255,1514,212691,1,253720
9127,0.031522,172.31.36.0-255,1489,214180,1,253720
9128,0.03294,104.244.42.0-255,66,214246,1,253720
9129,0.033036,104.244.42.0-255,66,214312,1,253720
9130,0.033053,104.244.42.0-255,66,214378,1,253720
9131,0.033187,104.244.42.0-255,66,214444,1,253720
9132,0.033532,74.125.24.0-255,4320,218764,1,253720
9133,0.033537,172.31.36.0-255,66,218830,1,253720
9134,0.033565,74.125.24.0-255,1484,220314,1,253720
9135,0.036092,74.125.24.0-255,4320,224634,1,253720
9136,0.036098,172.31.36.0-255,66,224700,1,253720
9137,0.038674,74.125.24.0-255,5738,230438,1,253720
9138,0.038679,172.31.36.0-255,66,230504,1,253720
9139,0.041259,74.125.24.0-255,5738,236242,1,253720
9140,0.041264,172.31.36.0-255,66,236308,1,253720
9141,0.04383,74.125.24.0-255,5738,242046,1,253720
9142,0.043836,172.31.36.0-255,66,242112,1,253720
9143,0.046402,74.125.24.0-255,5738,247850,1,253720
9144,0.046407,172.31.36.0-255,66,247916,1,253720
9145,0.049011,74.125.24.0-255,5738,253654,1,253720
9146,0.049017,172.31.36.0-255,66,253720,1,253720
9147,0.0,74.125.200.0-255,153,153,1,178811
9148,1.4e-05,172.31.36.0-255,66,219,1,178811
9149,2.1e-05,74.125.200.0-255,1484,1703,1,178811
9150,2.4e-05,172.31.36.0-255,66,1769,1,178811
9151,2.8e-05,74.125.200.0-255,1484,3253,1,178811
9152,3.1e-05,172.31.36.0-255,66,3319,1,178811
9153,5.7e-05,74.125.200.0-255,1484,4803,1,178811
9154,6.1e-05,172.31.36.0-255,66,4869,1,178811
9155,6.7e-05,74.125.200.0-255,4320,9189,1,178811
9156,7e-05,172.31.36.0-255,66,9255,1,178811
9157,7.4e-05,74.125.200.0-255,2902,12157,1,178811
9158,7.7e-05,172.31.36.0-255,66,12223,1,178811
9159,9.4e-05,74.125.200.0-255,2040,14263,1,178811
9160,9.7e-05,172.31.36.0-255,66,14329,1,178811
9161,0.000347,74.125.200.0-255,1484,15813,1,178811
9162,0.000352,172.31.36.0-255,66,15879,1,178811
9163,0.000359,74.125.200.0-255,2902,18781,1,178811
9164,0.000362,172.31.36.0-255,66,18847,1,178811
9165,0.000386,74.125.200.0-255,5738,24585,1,178811
9166,0.000389,172.31.36.0-255,66,24651,1,178811
9167,0.00042,74.125.200.0-255,6797,31448,1,178811
9168,0.000424,172.31.36.0-255,66,31514,1,178811
9169,0.001037,74.125.200.0-255,1484,32998,1,178811
9170,0.001043,172.31.36.0-255,66,33064,1,178811
9171,0.001053,74.125.200.0-255,2902,35966,1,178811
9172,0.001055,172.31.36.0-255,66,36032,1,178811
9173,0.001076,74.125.200.0-255,4320,40352,1,178811
9174,0.001078,172.31.36.0-255,66,40418,1,178811
9175,0.001085,74.125.200.0-255,5738,46156,1,178811
9176,0.001087,172.31.36.0-255,66,46222,1,178811
9177,0.001123,74.125.200.0-255,5738,51960,1,178811
9178,0.001125,172.31.36.0-255,66,52026,1,178811
9179,0.001148,74.125.200.0-255,5379,57405,1,178811
9180,0.001151,172.31.36.0-255,66,57471,1,178811
9181,0.001165,74.125.200.0-255,4320,61791,1,178811
9182,0.001167,172.31.36.0-255,66,61857,1,178811
9183,0.001184,74.125.200.0-255,3961,65818,1,178811
9184,0.001186,172.31.36.0-255,66,65884,1,178811
9185,0.005176,74.125.200.0-255,646,66530,1,178811
9186,0.005219,172.31.36.0-255,66,66596,1,178811
9187,0.005391,74.125.200.0-255,1484,68080,1,178811
9188,0.005407,74.125.200.0-255,2902,70982,1,178811
9189,0.005411,172.31.36.0-255,66,71048,1,178811
9190,0.007771,74.125.200.0-255,1484,72532,1,178811
9191,0.007964,74.125.200.0-255,4320,76852,1,178811
9192,0.00797,172.31.36.0-255,66,76918,1,178811
9193,0.010529,74.125.200.0-255,5738,82656,1,178811
9194,0.010539,172.31.36.0-255,66,82722,1,178811
9195,0.013101,74.125.200.0-255,5738,88460,1,178811
9196,0.013109,172.31.36.0-255,66,88526,1,178811
9197,0.015669,74.125.200.0-255,5738,94264,1,178811
9198,0.015682,172.31.36.0-255,66,94330,1,178811
9199,0.01825,74.125.200.0-255,5738,100068,1,178811
9200,0.01826,172.31.36.0-255,66,100134,1,178811
9201,0.020809,74.125.200.0-255,5738,105872,1,178811
9202,0.020817,172.31.36.0-255,66,105938,1,178811
9203,0.023402,74.125.200.0-255,5738,111676,1,178811
9204,0.023411,172.31.36.0-255,66,111742,1,178811
9205,0.02596,74.125.200.0-255,5738,117480,1,178811
9206,0.025969,172.31.36.0-255,66,117546,1,178811
9207,0.028543,74.125.200.0-255,5738,123284,1,178811
9208,0.028552,172.31.36.0-255,66,123350,1,178811
9209,0.031104,74.125.200.0-255,5738,129088,1,178811
9210,0.031113,172.31.36.0-255,66,129154,1,178811
9211,0.032492,172.31.36.0-255,172,129326,1,178811
9212,0.032525,172.31.36.0-255,1114,130440,1,178811
9213,0.032592,172.31.36.0-255,1514,131954,1,178811
9214,0.032593,172.31.36.0-255,1514,133468,1,178811
9215,0.032595,172.31.36.0-255,1514,134982,1,178811
9216,0.032599,172.31.36.0-255,1514,136496,1,178811
9217,0.0326,172.31.36.0-255,1489,137985,1,178811
9218,0.033661,74.125.200.0-255,5738,143723,1,178811
9219,0.033668,172.31.36.0-255,66,143789,1,178811
9220,0.034017,104.244.42.0-255,66,143855,1,178811
9221,0.034069,104.244.42.0-255,66,143921,1,178811
9222,0.034235,104.244.42.0-255,66,143987,1,178811
9223,0.036247,74.125.200.0-255,5738,149725,1,178811
9224,0.036254,172.31.36.0-255,66,149791,1,178811
9225,0.038818,74.125.200.0-255,5738,155529,1,178811
9226,0.038824,172.31.36.0-255,66,155595,1,178811
9227,0.041392,74.125.200.0-255,5738,161333,1,178811
9228,0.041399,172.31.36.0-255,66,161399,1,178811
9229,0.043943,74.125.200.0-255,5738,167137,1,178811
9230,0.043949,172.31.36.0-255,66,167203,1,178811
9231,0.046538,74.125.200.0-255,5738,172941,1,178811
9232,0.046544,172.31.36.0-255,66,173007,1,178811
9233,0.049088,74.125.200.0-255,5738,178745,1,178811
9234,0.049097,172.31.36.0-255,66,178811,1,178811
9235,0.0,74.125.130.0-255,148,148,1,264153
9236,2.1e-05,172.31.36.0-255,66,214,1,264153
9237,2.9e-05,74.125.130.0-255,1484,1698,1,264153
9238,3.3e-05,172.31.36.0-255,66,1764,1,264153
9239,3.7e-05,74.125.130.0-255,1484,3248,1,264153
9240,4e-05,172.31.36.0-255,66,3314,1,264153
9241,5.4e-05,74.125.130.0-255,2902,6216,1,264153
9242,5.7e-05,172.31.36.0-255,66,6282,1,264153
9243,6.4e-05,74.125.130.0-255,5738,12020,1,264153
9244,6.6e-05,172.31.36.0-255,66,12086,1,264153
9245,7e-05,74.125.130.0-255,2002,14088,1,264153
9246,7.3e-05,172.31.36.0-255,66,14154,1,264153
9247,0.000153,74.125.130.0-255,1484,15638,1,264153
9248,0.000157,172.31.36.0-255,66,15704,1,264153
9249,0.000188,74.125.130.0-255,2902,18606,1,264153
9250,0.000191,172.31.36.0-255,66,18672,1,264153
9251,0.000195,74.125.130.0-255,2902,21574,1,264153
9252,0.000197,172.31.36.0-255,66,21640,1,264153
9253,0.000208,74.125.130.0-255,4320,25960,1,264153
9254,0.000211,172.31.36.0-255,66,26026,1,264153
9255,0.000248,74.125.130.0-255,5379,31405,1,264153
9256,0.000251,172.31.36.0-255,66,31471,1,264153
9257,0.001136,74.125.130.0-255,1484,32955,1,264153
9258,0.001143,172.31.36.0-255,66,33021,1,264153
9259,0.001154,74.125.130.0-255,2902,35923,1,264153
9260,0.001161,172.31.36.0-255,66,35989,1,264153
9261,0.001165,74.125.130.0-255,1484,37473,1,264153
9262,0.001167,172.31.36.0-255,66,37539,1,264153
9263,0.001172,74.125.130.0-255,2902,40441,1,264153
9264,0.001173,172.31.36.0-255,66,40507,1,264153
9265,0.001179,74.125.130.0-255,2902,43409,1,264153
9266,0.001181,172.31.36.0-255,66,43475,1,264153
9267,0.001214,74.125.130.0-255,2902,46377,1,264153
9268,0.001217,172.31.36.0-255,66,46443,1,264153
9269,0.001225,74.125.130.0-255,2543,48986,1,264153
9270,0.001227,172.31.36.0-255,66,49052,1,264153
9271,0.001232,74.125.130.0-255,2902,51954,1,264153
9272,0.001234,172.31.36.0-255,66,52020,1,264153
9273,0.00124,74.125.130.0-255,4320,56340,1,264153
9274,0.001242,172.31.36.0-255,66,56406,1,264153
9275,0.001269,74.125.130.0-255,2902,59308,1,264153
9276,0.001271,172.31.36.0-255,66,59374,1,264153
9277,0.001276,74.125.130.0-255,2902,62276,1,264153
9278,0.001282,172.31.36.0-255,66,62342,1,264153
9279,0.001288,74.125.130.0-255,4238,66580,1,264153
9280,0.001289,172.31.36.0-255,66,66646,1,264153
9281,0.001377,74.125.130.0-255,1484,68130,1,264153
9282,0.001393,74.125.130.0-255,2902,71032,1,264153
9283,0.001397,172.31.36.0-255,66,71098,1,264153
9284,0.001402,74.125.130.0-255,2902,74000,1,264153
9285,0.001404,172.31.36.0-255,66,74066,1,264153
9286,0.001407,74.125.130.0-255,1484,75550,1,264153
9287,0.001441,74.125.130.0-255,2902,78452,1,264153
9288,0.001444,172.31.36.0-255,66,78518,1,264153
9289,0.001448,74.125.130.0-255,1484,80002,1,264153
9290,0.001473,74.125.130.0-255,3961,83963,1,264153
9291,0.001477,172.31.36.0-255,66,84029,1,264153
9292,0.00151,74.125.130.0-255,1484,85513,1,264153
9293,0.001514,74.125.130.0-255,1484,86997,1,264153
9294,0.001516,172.31.36.0-255,66,87063,1,264153
9295,0.001541,74.125.130.0-255,1484,88547,1,264153
9296,0.001548,74.125.130.0-255,5738,94285,1,264153
9297,0.00155,172.31.36.0-255,66,94351,1,264153
9298,0.001554,74.125.130.0-255,1484,95835,1,264153
9299,0.00158,74.125.130.0-255,2902,98737,1,264153
9300,0.001582,172.31.36.0-255,66,98803,1,264153
9301,0.001612,74.125.130.0-255,2543,101346,1,264153
9302,0.001615,172.31.36.0-255,66,101412,1,264153
9303,0.001825,74.125.130.0-255,1484,102896,1,264153
9304,0.001832,74.125.130.0-255,2902,105798,1,264153
9305,0.001835,172.31.36.0-255,66,105864,1,264153
9306,0.001865,74.125.130.0-255,5738,111602,1,264153
9307,0.001867,172.31.36.0-255,66,111668,1,264153
9308,0.001898,74.125.130.0-255,7156,118824,1,264153
9309,0.001901,172.31.36.0-255,66,118890,1,264153
9310,0.001966,172.31.36.0-255,66,118956,1,264153
9311,0.001972,74.125.130.0-255,3602,122558,1,264153
9312,0.001974,172.31.36.0-255,66,122624,1,264153
9313,0.003955,74.125.130.0-255,1484,124108,1,264153
9314,0.003971,74.125.130.0-255,4320,128428,1,264153
9315,0.003974,172.31.36.0-255,66,128494,1,264153
9316,0.005972,74.125.130.0-255,5738,134232,1,264153
9317,0.005976,172.31.36.0-255,66,134298,1,264153
9318,0.007988,74.125.130.0-255,5738,140036,1,264153
9319,0.007999,172.31.36.0-255,66,140102,1,264153
9320,0.010019,74.125.130.0-255,5738,145840,1,264153
9321,0.010029,172.31.36.0-255,66,145906,1,264153
9322,0.012058,74.125.130.0-255,5738,151644,1,264153
9323,0.012067,172.31.36.0-255,66,151710,1,264153
9324,0.014083,74.125.130.0-255,5738,157448,1,264153
9325,0.014093,172.31.36.0-255,66,157514,1,264153
9326,0.016104,74.125.130.0-255,5738,163252,1,264153
9327,0.016112,172.31.36.0-255,66,163318,1,264153
9328,0.018124,74.125.130.0-255,5738,169056,1,264153
9329,0.018134,172.31.36.0-255,66,169122,1,264153
9330,0.020143,74.125.130.0-255,5738,174860,1,264153
9331,0.02015,172.31.36.0-255,66,174926,1,264153
9332,0.022159,74.125.130.0-255,5738,180664,1,264153
9333,0.022167,172.31.36.0-255,66,180730,1,264153
9334,0.024173,74.125.130.0-255,5738,186468,1,264153
9335,0.024181,172.31.36.0-255,66,186534,1,264153
9336,0.025535,172.31.36.0-255,187,186721,1,264153
9337,0.025565,172.31.36.0-255,982,187703,1,264153
9338,0.02564,172.31.36.0-255,1514,189217,1,264153
9339,0.025642,172.31.36.0-255,1514,190731,1,264153
9340,0.025643,172.31.36.0-255,1514,192245,1,264153
9341,0.025645,172.31.36.0-255,1514,193759,1,264153
9342,0.025688,172.31.36.0-255,482,194241,1,264153
9343,0.026187,74.125.130.0-255,5738,199979,1,264153
9344,0.026194,172.31.36.0-255,66,200045,1,264153
9345,0.027095,104.244.42.0-255,66,200111,1,264153
9346,0.027133,104.244.42.0-255,66,200177,1,264153
9347,0.027246,104.244.42.0-255,66,200243,1,264153
9348,0.027249,104.244.42.0-255,66,200309,1,264153
9349,0.028205,74.125.130.0-255,5738,206047,1,264153
9350,0.028211,172.31.36.0-255,66,206113,1,264153
9351,0.030226,74.125.130.0-255,5738,211851,1,264153
9352,0.030231,172.31.36.0-255,66,211917,1,264153
9353,0.032257,74.125.130.0-255,5738,217655,1,264153
9354,0.032264,172.31.36.0-255,66,217721,1,264153
9355,0.034274,74.125.130.0-255,5738,223459,1,264153
9356,0.034279,172.31.36.0-255,66,223525,1,264153
9357,0.036302,74.125.130.0-255,5738,229263,1,264153
9358,0.036308,172.31.36.0-255,66,229329,1,264153
9359,0.038307,74.125.130.0-255,5738,235067,1,264153
9360,0.038313,172.31.36.0-255,66,235133,1,264153
9361,0.040333,74.125.130.0-255,5738,240871,1,264153
9362,0.040339,172.31.36.0-255,66,240937,1,264153
9363,0.042355,74.125.130.0-255,5738,246675,1,264153
9364,0.042364,172.31.36.0-255,66,246741,1,264153
9365,0.044378,74.125.130.0-255,5738,252479,1,264153
9366,0.044385,172.31.36.0-255,66,252545,1,264153
9367,0.0464,74.125.130.0-255,5738,258283,1,264153
9368,0.046406,172.31.36.0-255,66,258349,1,264153
9369,0.048418,74.125.130.0-255,5738,264087,1,264153
9370,0.048423,172.31.36.0-255,66,264153,1,264153
9371,0.0,74.125.24.0-255,152,152,1,259497
9372,2.3e-05,172.31.36.0-255,66,218,1,259497
9373,3.1e-05,74.125.24.0-255,1484,1702,1,259497
9374,3.6e-05,172.31.36.0-255,66,1768,1,259497
9375,4.1e-05,74.125.24.0-255,2902,4670,1,259497
9376,4.4e-05,172.31.36.0-255,66,4736,1,259497
9377,5.2e-05,74.125.24.0-255,7156,11892,1,259497
9378,5.5e-05,172.31.36.0-255,66,11958,1,259497
9379,5.9e-05,74.125.24.0-255,2029,13987,1,259497
9380,6.3e-05,172.31.36.0-255,66,14053,1,259497
9381,0.000185,74.125.24.0-255,1484,15537,1,259497
9382,0.00019,172.31.36.0-255,66,15603,1,259497
9383,0.000196,74.125.24.0-255,2902,18505,1,259497
9384,0.000199,172.31.36.0-255,66,18571,1,259497
9385,0.000205,74.125.24.0-255,5738,24309,1,259497
9386,0.000208,172.31.36.0-255,66,24375,1,259497
9387,0.000261,74.125.24.0-255,4320,28695,1,259497
9388,0.000264,172.31.36.0-255,66,28761,1,259497
9389,0.000284,74.125.24.0-255,2543,31304,1,259497
9390,0.000286,172.31.36.0-255,66,31370,1,259497
9391,0.00033,74.125.24.0-255,1484,32854,1,259497
9392,0.000333,172.31.36.0-255,66,32920,1,259497
9393,0.000336,74.125.24.0-255,1484,34404,1,259497
9394,0.000338,172.31.36.0-255,66,34470,1,259497
9395,0.000352,74.125.24.0-255,1484,35954,1,259497
9396,0.000354,172.31.36.0-255,66,36020,1,259497
9397,0.000374,74.125.24.0-255,1484,37504,1,259497
9398,0.000377,172.31.36.0-255,66,37570,1,259497
9399,0.000398,74.125.24.0-255,4320,41890,1,259497
9400,0.0004,172.31.36.0-255,66,41956,1,259497
9401,0.000421,74.125.24.0-255,5738,47694,1,259497
9402,0.000424,172.31.36.0-255,66,47760,1,259497
9403,0.000453,172.31.36.0-255,66,47826,1,259497
9404,0.000459,74.125.24.0-255,5738,53564,1,259497
9405,0.000461,172.31.36.0-255,66,53630,1,259497
9406,0.000487,74.125.24.0-255,4308,57938,1,259497
9407,0.000489,172.31.36.0-255,66,58004,1,259497
9408,0.000593,74.125.24.0-255,330,58334,1,259497
9409,0.001005,172.31.36.0-255,66,58400,1,259497
9410,0.001027,74.125.24.0-255,1484,59884,1,259497
9411,0.001048,74.125.24.0-255,2902,62786,1,259497
9412,0.001051,172.31.36.0-255,66,62852,1,259497
9413,0.001058,74.125.24.0-255,5738,68590,1,259497
9414,0.00106,172.31.36.0-255,66,68656,1,259497
9415,0.001066,74.125.24.0-255,4320,72976,1,259497
9416,0.001068,172.31.36.0-255,66,73042,1,259497
9417,0.00109,172.31.36.0-255,66,73108,1,259497
9418,0.001122,74.125.24.0-255,2902,76010,1,259497
9419,0.001124,172.31.36.0-255,66,76076,1,259497
9420,0.001144,172.31.36.0-255,66,76142,1,259497
9421,0.001718,74.125.24.0-255,1484,77626,1,259497
9422,0.001729,74.125.24.0-255,2902,80528,1,259497
9423,0.001733,172.31.36.0-255,66,80594,1,259497
9424,0.001742,74.125.24.0-255,5738,86332,1,259497
9425,0.001744,172.31.36.0-255,66,86398,1,259497
9426,0.001752,74.125.24.0-255,7156,93554,1,259497
9427,0.001754,172.31.36.0-255,66,93620,1,259497
9428,0.001775,74.125.24.0-255,5738,99358,1,259497
9429,0.001777,172.31.36.0-255,66,99424,1,259497
9430,0.00179,172.31.36.0-255,66,99490,1,259497
9431,0.001951,74.125.24.0-255,1484,100974,1,259497
9432,0.001958,74.125.24.0-255,2902,103876,1,259497
9433,0.001961,172.31.36.0-255,66,103942,1,259497
9434,0.001981,74.125.24.0-255,1484,105426,1,259497
9435,0.001985,74.125.24.0-255,2902,108328,1,259497
9436,0.001987,172.31.36.0-255,66,108394,1,259497
9437,0.00201,74.125.24.0-255,5738,114132,1,259497
9438,0.002013,172.31.36.0-255,66,114198,1,259497
9439,0.002044,172.31.36.0-255,66,114264,1,259497
9440,0.002047,74.125.24.0-255,1484,115748,1,259497
9441,0.00209,74.125.24.0-255,5020,120768,1,259497
9442,0.002094,172.31.36.0-255,66,120834,1,259497
9443,0.002412,74.125.24.0-255,1484,122318,1,259497
9444,0.002419,74.125.24.0-255,2902,125220,1,259497
9445,0.002423,172.31.36.0-255,66,125286,1,259497
9446,0.002427,74.125.24.0-255,1484,126770,1,259497
9447,0.002448,74.125.24.0-255,4320,131090,1,259497
9448,0.002451,172.31.36.0-255,66,131156,1,259497
9449,0.002462,172.31.36.0-255,66,131222,1,259497
9450,0.002488,74.125.24.0-255,4320,135542,1,259497
9451,0.00249,172.31.36.0-255,66,135608,1,259497
9452,0.002511,172.31.36.0-255,66,135674,1,259497
9453,0.00255,74.125.24.0-255,1484,137158,1,259497
9454,0.002554,74.125.24.0-255,2902,140060,1,259497
9455,0.002557,172.31.36.0-255,66,140126,1,259497
9456,0.002564,74.125.24.0-255,5738,145864,1,259497
9457,0.002566,172.31.36.0-255,66,145930,1,259497
9458,0.002603,172.31.36.0-255,66,145996,1,259497
9459,0.005202,74.125.24.0-255,5738,151734,1,259497
9460,0.005206,172.31.36.0-255,66,151800,1,259497
9461,0.007789,74.125.24.0-255,5738,157538,1,259497
9462,0.007799,172.31.36.0-255,66,157604,1,259497
9463,0.010438,74.125.24.0-255,5738,163342,1,259497
9464,0.01045,172.31.36.0-255,66,163408,1,259497
9465,0.013079,74.125.24.0-255,5738,169146,1,259497
9466,0.013087,172.31.36.0-255,66,169212,1,259497
9467,0.015705,74.125.24.0-255,5738,174950,1,259497
9468,0.015713,172.31.36.0-255,66,175016,1,259497
9469,0.018314,74.125.24.0-255,5738,180754,1,259497
9470,0.018328,172.31.36.0-255,66,180820,1,259497
9471,0.020929,74.125.24.0-255,5738,186558,1,259497
9472,0.020939,172.31.36.0-255,66,186624,1,259497
9473,0.023583,74.125.24.0-255,5738,192362,1,259497
9474,0.023591,172.31.36.0-255,66,192428,1,259497
9475,0.026191,74.125.24.0-255,5738,198166,1,259497
9476,0.026199,172.31.36.0-255,66,198232,1,259497
9477,0.028798,74.125.24.0-255,5738,203970,1,259497
9478,0.028808,172.31.36.0-255,66,204036,1,259497
9479,0.031386,74.125.24.0-255,5738,209774,1,259497
9480,0.031395,172.31.36.0-255,66,209840,1,259497
9481,0.033969,74.125.24.0-255,5738,215578,1,259497
9482,0.033977,172.31.36.0-255,66,215644,1,259497
9483,0.036591,74.125.24.0-255,5738,221382,1,259497
9484,0.036601,172.31.36.0-255,66,221448,1,259497
9485,0.037462,172.31.36.0-255,172,221620,1,259497
9486,0.03749,172.31.36.0-255,1115,222735,1,259497
9487,0.037553,172.31.36.0-255,1514,224249,1,259497
9488,0.037554,172.31.36.0-255,1514,225763,1,259497
9489,0.037555,172.31.36.0-255,1514,227277,1,259497
9490,0.037559,172.31.36.0-255,1514,228791,1,259497
9491,0.03756,172.31.36.0-255,1488,230279,1,259497
9492,0.039043,104.244.42.0-255,66,230345,1,259497
9493,0.039071,104.244.42.0-255,66,230411,1,259497
9494,0.039181,104.244.42.0-255,66,230477,1,259497
9495,0.039202,74.125.24.0-255,5738,236215,1,259497
9496,0.039207,172.31.36.0-255,66,236281,1,259497
9497,0.041796,74.125.24.0-255,5738,242019,1,259497
9498,0.041805,172.31.36.0-255,66,242085,1,259497
9499,0.044436,74.125.24.0-255,5738,247823,1,259497
9500,0.044442,172.31.36.0-255,66,247889,1,259497
9501,0.047062,74.125.24.0-255,5738,253627,1,259497
9502,0.047069,172.31.36.0-255,66,253693,1,259497
9503,0.049658,74.125.24.0-255,5738,259431,1,259497
9504,0.049669,172.31.36.0-255,66,259497,1,259497
9505,0.0,172.217.194.0-255,152,152,1,151274
9506,2.4e-05,172.31.36.0-255,66,218,1,151274
9507,3.2e-05,172.217.194.0-255,1484,1702,1,151274
9508,3.7e-05,172.31.36.0-255,66,1768,1,151274
9509,7.5e-05,172.217.194.0-255,2902,4670,1,151274
9510,7.9e-05,172.31.36.0-255,66,4736,1,151274
9511,8.5e-05,172.217.194.0-255,5738,10474,1,151274
9512,8.8e-05,172.31.36.0-255,66,10540,1,151274
9513,0.000113,172.217.194.0-255,4845,15385,1,151274
9514,0.000117,172.31.36.0-255,66,15451,1,151274
9515,0.000123,172.217.194.0-255,4320,19771,1,151274
9516,0.000126,172.31.36.0-255,66,19837,1,151274
9517,0.000152,172.217.194.0-255,1484,21321,1,151274
9518,0.000154,172.31.36.0-255,66,21387,1,151274
9519,0.000162,172.217.194.0-255,5738,27125,1,151274
9520,0.000165,172.31.36.0-255,66,27191,1,151274
9521,0.000202,172.217.194.0-255,7156,34347,1,151274
9522,0.000205,172.31.36.0-255,66,34413,1,151274
9523,0.000211,172.217.194.0-255,5738,40151,1,151274
9524,0.000213,172.31.36.0-255,66,40217,1,151274
9525,0.000255,172.31.36.0-255,66,40283,1,151274
9526,0.000294,172.31.36.0-255,66,40349,1,151274
9527,0.0003,172.217.194.0-255,5671,46020,1,151274
9528,0.000302,172.31.36.0-255,66,46086,1,151274
9529,0.000305,172.217.194.0-255,363,46449,1,151274
9530,0.000307,172.31.36.0-255,66,46515,1,151274
9531,0.00031,172.217.194.0-255,1484,47999,1,151274
9532,0.000313,172.31.36.0-255,66,48065,1,151274
9533,0.000318,172.217.194.0-255,2902,50967,1,151274
9534,0.000321,172.31.36.0-255,66,51033,1,151274
9535,0.000356,172.217.194.0-255,5738,56771,1,151274
9536,0.000359,172.31.36.0-255,66,56837,1,151274
9537,0.000372,172.31.36.0-255,66,56903,1,151274
9538,0.000403,172.217.194.0-255,2902,59805,1,151274
9539,0.000405,172.31.36.0-255,66,59871,1,151274
9540,0.000408,172.217.194.0-255,1484,61355,1,151274
9541,0.000416,172.217.194.0-255,5738,67093,1,151274
9542,0.000418,172.31.36.0-255,66,67159,1,151274
9543,0.000447,172.217.194.0-255,3602,70761,1,151274
9544,0.00045,172.31.36.0-255,66,70827,1,151274
9545,0.000603,172.217.194.0-255,1484,72311,1,151274
9546,0.000609,172.217.194.0-255,2902,75213,1,151274
9547,0.000613,172.31.36.0-255,66,75279,1,151274
9548,0.000645,172.217.194.0-255,5738,81017,1,151274
9549,0.000649,172.31.36.0-255,66,81083,1,151274
9550,0.000655,172.217.194.0-255,4320,85403,1,151274
9551,0.000657,172.31.36.0-255,66,85469,1,151274
9552,0.000704,172.31.36.0-255,66,85535,1,151274
9553,0.000717,172.31.36.0-255,66,85601,1,151274
9554,0.000723,172.217.194.0-255,5738,91339,1,151274
9555,0.000726,172.31.36.0-255,66,91405,1,151274
9556,0.000771,172.31.36.0-255,66,91471,1,151274
9557,0.000788,172.31.36.0-255,66,91537,1,151274
9558,0.000791,172.217.194.0-255,766,92303,1,151274
9559,0.000871,172.31.36.0-255,66,92369,1,151274
9560,0.000884,172.31.36.0-255,66,92435,1,151274
9561,0.000892,172.217.194.0-255,7156,99591,1,151274
9562,0.000895,172.31.36.0-255,66,99657,1,151274
9563,0.00091,172.217.194.0-255,5020,104677,1,151274
9564,0.000916,172.31.36.0-255,66,104743,1,151274
9565,0.001002,172.217.194.0-255,1484,106227,1,151274
9566,0.001008,172.217.194.0-255,2902,109129,1,151274
9567,0.001011,172.31.36.0-255,66,109195,1,151274
9568,0.001015,172.217.194.0-255,1484,110679,1,151274
9569,0.001039,172.217.194.0-255,2902,113581,1,151274
9570,0.001045,172.217.194.0-255,5738,119319,1,151274
9571,0.001051,172.31.36.0-255,66,119385,1,151274
9572,0.001053,172.31.36.0-255,66,119451,1,151274
9573,0.001088,172.31.36.0-255,66,119517,1,151274
9574,0.001099,172.31.36.0-255,66,119583,1,151274
9575,0.001162,172.217.194.0-255,1484,121067,1,151274
9576,0.001167,172.217.194.0-255,1484,122551,1,151274
9577,0.00117,172.31.36.0-255,66,122617,1,151274
9578,0.001192,172.217.194.0-255,1484,124101,1,151274
9579,0.001199,172.217.194.0-255,5738,129839,1,151274
9580,0.001202,172.31.36.0-255,66,129905,1,151274
9581,0.001241,172.31.36.0-255,66,129971,1,151274
9582,0.001269,172.217.194.0-255,2902,132873,1,151274
9583,0.001272,172.31.36.0-255,66,132939,1,151274
9584,0.001283,172.31.36.0-255,66,133005,1,151274
9585,0.001295,172.31.36.0-255,66,133071,1,151274
9586,0.001335,172.31.36.0-255,66,133137,1,151274
9587,0.001349,172.31.36.0-255,66,133203,1,151274
9588,0.001389,172.31.36.0-255,66,133269,1,151274
9589,0.001433,172.31.36.0-255,66,133335,1,151274
9590,0.001452,172.31.36.0-255,66,133401,1,151274
9591,0.001479,172.31.36.0-255,66,133467,1,151274
9592,0.001503,172.31.36.0-255,66,133533,1,151274
9593,0.001552,172.217.194.0-255,5738,139271,1,151274
9594,0.001554,172.31.36.0-255,66,139337,1,151274
9595,0.001595,172.31.36.0-255,66,139403,1,151274
9596,0.0016,172.217.194.0-255,3509,142912,1,151274
9597,0.001603,172.31.36.0-255,66,142978,1,151274
9598,0.001606,172.217.194.0-255,105,143083,1,151274
9599,0.009806,172.31.36.0-255,66,143149,1,151274
9600,0.009854,172.31.36.0-255,105,143254,1,151274
9601,0.012418,172.217.194.0-255,66,143320,1,151274
9602,0.038698,172.31.36.0-255,171,143491,1,151274
9603,0.038731,172.31.36.0-255,1137,144628,1,151274
9604,0.038803,172.31.36.0-255,1514,146142,1,151274
9605,0.038805,172.31.36.0-255,1514,147656,1,151274
9606,0.038811,172.31.36.0-255,1514,149170,1,151274
9607,0.038813,172.31.36.0-255,1514,150684,1,151274
9608,0.038836,172.31.36.0-255,326,151010,1,151274
9609,0.040271,104.244.42.0-255,66,151076,1,151274
9610,0.040282,104.244.42.0-255,66,151142,1,151274
9611,0.040369,104.244.42.0-255,66,151208,1,151274
9612,0.040375,104.244.42.0-255,66,151274,1,151274
9613,0.0,74.125.68.0-255,153,153,1,256444
9614,2e-05,172.31.36.0-255,66,219,1,256444
9615,2.7e-05,74.125.68.0-255,1484,1703,1,256444
9616,3.1e-05,172.31.36.0-255,66,1769,1,256444
9617,3.4e-05,74.125.68.0-255,1484,3253,1,256444
9618,3.6e-05,172.31.36.0-255,66,3319,1,256444
9619,4.1e-05,74.125.68.0-255,2902,6221,1,256444
9620,4.3e-05,172.31.36.0-255,66,6287,1,256444
9621,4.9e-05,74.125.68.0-255,5738,12025,1,256444
9622,5.1e-05,172.31.36.0-255,66,12091,1,256444
9623,7.7e-05,74.125.68.0-255,2046,14137,1,256444
9624,8e-05,172.31.36.0-255,66,14203,1,256444
9625,0.000349,74.125.68.0-255,1484,15687,1,256444
9626,0.000356,172.31.36.0-255,66,15753,1,256444
9627,0.000377,74.125.68.0-255,2902,18655,1,256444
9628,0.00038,172.31.36.0-255,66,18721,1,256444
9629,0.000385,74.125.68.0-255,2902,21623,1,256444
9630,0.000387,172.31.36.0-255,66,21689,1,256444
9631,0.000413,74.125.68.0-255,1484,23173,1,256444
9632,0.000416,172.31.36.0-255,66,23239,1,256444
9633,0.000441,172.31.36.0-255,66,23305,1,256444
9634,0.000483,74.125.68.0-255,1484,24789,1,256444
9635,0.000486,172.31.36.0-255,66,24855,1,256444
9636,0.000491,74.125.68.0-255,1484,26339,1,256444
9637,0.000493,172.31.36.0-255,66,26405,1,256444
9638,0.000507,74.125.68.0-255,1484,27889,1,256444
9639,0.000511,74.125.68.0-255,2902,30791,1,256444
9640,0.000515,172.31.36.0-255,66,30857,1,256444
9641,0.000523,172.31.36.0-255,66,30923,1,256444
9642,0.000526,74.125.68.0-255,1484,32407,1,256444
9643,0.000528,172.31.36.0-255,66,32473,1,256444
9644,0.000579,172.31.36.0-255,66,32539,1,256444
9645,0.00077,74.125.68.0-255,1484,34023,1,256444
9646,0.000792,74.125.68.0-255,2902,36925,1,256444
9647,0.000796,172.31.36.0-255,66,36991,1,256444
9648,0.0008,74.125.68.0-255,1484,38475,1,256444
9649,0.000819,74.125.68.0-255,2902,41377,1,256444
9650,0.000821,172.31.36.0-255,66,41443,1,256444
9651,0.000828,74.125.68.0-255,5738,47181,1,256444
9652,0.00083,172.31.36.0-255,66,47247,1,256444
9653,0.000849,74.125.68.0-255,1484,48731,1,256444
9654,0.000866,74.125.68.0-255,1436,50167,1,256444
9655,0.000869,172.31.36.0-255,66,50233,1,256444
9656,0.000922,74.125.68.0-255,1484,51717,1,256444
9657,0.000928,74.125.68.0-255,2902,54619,1,256444
9658,0.00093,172.31.36.0-255,66,54685,1,256444
9659,0.000955,74.125.68.0-255,5738,60423,1,256444
9660,0.000958,172.31.36.0-255,66,60489,1,256444
9661,0.000962,74.125.68.0-255,2902,63391,1,256444
9662,0.000964,172.31.36.0-255,66,63457,1,256444
9663,0.000987,74.125.68.0-255,2902,66359,1,256444
9664,0.000989,172.31.36.0-255,66,66425,1,256444
9665,0.00101,74.125.68.0-255,7156,73581,1,256444
9666,0.001013,172.31.36.0-255,66,73647,1,256444
9667,0.001021,74.125.68.0-255,7156,80803,1,256444
9668,0.001024,172.31.36.0-255,66,80869,1,256444
9669,0.001038,74.125.68.0-255,3602,84471,1,256444
9670,0.001041,172.31.36.0-255,66,84537,1,256444
9671,0.001044,74.125.68.0-255,344,84881,1,256444
9672,0.001462,172.31.36.0-255,66,84947,1,256444
9673,0.001508,74.125.68.0-255,1484,86431,1,256444
9674,0.001531,74.125.68.0-255,2902,89333,1,256444
9675,0.001534,172.31.36.0-255,66,89399,1,256444
9676,0.001538,74.125.68.0-255,1484,90883,1,256444
9677,0.001557,74.125.68.0-255,4320,95203,1,256444
9678,0.001559,172.31.36.0-255,66,95269,1,256444
9679,0.001583,74.125.68.0-255,7156,102425,1,256444
9680,0.001585,172.31.36.0-255,66,102491,1,256444
9681,0.001612,74.125.68.0-255,1484,103975,1,256444
9682,0.001625,172.31.36.0-255,66,104041,1,256444
9683,0.001631,74.125.68.0-255,5020,109061,1,256444
9684,0.001633,172.31.36.0-255,66,109127,1,256444
9685,0.002292,74.125.68.0-255,1484,110611,1,256444
9686,0.002302,74.125.68.0-255,2902,113513,1,256444
9687,0.002307,172.31.36.0-255,66,113579,1,256444
9688,0.002332,74.125.68.0-255,5738,119317,1,256444
9689,0.002335,172.31.36.0-255,66,119383,1,256444
9690,0.00234,74.125.68.0-255,2902,122285,1,256444
9691,0.002342,172.31.36.0-255,66,122351,1,256444
9692,0.002347,74.125.68.0-255,4320,126671,1,256444
9693,0.002349,172.31.36.0-255,66,126737,1,256444
9694,0.002353,74.125.68.0-255,1484,128221,1,256444
9695,0.002373,74.125.68.0-255,2902,131123,1,256444
9696,0.002376,172.31.36.0-255,66,131189,1,256444
9697,0.004672,74.125.68.0-255,1484,132673,1,256444
9698,0.004699,74.125.68.0-255,4320,136993,1,256444
9699,0.004703,172.31.36.0-255,66,137059,1,256444
9700,0.007039,74.125.68.0-255,5738,142797,1,256444
9701,0.007044,172.31.36.0-255,66,142863,1,256444
9702,0.009392,74.125.68.0-255,5738,148601,1,256444
9703,0.0094,172.31.36.0-255,66,148667,1,256444
9704,0.011744,74.125.68.0-255,5738,154405,1,256444
9705,0.01175,172.31.36.0-255,66,154471,1,256444
9706,0.014094,74.125.68.0-255,5738,160209,1,256444
9707,0.014102,172.31.36.0-255,66,160275,1,256444
9708,0.016439,74.125.68.0-255,5738,166013,1,256444
9709,0.016451,172.31.36.0-255,66,166079,1,256444
9710,0.018804,74.125.68.0-255,5738,171817,1,256444
9711,0.018811,172.31.36.0-255,66,171883,1,256444
9712,0.021164,74.125.68.0-255,5738,177621,1,256444
9713,0.021171,172.31.36.0-255,66,177687,1,256444
9714,0.023524,74.125.68.0-255,5738,183425,1,256444
9715,0.02353,172.31.36.0-255,66,183491,1,256444
9716,0.025924,74.125.68.0-255,5738,189229,1,256444
9717,0.025932,172.31.36.0-255,66,189295,1,256444
9718,0.028268,74.125.68.0-255,5738,195033,1,256444
9719,0.028276,172.31.36.0-255,66,195099,1,256444
9720,0.030627,74.125.68.0-255,5738,200837,1,256444
9721,0.030635,172.31.36.0-255,66,200903,1,256444
9722,0.031682,172.31.36.0-255,172,201075,1,256444
9723,0.031708,172.31.36.0-255,1112,202187,1,256444
9724,0.031768,172.31.36.0-255,1514,203701,1,256444
9725,0.03177,172.31.36.0-255,1514,205215,1,256444
9726,0.031774,172.31.36.0-255,1514,206729,1,256444
9727,0.031775,172.31.36.0-255,1514,208243,1,256444
9728,0.031799,172.31.36.0-255,1505,209748,1,256444
9729,0.03298,74.125.68.0-255,5738,215486,1,256444
9730,0.032986,172.31.36.0-255,66,215552,1,256444
9731,0.03323,104.244.42.0-255,66,215618,1,256444
9732,0.033276,104.244.42.0-255,66,215684,1,256444
9733,0.033366,104.244.42.0-255,66,215750,1,256444
9734,0.03338,104.244.42.0-255,66,215816,1,256444
9735,0.035329,74.125.68.0-255,5738,221554,1,256444
9736,0.035346,172.31.36.0-255,66,221620,1,256444
9737,0.037733,74.125.68.0-255,5738,227358,1,256444
9738,0.03774,172.31.36.0-255,66,227424,1,256444
9739,0.040091,74.125.68.0-255,5738,233162,1,256444
9740,0.0401,172.31.36.0-255,66,233228,1,256444
9741,0.042458,74.125.68.0-255,5738,238966,1,256444
9742,0.042464,172.31.36.0-255,66,239032,1,256444
9743,0.044812,74.125.68.0-255,5738,244770,1,256444
9744,0.044821,172.31.36.0-255,66,244836,1,256444
9745,0.047166,74.125.68.0-255,5738,250574,1,256444
9746,0.047173,172.31.36.0-255,66,250640,1,256444
9747,0.049509,74.125.68.0-255,5738,256378,1,256444
9748,0.049515,172.31.36.0-255,66,256444,1,256444
9749,0.0,74.125.24.0-255,218,218,1,303626
9750,1.5e-05,172.31.36.0-255,66,284,1,303626
9751,2.1e-05,74.125.24.0-255,1484,1768,1,303626
9752,2.6e-05,172.31.36.0-255,66,1834,1,303626
9753,3.2e-05,74.125.24.0-255,4320,6154,1,303626
9754,4.4e-05,172.31.36.0-255,66,6220,1,303626
9755,5.1e-05,74.125.24.0-255,5738,11958,1,303626
9756,5.4e-05,172.31.36.0-255,66,12024,1,303626
9757,6.7e-05,172.31.36.0-255,66,12090,1,303626
9758,8.4e-05,74.125.24.0-255,1769,13859,1,303626
9759,8.6e-05,172.31.36.0-255,66,13925,1,303626
9760,9.8e-05,74.125.24.0-255,6797,20722,1,303626
9761,0.000101,172.31.36.0-255,66,20788,1,303626
9762,0.000187,74.125.24.0-255,1484,22272,1,303626
9763,0.00019,172.31.36.0-255,66,22338,1,303626
9764,0.000196,74.125.24.0-255,2902,25240,1,303626
9765,0.000198,172.31.36.0-255,66,25306,1,303626
9766,0.00023,74.125.24.0-255,5738,31044,1,303626
9767,0.000233,172.31.36.0-255,66,31110,1,303626
9768,0.000241,74.125.24.0-255,6797,37907,1,303626
9769,0.000243,172.31.36.0-255,66,37973,1,303626
9770,0.000365,74.125.24.0-255,1484,39457,1,303626
9771,0.00037,172.31.36.0-255,66,39523,1,303626
9772,0.000375,74.125.24.0-255,2902,42425,1,303626
9773,0.000378,172.31.36.0-255,66,42491,1,303626
9774,0.000388,74.125.24.0-255,5738,48229,1,303626
9775,0.000391,172.31.36.0-255,66,48295,1,303626
9776,0.000398,74.125.24.0-255,5738,54033,1,303626
9777,0.0004,172.31.36.0-255,66,54099,1,303626
9778,0.000423,74.125.24.0-255,1125,55224,1,303626
9779,0.000425,172.31.36.0-255,66,55290,1,303626
9780,0.000428,74.125.24.0-255,412,55702,1,303626
9781,0.000462,74.125.24.0-255,332,56034,1,303626
9782,0.000686,74.125.24.0-255,1484,57518,1,303626
9783,0.000692,172.31.36.0-255,66,57584,1,303626
9784,0.000698,74.125.24.0-255,2902,60486,1,303626
9785,0.0007,172.31.36.0-255,66,60552,1,303626
9786,0.000711,74.125.24.0-255,5738,66290,1,303626
9787,0.000714,172.31.36.0-255,66,66356,1,303626
9788,0.000739,74.125.24.0-255,5738,72094,1,303626
9789,0.000743,172.31.36.0-255,66,72160,1,303626
9790,0.000779,172.31.36.0-255,66,72226,1,303626
9791,0.000786,74.125.24.0-255,7156,79382,1,303626
9792,0.000788,172.31.36.0-255,66,79448,1,303626
9793,0.000793,74.125.24.0-255,2543,81991,1,303626
9794,0.000795,172.31.36.0-255,66,82057,1,303626
9795,0.00109,74.125.24.0-255,1484,83541,1,303626
9796,0.001097,74.125.24.0-255,2902,86443,1,303626
9797,0.0011,172.31.36.0-255,66,86509,1,303626
9798,0.001108,74.125.24.0-255,5738,92247,1,303626
9799,0.00111,172.31.36.0-255,66,92313,1,303626
9800,0.001154,172.31.36.0-255,66,92379,1,303626
9801,0.001167,172.31.36.0-255,66,92445,1,303626
9802,0.00167,74.125.24.0-255,1484,93929,1,303626
9803,0.001695,74.125.24.0-255,2902,96831,1,303626
9804,0.001698,172.31.36.0-255,66,96897,1,303626
9805,0.001704,74.125.24.0-255,2902,99799,1,303626
9806,0.001707,172.31.36.0-255,66,99865,1,303626
9807,0.001758,74.125.24.0-255,2902,102767,1,303626
9808,0.001763,172.31.36.0-255,66,102833,1,303626
9809,0.00177,74.125.24.0-255,7156,109989,1,303626
9810,0.001772,172.31.36.0-255,66,110055,1,303626
9811,0.001785,172.31.36.0-255,66,110121,1,303626
9812,0.00179,74.125.24.0-255,2184,112305,1,303626
9813,0.001792,172.31.36.0-255,66,112371,1,303626
9814,0.001852,74.125.24.0-255,1484,113855,1,303626
9815,0.001857,74.125.24.0-255,2902,116757,1,303626
9816,0.001859,172.31.36.0-255,66,116823,1,303626
9817,0.001866,74.125.24.0-255,5738,122561,1,303626
9818,0.001868,172.31.36.0-255,66,122627,1,303626
9819,0.001879,172.31.36.0-255,66,122693,1,303626
9820,0.001926,172.31.36.0-255,66,122759,1,303626
9821,0.00193,74.125.24.0-255,2184,124943,1,303626
9822,0.001932,172.31.36.0-255,66,125009,1,303626
9823,0.001993,74.125.24.0-255,1484,126493,1,303626
9824,0.002011,74.125.24.0-255,1484,127977,1,303626
9825,0.002014,172.31.36.0-255,66,128043,1,303626
9826,0.002019,74.125.24.0-255,2902,130945,1,303626
9827,0.002022,172.31.36.0-255,66,131011,1,303626
9828,0.002058,74.125.24.0-255,5738,136749,1,303626
9829,0.00206,172.31.36.0-255,66,136815,1,303626
9830,0.002092,172.31.36.0-255,66,136881,1,303626
9831,0.002105,172.31.36.0-255,66,136947,1,303626
9832,0.002108,74.125.24.0-255,766,137713,1,303626
9833,0.002255,74.125.24.0-255,1484,139197,1,303626
9834,0.002261,172.31.36.0-255,66,139263,1,303626
9835,0.002267,74.125.24.0-255,2902,142165,1,303626
9836,0.00227,172.31.36.0-255,66,142231,1,303626
9837,0.002281,74.125.24.0-255,5738,147969,1,303626
9838,0.002283,172.31.36.0-255,66,148035,1,303626
9839,0.002344,172.31.36.0-255,66,148101,1,303626
9840,0.00235,74.125.24.0-255,5738,153839,1,303626
9841,0.002353,172.31.36.0-255,66,153905,1,303626
9842,0.002371,74.125.24.0-255,5020,158925,1,303626
9843,0.002377,172.31.36.0-255,66,158991,1,303626
9844,0.002443,74.125.24.0-255,1484,160475,1,303626
9845,0.002449,74.125.24.0-255,2902,163377,1,303626
9846,0.002453,172.31.36.0-255,66,163443,1,303626
9847,0.002458,74.125.24.0-255,2902,166345,1,303626
9848,0.00246,172.31.36.0-255,66,166411,1,303626
9849,0.002481,74.125.24.0-255,2902,169313,1,303626
9850,0.002483,172.31.36.0-255,66,169379,1,303626
9851,0.002491,74.125.24.0-255,7156,176535,1,303626
9852,0.002493,172.31.36.0-255,66,176601,1,303626
9853,0.002501,74.125.24.0-255,7156,183757,1,303626
9854,0.002504,172.31.36.0-255,66,183823,1,303626
9855,0.002538,74.125.24.0-255,7156,190979,1,303626
9856,0.002541,172.31.36.0-255,66,191045,1,303626
9857,0.002548,74.125.24.0-255,5020,196065,1,303626
9858,0.00255,172.31.36.0-255,66,196131,1,303626
9859,0.002566,172.31.36.0-255,66,196197,1,303626
9860,0.002602,74.125.24.0-255,7156,203353,1,303626
9861,0.002605,172.31.36.0-255,66,203419,1,303626
9862,0.00515,74.125.24.0-255,5738,209157,1,303626
9863,0.005159,172.31.36.0-255,66,209223,1,303626
9864,0.007701,74.125.24.0-255,5738,214961,1,303626
9865,0.007708,172.31.36.0-255,66,215027,1,303626
9866,0.010228,74.125.24.0-255,5738,220765,1,303626
9867,0.010236,172.31.36.0-255,66,220831,1,303626
9868,0.012781,74.125.24.0-255,5738,226569,1,303626
9869,0.012787,172.31.36.0-255,66,226635,1,303626
9870,0.01531,74.125.24.0-255,5738,232373,1,303626
9871,0.015318,172.31.36.0-255,66,232439,1,303626
9872,0.017849,74.125.24.0-255,5738,238177,1,303626
9873,0.017857,172.31.36.0-255,66,238243,1,303626
9874,0.020421,74.125.24.0-255,5738,243981,1,303626
9875,0.020431,172.31.36.0-255,66,244047,1,303626
9876,0.022991,74.125.24.0-255,5738,249785,1,303626
9877,0.023001,172.31.36.0-255,66,249851,1,303626
9878,0.025549,74.125.24.0-255,5738,255589,1,303626
9879,0.025557,172.31.36.0-255,66,255655,1,303626
9880,0.028093,74.125.24.0-255,5738,261393,1,303626
9881,0.0281,172.31.36.0-255,66,261459,1,303626
9882,0.030623,74.125.24.0-255,5738,267197,1,303626
9883,0.03063,172.31.36.0-255,66,267263,1,303626
9884,0.033181,74.125.24.0-255,5738,273001,1,303626
9885,0.033189,172.31.36.0-255,66,273067,1,303626
9886,0.035725,74.125.24.0-255,5738,278805,1,303626
9887,0.035732,172.31.36.0-255,66,278871,1,303626
9888,0.038266,74.125.24.0-255,5738,284609,1,303626
9889,0.038273,172.31.36.0-255,66,284675,1,303626
9890,0.040801,74.125.24.0-255,5738,290413,1,303626
9891,0.040808,172.31.36.0-255,66,290479,1,303626
9892,0.041433,172.31.36.0-255,188,290667,1,303626
9893,0.041465,172.31.36.0-255,958,291625,1,303626
9894,0.041531,172.31.36.0-255,1514,293139,1,303626
9895,0.041533,172.31.36.0-255,1514,294653,1,303626
9896,0.041539,172.31.36.0-255,1514,296167,1,303626
9897,0.04154,172.31.36.0-255,1514,297681,1,303626
9898,0.041558,172.31.36.0-255,1514,299195,1,303626
9899,0.04156,172.31.36.0-255,200,299395,1,303626
9900,0.042977,104.244.42.0-255,66,299461,1,303626
9901,0.042986,104.244.42.0-255,66,299527,1,303626
9902,0.043103,104.244.42.0-255,66,299593,1,303626
9903,0.043109,104.244.42.0-255,66,299659,1,303626
9904,0.043331,74.125.24.0-255,3730,303389,1,303626
9905,0.04334,172.31.36.0-255,66,303455,1,303626
9906,0.043559,172.31.36.0-255,105,303560,1,303626
9907,0.04605,74.125.24.0-255,66,303626,1,303626
9908,0.0,172.31.36.0-255,245,245,1,311
9909,0.005058,172.217.160.0-255,66,311,1,311
9910,0.0,74.125.130.0-255,150,150,1,286441
9911,2.1e-05,172.31.36.0-255,66,216,1,286441
9912,4e-05,74.125.130.0-255,1484,1700,1,286441
9913,4.4e-05,172.31.36.0-255,66,1766,1,286441
9914,7.2e-05,74.125.130.0-255,2902,4668,1,286441
9915,7.5e-05,172.31.36.0-255,66,4734,1,286441
9916,9.4e-05,74.125.130.0-255,4320,9054,1,286441
9917,9.6e-05,172.31.36.0-255,66,9120,1,286441
9918,0.00012,74.125.130.0-255,4911,14031,1,286441
9919,0.000123,172.31.36.0-255,66,14097,1,286441
9920,0.000284,74.125.130.0-255,1484,15581,1,286441
9921,0.000289,172.31.36.0-255,66,15647,1,286441
9922,0.000296,74.125.130.0-255,2902,18549,1,286441
9923,0.0003,172.31.36.0-255,66,18615,1,286441
9924,0.000325,74.125.130.0-255,2902,21517,1,286441
9925,0.00033,172.31.36.0-255,66,21583,1,286441
9926,0.000335,74.125.130.0-255,4320,25903,1,286441
9927,0.000339,172.31.36.0-255,66,25969,1,286441
9928,0.000376,74.125.130.0-255,5379,31348,1,286441
9929,0.000382,172.31.36.0-255,66,31414,1,286441
9930,0.000386,74.125.130.0-255,2902,34316,1,286441
9931,0.000389,172.31.36.0-255,66,34382,1,286441
9932,0.000403,74.125.130.0-255,2902,37284,1,286441
9933,0.000406,172.31.36.0-255,66,37350,1,286441
9934,0.000429,74.125.130.0-255,4320,41670,1,286441
9935,0.000432,172.31.36.0-255,66,41736,1,286441
9936,0.000448,74.125.130.0-255,6797,48533,1,286441
9937,0.00045,172.31.36.0-255,66,48599,1,286441
9938,0.000501,74.125.130.0-255,1484,50083,1,286441
9939,0.000505,172.31.36.0-255,66,50149,1,286441
9940,0.00051,74.125.130.0-255,2902,53051,1,286441
9941,0.000512,172.31.36.0-255,66,53117,1,286441
9942,0.000534,74.125.130.0-255,4320,57437,1,286441
9943,0.000537,172.31.36.0-255,66,57503,1,286441
9944,0.000562,74.125.130.0-255,5738,63241,1,286441
9945,0.000567,172.31.36.0-255,66,63307,1,286441
9946,0.000586,74.125.130.0-255,2794,66101,1,286441
9947,0.000589,172.31.36.0-255,66,66167,1,286441
9948,0.000592,74.125.130.0-255,404,66571,1,286441
9949,0.000781,172.31.36.0-255,66,66637,1,286441
9950,0.000875,74.125.130.0-255,1484,68121,1,286441
9951,0.000883,74.125.130.0-255,2902,71023,1,286441
9952,0.000886,172.31.36.0-255,66,71089,1,286441
9953,0.000907,74.125.130.0-255,4320,75409,1,286441
9954,0.000909,172.31.36.0-255,66,75475,1,286441
9955,0.000932,74.125.130.0-255,1484,76959,1,286441
9956,0.00094,74.125.130.0-255,7156,84115,1,286441
9957,0.000943,172.31.36.0-255,66,84181,1,286441
9958,0.000954,172.31.36.0-255,66,84247,1,286441
9959,0.000987,172.31.36.0-255,66,84313,1,286441
9960,0.001233,74.125.130.0-255,1484,85797,1,286441
9961,0.00124,74.125.130.0-255,2902,88699,1,286441
9962,0.001244,172.31.36.0-255,66,88765,1,286441
9963,0.001281,74.125.130.0-255,5738,94503,1,286441
9964,0.001285,172.31.36.0-255,66,94569,1,286441
9965,0.00129,74.125.130.0-255,2902,97471,1,286441
9966,0.001293,172.31.36.0-255,66,97537,1,286441
9967,0.00131,74.125.130.0-255,4320,101857,1,286441
9968,0.001313,172.31.36.0-255,66,101923,1,286441
9969,0.001362,172.31.36.0-255,66,101989,1,286441
9970,0.001381,74.125.130.0-255,2902,104891,1,286441
9971,0.001385,172.31.36.0-255,66,104957,1,286441
9972,0.001406,74.125.130.0-255,766,105723,1,286441
9973,0.00153,74.125.130.0-255,1484,107207,1,286441
9974,0.001533,172.31.36.0-255,66,107273,1,286441
9975,0.001546,74.125.130.0-255,2902,110175,1,286441
9976,0.001548,172.31.36.0-255,66,110241,1,286441
9977,0.001572,74.125.130.0-255,5738,115979,1,286441
9978,0.001575,172.31.36.0-255,66,116045,1,286441
9979,0.00158,74.125.130.0-255,4320,120365,1,286441
9980,0.001583,172.31.36.0-255,66,120431,1,286441
9981,0.001601,74.125.130.0-255,5738,126169,1,286441
9982,0.001603,172.31.36.0-255,66,126235,1,286441
9983,0.001639,74.125.130.0-255,4320,130555,1,286441
9984,0.001641,172.31.36.0-255,66,130621,1,286441
9985,0.001671,74.125.130.0-255,5738,136359,1,286441
9986,0.001673,172.31.36.0-255,66,136425,1,286441
9987,0.001676,74.125.130.0-255,1484,137909,1,286441
9988,0.00169,74.125.130.0-255,2184,140093,1,286441
9989,0.001692,172.31.36.0-255,66,140159,1,286441
9990,0.00177,74.125.130.0-255,1484,141643,1,286441
9991,0.001783,74.125.130.0-255,2902,144545,1,286441
9992,0.001786,172.31.36.0-255,66,144611,1,286441
9993,0.001801,74.125.130.0-255,5738,150349,1,286441
9994,0.001804,172.31.36.0-255,66,150415,1,286441
9995,0.00183,74.125.130.0-255,2902,153317,1,286441
9996,0.001832,172.31.36.0-255,66,153383,1,286441
9997,0.001858,172.31.36.0-255,66,153449,1,286441
9998,0.001918,172.31.36.0-255,66,153515,1,286441
9999,0.002503,74.125.130.0-255,1484,154999,1,286441
10000,0.002515,74.125.130.0-255,2902,157901,1,286441
10001,0.002518,172.31.36.0-255,66,157967,1,286441
10002,0.002539,74.125.130.0-255,5738,163705,1,286441
10003,0.002542,172.31.36.0-255,66,163771,1,286441
10004,0.002578,74.125.130.0-255,7156,170927,1,286441
10005,0.002581,172.31.36.0-255,66,170993,1,286441
10006,0.002584,74.125.130.0-255,1484,172477,1,286441
10007,0.002587,74.125.130.0-255,1484,173961,1,286441
10008,0.002589,172.31.36.0-255,66,174027,1,286441
10009,0.0026,74.125.130.0-255,1484,175511,1,286441
10010,0.005127,74.125.130.0-255,1484,176995,1,286441
10011,0.005131,172.31.36.0-255,66,177061,1,286441
10012,0.005148,74.125.130.0-255,2902,179963,1,286441
10013,0.005151,172.31.36.0-255,66,180029,1,286441
10014,0.007691,74.125.130.0-255,4320,184349,1,286441
10015,0.007695,172.31.36.0-255,66,184415,1,286441
10016,0.007728,74.125.130.0-255,1484,185899,1,286441
10017,0.010261,74.125.130.0-255,4320,190219,1,286441
10018,0.010269,172.31.36.0-255,66,190285,1,286441
10019,0.012836,74.125.130.0-255,5738,196023,1,286441
10020,0.012842,172.31.36.0-255,66,196089,1,286441
10021,0.015406,74.125.130.0-255,5738,201827,1,286441
10022,0.015429,172.31.36.0-255,66,201893,1,286441
10023,0.017996,74.125.130.0-255,5738,207631,1,286441
10024,0.018003,172.31.36.0-255,66,207697,1,286441
10025,0.020573,74.125.130.0-255,5738,213435,1,286441
10026,0.02058,172.31.36.0-255,66,213501,1,286441
10027,0.023159,74.125.130.0-255,5738,219239,1,286441
10028,0.023169,172.31.36.0-255,66,219305,1,286441
10029,0.025733,74.125.130.0-255,5738,225043,1,286441
10030,0.02574,172.31.36.0-255,66,225109,1,286441
10031,0.028302,74.125.130.0-255,5738,230847,1,286441
10032,0.02831,172.31.36.0-255,66,230913,1,286441
10033,0.030877,74.125.130.0-255,5738,236651,1,286441
10034,0.030886,172.31.36.0-255,66,236717,1,286441
10035,0.033451,74.125.130.0-255,5738,242455,1,286441
10036,0.033459,172.31.36.0-255,66,242521,1,286441
10037,0.034223,172.31.36.0-255,172,242693,1,286441
10038,0.034256,172.31.36.0-255,1115,243808,1,286441
10039,0.034307,172.31.36.0-255,1514,245322,1,286441
10040,0.034309,172.31.36.0-255,1514,246836,1,286441
10041,0.03431,172.31.36.0-255,1514,248350,1,286441
10042,0.034311,172.31.36.0-255,1514,249864,1,286441
10043,0.034337,172.31.36.0-255,1489,251353,1,286441
10044,0.03575,104.244.42.0-255,66,251419,1,286441
10045,0.03583,104.244.42.0-255,66,251485,1,286441
10046,0.035866,104.244.42.0-255,66,251551,1,286441
10047,0.035919,104.244.42.0-255,66,251617,1,286441
10048,0.036019,74.125.130.0-255,5738,257355,1,286441
10049,0.036024,172.31.36.0-255,66,257421,1,286441
10050,0.038591,74.125.130.0-255,5738,263159,1,286441
10051,0.038597,172.31.36.0-255,66,263225,1,286441
10052,0.041159,74.125.130.0-255,5738,268963,1,286441
10053,0.041165,172.31.36.0-255,66,269029,1,286441
10054,0.043733,74.125.130.0-255,5738,274767,1,286441
10055,0.043738,172.31.36.0-255,66,274833,1,286441
10056,0.046297,74.125.130.0-255,5738,280571,1,286441
10057,0.046317,172.31.36.0-255,66,280637,1,286441
10058,0.048876,74.125.130.0-255,5738,286375,1,286441
10059,0.048882,172.31.36.0-255,66,286441,1,286441
10060,0.0,172.217.194.0-255,153,153,1,208734
10061,1.7e-05,172.31.36.0-255,66,219,1,208734
10062,2.4e-05,172.217.194.0-255,1484,1703,1,208734
10063,2.9e-05,172.31.36.0-255,66,1769,1,208734
10064,3.5e-05,172.217.194.0-255,2902,4671,1,208734
10065,3.8e-05,172.31.36.0-255,66,4737,1,208734
10066,4.7e-05,172.217.194.0-255,7156,11893,1,208734
10067,5.1e-05,172.31.36.0-255,66,11959,1,208734
10068,6.6e-05,172.31.36.0-255,66,12025,1,208734
10069,0.000103,172.217.194.0-255,3961,15986,1,208734
10070,0.000106,172.31.36.0-255,66,16052,1,208734
10071,0.000112,172.217.194.0-255,2902,18954,1,208734
10072,0.000114,172.31.36.0-255,66,19020,1,208734
10073,0.000126,172.217.194.0-255,1484,20504,1,208734
10074,0.000129,172.31.36.0-255,66,20570,1,208734
10075,0.000142,172.31.36.0-255,66,20636,1,208734
10076,0.000147,172.217.194.0-255,3961,24597,1,208734
10077,0.000149,172.31.36.0-255,66,24663,1,208734
10078,0.000168,172.217.194.0-255,2902,27565,1,208734
10079,0.00017,172.31.36.0-255,66,27631,1,208734
10080,0.000197,172.31.36.0-255,66,27697,1,208734
10081,0.000607,172.217.194.0-255,366,28063,1,208734
10082,0.000613,172.31.36.0-255,66,28129,1,208734
10083,0.000896,172.217.194.0-255,1484,29613,1,208734
10084,0.0009,172.31.36.0-255,66,29679,1,208734
10085,0.000907,172.217.194.0-255,2902,32581,1,208734
10086,0.000909,172.31.36.0-255,66,32647,1,208734
10087,0.000914,172.217.194.0-255,4320,36967,1,208734
10088,0.000917,172.31.36.0-255,66,37033,1,208734
10089,0.00092,172.217.194.0-255,1484,38517,1,208734
10090,0.000949,172.217.194.0-255,7156,45673,1,208734
10091,0.000952,172.31.36.0-255,66,45739,1,208734
10092,0.000976,172.217.194.0-255,5738,51477,1,208734
10093,0.000979,172.31.36.0-255,66,51543,1,208734
10094,0.000996,172.217.194.0-255,7156,58699,1,208734
10095,0.000999,172.31.36.0-255,66,58765,1,208734
10096,0.001025,172.217.194.0-255,3602,62367,1,208734
10097,0.001028,172.31.36.0-255,66,62433,1,208734
10098,0.0013,172.217.194.0-255,1484,63917,1,208734
10099,0.001307,172.217.194.0-255,2902,66819,1,208734
10100,0.00131,172.31.36.0-255,66,66885,1,208734
10101,0.001317,172.217.194.0-255,4320,71205,1,208734
10102,0.001319,172.31.36.0-255,66,71271,1,208734
10103,0.001345,172.217.194.0-255,1484,72755,1,208734
10104,0.001359,172.31.36.0-255,66,72821,1,208734
10105,0.001381,172.217.194.0-255,7156,79977,1,208734
10106,0.001384,172.31.36.0-255,66,80043,1,208734
10107,0.001411,172.217.194.0-255,3602,83645,1,208734
10108,0.001425,172.217.194.0-255,4320,87965,1,208734
10109,0.001429,172.31.36.0-255,66,88031,1,208734
10110,0.001432,172.31.36.0-255,66,88097,1,208734
10111,0.001439,172.31.36.0-255,66,88163,1,208734
10112,0.001447,172.217.194.0-255,5738,93901,1,208734
10113,0.001449,172.31.36.0-255,66,93967,1,208734
10114,0.001487,172.31.36.0-255,66,94033,1,208734
10115,0.001509,172.217.194.0-255,2184,96217,1,208734
10116,0.001513,172.31.36.0-255,66,96283,1,208734
10117,0.001527,172.31.36.0-255,66,96349,1,208734
10118,0.001539,172.31.36.0-255,66,96415,1,208734
10119,0.001567,172.31.36.0-255,66,96481,1,208734
10120,0.00159,172.217.194.0-255,1484,97965,1,208734
10121,0.001596,172.217.194.0-255,2902,100867,1,208734
10122,0.001598,172.31.36.0-255,66,100933,1,208734
10123,0.001618,172.217.194.0-255,5738,106671,1,208734
10124,0.001621,172.31.36.0-255,66,106737,1,208734
10125,0.001659,172.217.194.0-255,4320,111057,1,208734
10126,0.001661,172.31.36.0-255,66,111123,1,208734
10127,0.001681,172.217.194.0-255,1484,112607,1,208734
10128,0.001696,172.31.36.0-255,66,112673,1,208734
10129,0.001702,172.217.194.0-255,5020,117693,1,208734
10130,0.001704,172.31.36.0-255,66,117759,1,208734
10131,0.00171,172.217.194.0-255,5738,123497,1,208734
10132,0.001712,172.31.36.0-255,66,123563,1,208734
10133,0.001718,172.217.194.0-255,4320,127883,1,208734
10134,0.001721,172.31.36.0-255,66,127949,1,208734
10135,0.001746,172.31.36.0-255,66,128015,1,208734
10136,0.001753,172.217.194.0-255,5738,133753,1,208734
10137,0.001755,172.31.36.0-255,66,133819,1,208734
10138,0.001775,172.217.194.0-255,4320,138139,1,208734
10139,0.001777,172.31.36.0-255,66,138205,1,208734
10140,0.001783,172.217.194.0-255,4320,142525,1,208734
10141,0.001785,172.31.36.0-255,66,142591,1,208734
10142,0.00182,172.31.36.0-255,66,142657,1,208734
10143,0.001832,172.31.36.0-255,66,142723,1,208734
10144,0.001854,172.217.194.0-255,2184,144907,1,208734
10145,0.001856,172.31.36.0-255,66,144973,1,208734
10146,0.001859,172.217.194.0-255,1484,146457,1,208734
10147,0.001864,172.217.194.0-255,2902,149359,1,208734
10148,0.001866,172.31.36.0-255,66,149425,1,208734
10149,0.001871,172.217.194.0-255,2902,152327,1,208734
10150,0.001873,172.31.36.0-255,66,152393,1,208734
10151,0.00192,172.217.194.0-255,2902,155295,1,208734
10152,0.001924,172.31.36.0-255,66,155361,1,208734
10153,0.001936,172.31.36.0-255,66,155427,1,208734
10154,0.001965,172.31.36.0-255,66,155493,1,208734
10155,0.001984,172.217.194.0-255,3602,159095,1,208734
10156,0.001987,172.31.36.0-255,66,159161,1,208734
10157,0.001999,172.217.194.0-255,1484,160645,1,208734
10158,0.002002,172.217.194.0-255,1484,162129,1,208734
10159,0.002004,172.31.36.0-255,66,162195,1,208734
10160,0.002027,172.217.194.0-255,1484,163679,1,208734
10161,0.002033,172.217.194.0-255,5738,169417,1,208734
10162,0.002036,172.31.36.0-255,66,169483,1,208734
10163,0.002064,172.217.194.0-255,7156,176639,1,208734
10164,0.002067,172.31.36.0-255,66,176705,1,208734
10165,0.002077,172.31.36.0-255,66,176771,1,208734
10166,0.002109,172.31.36.0-255,66,176837,1,208734
10167,0.002128,172.217.194.0-255,5738,182575,1,208734
10168,0.002143,172.217.194.0-255,4320,186895,1,208734
10169,0.002158,172.217.194.0-255,2902,189797,1,208734
10170,0.002172,172.217.194.0-255,5738,195535,1,208734
10171,0.002189,172.217.194.0-255,7156,202691,1,208734
10172,0.002257,172.217.194.0-255,3528,206219,1,208734
10173,0.00226,172.217.194.0-255,97,206316,1,208734
10174,0.002263,172.217.194.0-255,105,206421,1,208734
10175,0.007273,172.31.36.0-255,66,206487,1,208734
10176,0.009673,172.31.36.0-255,105,206592,1,208734
10177,0.011995,172.217.194.0-255,66,206658,1,208734
10178,0.039881,172.31.36.0-255,199,206857,1,208734
10179,0.039917,172.31.36.0-255,1114,207971,1,208734
10180,0.03997,172.31.36.0-255,565,208536,1,208734
10181,0.041377,104.244.42.0-255,66,208602,1,208734
10182,0.041428,104.244.42.0-255,66,208668,1,208734
10183,0.041432,104.244.42.0-255,66,208734,1,208734
10184,0.0,74.125.24.0-255,298,298,1,233216
10185,3.5e-05,172.31.36.0-255,66,364,1,233216
10186,4.2e-05,74.125.24.0-255,1484,1848,1,233216
10187,4.7e-05,172.31.36.0-255,66,1914,1,233216
10188,6.3e-05,74.125.24.0-255,4320,6234,1,233216
10189,6.7e-05,172.31.36.0-255,66,6300,1,233216
10190,7.4e-05,74.125.24.0-255,5738,12038,1,233216
10191,7.7e-05,172.31.36.0-255,66,12104,1,233216
10192,0.000107,74.125.24.0-255,1894,13998,1,233216
10193,0.00011,172.31.36.0-255,66,14064,1,233216
10194,0.000135,74.125.24.0-255,1484,15548,1,233216
10195,0.000137,172.31.36.0-255,66,15614,1,233216
10196,0.000142,74.125.24.0-255,2902,18516,1,233216
10197,0.000145,172.31.36.0-255,66,18582,1,233216
10198,0.000173,74.125.24.0-255,1484,20066,1,233216
10199,0.000175,172.31.36.0-255,66,20132,1,233216
10200,0.000183,74.125.24.0-255,5738,25870,1,233216
10201,0.000185,172.31.36.0-255,66,25936,1,233216
10202,0.00023,74.125.24.0-255,5379,31315,1,233216
10203,0.000234,172.31.36.0-255,66,31381,1,233216
10204,0.000293,74.125.24.0-255,1484,32865,1,233216
10205,0.000298,172.31.36.0-255,66,32931,1,233216
10206,0.000302,74.125.24.0-255,2902,35833,1,233216
10207,0.000304,172.31.36.0-255,66,35899,1,233216
10208,0.000307,74.125.24.0-255,1484,37383,1,233216
10209,0.000309,172.31.36.0-255,66,37449,1,233216
10210,0.000328,74.125.24.0-255,4320,41769,1,233216
10211,0.000335,172.31.36.0-255,66,41835,1,233216
10212,0.000373,172.31.36.0-255,66,41901,1,233216
10213,0.000385,172.31.36.0-255,66,41967,1,233216
10214,0.000412,74.125.24.0-255,1401,43368,1,233216
10215,0.000575,74.125.24.0-255,129,43497,1,233216
10216,0.000682,74.125.24.0-255,1484,44981,1,233216
10217,0.000687,172.31.36.0-255,66,45047,1,233216
10218,0.000692,74.125.24.0-255,2902,47949,1,233216
10219,0.000695,172.31.36.0-255,66,48015,1,233216
10220,0.000728,74.125.24.0-255,1484,49499,1,233216
10221,0.000755,74.125.24.0-255,4320,53819,1,233216
10222,0.000759,172.31.36.0-255,66,53885,1,233216
10223,0.000766,74.125.24.0-255,6797,60682,1,233216
10224,0.000769,172.31.36.0-255,66,60748,1,233216
10225,0.000775,74.125.24.0-255,7156,67904,1,233216
10226,0.000777,172.31.36.0-255,66,67970,1,233216
10227,0.000789,172.31.36.0-255,66,68036,1,233216
10228,0.00082,74.125.24.0-255,347,68383,1,233216
10229,0.001093,172.31.36.0-255,66,68449,1,233216
10230,0.001312,74.125.24.0-255,1484,69933,1,233216
10231,0.001321,74.125.24.0-255,2902,72835,1,233216
10232,0.001325,172.31.36.0-255,66,72901,1,233216
10233,0.001358,74.125.24.0-255,5738,78639,1,233216
10234,0.001362,172.31.36.0-255,66,78705,1,233216
10235,0.00137,74.125.24.0-255,7156,85861,1,233216
10236,0.001372,172.31.36.0-255,66,85927,1,233216
10237,0.001415,74.125.24.0-255,5738,91665,1,233216
10238,0.001419,172.31.36.0-255,66,91731,1,233216
10239,0.001432,172.31.36.0-255,66,91797,1,233216
10240,0.002132,74.125.24.0-255,1484,93281,1,233216
10241,0.00216,74.125.24.0-255,1484,94765,1,233216
10242,0.002164,172.31.36.0-255,66,94831,1,233216
10243,0.00217,74.125.24.0-255,2902,97733,1,233216
10244,0.002172,172.31.36.0-255,66,97799,1,233216
10245,0.002199,74.125.24.0-255,5738,103537,1,233216
10246,0.002201,172.31.36.0-255,66,103603,1,233216
10247,0.002206,74.125.24.0-255,4320,107923,1,233216
10248,0.002208,172.31.36.0-255,66,107989,1,233216
10249,0.002249,172.31.36.0-255,66,108055,1,233216
10250,0.002255,74.125.24.0-255,4320,112375,1,233216
10251,0.002257,172.31.36.0-255,66,112441,1,233216
10252,0.002275,74.125.24.0-255,2184,114625,1,233216
10253,0.002281,172.31.36.0-255,66,114691,1,233216
10254,0.004513,74.125.24.0-255,2902,117593,1,233216
10255,0.004519,172.31.36.0-255,66,117659,1,233216
10256,0.004545,74.125.24.0-255,2902,120561,1,233216
10257,0.004547,172.31.36.0-255,66,120627,1,233216
10258,0.006782,74.125.24.0-255,2902,123529,1,233216
10259,0.006787,172.31.36.0-255,66,123595,1,233216
10260,0.006821,74.125.24.0-255,2902,126497,1,233216
10261,0.006825,172.31.36.0-255,66,126563,1,233216
10262,0.009075,74.125.24.0-255,2902,129465,1,233216
10263,0.009081,172.31.36.0-255,66,129531,1,233216
10264,0.009115,74.125.24.0-255,2902,132433,1,233216
10265,0.009118,172.31.36.0-255,66,132499,1,233216
10266,0.011367,74.125.24.0-255,5738,138237,1,233216
10267,0.011375,172.31.36.0-255,66,138303,1,233216
10268,0.013675,74.125.24.0-255,5738,144041,1,233216
10269,0.013683,172.31.36.0-255,66,144107,1,233216
10270,0.015948,74.125.24.0-255,5738,149845,1,233216
10271,0.015962,172.31.36.0-255,66,149911,1,233216
10272,0.018301,74.125.24.0-255,5738,155649,1,233216
10273,0.018311,172.31.36.0-255,66,155715,1,233216
10274,0.020593,74.125.24.0-255,5738,161453,1,233216
10275,0.020602,172.31.36.0-255,66,161519,1,233216
10276,0.022863,74.125.24.0-255,5738,167257,1,233216
10277,0.02287,172.31.36.0-255,66,167323,1,233216
10278,0.025149,74.125.24.0-255,5738,173061,1,233216
10279,0.025157,172.31.36.0-255,66,173127,1,233216
10280,0.027445,74.125.24.0-255,5738,178865,1,233216
10281,0.027452,172.31.36.0-255,66,178931,1,233216
10282,0.029728,74.125.24.0-255,5738,184669,1,233216
10283,0.029735,172.31.36.0-255,66,184735,1,233216
10284,0.032017,74.125.24.0-255,5738,190473,1,233216
10285,0.032026,172.31.36.0-255,66,190539,1,233216
10286,0.034171,172.31.36.0-255,172,190711,1,233216
10287,0.034201,172.31.36.0-255,1115,191826,1,233216
10288,0.034238,172.31.36.0-255,564,192390,1,233216
10289,0.034309,74.125.24.0-255,5738,198128,1,233216
10290,0.034337,172.31.36.0-255,66,198194,1,233216
10291,0.03572,104.244.42.0-255,66,198260,1,233216
10292,0.035765,104.244.42.0-255,66,198326,1,233216
10293,0.035814,104.244.42.0-255,66,198392,1,233216
10294,0.036656,74.125.24.0-255,5738,204130,1,233216
10295,0.036668,172.31.36.0-255,66,204196,1,233216
10296,0.038962,74.125.24.0-255,5738,209934,1,233216
10297,0.038976,172.31.36.0-255,66,210000,1,233216
10298,0.041269,74.125.24.0-255,5738,215738,1,233216
10299,0.041288,172.31.36.0-255,66,215804,1,233216
10300,0.043597,74.125.24.0-255,5738,221542,1,233216
10301,0.043617,172.31.36.0-255,66,221608,1,233216
10302,0.045891,74.125.24.0-255,5738,227346,1,233216
10303,0.045903,172.31.36.0-255,66,227412,1,233216
10304,0.048184,74.125.24.0-255,5738,233150,1,233216
10305,0.048197,172.31.36.0-255,66,233216,1,233216
10306,0.0,74.125.24.0-255,153,153,1,240679
10307,3e-05,172.31.36.0-255,66,219,1,240679
10308,3.7e-05,74.125.24.0-255,1484,1703,1,240679
10309,4.1e-05,172.31.36.0-255,66,1769,1,240679
10310,5.5e-05,74.125.24.0-255,2902,4671,1,240679
10311,5.8e-05,172.31.36.0-255,66,4737,1,240679
10312,6.6e-05,74.125.24.0-255,7156,11893,1,240679
10313,6.9e-05,172.31.36.0-255,66,11959,1,240679
10314,7.2e-05,74.125.24.0-255,2018,13977,1,240679
10315,7.6e-05,172.31.36.0-255,66,14043,1,240679
10316,0.000113,74.125.24.0-255,2902,16945,1,240679
10317,0.000116,172.31.36.0-255,66,17011,1,240679
10318,0.000121,74.125.24.0-255,4320,21331,1,240679
10319,0.000123,172.31.36.0-255,66,21397,1,240679
10320,0.000162,172.31.36.0-255,66,21463,1,240679
10321,0.000165,74.125.24.0-255,1125,22588,1,240679
10322,0.000168,172.31.36.0-255,66,22654,1,240679
10323,0.000383,74.125.24.0-255,1484,24138,1,240679
10324,0.000388,172.31.36.0-255,66,24204,1,240679
10325,0.000392,74.125.24.0-255,1484,25688,1,240679
10326,0.000394,172.31.36.0-255,66,25754,1,240679
10327,0.00042,74.125.24.0-255,1484,27238,1,240679
10328,0.000424,172.31.36.0-255,66,27304,1,240679
10329,0.000431,74.125.24.0-255,5738,33042,1,240679
10330,0.000433,172.31.36.0-255,66,33108,1,240679
10331,0.00044,74.125.24.0-255,6797,39905,1,240679
10332,0.000442,172.31.36.0-255,66,39971,1,240679
10333,0.000445,74.125.24.0-255,1484,41455,1,240679
10334,0.000447,172.31.36.0-255,66,41521,1,240679
10335,0.0005,172.31.36.0-255,66,41587,1,240679
10336,0.000504,74.125.24.0-255,2543,44130,1,240679
10337,0.000507,172.31.36.0-255,66,44196,1,240679
10338,0.000775,74.125.24.0-255,646,44842,1,240679
10339,0.000808,172.31.36.0-255,66,44908,1,240679
10340,0.000938,74.125.24.0-255,1484,46392,1,240679
10341,0.000946,74.125.24.0-255,1484,47876,1,240679
10342,0.00095,172.31.36.0-255,66,47942,1,240679
10343,0.000982,74.125.24.0-255,1484,49426,1,240679
10344,0.00099,74.125.24.0-255,5738,55164,1,240679
10345,0.000993,172.31.36.0-255,66,55230,1,240679
10346,0.000999,74.125.24.0-255,5738,60968,1,240679
10347,0.001002,172.31.36.0-255,66,61034,1,240679
10348,0.001008,74.125.24.0-255,5738,66772,1,240679
10349,0.001018,172.31.36.0-255,66,66838,1,240679
10350,0.001047,74.125.24.0-255,7156,73994,1,240679
10351,0.001056,172.31.36.0-255,66,74060,1,240679
10352,0.001062,74.125.24.0-255,5020,79080,1,240679
10353,0.001066,172.31.36.0-255,66,79146,1,240679
10354,0.001362,74.125.24.0-255,1484,80630,1,240679
10355,0.00137,74.125.24.0-255,2902,83532,1,240679
10356,0.001375,172.31.36.0-255,66,83598,1,240679
10357,0.001382,74.125.24.0-255,5738,89336,1,240679
10358,0.001385,172.31.36.0-255,66,89402,1,240679
10359,0.001388,74.125.24.0-255,1484,90886,1,240679
10360,0.001457,172.31.36.0-255,66,90952,1,240679
10361,0.001491,172.31.36.0-255,66,91018,1,240679
10362,0.00207,74.125.24.0-255,1484,92502,1,240679
10363,0.002077,74.125.24.0-255,2902,95404,1,240679
10364,0.002081,172.31.36.0-255,66,95470,1,240679
10365,0.002114,74.125.24.0-255,5738,101208,1,240679
10366,0.002117,172.31.36.0-255,66,101274,1,240679
10367,0.002124,74.125.24.0-255,7156,108430,1,240679
10368,0.002127,172.31.36.0-255,66,108496,1,240679
10369,0.002155,74.125.24.0-255,5738,114234,1,240679
10370,0.002158,172.31.36.0-255,66,114300,1,240679
10371,0.002168,172.31.36.0-255,66,114366,1,240679
10372,0.002196,74.125.24.0-255,2184,116550,1,240679
10373,0.002198,172.31.36.0-255,66,116616,1,240679
10374,0.004447,74.125.24.0-255,5738,122354,1,240679
10375,0.004451,172.31.36.0-255,66,122420,1,240679
10376,0.00674,74.125.24.0-255,5738,128158,1,240679
10377,0.006746,172.31.36.0-255,66,128224,1,240679
10378,0.009025,74.125.24.0-255,5738,133962,1,240679
10379,0.009031,172.31.36.0-255,66,134028,1,240679
10380,0.011297,74.125.24.0-255,5738,139766,1,240679
10381,0.011305,172.31.36.0-255,66,139832,1,240679
10382,0.013621,74.125.24.0-255,5738,145570,1,240679
10383,0.01363,172.31.36.0-255,66,145636,1,240679
10384,0.015926,74.125.24.0-255,5738,151374,1,240679
10385,0.015935,172.31.36.0-255,66,151440,1,240679
10386,0.018214,74.125.24.0-255,5738,157178,1,240679
10387,0.018222,172.31.36.0-255,66,157244,1,240679
10388,0.020577,74.125.24.0-255,5738,162982,1,240679
10389,0.020584,172.31.36.0-255,66,163048,1,240679
10390,0.022851,74.125.24.0-255,5738,168786,1,240679
10391,0.022858,172.31.36.0-255,66,168852,1,240679
10392,0.025195,74.125.24.0-255,5738,174590,1,240679
10393,0.025202,172.31.36.0-255,66,174656,1,240679
10394,0.027473,74.125.24.0-255,5738,180394,1,240679
10395,0.02748,172.31.36.0-255,66,180460,1,240679
10396,0.029817,74.125.24.0-255,5738,186198,1,240679
10397,0.029824,172.31.36.0-255,66,186264,1,240679
10398,0.032117,74.125.24.0-255,1484,187748,1,240679
10399,0.032152,74.125.24.0-255,4320,192068,1,240679
10400,0.032158,172.31.36.0-255,66,192134,1,240679
10401,0.032812,172.31.36.0-255,172,192306,1,240679
10402,0.032841,172.31.36.0-255,1115,193421,1,240679
10403,0.032879,172.31.36.0-255,1514,194935,1,240679
10404,0.03288,172.31.36.0-255,1514,196449,1,240679
10405,0.032882,172.31.36.0-255,1514,197963,1,240679
10406,0.032883,172.31.36.0-255,1514,199477,1,240679
10407,0.032888,172.31.36.0-255,1488,200965,1,240679
10408,0.03433,104.244.42.0-255,66,201031,1,240679
10409,0.034377,104.244.42.0-255,66,201097,1,240679
10410,0.034457,74.125.24.0-255,5738,206835,1,240679
10411,0.034462,172.31.36.0-255,66,206901,1,240679
10412,0.034501,104.244.42.0-255,66,206967,1,240679
10413,0.035073,104.244.42.0-255,108,207075,1,240679
10414,0.035079,172.31.36.0-255,66,207141,1,240679
10415,0.036752,74.125.24.0-255,4320,211461,1,240679
10416,0.036757,172.31.36.0-255,66,211527,1,240679
10417,0.036791,74.125.24.0-255,1484,213011,1,240679
10418,0.039009,74.125.24.0-255,4320,217331,1,240679
10419,0.039014,172.31.36.0-255,66,217397,1,240679
10420,0.041271,74.125.24.0-255,5738,223135,1,240679
10421,0.041276,172.31.36.0-255,66,223201,1,240679
10422,0.04357,74.125.24.0-255,5738,228939,1,240679
10423,0.043576,172.31.36.0-255,66,229005,1,240679
10424,0.045866,74.125.24.0-255,5738,234743,1,240679
10425,0.045872,172.31.36.0-255,66,234809,1,240679
10426,0.048164,74.125.24.0-255,4320,239129,1,240679
10427,0.048169,172.31.36.0-255,66,239195,1,240679
10428,0.0482,74.125.24.0-255,1484,240679,1,240679
10429,0.0,172.217.194.0-255,152,152,1,176498
10430,1.7e-05,172.31.36.0-255,66,218,1,176498
10431,2.4e-05,172.217.194.0-255,1484,1702,1,176498
10432,2.9e-05,172.31.36.0-255,66,1768,1,176498
10433,3.5e-05,172.217.194.0-255,2902,4670,1,176498
10434,3.7e-05,172.31.36.0-255,66,4736,1,176498
10435,5.3e-05,172.217.194.0-255,7156,11892,1,176498
10436,5.7e-05,172.31.36.0-255,66,11958,1,176498
10437,6.1e-05,172.217.194.0-255,2064,14022,1,176498
10438,6.3e-05,172.31.36.0-255,66,14088,1,176498
10439,7.8e-05,172.31.36.0-255,66,14154,1,176498
10440,8.2e-05,172.217.194.0-255,2902,17056,1,176498
10441,8.4e-05,172.31.36.0-255,66,17122,1,176498
10442,0.000105,172.217.194.0-255,2543,19665,1,176498
10443,0.000108,172.31.36.0-255,66,19731,1,176498
10444,0.000155,172.217.194.0-255,1484,21215,1,176498
10445,0.000157,172.31.36.0-255,66,21281,1,176498
10446,0.000162,172.217.194.0-255,2902,24183,1,176498
10447,0.000165,172.31.36.0-255,66,24249,1,176498
10448,0.00019,172.217.194.0-255,5738,29987,1,176498
10449,0.000193,172.31.36.0-255,66,30053,1,176498
10450,0.000204,172.217.194.0-255,4320,34373,1,176498
10451,0.000206,172.31.36.0-255,66,34439,1,176498
10452,0.000247,172.31.36.0-255,66,34505,1,176498
10453,0.000264,172.31.36.0-255,66,34571,1,176498
10454,0.000286,172.217.194.0-255,378,34949,1,176498
10455,0.000288,172.31.36.0-255,66,35015,1,176498
10456,0.000291,172.217.194.0-255,98,35113,1,176498
10457,0.000294,172.31.36.0-255,66,35179,1,176498
10458,0.000329,172.217.194.0-255,363,35542,1,176498
10459,0.000425,172.217.194.0-255,1484,37026,1,176498
10460,0.000429,172.31.36.0-255,66,37092,1,176498
10461,0.000451,172.217.194.0-255,2902,39994,1,176498
10462,0.000454,172.31.36.0-255,66,40060,1,176498
10463,0.000461,172.217.194.0-255,5738,45798,1,176498
10464,0.000463,172.31.36.0-255,66,45864,1,176498
10465,0.000493,172.217.194.0-255,6797,52661,1,176498
10466,0.0005,172.31.36.0-255,66,52727,1,176498
10467,0.000506,172.217.194.0-255,4320,57047,1,176498
10468,0.000508,172.31.36.0-255,66,57113,1,176498
10469,0.00053,172.217.194.0-255,2902,60015,1,176498
10470,0.000533,172.31.36.0-255,66,60081,1,176498
10471,0.00054,172.217.194.0-255,1484,61565,1,176498
10472,0.000573,172.31.36.0-255,66,61631,1,176498
10473,0.001673,172.217.194.0-255,1484,63115,1,176498
10474,0.001681,172.217.194.0-255,2902,66017,1,176498
10475,0.001686,172.31.36.0-255,66,66083,1,176498
10476,0.001695,172.217.194.0-255,5738,71821,1,176498
10477,0.001697,172.31.36.0-255,66,71887,1,176498
10478,0.001754,172.217.194.0-255,4320,76207,1,176498
10479,0.001756,172.31.36.0-255,66,76273,1,176498
10480,0.001784,172.217.194.0-255,7156,83429,1,176498
10481,0.001787,172.31.36.0-255,66,83495,1,176498
10482,0.001794,172.217.194.0-255,5738,89233,1,176498
10483,0.001796,172.31.36.0-255,66,89299,1,176498
10484,0.00183,172.217.194.0-255,6438,95737,1,176498
10485,0.001832,172.31.36.0-255,66,95803,1,176498
10486,0.001995,172.217.194.0-255,1484,97287,1,176498
10487,0.002003,172.217.194.0-255,2902,100189,1,176498
10488,0.002007,172.31.36.0-255,66,100255,1,176498
10489,0.002046,172.217.194.0-255,2902,103157,1,176498
10490,0.002049,172.31.36.0-255,66,103223,1,176498
10491,0.002054,172.217.194.0-255,4320,107543,1,176498
10492,0.002056,172.31.36.0-255,66,107609,1,176498
10493,0.002061,172.217.194.0-255,2902,110511,1,176498
10494,0.002068,172.31.36.0-255,66,110577,1,176498
10495,0.002104,172.31.36.0-255,66,110643,1,176498
10496,0.002158,172.217.194.0-255,4320,114963,1,176498
10497,0.002161,172.31.36.0-255,66,115029,1,176498
10498,0.002192,172.217.194.0-255,6438,121467,1,176498
10499,0.002195,172.31.36.0-255,66,121533,1,176498
10500,0.002211,172.31.36.0-255,66,121599,1,176498
10501,0.002226,172.31.36.0-255,66,121665,1,176498
10502,0.002237,172.31.36.0-255,66,121731,1,176498
10503,0.002284,172.217.194.0-255,1484,123215,1,176498
10504,0.002296,172.217.194.0-255,2902,126117,1,176498
10505,0.002299,172.31.36.0-255,66,126183,1,176498
10506,0.002329,172.217.194.0-255,5738,131921,1,176498
10507,0.002332,172.31.36.0-255,66,131987,1,176498
10508,0.002344,172.31.36.0-255,66,132053,1,176498
10509,0.002347,172.217.194.0-255,1484,133537,1,176498
10510,0.002389,172.31.36.0-255,66,133603,1,176498
10511,0.002426,172.217.194.0-255,1484,135087,1,176498
10512,0.002431,172.217.194.0-255,2902,137989,1,176498
10513,0.002434,172.31.36.0-255,66,138055,1,176498
10514,0.002455,172.217.194.0-255,5738,143793,1,176498
10515,0.002458,172.31.36.0-255,66,143859,1,176498
10516,0.002464,172.217.194.0-255,4320,148179,1,176498
10517,0.002466,172.31.36.0-255,66,148245,1,176498
10518,0.002503,172.31.36.0-255,66,148311,1,176498
10519,0.002515,172.31.36.0-255,66,148377,1,176498
10520,0.002556,172.31.36.0-255,66,148443,1,176498
10521,0.0026,172.31.36.0-255,66,148509,1,176498
10522,0.002612,172.31.36.0-255,66,148575,1,176498
10523,0.002644,172.31.36.0-255,66,148641,1,176498
10524,0.002647,172.217.194.0-255,1484,150125,1,176498
10525,0.002725,172.31.36.0-255,66,150191,1,176498
10526,0.002761,172.31.36.0-255,66,150257,1,176498
10527,0.00279,172.31.36.0-255,66,150323,1,176498
10528,0.002793,172.217.194.0-255,1484,151807,1,176498
10529,0.002814,172.217.194.0-255,2184,153991,1,176498
10530,0.002824,172.31.36.0-255,66,154057,1,176498
10531,0.005464,172.217.194.0-255,2902,156959,1,176498
10532,0.005469,172.31.36.0-255,66,157025,1,176498
10533,0.005498,172.217.194.0-255,2902,159927,1,176498
10534,0.005502,172.31.36.0-255,66,159993,1,176498
10535,0.008107,172.217.194.0-255,2902,162895,1,176498
10536,0.008114,172.31.36.0-255,66,162961,1,176498
10537,0.008166,172.217.194.0-255,2902,165863,1,176498
10538,0.00817,172.31.36.0-255,66,165929,1,176498
10539,0.010755,172.217.194.0-255,1128,167057,1,176498
10540,0.010875,172.31.36.0-255,66,167123,1,176498
10541,0.010913,172.31.36.0-255,105,167228,1,176498
10542,0.013553,172.217.194.0-255,66,167294,1,176498
10543,0.038699,172.31.36.0-255,172,167466,1,176498
10544,0.038733,172.31.36.0-255,1114,168580,1,176498
10545,0.038804,172.31.36.0-255,1514,170094,1,176498
10546,0.038806,172.31.36.0-255,1514,171608,1,176498
10547,0.038807,172.31.36.0-255,1514,173122,1,176498
10548,0.038808,172.31.36.0-255,1514,174636,1,176498
10549,0.038842,172.31.36.0-255,1490,176126,1,176498
10550,0.040238,104.244.42.0-255,66,176192,1,176498
10551,0.040274,104.244.42.0-255,66,176258,1,176498
10552,0.040391,104.244.42.0-255,66,176324,1,176498
10553,0.040931,104.244.42.0-255,108,176432,1,176498
10554,0.04094,172.31.36.0-255,66,176498,1,176498
10555,0.0,172.217.194.0-255,147,147,1,200370
10556,2.3e-05,172.31.36.0-255,66,213,1,200370
10557,3e-05,172.217.194.0-255,1484,1697,1,200370
10558,3.4e-05,172.31.36.0-255,66,1763,1,200370
10559,4.1e-05,172.217.194.0-255,2902,4665,1,200370
10560,5.2e-05,172.31.36.0-255,66,4731,1,200370
10561,5.7e-05,172.217.194.0-255,2902,7633,1,200370
10562,6.1e-05,172.31.36.0-255,66,7699,1,200370
10563,6.7e-05,172.217.194.0-255,4320,12019,1,200370
10564,7e-05,172.31.36.0-255,66,12085,1,200370
10565,0.00011,172.217.194.0-255,1970,14055,1,200370
10566,0.000113,172.31.36.0-255,66,14121,1,200370
10567,0.000497,172.217.194.0-255,1484,15605,1,200370
10568,0.000503,172.31.36.0-255,66,15671,1,200370
10569,0.00051,172.217.194.0-255,2902,18573,1,200370
10570,0.000512,172.31.36.0-255,66,18639,1,200370
10571,0.000525,172.217.194.0-255,5738,24377,1,200370
10572,0.000527,172.31.36.0-255,66,24443,1,200370
10573,0.000566,172.217.194.0-255,6797,31240,1,200370
10574,0.000569,172.31.36.0-255,66,31306,1,200370
10575,0.001157,172.217.194.0-255,1484,32790,1,200370
10576,0.001164,172.31.36.0-255,66,32856,1,200370
10577,0.001174,172.217.194.0-255,2902,35758,1,200370
10578,0.001177,172.31.36.0-255,66,35824,1,200370
10579,0.001191,172.217.194.0-255,5738,41562,1,200370
10580,0.001193,172.31.36.0-255,66,41628,1,200370
10581,0.001222,172.217.194.0-255,6797,48425,1,200370
10582,0.001229,172.31.36.0-255,66,48491,1,200370
10583,0.001759,172.217.194.0-255,1484,49975,1,200370
10584,0.001767,172.31.36.0-255,66,50041,1,200370
10585,0.001773,172.217.194.0-255,2902,52943,1,200370
10586,0.001776,172.31.36.0-255,66,53009,1,200370
10587,0.001788,172.217.194.0-255,5738,58747,1,200370
10588,0.00179,172.31.36.0-255,66,58813,1,200370
10589,0.001823,172.217.194.0-255,6797,65610,1,200370
10590,0.001826,172.31.36.0-255,66,65676,1,200370
10591,0.001853,172.217.194.0-255,5738,71414,1,200370
10592,0.001856,172.31.36.0-255,66,71480,1,200370
10593,0.001878,172.217.194.0-255,1484,72964,1,200370
10594,0.001893,172.31.36.0-255,66,73030,1,200370
10595,0.001932,172.217.194.0-255,4320,77350,1,200370
10596,0.001935,172.31.36.0-255,66,77416,1,200370
10597,0.00196,172.31.36.0-255,66,77482,1,200370
10598,0.001986,172.217.194.0-255,3124,80606,1,200370
10599,0.001988,172.31.36.0-255,66,80672,1,200370
10600,0.004307,172.217.194.0-255,1484,82156,1,200370
10601,0.004389,172.217.194.0-255,4320,86476,1,200370
10602,0.004392,172.31.36.0-255,66,86542,1,200370
10603,0.006843,172.217.194.0-255,5738,92280,1,200370
10604,0.006852,172.31.36.0-255,66,92346,1,200370
10605,0.009244,172.217.194.0-255,5738,98084,1,200370
10606,0.009254,172.31.36.0-255,66,98150,1,200370
10607,0.011628,172.217.194.0-255,5738,103888,1,200370
10608,0.011636,172.31.36.0-255,66,103954,1,200370
10609,0.014081,172.217.194.0-255,5738,109692,1,200370
10610,0.01409,172.31.36.0-255,66,109758,1,200370
10611,0.016456,172.217.194.0-255,5738,115496,1,200370
10612,0.016466,172.31.36.0-255,66,115562,1,200370
10613,0.018901,172.217.194.0-255,5738,121300,1,200370
10614,0.018909,172.31.36.0-255,66,121366,1,200370
10615,0.02128,172.217.194.0-255,5738,127104,1,200370
10616,0.021289,172.31.36.0-255,66,127170,1,200370
10617,0.023667,172.217.194.0-255,5738,132908,1,200370
10618,0.023677,172.31.36.0-255,66,132974,1,200370
10619,0.026063,172.217.194.0-255,5738,138712,1,200370
10620,0.026073,172.31.36.0-255,66,138778,1,200370
10621,0.028507,172.217.194.0-255,5738,144516,1,200370
10622,0.028514,172.31.36.0-255,66,144582,1,200370
10623,0.030896,172.217.194.0-255,5738,150320,1,200370
10624,0.030905,172.31.36.0-255,66,150386,1,200370
10625,0.03328,172.217.194.0-255,5738,156124,1,200370
10626,0.033292,172.31.36.0-255,66,156190,1,200370
10627,0.03571,172.217.194.0-255,5738,161928,1,200370
10628,0.035717,172.31.36.0-255,66,161994,1,200370
10629,0.035761,172.31.36.0-255,192,162186,1,200370
10630,0.035789,172.31.36.0-255,1138,163324,1,200370
10631,0.035915,172.31.36.0-255,1514,164838,1,200370
10632,0.035918,172.31.36.0-255,1514,166352,1,200370
10633,0.035919,172.31.36.0-255,1514,167866,1,200370
10634,0.035921,172.31.36.0-255,1514,169380,1,200370
10635,0.035949,172.31.36.0-255,1466,170846,1,200370
10636,0.037292,104.244.42.0-255,66,170912,1,200370
10637,0.037325,104.244.42.0-255,66,170978,1,200370
10638,0.037505,104.244.42.0-255,66,171044,1,200370
10639,0.037574,104.244.42.0-255,66,171110,1,200370
10640,0.038102,104.244.42.0-255,108,171218,1,200370
10641,0.038116,172.31.36.0-255,66,171284,1,200370
10642,0.038132,172.217.194.0-255,5738,177022,1,200370
10643,0.038135,172.31.36.0-255,66,177088,1,200370
10644,0.040527,172.217.194.0-255,5738,182826,1,200370
10645,0.040537,172.31.36.0-255,66,182892,1,200370
10646,0.042952,172.217.194.0-255,5738,188630,1,200370
10647,0.042959,172.31.36.0-255,66,188696,1,200370
10648,0.045351,172.217.194.0-255,5738,194434,1,200370
10649,0.045358,172.31.36.0-255,66,194500,1,200370
10650,0.047718,172.217.194.0-255,4320,198820,1,200370
10651,0.047725,172.31.36.0-255,66,198886,1,200370
10652,0.047756,172.217.194.0-255,1484,200370,1,200370
10653,0.0,74.125.24.0-255,153,153,1,204129
10654,2.9e-05,172.31.36.0-255,66,219,1,204129
10655,3.6e-05,74.125.24.0-255,1484,1703,1,204129
10656,4e-05,172.31.36.0-255,66,1769,1,204129
10657,4.5e-05,74.125.24.0-255,2902,4671,1,204129
10658,4.7e-05,172.31.36.0-255,66,4737,1,204129
10659,5.1e-05,74.125.24.0-255,2902,7639,1,204129
10660,5.3e-05,172.31.36.0-255,66,7705,1,204129
10661,0.000102,74.125.24.0-255,6353,14058,1,204129
10662,0.000105,172.31.36.0-255,66,14124,1,204129
10663,0.000124,74.125.24.0-255,2902,17026,1,204129
10664,0.000127,172.31.36.0-255,66,17092,1,204129
10665,0.00015,74.125.24.0-255,4320,21412,1,204129
10666,0.000153,172.31.36.0-255,66,21478,1,204129
10667,0.00016,74.125.24.0-255,7156,28634,1,204129
10668,0.000162,172.31.36.0-255,66,28700,1,204129
10669,0.000179,74.125.24.0-255,2902,31602,1,204129
10670,0.000181,172.31.36.0-255,66,31668,1,204129
10671,0.000206,172.31.36.0-255,66,31734,1,204129
10672,0.00021,74.125.24.0-255,2543,34277,1,204129
10673,0.000212,172.31.36.0-255,66,34343,1,204129
10674,0.000781,74.125.24.0-255,1484,35827,1,204129
10675,0.000787,172.31.36.0-255,66,35893,1,204129
10676,0.000797,74.125.24.0-255,2902,38795,1,204129
10677,0.000799,172.31.36.0-255,66,38861,1,204129
10678,0.000806,74.125.24.0-255,5738,44599,1,204129
10679,0.000808,172.31.36.0-255,66,44665,1,204129
10680,0.000837,74.125.24.0-255,5738,50403,1,204129
10681,0.00084,172.31.36.0-255,66,50469,1,204129
10682,0.00087,74.125.24.0-255,2902,53371,1,204129
10683,0.000873,172.31.36.0-255,66,53437,1,204129
10684,0.000897,172.31.36.0-255,66,53503,1,204129
10685,0.000916,74.125.24.0-255,4320,57823,1,204129
10686,0.000919,172.31.36.0-255,66,57889,1,204129
10687,0.000938,74.125.24.0-255,3123,61012,1,204129
10688,0.000941,172.31.36.0-255,66,61078,1,204129
10689,0.00095,172.31.36.0-255,66,61144,1,204129
10690,0.00097,74.125.24.0-255,5738,66882,1,204129
10691,0.000972,172.31.36.0-255,66,66948,1,204129
10692,0.000993,74.125.24.0-255,2543,69491,1,204129
10693,0.000996,172.31.36.0-255,66,69557,1,204129
10694,0.00113,74.125.24.0-255,1484,71041,1,204129
10695,0.001146,74.125.24.0-255,2902,73943,1,204129
10696,0.001152,172.31.36.0-255,66,74009,1,204129
10697,0.001158,74.125.24.0-255,4320,78329,1,204129
10698,0.00116,172.31.36.0-255,66,78395,1,204129
10699,0.001176,74.125.24.0-255,1484,79879,1,204129
10700,0.00118,74.125.24.0-255,2902,82781,1,204129
10701,0.001183,172.31.36.0-255,66,82847,1,204129
10702,0.001208,74.125.24.0-255,4320,87167,1,204129
10703,0.001212,172.31.36.0-255,66,87233,1,204129
10704,0.001227,172.31.36.0-255,66,87299,1,204129
10705,0.001231,74.125.24.0-255,2184,89483,1,204129
10706,0.001233,172.31.36.0-255,66,89549,1,204129
10707,0.001285,74.125.24.0-255,1484,91033,1,204129
10708,0.001289,74.125.24.0-255,2902,93935,1,204129
10709,0.001291,172.31.36.0-255,66,94001,1,204129
10710,0.001313,74.125.24.0-255,5738,99739,1,204129
10711,0.001315,172.31.36.0-255,66,99805,1,204129
10712,0.00132,74.125.24.0-255,4320,104125,1,204129
10713,0.001323,172.31.36.0-255,66,104191,1,204129
10714,0.001337,74.125.24.0-255,2902,107093,1,204129
10715,0.00134,172.31.36.0-255,66,107159,1,204129
10716,0.001378,74.125.24.0-255,4320,111479,1,204129
10717,0.001381,172.31.36.0-255,66,111545,1,204129
10718,0.001412,172.31.36.0-255,66,111611,1,204129
10719,0.001418,74.125.24.0-255,6438,118049,1,204129
10720,0.00142,172.31.36.0-255,66,118115,1,204129
10721,0.001426,74.125.24.0-255,7156,125271,1,204129
10722,0.001428,172.31.36.0-255,66,125337,1,204129
10723,0.001435,74.125.24.0-255,7156,132493,1,204129
10724,0.001437,172.31.36.0-255,66,132559,1,204129
10725,0.001447,172.31.36.0-255,66,132625,1,204129
10726,0.001484,74.125.24.0-255,6438,139063,1,204129
10727,0.001486,172.31.36.0-255,66,139129,1,204129
10728,0.001563,74.125.24.0-255,1484,140613,1,204129
10729,0.001575,74.125.24.0-255,2902,143515,1,204129
10730,0.001578,172.31.36.0-255,66,143581,1,204129
10731,0.00162,74.125.24.0-255,2902,146483,1,204129
10732,0.001623,172.31.36.0-255,66,146549,1,204129
10733,0.001643,74.125.24.0-255,2902,149451,1,204129
10734,0.001645,172.31.36.0-255,66,149517,1,204129
10735,0.001651,74.125.24.0-255,5738,155255,1,204129
10736,0.001653,172.31.36.0-255,66,155321,1,204129
10737,0.001658,74.125.24.0-255,4320,159641,1,204129
10738,0.00166,172.31.36.0-255,66,159707,1,204129
10739,0.001682,172.31.36.0-255,66,159773,1,204129
10740,0.001688,74.125.24.0-255,5020,164793,1,204129
10741,0.00169,172.31.36.0-255,66,164859,1,204129
10742,0.001766,74.125.24.0-255,1484,166343,1,204129
10743,0.001779,74.125.24.0-255,2902,169245,1,204129
10744,0.001781,172.31.36.0-255,66,169311,1,204129
10745,0.001786,74.125.24.0-255,2902,172213,1,204129
10746,0.001788,172.31.36.0-255,66,172279,1,204129
10747,0.001801,74.125.24.0-255,2902,175181,1,204129
10748,0.001803,172.31.36.0-255,66,175247,1,204129
10749,0.001808,74.125.24.0-255,2902,178149,1,204129
10750,0.00181,172.31.36.0-255,66,178215,1,204129
10751,0.001839,172.31.36.0-255,66,178281,1,204129
10752,0.00185,172.31.36.0-255,66,178347,1,204129
10753,0.001869,74.125.24.0-255,2184,180531,1,204129
10754,0.001871,172.31.36.0-255,66,180597,1,204129
10755,0.001898,172.31.36.0-255,66,180663,1,204129
10756,0.001908,172.31.36.0-255,66,180729,1,204129
10757,0.001951,74.125.24.0-255,4320,185049,1,204129
10758,0.001953,172.31.36.0-255,66,185115,1,204129
10759,0.001985,172.31.36.0-255,66,185181,1,204129
10760,0.00199,74.125.24.0-255,4320,189501,1,204129
10761,0.001992,172.31.36.0-255,66,189567,1,204129
10762,0.002014,172.31.36.0-255,66,189633,1,204129
10763,0.002073,172.31.36.0-255,66,189699,1,204129
10764,0.00211,172.31.36.0-255,66,189765,1,204129
10765,0.002134,172.31.36.0-255,66,189831,1,204129
10766,0.002136,74.125.24.0-255,1484,191315,1,204129
10767,0.002155,172.31.36.0-255,66,191381,1,204129
10768,0.002185,172.31.36.0-255,66,191447,1,204129
10769,0.00219,74.125.24.0-255,3006,194453,1,204129
10770,0.002192,172.31.36.0-255,66,194519,1,204129
10771,0.002194,74.125.24.0-255,105,194624,1,204129
10772,0.006691,172.31.36.0-255,66,194690,1,204129
10773,0.006718,172.31.36.0-255,105,194795,1,204129
10774,0.008882,74.125.24.0-255,66,194861,1,204129
10775,0.03305,172.31.36.0-255,171,195032,1,204129
10776,0.033081,172.31.36.0-255,1138,196170,1,204129
10777,0.033125,172.31.36.0-255,1514,197684,1,204129
10778,0.033126,172.31.36.0-255,1514,199198,1,204129
10779,0.033128,172.31.36.0-255,1514,200712,1,204129
10780,0.033129,172.31.36.0-255,1514,202226,1,204129
10781,0.033154,172.31.36.0-255,1465,203691,1,204129
10782,0.034583,104.244.42.0-255,66,203757,1,204129
10783,0.034645,104.244.42.0-255,66,203823,1,204129
10784,0.034693,104.244.42.0-255,66,203889,1,204129
10785,0.034734,104.244.42.0-255,66,203955,1,204129
10786,0.035344,104.244.42.0-255,108,204063,1,204129
10787,0.035353,172.31.36.0-255,66,204129,1,204129
10788,0.0,74.125.130.0-255,153,153,1,327745
10789,3.4e-05,172.31.36.0-255,66,219,1,327745
10790,4e-05,74.125.130.0-255,1484,1703,1,327745
10791,4.5e-05,172.31.36.0-255,66,1769,1,327745
10792,4.9e-05,74.125.130.0-255,2902,4671,1,327745
10793,5.3e-05,172.31.36.0-255,66,4737,1,327745
10794,5.9e-05,74.125.130.0-255,4320,9057,1,327745
10795,6.2e-05,172.31.36.0-255,66,9123,1,327745
10796,0.000105,172.31.36.0-255,66,9189,1,327745
10797,0.000117,172.31.36.0-255,66,9255,1,327745
10798,0.000138,74.125.130.0-255,2543,11798,1,327745
10799,0.000142,172.31.36.0-255,66,11864,1,327745
10800,0.000229,74.125.130.0-255,1484,13348,1,327745
10801,0.000232,172.31.36.0-255,66,13414,1,327745
10802,0.000237,74.125.130.0-255,2902,16316,1,327745
10803,0.000241,172.31.36.0-255,66,16382,1,327745
10804,0.000245,74.125.130.0-255,2902,19284,1,327745
10805,0.000248,172.31.36.0-255,66,19350,1,327745
10806,0.000273,74.125.130.0-255,2902,22252,1,327745
10807,0.000278,172.31.36.0-255,66,22318,1,327745
10808,0.000291,172.31.36.0-255,66,22384,1,327745
10809,0.000294,74.125.130.0-255,1484,23868,1,327745
10810,0.000296,172.31.36.0-255,66,23934,1,327745
10811,0.000313,74.125.130.0-255,1484,25418,1,327745
10812,0.000316,172.31.36.0-255,66,25484,1,327745
10813,0.000342,74.125.130.0-255,1484,26968,1,327745
10814,0.000344,172.31.36.0-255,66,27034,1,327745
10815,0.00035,74.125.130.0-255,4320,31354,1,327745
10816,0.000352,172.31.36.0-255,66,31420,1,327745
10817,0.00038,74.125.130.0-255,2510,33930,1,327745
10818,0.000384,172.31.36.0-255,66,33996,1,327745
10819,0.000597,74.125.130.0-255,1484,35480,1,327745
10820,0.000619,74.125.130.0-255,2902,38382,1,327745
10821,0.000623,172.31.36.0-255,66,38448,1,327745
10822,0.000641,74.125.130.0-255,1484,39932,1,327745
10823,0.000667,74.125.130.0-255,2902,42834,1,327745
10824,0.00067,172.31.36.0-255,66,42900,1,327745
10825,0.000676,74.125.130.0-255,5738,48638,1,327745
10826,0.000678,172.31.36.0-255,66,48704,1,327745
10827,0.000706,74.125.130.0-255,5738,54442,1,327745
10828,0.000709,172.31.36.0-255,66,54508,1,327745
10829,0.000735,74.125.130.0-255,7156,61664,1,327745
10830,0.000738,172.31.36.0-255,66,61730,1,327745
10831,0.000751,74.125.130.0-255,2902,64632,1,327745
10832,0.000754,172.31.36.0-255,66,64698,1,327745
10833,0.000771,74.125.130.0-255,3602,68300,1,327745
10834,0.000774,172.31.36.0-255,66,68366,1,327745
10835,0.000814,74.125.130.0-255,382,68748,1,327745
10836,0.001,74.125.130.0-255,1484,70232,1,327745
10837,0.001005,172.31.36.0-255,66,70298,1,327745
10838,0.00101,74.125.130.0-255,2902,73200,1,327745
10839,0.001012,172.31.36.0-255,66,73266,1,327745
10840,0.001039,74.125.130.0-255,5738,79004,1,327745
10841,0.001042,172.31.36.0-255,66,79070,1,327745
10842,0.001055,74.125.130.0-255,1484,80554,1,327745
10843,0.001078,74.125.130.0-255,5738,86292,1,327745
10844,0.00108,172.31.36.0-255,66,86358,1,327745
10845,0.001094,74.125.130.0-255,2902,89260,1,327745
10846,0.001097,172.31.36.0-255,66,89326,1,327745
10847,0.001132,172.31.36.0-255,66,89392,1,327745
10848,0.001151,74.125.130.0-255,2184,91576,1,327745
10849,0.001154,172.31.36.0-255,66,91642,1,327745
10850,0.001188,74.125.130.0-255,1484,93126,1,327745
10851,0.001205,74.125.130.0-255,2902,96028,1,327745
10852,0.001208,172.31.36.0-255,66,96094,1,327745
10853,0.001231,74.125.130.0-255,5738,101832,1,327745
10854,0.001236,172.31.36.0-255,66,101898,1,327745
10855,0.001287,74.125.130.0-255,2902,104800,1,327745
10856,0.00129,172.31.36.0-255,66,104866,1,327745
10857,0.001316,172.31.36.0-255,66,104932,1,327745
10858,0.001319,74.125.130.0-255,1484,106416,1,327745
10859,0.001324,74.125.130.0-255,2902,109318,1,327745
10860,0.001326,172.31.36.0-255,66,109384,1,327745
10861,0.001332,74.125.130.0-255,5738,115122,1,327745
10862,0.001335,172.31.36.0-255,66,115188,1,327745
10863,0.001338,74.125.130.0-255,766,115954,1,327745
10864,0.001458,74.125.130.0-255,1484,117438,1,327745
10865,0.001462,172.31.36.0-255,66,117504,1,327745
10866,0.001501,74.125.130.0-255,1484,118988,1,327745
10867,0.001521,74.125.130.0-255,1484,120472,1,327745
10868,0.001524,172.31.36.0-255,66,120538,1,327745
10869,0.00153,74.125.130.0-255,4320,124858,1,327745
10870,0.001533,172.31.36.0-255,66,124924,1,327745
10871,0.001563,74.125.130.0-255,1484,126408,1,327745
10872,0.001587,74.125.130.0-255,7156,133564,1,327745
10873,0.00159,172.31.36.0-255,66,133630,1,327745
10874,0.001596,74.125.130.0-255,4320,137950,1,327745
10875,0.001598,172.31.36.0-255,66,138016,1,327745
10876,0.001615,74.125.130.0-255,5738,143754,1,327745
10877,0.001617,172.31.36.0-255,66,143820,1,327745
10878,0.001624,74.125.130.0-255,6438,150258,1,327745
10879,0.001627,172.31.36.0-255,66,150324,1,327745
10880,0.001668,74.125.130.0-255,1484,151808,1,327745
10881,0.001673,74.125.130.0-255,2902,154710,1,327745
10882,0.001676,172.31.36.0-255,66,154776,1,327745
10883,0.001704,74.125.130.0-255,4320,159096,1,327745
10884,0.001708,172.31.36.0-255,66,159162,1,327745
10885,0.001712,74.125.130.0-255,1484,160646,1,327745
10886,0.001731,74.125.130.0-255,4320,164966,1,327745
10887,0.001734,172.31.36.0-255,66,165032,1,327745
10888,0.001752,74.125.130.0-255,7156,172188,1,327745
10889,0.001755,172.31.36.0-255,66,172254,1,327745
10890,0.001769,74.125.130.0-255,4320,176574,1,327745
10891,0.001772,172.31.36.0-255,66,176640,1,327745
10892,0.001788,74.125.130.0-255,1484,178124,1,327745
10893,0.0018,74.125.130.0-255,1484,179608,1,327745
10894,0.001803,172.31.36.0-255,66,179674,1,327745
10895,0.00183,74.125.130.0-255,1484,181158,1,327745
10896,0.001844,74.125.130.0-255,2902,184060,1,327745
10897,0.001847,172.31.36.0-255,66,184126,1,327745
10898,0.001851,74.125.130.0-255,766,184892,1,327745
10899,0.002181,172.31.36.0-255,66,184958,1,327745
10900,0.003781,74.125.130.0-255,4320,189278,1,327745
10901,0.003789,172.31.36.0-255,66,189344,1,327745
10902,0.004112,74.125.130.0-255,1484,190828,1,327745
10903,0.005725,74.125.130.0-255,4320,195148,1,327745
10904,0.005727,172.31.36.0-255,66,195214,1,327745
10905,0.007683,74.125.130.0-255,5738,200952,1,327745
10906,0.007689,172.31.36.0-255,66,201018,1,327745
10907,0.009636,74.125.130.0-255,5738,206756,1,327745
10908,0.00965,172.31.36.0-255,66,206822,1,327745
10909,0.01159,74.125.130.0-255,5738,212560,1,327745
10910,0.0116,172.31.36.0-255,66,212626,1,327745
10911,0.013541,74.125.130.0-255,5738,218364,1,327745
10912,0.013549,172.31.36.0-255,66,218430,1,327745
10913,0.01549,74.125.130.0-255,5738,224168,1,327745
10914,0.015498,172.31.36.0-255,66,224234,1,327745
10915,0.017445,74.125.130.0-255,5738,229972,1,327745
10916,0.017457,172.31.36.0-255,66,230038,1,327745
10917,0.019413,74.125.130.0-255,5738,235776,1,327745
10918,0.01943,172.31.36.0-255,66,235842,1,327745
10919,0.021383,74.125.130.0-255,5738,241580,1,327745
10920,0.021393,172.31.36.0-255,66,241646,1,327745
10921,0.021579,172.31.36.0-255,172,241818,1,327745
10922,0.021607,172.31.36.0-255,1114,242932,1,327745
10923,0.021728,172.31.36.0-255,1514,244446,1,327745
10924,0.02173,172.31.36.0-255,327,244773,1,327745
10925,0.023124,104.244.42.0-255,66,244839,1,327745
10926,0.023159,104.244.42.0-255,66,244905,1,327745
10927,0.023306,104.244.42.0-255,66,244971,1,327745
10928,0.023327,74.125.130.0-255,1484,246455,1,327745
10929,0.023359,74.125.130.0-255,4320,250775,1,327745
10930,0.023364,172.31.36.0-255,66,250841,1,327745
10931,0.025292,74.125.130.0-255,1484,252325,1,327745
10932,0.025331,74.125.130.0-255,4320,256645,1,327745
10933,0.025337,172.31.36.0-255,66,256711,1,327745
10934,0.027309,74.125.130.0-255,2902,259613,1,327745
10935,0.027314,172.31.36.0-255,66,259679,1,327745
10936,0.027348,74.125.130.0-255,2902,262581,1,327745
10937,0.027352,172.31.36.0-255,66,262647,1,327745
10938,0.029266,74.125.130.0-255,2902,265549,1,327745
10939,0.029272,172.31.36.0-255,66,265615,1,327745
10940,0.029305,74.125.130.0-255,2902,268517,1,327745
10941,0.029309,172.31.36.0-255,66,268583,1,327745
10942,0.031218,74.125.130.0-255,2902,271485,1,327745
10943,0.031224,172.31.36.0-255,66,271551,1,327745
10944,0.031252,74.125.130.0-255,2902,274453,1,327745
10945,0.031255,172.31.36.0-255,66,274519,1,327745
10946,0.03322,74.125.130.0-255,2902,277421,1,327745
10947,0.033226,172.31.36.0-255,66,277487,1,327745
10948,0.033257,74.125.130.0-255,2902,280389,1,327745
10949,0.03326,172.31.36.0-255,66,280455,1,327745
10950,0.035163,74.125.130.0-255,2902,283357,1,327745
10951,0.035168,172.31.36.0-255,66,283423,1,327745
10952,0.035195,74.125.130.0-255,2902,286325,1,327745
10953,0.035198,172.31.36.0-255,66,286391,1,327745
10954,0.037106,74.125.130.0-255,2902,289293,1,327745
10955,0.037111,172.31.36.0-255,66,289359,1,327745
10956,0.037142,74.125.130.0-255,2902,292261,1,327745
10957,0.037145,172.31.36.0-255,66,292327,1,327745
10958,0.039055,74.125.130.0-255,2902,295229,1,327745
10959,0.03906,172.31.36.0-255,66,295295,1,327745
10960,0.039092,74.125.130.0-255,2902,298197,1,327745
10961,0.039096,172.31.36.0-255,66,298263,1,327745
10962,0.040995,74.125.130.0-255,2902,301165,1,327745
10963,0.041,172.31.36.0-255,66,301231,1,327745
10964,0.041037,74.125.130.0-255,2902,304133,1,327745
10965,0.041041,172.31.36.0-255,66,304199,1,327745
10966,0.04293,74.125.130.0-255,2902,307101,1,327745
10967,0.042935,172.31.36.0-255,66,307167,1,327745
10968,0.042971,74.125.130.0-255,2902,310069,1,327745
10969,0.042974,172.31.36.0-255,66,310135,1,327745
10970,0.044869,74.125.130.0-255,2902,313037,1,327745
10971,0.044874,172.31.36.0-255,66,313103,1,327745
10972,0.044913,74.125.130.0-255,2902,316005,1,327745
10973,0.044917,172.31.36.0-255,66,316071,1,327745
10974,0.046817,74.125.130.0-255,1484,317555,1,327745
10975,0.046848,74.125.130.0-255,4320,321875,1,327745
10976,0.046853,172.31.36.0-255,66,321941,1,327745
10977,0.048783,74.125.130.0-255,5738,327679,1,327745
10978,0.048789,172.31.36.0-255,66,327745,1,327745
10979,0.0,172.217.194.0-255,153,153,1,271172
10980,1.6e-05,172.31.36.0-255,66,219,1,271172
10981,2.4e-05,172.217.194.0-255,1484,1703,1,271172
10982,2.9e-05,172.31.36.0-255,66,1769,1,271172
10983,4.3e-05,172.217.194.0-255,2902,4671,1,271172
10984,4.7e-05,172.31.36.0-255,66,4737,1,271172
10985,5.3e-05,172.217.194.0-255,4320,9057,1,271172
10986,5.5e-05,172.31.36.0-255,66,9123,1,271172
10987,6.2e-05,172.217.194.0-255,4851,13974,1,271172
10988,6.4e-05,172.31.36.0-255,66,14040,1,271172
10989,0.000267,172.217.194.0-255,1484,15524,1,271172
10990,0.000272,172.31.36.0-255,66,15590,1,271172
10991,0.000279,172.217.194.0-255,2902,18492,1,271172
10992,0.000281,172.31.36.0-255,66,18558,1,271172
10993,0.000292,172.217.194.0-255,4320,22878,1,271172
10994,0.000295,172.31.36.0-255,66,22944,1,271172
10995,0.000327,172.217.194.0-255,5738,28682,1,271172
10996,0.00033,172.31.36.0-255,66,28748,1,271172
10997,0.000335,172.217.194.0-255,2543,31291,1,271172
10998,0.000337,172.31.36.0-255,66,31357,1,271172
10999,0.000509,172.217.194.0-255,1484,32841,1,271172
11000,0.000513,172.31.36.0-255,66,32907,1,271172
11001,0.00052,172.217.194.0-255,2902,35809,1,271172
11002,0.000523,172.31.36.0-255,66,35875,1,271172
11003,0.000535,172.217.194.0-255,5738,41613,1,271172
11004,0.000538,172.31.36.0-255,66,41679,1,271172
11005,0.000543,172.217.194.0-255,4320,45999,1,271172
11006,0.000545,172.31.36.0-255,66,46065,1,271172
11007,0.000593,172.217.194.0-255,2543,48608,1,271172
11008,0.000596,172.31.36.0-255,66,48674,1,271172
11009,0.000627,172.217.194.0-255,2902,51576,1,271172
11010,0.00063,172.31.36.0-255,66,51642,1,271172
11011,0.000659,172.217.194.0-255,5738,57380,1,271172
11012,0.000662,172.31.36.0-255,66,57446,1,271172
11013,0.000701,172.217.194.0-255,5738,63184,1,271172
11014,0.000705,172.31.36.0-255,66,63250,1,271172
11015,0.00073,172.217.194.0-255,2543,65793,1,271172
11016,0.000732,172.31.36.0-255,66,65859,1,271172
11017,0.000803,172.217.194.0-255,646,66505,1,271172
11018,0.000987,172.217.194.0-255,1484,67989,1,271172
11019,0.000992,172.31.36.0-255,66,68055,1,271172
11020,0.000997,172.217.194.0-255,2902,70957,1,271172
11021,0.001,172.31.36.0-255,66,71023,1,271172
11022,0.001025,172.217.194.0-255,5738,76761,1,271172
11023,0.001027,172.31.36.0-255,66,76827,1,271172
11024,0.001054,172.217.194.0-255,4320,81147,1,271172
11025,0.001057,172.31.36.0-255,66,81213,1,271172
11026,0.001073,172.217.194.0-255,2543,83756,1,271172
11027,0.001076,172.31.36.0-255,66,83822,1,271172
11028,0.001081,172.217.194.0-255,4320,88142,1,271172
11029,0.001083,172.31.36.0-255,66,88208,1,271172
11030,0.001107,172.217.194.0-255,2902,91110,1,271172
11031,0.001114,172.31.36.0-255,66,91176,1,271172
11032,0.00112,172.217.194.0-255,4320,95496,1,271172
11033,0.001123,172.31.36.0-255,66,95562,1,271172
11034,0.001157,172.217.194.0-255,5379,100941,1,271172
11035,0.001164,172.31.36.0-255,66,101007,1,271172
11036,0.001342,172.217.194.0-255,1484,102491,1,271172
11037,0.001357,172.217.194.0-255,2902,105393,1,271172
11038,0.001362,172.31.36.0-255,66,105459,1,271172
11039,0.001391,172.217.194.0-255,5738,111197,1,271172
11040,0.001394,172.31.36.0-255,66,111263,1,271172
11041,0.001398,172.217.194.0-255,1484,112747,1,271172
11042,0.001431,172.31.36.0-255,66,112813,1,271172
11043,0.001438,172.217.194.0-255,7156,119969,1,271172
11044,0.001441,172.31.36.0-255,66,120035,1,271172
11045,0.001456,172.31.36.0-255,66,120101,1,271172
11046,0.00146,172.217.194.0-255,1484,121585,1,271172
11047,0.001496,172.31.36.0-255,66,121651,1,271172
11048,0.001828,172.217.194.0-255,1484,123135,1,271172
11049,0.001849,172.217.194.0-255,2902,126037,1,271172
11050,0.001854,172.217.194.0-255,5738,131775,1,271172
11051,0.00186,172.31.36.0-255,66,131841,1,271172
11052,0.001863,172.31.36.0-255,66,131907,1,271172
11053,0.001883,172.31.36.0-255,66,131973,1,271172
11054,0.001933,172.31.36.0-255,66,132039,1,271172
11055,0.001957,172.217.194.0-255,3602,135641,1,271172
11056,0.00196,172.31.36.0-255,66,135707,1,271172
11057,0.00399,172.217.194.0-255,1484,137191,1,271172
11058,0.004031,172.217.194.0-255,1484,138675,1,271172
11059,0.004036,172.31.36.0-255,66,138741,1,271172
11060,0.004062,172.217.194.0-255,2902,141643,1,271172
11061,0.004065,172.31.36.0-255,66,141709,1,271172
11062,0.006076,172.217.194.0-255,2902,144611,1,271172
11063,0.006079,172.31.36.0-255,66,144677,1,271172
11064,0.006102,172.217.194.0-255,1484,146161,1,271172
11065,0.006115,172.217.194.0-255,1484,147645,1,271172
11066,0.006117,172.31.36.0-255,66,147711,1,271172
11067,0.008164,172.217.194.0-255,2902,150613,1,271172
11068,0.00817,172.31.36.0-255,66,150679,1,271172
11069,0.0082,172.217.194.0-255,1484,152163,1,271172
11070,0.008217,172.217.194.0-255,1484,153647,1,271172
11071,0.00822,172.31.36.0-255,66,153713,1,271172
11072,0.01024,172.217.194.0-255,2902,156615,1,271172
11073,0.010248,172.31.36.0-255,66,156681,1,271172
11074,0.010281,172.217.194.0-255,2902,159583,1,271172
11075,0.010285,172.31.36.0-255,66,159649,1,271172
11076,0.012321,172.217.194.0-255,2902,162551,1,271172
11077,0.012328,172.31.36.0-255,66,162617,1,271172
11078,0.012396,172.217.194.0-255,2902,165519,1,271172
11079,0.0124,172.31.36.0-255,66,165585,1,271172
11080,0.014388,172.217.194.0-255,2902,168487,1,271172
11081,0.014394,172.31.36.0-255,66,168553,1,271172
11082,0.014486,172.217.194.0-255,2902,171455,1,271172
11083,0.01449,172.31.36.0-255,66,171521,1,271172
11084,0.016467,172.217.194.0-255,2902,174423,1,271172
11085,0.016474,172.31.36.0-255,66,174489,1,271172
11086,0.016542,172.217.194.0-255,2902,177391,1,271172
11087,0.016545,172.31.36.0-255,66,177457,1,271172
11088,0.01859,172.217.194.0-255,2902,180359,1,271172
11089,0.018603,172.31.36.0-255,66,180425,1,271172
11090,0.01864,172.217.194.0-255,2902,183327,1,271172
11091,0.018644,172.31.36.0-255,66,183393,1,271172
11092,0.020659,172.217.194.0-255,2902,186295,1,271172
11093,0.020669,172.31.36.0-255,66,186361,1,271172
11094,0.0207,172.217.194.0-255,2902,189263,1,271172
11095,0.020703,172.31.36.0-255,66,189329,1,271172
11096,0.022731,172.217.194.0-255,2902,192231,1,271172
11097,0.022739,172.31.36.0-255,66,192297,1,271172
11098,0.02277,172.217.194.0-255,2902,195199,1,271172
11099,0.022773,172.31.36.0-255,66,195265,1,271172
11100,0.024867,172.217.194.0-255,4320,199585,1,271172
11101,0.024874,172.31.36.0-255,66,199651,1,271172
11102,0.024905,172.217.194.0-255,1484,201135,1,271172
11103,0.02694,172.217.194.0-255,2902,204037,1,271172
11104,0.026947,172.31.36.0-255,66,204103,1,271172
11105,0.029042,172.217.194.0-255,5738,209841,1,271172
11106,0.029051,172.31.36.0-255,66,209907,1,271172
11107,0.031131,172.217.194.0-255,5738,215645,1,271172
11108,0.031138,172.31.36.0-255,66,215711,1,271172
11109,0.033235,172.217.194.0-255,5738,221449,1,271172
11110,0.033242,172.31.36.0-255,66,221515,1,271172
11111,0.035342,172.217.194.0-255,5738,227253,1,271172
11112,0.035351,172.31.36.0-255,66,227319,1,271172
11113,0.037296,172.31.36.0-255,172,227491,1,271172
11114,0.037327,172.31.36.0-255,1116,228607,1,271172
11115,0.037389,172.31.36.0-255,1514,230121,1,271172
11116,0.037391,172.31.36.0-255,1514,231635,1,271172
11117,0.037392,172.31.36.0-255,1514,233149,1,271172
11118,0.037397,172.31.36.0-255,1514,234663,1,271172
11119,0.037399,172.31.36.0-255,1487,236150,1,271172
11120,0.03743,172.217.194.0-255,5738,241888,1,271172
11121,0.037435,172.31.36.0-255,66,241954,1,271172
11122,0.038871,104.244.42.0-255,66,242020,1,271172
11123,0.038915,104.244.42.0-255,66,242086,1,271172
11124,0.038975,104.244.42.0-255,66,242152,1,271172
11125,0.03963,172.217.194.0-255,5738,247890,1,271172
11126,0.039637,172.31.36.0-255,66,247956,1,271172
11127,0.041705,172.217.194.0-255,5738,253694,1,271172
11128,0.041712,172.31.36.0-255,66,253760,1,271172
11129,0.043806,172.217.194.0-255,5738,259498,1,271172
11130,0.043813,172.31.36.0-255,66,259564,1,271172
11131,0.045896,172.217.194.0-255,5738,265302,1,271172
11132,0.045903,172.31.36.0-255,66,265368,1,271172
11133,0.047987,172.217.194.0-255,5738,271106,1,271172
11134,0.047995,172.31.36.0-255,66,271172,1,271172
11135,0.0,172.217.194.0-255,153,153,1,208086
11136,2.6e-05,172.31.36.0-255,66,219,1,208086
11137,3.3e-05,172.217.194.0-255,1484,1703,1,208086
11138,3.7e-05,172.31.36.0-255,66,1769,1,208086
11139,4.1e-05,172.217.194.0-255,2902,4671,1,208086
11140,4.3e-05,172.31.36.0-255,66,4737,1,208086
11141,5.4e-05,172.217.194.0-255,2902,7639,1,208086
11142,5.6e-05,172.31.36.0-255,66,7705,1,208086
11143,8.3e-05,172.217.194.0-255,4320,12025,1,208086
11144,8.5e-05,172.31.36.0-255,66,12091,1,208086
11145,9.4e-05,172.217.194.0-255,2029,14120,1,208086
11146,9.6e-05,172.31.36.0-255,66,14186,1,208086
11147,0.000206,172.217.194.0-255,1484,15670,1,208086
11148,0.000209,172.31.36.0-255,66,15736,1,208086
11149,0.000214,172.217.194.0-255,2902,18638,1,208086
11150,0.000216,172.31.36.0-255,66,18704,1,208086
11151,0.000221,172.217.194.0-255,5738,24442,1,208086
11152,0.000228,172.31.36.0-255,66,24508,1,208086
11153,0.000231,172.217.194.0-255,1484,25992,1,208086
11154,0.000233,172.31.36.0-255,66,26058,1,208086
11155,0.000265,172.217.194.0-255,4320,30378,1,208086
11156,0.000269,172.31.36.0-255,66,30444,1,208086
11157,0.000272,172.217.194.0-255,1125,31569,1,208086
11158,0.000273,172.31.36.0-255,66,31635,1,208086
11159,0.000308,172.217.194.0-255,1484,33119,1,208086
11160,0.000311,172.31.36.0-255,66,33185,1,208086
11161,0.000317,172.217.194.0-255,4320,37505,1,208086
11162,0.000319,172.31.36.0-255,66,37571,1,208086
11163,0.000321,172.217.194.0-255,1484,39055,1,208086
11164,0.000328,172.31.36.0-255,66,39121,1,208086
11165,0.000365,172.217.194.0-255,1125,40246,1,208086
11166,0.000367,172.31.36.0-255,66,40312,1,208086
11167,0.000454,172.217.194.0-255,1484,41796,1,208086
11168,0.000457,172.31.36.0-255,66,41862,1,208086
11169,0.000464,172.217.194.0-255,2902,44764,1,208086
11170,0.000471,172.31.36.0-255,66,44830,1,208086
11171,0.000497,172.217.194.0-255,5738,50568,1,208086
11172,0.000503,172.217.194.0-255,6797,57365,1,208086
11173,0.000503,172.31.36.0-255,66,57431,1,208086
11174,0.000507,172.31.36.0-255,66,57497,1,208086
11175,0.000545,172.217.194.0-255,365,57862,1,208086
11176,0.000664,172.31.36.0-255,66,57928,1,208086
11177,0.000891,172.217.194.0-255,378,58306,1,208086
11178,0.001065,172.217.194.0-255,1484,59790,1,208086
11179,0.001071,172.217.194.0-255,2902,62692,1,208086
11180,0.001087,172.217.194.0-255,5738,68430,1,208086
11181,0.001163,172.217.194.0-255,4320,72750,1,208086
11182,0.001358,172.217.194.0-255,1484,74234,1,208086
11183,0.001361,172.217.194.0-255,1484,75718,1,208086
11184,0.001372,172.217.194.0-255,1484,77202,1,208086
11185,0.001394,172.217.194.0-255,2902,80104,1,208086
11186,0.001408,172.217.194.0-255,2902,83006,1,208086
11187,0.001412,172.217.194.0-255,4320,87326,1,208086
11188,0.001427,172.217.194.0-255,2902,90228,1,208086
11189,0.001456,172.217.194.0-255,1484,91712,1,208086
11190,0.001473,172.217.194.0-255,6438,98150,1,208086
11191,0.009498,172.217.194.0-255,1484,99634,1,208086
11192,0.012773,172.31.36.0-255,66,99700,1,208086
11193,0.014818,172.217.194.0-255,5738,105438,1,208086
11194,0.014826,172.31.36.0-255,66,105504,1,208086
11195,0.016828,172.217.194.0-255,5738,111242,1,208086
11196,0.017097,172.31.36.0-255,66,111308,1,208086
11197,0.01908,172.217.194.0-255,5738,117046,1,208086
11198,0.019096,172.31.36.0-255,66,117112,1,208086
11199,0.021091,172.217.194.0-255,5738,122850,1,208086
11200,0.021102,172.31.36.0-255,66,122916,1,208086
11201,0.023123,172.217.194.0-255,5738,128654,1,208086
11202,0.023129,172.31.36.0-255,66,128720,1,208086
11203,0.025141,172.217.194.0-255,5738,134458,1,208086
11204,0.025148,172.31.36.0-255,66,134524,1,208086
11205,0.027193,172.217.194.0-255,5738,140262,1,208086
11206,0.027199,172.31.36.0-255,66,140328,1,208086
11207,0.029226,172.217.194.0-255,5738,146066,1,208086
11208,0.029234,172.31.36.0-255,66,146132,1,208086
11209,0.031246,172.217.194.0-255,5738,151870,1,208086
11210,0.031251,172.31.36.0-255,66,151936,1,208086
11211,0.033245,172.217.194.0-255,5738,157674,1,208086
11212,0.033254,172.31.36.0-255,66,157740,1,208086
11213,0.035245,172.217.194.0-255,4320,162060,1,208086
11214,0.035252,172.31.36.0-255,66,162126,1,208086
11215,0.035281,172.217.194.0-255,1484,163610,1,208086
11216,0.037241,172.217.194.0-255,4320,167930,1,208086
11217,0.037247,172.31.36.0-255,66,167996,1,208086
11218,0.037653,172.31.36.0-255,187,168183,1,208086
11219,0.037681,172.31.36.0-255,982,169165,1,208086
11220,0.037717,172.31.36.0-255,1514,170679,1,208086
11221,0.037719,172.31.36.0-255,1514,172193,1,208086
11222,0.037723,172.31.36.0-255,1514,173707,1,208086
11223,0.037724,172.31.36.0-255,1514,175221,1,208086
11224,0.037742,172.31.36.0-255,481,175702,1,208086
11225,0.039228,172.217.194.0-255,4320,180022,1,208086
11226,0.039234,172.31.36.0-255,66,180088,1,208086
11227,0.039269,104.244.42.0-255,66,180154,1,208086
11228,0.039275,104.244.42.0-255,66,180220,1,208086
11229,0.039277,172.217.194.0-255,1484,181704,1,208086
11230,0.039324,104.244.42.0-255,66,181770,1,208086
11231,0.039329,104.244.42.0-255,66,181836,1,208086
11232,0.041221,172.217.194.0-255,4320,186156,1,208086
11233,0.041226,172.31.36.0-255,66,186222,1,208086
11234,0.043226,172.217.194.0-255,5738,191960,1,208086
11235,0.043276,172.31.36.0-255,66,192026,1,208086
11236,0.045276,172.217.194.0-255,5738,197764,1,208086
11237,0.045282,172.31.36.0-255,66,197830,1,208086
11238,0.047265,172.217.194.0-255,4320,202150,1,208086
11239,0.04727,172.31.36.0-255,66,202216,1,208086
11240,0.047303,172.217.194.0-255,1484,203700,1,208086
11241,0.049261,172.217.194.0-255,4320,208020,1,208086
11242,0.049267,172.31.36.0-255,66,208086,1,208086
11243,0.0,172.217.24.0-255,153,153,1,222999
11244,2.2e-05,172.31.36.0-255,66,219,1,222999
11245,2.9e-05,172.217.24.0-255,1484,1703,1,222999
11246,3.3e-05,172.31.36.0-255,66,1769,1,222999
11247,4e-05,172.217.24.0-255,2902,4671,1,222999
11248,5.2e-05,172.31.36.0-255,66,4737,1,222999
11249,6e-05,172.217.24.0-255,7156,11893,1,222999
11250,6.3e-05,172.31.36.0-255,66,11959,1,222999
11251,6.8e-05,172.217.24.0-255,1966,13925,1,222999
11252,7e-05,172.31.36.0-255,66,13991,1,222999
11253,0.000142,172.217.24.0-255,1484,15475,1,222999
11254,0.000146,172.31.36.0-255,66,15541,1,222999
11255,0.000152,172.217.24.0-255,2902,18443,1,222999
11256,0.000154,172.31.36.0-255,66,18509,1,222999
11257,0.000166,172.217.24.0-255,5738,24247,1,222999
11258,0.000168,172.31.36.0-255,66,24313,1,222999
11259,0.000202,172.217.24.0-255,6797,31110,1,222999
11260,0.000205,172.31.36.0-255,66,31176,1,222999
11261,0.000212,172.217.24.0-255,5738,36914,1,222999
11262,0.000214,172.31.36.0-255,66,36980,1,222999
11263,0.000232,172.217.24.0-255,1484,38464,1,222999
11264,0.000238,172.31.36.0-255,66,38530,1,222999
11265,0.00025,172.217.24.0-255,1484,40014,1,222999
11266,0.000256,172.31.36.0-255,66,40080,1,222999
11267,0.000289,172.31.36.0-255,66,40146,1,222999
11268,0.000321,172.217.24.0-255,2902,43048,1,222999
11269,0.000323,172.31.36.0-255,66,43114,1,222999
11270,0.000329,172.217.24.0-255,4320,47434,1,222999
11271,0.000332,172.31.36.0-255,66,47500,1,222999
11272,0.000347,172.31.36.0-255,66,47566,1,222999
11273,0.00035,172.217.24.0-255,1125,48691,1,222999
11274,0.000354,172.217.24.0-255,395,49086,1,222999
11275,0.001083,172.31.36.0-255,66,49152,1,222999
11276,0.001169,172.217.24.0-255,115,49267,1,222999
11277,0.001209,172.217.24.0-255,1484,50751,1,222999
11278,0.001213,172.31.36.0-255,66,50817,1,222999
11279,0.001219,172.217.24.0-255,2902,53719,1,222999
11280,0.001221,172.31.36.0-255,66,53785,1,222999
11281,0.001224,172.217.24.0-255,1484,55269,1,222999
11282,0.001255,172.217.24.0-255,4320,59589,1,222999
11283,0.001257,172.31.36.0-255,66,59655,1,222999
11284,0.001265,172.217.24.0-255,6797,66452,1,222999
11285,0.001267,172.31.36.0-255,66,66518,1,222999
11286,0.001317,172.217.24.0-255,1484,68002,1,222999
11287,0.001321,172.217.24.0-255,1484,69486,1,222999
11288,0.001323,172.31.36.0-255,66,69552,1,222999
11289,0.001345,172.217.24.0-255,1484,71036,1,222999
11290,0.001352,172.217.24.0-255,5738,76774,1,222999
11291,0.001354,172.31.36.0-255,66,76840,1,222999
11292,0.001362,172.217.24.0-255,6797,83637,1,222999
11293,0.001365,172.31.36.0-255,66,83703,1,222999
11294,0.003296,172.217.24.0-255,5738,89441,1,222999
11295,0.003306,172.31.36.0-255,66,89507,1,222999
11296,0.005243,172.217.24.0-255,5738,95245,1,222999
11297,0.005246,172.31.36.0-255,66,95311,1,222999
11298,0.00718,172.217.24.0-255,5738,101049,1,222999
11299,0.007187,172.31.36.0-255,66,101115,1,222999
11300,0.009123,172.217.24.0-255,5738,106853,1,222999
11301,0.009138,172.31.36.0-255,66,106919,1,222999
11302,0.011079,172.217.24.0-255,5738,112657,1,222999
11303,0.011088,172.31.36.0-255,66,112723,1,222999
11304,0.013042,172.217.24.0-255,5738,118461,1,222999
11305,0.01305,172.31.36.0-255,66,118527,1,222999
11306,0.014998,172.217.24.0-255,5738,124265,1,222999
11307,0.015006,172.31.36.0-255,66,124331,1,222999
11308,0.016952,172.217.24.0-255,5738,130069,1,222999
11309,0.016964,172.31.36.0-255,66,130135,1,222999
11310,0.018913,172.217.24.0-255,5738,135873,1,222999
11311,0.018926,172.31.36.0-255,66,135939,1,222999
11312,0.020881,172.217.24.0-255,5738,141677,1,222999
11313,0.020898,172.31.36.0-255,66,141743,1,222999
11314,0.022838,172.217.24.0-255,5738,147481,1,222999
11315,0.022846,172.31.36.0-255,66,147547,1,222999
11316,0.024801,172.217.24.0-255,5738,153285,1,222999
11317,0.024812,172.31.36.0-255,66,153351,1,222999
11318,0.026753,172.217.24.0-255,5738,159089,1,222999
11319,0.026769,172.31.36.0-255,66,159155,1,222999
11320,0.028776,172.217.24.0-255,5738,164893,1,222999
11321,0.028789,172.31.36.0-255,66,164959,1,222999
11322,0.030764,172.217.24.0-255,5738,170697,1,222999
11323,0.030774,172.31.36.0-255,66,170763,1,222999
11324,0.032721,172.217.24.0-255,5738,176501,1,222999
11325,0.032736,172.31.36.0-255,66,176567,1,222999
11326,0.034673,172.217.24.0-255,5738,182305,1,222999
11327,0.034682,172.31.36.0-255,66,182371,1,222999
11328,0.036624,172.217.24.0-255,5738,188109,1,222999
11329,0.036634,172.31.36.0-255,66,188175,1,222999
11330,0.038586,172.217.24.0-255,5738,193913,1,222999
11331,0.038605,172.31.36.0-255,66,193979,1,222999
11332,0.04061,172.217.24.0-255,5738,199717,1,222999
11333,0.04062,172.31.36.0-255,66,199783,1,222999
11334,0.042555,172.217.24.0-255,5738,205521,1,222999
11335,0.042561,172.31.36.0-255,66,205587,1,222999
11336,0.0445,172.217.24.0-255,5738,211325,1,222999
11337,0.044507,172.31.36.0-255,66,211391,1,222999
11338,0.046476,172.217.24.0-255,5738,217129,1,222999
11339,0.046484,172.31.36.0-255,66,217195,1,222999
11340,0.048416,172.217.24.0-255,5738,222933,1,222999
11341,0.048424,172.31.36.0-255,66,222999,1,222999
11342,0.0,172.217.160.0-255,150,150,1,295875
11343,3.4e-05,172.31.36.0-255,66,216,1,295875
11344,4.1e-05,172.217.160.0-255,1484,1700,1,295875
11345,4.6e-05,172.31.36.0-255,66,1766,1,295875
11346,5.1e-05,172.217.160.0-255,2902,4668,1,295875
11347,5.4e-05,172.31.36.0-255,66,4734,1,295875
11348,6.2e-05,172.217.160.0-255,7156,11890,1,295875
11349,6.4e-05,172.31.36.0-255,66,11956,1,295875
11350,6.8e-05,172.217.160.0-255,1993,13949,1,295875
11351,7.1e-05,172.31.36.0-255,66,14015,1,295875
11352,7.4e-05,172.217.160.0-255,1484,15499,1,295875
11353,7.6e-05,172.31.36.0-255,66,15565,1,295875
11354,0.000106,172.217.160.0-255,1484,17049,1,295875
11355,0.000109,172.31.36.0-255,66,17115,1,295875
11356,0.000116,172.217.160.0-255,7156,24271,1,295875
11357,0.000118,172.31.36.0-255,66,24337,1,295875
11358,0.000125,172.217.160.0-255,6797,31134,1,295875
11359,0.000127,172.31.36.0-255,66,31200,1,295875
11360,0.000226,172.217.160.0-255,1484,32684,1,295875
11361,0.00023,172.31.36.0-255,66,32750,1,295875
11362,0.000235,172.217.160.0-255,2902,35652,1,295875
11363,0.000237,172.31.36.0-255,66,35718,1,295875
11364,0.000241,172.217.160.0-255,1484,37202,1,295875
11365,0.000243,172.31.36.0-255,66,37268,1,295875
11366,0.000266,172.217.160.0-255,4320,41588,1,295875
11367,0.00027,172.31.36.0-255,66,41654,1,295875
11368,0.000276,172.217.160.0-255,6797,48451,1,295875
11369,0.000279,172.31.36.0-255,66,48517,1,295875
11370,0.000301,172.217.160.0-255,4320,52837,1,295875
11371,0.000304,172.31.36.0-255,66,52903,1,295875
11372,0.000327,172.217.160.0-255,2902,55805,1,295875
11373,0.000333,172.217.160.0-255,5738,61543,1,295875
11374,0.000333,172.31.36.0-255,66,61609,1,295875
11375,0.000336,172.31.36.0-255,66,61675,1,295875
11376,0.000363,172.217.160.0-255,4270,65945,1,295875
11377,0.000367,172.31.36.0-255,66,66011,1,295875
11378,0.001111,172.217.160.0-255,100,66111,1,295875
11379,0.001201,172.217.160.0-255,1484,67595,1,295875
11380,0.001207,172.31.36.0-255,66,67661,1,295875
11381,0.001219,172.217.160.0-255,1484,69145,1,295875
11382,0.001237,172.217.160.0-255,2902,72047,1,295875
11383,0.001239,172.31.36.0-255,66,72113,1,295875
11384,0.001246,172.217.160.0-255,5738,77851,1,295875
11385,0.001248,172.31.36.0-255,66,77917,1,295875
11386,0.001287,172.217.160.0-255,5379,83296,1,295875
11387,0.00129,172.31.36.0-255,66,83362,1,295875
11388,0.001294,172.217.160.0-255,1484,84846,1,295875
11389,0.001314,172.217.160.0-255,4320,89166,1,295875
11390,0.001317,172.31.36.0-255,66,89232,1,295875
11391,0.001338,172.217.160.0-255,1484,90716,1,295875
11392,0.001364,172.31.36.0-255,66,90782,1,295875
11393,0.00138,172.217.160.0-255,1424,92206,1,295875
11394,0.001579,172.217.160.0-255,1484,93690,1,295875
11395,0.001581,172.31.36.0-255,66,93756,1,295875
11396,0.001585,172.217.160.0-255,1484,95240,1,295875
11397,0.001605,172.217.160.0-255,1484,96724,1,295875
11398,0.001607,172.31.36.0-255,66,96790,1,295875
11399,0.001613,172.217.160.0-255,5738,102528,1,295875
11400,0.001615,172.31.36.0-255,66,102594,1,295875
11401,0.001618,172.217.160.0-255,1484,104078,1,295875
11402,0.001631,172.217.160.0-255,4320,108398,1,295875
11403,0.001633,172.31.36.0-255,66,108464,1,295875
11404,0.001658,172.217.160.0-255,7156,115620,1,295875
11405,0.00166,172.31.36.0-255,66,115686,1,295875
11406,0.001668,172.217.160.0-255,7156,122842,1,295875
11407,0.00167,172.31.36.0-255,66,122908,1,295875
11408,0.001687,172.217.160.0-255,3602,126510,1,295875
11409,0.001689,172.31.36.0-255,66,126576,1,295875
11410,0.001786,172.217.160.0-255,1484,128060,1,295875
11411,0.00179,172.217.160.0-255,2902,130962,1,295875
11412,0.001794,172.31.36.0-255,66,131028,1,295875
11413,0.001817,172.217.160.0-255,5738,136766,1,295875
11414,0.00182,172.31.36.0-255,66,136832,1,295875
11415,0.001834,172.217.160.0-255,4320,141152,1,295875
11416,0.001836,172.31.36.0-255,66,141218,1,295875
11417,0.001855,172.31.36.0-255,66,141284,1,295875
11418,0.001866,172.31.36.0-255,66,141350,1,295875
11419,0.003749,172.217.160.0-255,2902,144252,1,295875
11420,0.003752,172.31.36.0-255,66,144318,1,295875
11421,0.00377,172.217.160.0-255,2902,147220,1,295875
11422,0.003772,172.31.36.0-255,66,147286,1,295875
11423,0.005639,172.217.160.0-255,2902,150188,1,295875
11424,0.005643,172.31.36.0-255,66,150254,1,295875
11425,0.005662,172.217.160.0-255,2902,153156,1,295875
11426,0.005665,172.31.36.0-255,66,153222,1,295875
11427,0.007537,172.217.160.0-255,2902,156124,1,295875
11428,0.007543,172.31.36.0-255,66,156190,1,295875
11429,0.007564,172.217.160.0-255,2902,159092,1,295875
11430,0.007567,172.31.36.0-255,66,159158,1,295875
11431,0.009448,172.217.160.0-255,5738,164896,1,295875
11432,0.009456,172.31.36.0-255,66,164962,1,295875
11433,0.011375,172.217.160.0-255,5738,170700,1,295875
11434,0.011383,172.31.36.0-255,66,170766,1,295875
11435,0.013301,172.217.160.0-255,5738,176504,1,295875
11436,0.013309,172.31.36.0-255,66,176570,1,295875
11437,0.015208,172.217.160.0-255,5738,182308,1,295875
11438,0.015217,172.31.36.0-255,66,182374,1,295875
11439,0.017159,172.217.160.0-255,5738,188112,1,295875
11440,0.017166,172.31.36.0-255,66,188178,1,295875
11441,0.019071,172.217.160.0-255,5738,193916,1,295875
11442,0.019078,172.31.36.0-255,66,193982,1,295875
11443,0.020986,172.217.160.0-255,5738,199720,1,295875
11444,0.020993,172.31.36.0-255,66,199786,1,295875
11445,0.02289,172.217.160.0-255,5738,205524,1,295875
11446,0.022897,172.31.36.0-255,66,205590,1,295875
11447,0.024816,172.217.160.0-255,5738,211328,1,295875
11448,0.024823,172.31.36.0-255,66,211394,1,295875
11449,0.026723,172.217.160.0-255,5738,217132,1,295875
11450,0.026729,172.31.36.0-255,66,217198,1,295875
11451,0.02863,172.217.160.0-255,5738,222936,1,295875
11452,0.028638,172.31.36.0-255,66,223002,1,295875
11453,0.030577,172.217.160.0-255,5738,228740,1,295875
11454,0.030586,172.31.36.0-255,66,228806,1,295875
11455,0.032487,172.217.160.0-255,5738,234544,1,295875
11456,0.032495,172.31.36.0-255,66,234610,1,295875
11457,0.033419,172.31.36.0-255,172,234782,1,295875
11458,0.03357,172.31.36.0-255,1113,235895,1,295875
11459,0.033623,172.31.36.0-255,1514,237409,1,295875
11460,0.033625,172.31.36.0-255,1514,238923,1,295875
11461,0.033632,172.31.36.0-255,1514,240437,1,295875
11462,0.033633,172.31.36.0-255,1514,241951,1,295875
11463,0.033655,172.31.36.0-255,1490,243441,1,295875
11464,0.034466,172.217.160.0-255,5738,249179,1,295875
11465,0.034471,172.31.36.0-255,66,249245,1,295875
11466,0.034979,104.244.42.0-255,66,249311,1,295875
11467,0.035151,104.244.42.0-255,66,249377,1,295875
11468,0.03518,104.244.42.0-255,66,249443,1,295875
11469,0.036365,172.217.160.0-255,5738,255181,1,295875
11470,0.036371,172.31.36.0-255,66,255247,1,295875
11471,0.038268,172.217.160.0-255,5738,260985,1,295875
11472,0.038274,172.31.36.0-255,66,261051,1,295875
11473,0.040158,172.217.160.0-255,5738,266789,1,295875
11474,0.040176,172.31.36.0-255,66,266855,1,295875
11475,0.042067,172.217.160.0-255,5738,272593,1,295875
11476,0.042074,172.31.36.0-255,66,272659,1,295875
11477,0.043968,172.217.160.0-255,5738,278397,1,295875
11478,0.043972,172.31.36.0-255,66,278463,1,295875
11479,0.045891,172.217.160.0-255,5738,284201,1,295875
11480,0.045898,172.31.36.0-255,66,284267,1,295875
11481,0.0478,172.217.160.0-255,5738,290005,1,295875
11482,0.047805,172.31.36.0-255,66,290071,1,295875
11483,0.0497,172.217.160.0-255,5738,295809,1,295875
11484,0.049705,172.31.36.0-255,66,295875,1,295875
11485,0.0,172.217.160.0-255,146,146,1,295763
11486,2.4e-05,172.31.36.0-255,66,212,1,295763
11487,3e-05,172.217.160.0-255,1484,1696,1,295763
11488,3.5e-05,172.31.36.0-255,66,1762,1,295763
11489,4.1e-05,172.217.160.0-255,2902,4664,1,295763
11490,4.4e-05,172.31.36.0-255,66,4730,1,295763
11491,5.2e-05,172.217.160.0-255,7156,11886,1,295763
11492,5.5e-05,172.31.36.0-255,66,11952,1,295763
11493,8.7e-05,172.217.160.0-255,1484,13436,1,295763
11494,9e-05,172.31.36.0-255,66,13502,1,295763
11495,0.000108,172.217.160.0-255,6242,19744,1,295763
11496,0.00011,172.31.36.0-255,66,19810,1,295763
11497,0.000165,172.217.160.0-255,7156,26966,1,295763
11498,0.000169,172.31.36.0-255,66,27032,1,295763
11499,0.000189,172.217.160.0-255,3961,30993,1,295763
11500,0.000193,172.31.36.0-255,66,31059,1,295763
11501,0.000264,172.217.160.0-255,7156,38215,1,295763
11502,0.000268,172.31.36.0-255,66,38281,1,295763
11503,0.000294,172.31.36.0-255,66,38347,1,295763
11504,0.000419,172.31.36.0-255,66,38413,1,295763
11505,0.000441,172.217.160.0-255,6797,45210,1,295763
11506,0.000444,172.31.36.0-255,66,45276,1,295763
11507,0.000538,172.217.160.0-255,334,45610,1,295763
11508,0.000544,172.31.36.0-255,66,45676,1,295763
11509,0.000612,172.217.160.0-255,125,45801,1,295763
11510,0.000616,172.31.36.0-255,66,45867,1,295763
11511,0.00072,172.217.160.0-255,1484,47351,1,295763
11512,0.000724,172.31.36.0-255,66,47417,1,295763
11513,0.00073,172.217.160.0-255,2902,50319,1,295763
11514,0.000733,172.31.36.0-255,66,50385,1,295763
11515,0.000737,172.217.160.0-255,1484,51869,1,295763
11516,0.000764,172.217.160.0-255,4320,56189,1,295763
11517,0.000767,172.31.36.0-255,66,56255,1,295763
11518,0.000785,172.217.160.0-255,1484,57739,1,295763
11519,0.000805,172.217.160.0-255,5379,63118,1,295763
11520,0.000808,172.31.36.0-255,66,63184,1,295763
11521,0.000848,172.217.160.0-255,2902,66086,1,295763
11522,0.000851,172.31.36.0-255,66,66152,1,295763
11523,0.00088,172.31.36.0-255,66,66218,1,295763
11524,0.000982,172.217.160.0-255,2858,69076,1,295763
11525,0.000985,172.31.36.0-255,66,69142,1,295763
11526,0.001004,172.217.160.0-255,2902,72044,1,295763
11527,0.001007,172.31.36.0-255,66,72110,1,295763
11528,0.001027,172.217.160.0-255,4320,76430,1,295763
11529,0.00103,172.31.36.0-255,66,76496,1,295763
11530,0.00105,172.217.160.0-255,2902,79398,1,295763
11531,0.001052,172.31.36.0-255,66,79464,1,295763
11532,0.001094,172.217.160.0-255,1484,80948,1,295763
11533,0.001103,172.217.160.0-255,7156,88104,1,295763
11534,0.001105,172.31.36.0-255,66,88170,1,295763
11535,0.001131,172.217.160.0-255,7156,95326,1,295763
11536,0.001133,172.31.36.0-255,66,95392,1,295763
11537,0.001242,172.31.36.0-255,66,95458,1,295763
11538,0.001297,172.217.160.0-255,1484,96942,1,295763
11539,0.001315,172.217.160.0-255,2902,99844,1,295763
11540,0.001324,172.31.36.0-255,66,99910,1,295763
11541,0.001348,172.217.160.0-255,5738,105648,1,295763
11542,0.001351,172.31.36.0-255,66,105714,1,295763
11543,0.00139,172.217.160.0-255,4320,110034,1,295763
11544,0.001393,172.31.36.0-255,66,110100,1,295763
11545,0.001434,172.217.160.0-255,5738,115838,1,295763
11546,0.001437,172.31.36.0-255,66,115904,1,295763
11547,0.001478,172.31.36.0-255,66,115970,1,295763
11548,0.001568,172.217.160.0-255,1484,117454,1,295763
11549,0.001585,172.217.160.0-255,2184,119638,1,295763
11550,0.00159,172.31.36.0-255,66,119704,1,295763
11551,0.003094,172.217.160.0-255,1484,121188,1,295763
11552,0.003199,172.217.160.0-255,4320,125508,1,295763
11553,0.003204,172.31.36.0-255,66,125574,1,295763
11554,0.00483,172.217.160.0-255,5738,131312,1,295763
11555,0.004836,172.31.36.0-255,66,131378,1,295763
11556,0.006454,172.217.160.0-255,5738,137116,1,295763
11557,0.006459,172.31.36.0-255,66,137182,1,295763
11558,0.008081,172.217.160.0-255,5738,142920,1,295763
11559,0.008087,172.31.36.0-255,66,142986,1,295763
11560,0.009708,172.217.160.0-255,5738,148724,1,295763
11561,0.009717,172.31.36.0-255,66,148790,1,295763
11562,0.011346,172.217.160.0-255,5738,154528,1,295763
11563,0.011353,172.31.36.0-255,66,154594,1,295763
11564,0.012978,172.217.160.0-255,5738,160332,1,295763
11565,0.012987,172.31.36.0-255,66,160398,1,295763
11566,0.014616,172.217.160.0-255,5738,166136,1,295763
11567,0.014624,172.31.36.0-255,66,166202,1,295763
11568,0.016254,172.217.160.0-255,5738,171940,1,295763
11569,0.016264,172.31.36.0-255,66,172006,1,295763
11570,0.017894,172.217.160.0-255,5738,177744,1,295763
11571,0.017902,172.31.36.0-255,66,177810,1,295763
11572,0.019519,172.217.160.0-255,5738,183548,1,295763
11573,0.019524,172.31.36.0-255,66,183614,1,295763
11574,0.021151,172.217.160.0-255,4320,187934,1,295763
11575,0.021157,172.31.36.0-255,66,188000,1,295763
11576,0.021175,172.217.160.0-255,1484,189484,1,295763
11577,0.02278,172.217.160.0-255,4320,193804,1,295763
11578,0.022787,172.31.36.0-255,66,193870,1,295763
11579,0.024454,172.217.160.0-255,5738,199608,1,295763
11580,0.024462,172.31.36.0-255,66,199674,1,295763
11581,0.026096,172.217.160.0-255,5738,205412,1,295763
11582,0.026103,172.31.36.0-255,66,205478,1,295763
11583,0.027739,172.217.160.0-255,5738,211216,1,295763
11584,0.027746,172.31.36.0-255,66,211282,1,295763
11585,0.029387,172.217.160.0-255,5738,217020,1,295763
11586,0.029395,172.31.36.0-255,66,217086,1,295763
11587,0.03104,172.217.160.0-255,5738,222824,1,295763
11588,0.031049,172.31.36.0-255,66,222890,1,295763
11589,0.03269,172.217.160.0-255,5738,228628,1,295763
11590,0.032699,172.31.36.0-255,66,228694,1,295763
11591,0.034466,172.217.160.0-255,5738,234432,1,295763
11592,0.034475,172.31.36.0-255,66,234498,1,295763
11593,0.036129,172.217.160.0-255,5738,240236,1,295763
11594,0.036136,172.31.36.0-255,66,240302,1,295763
11595,0.037758,172.217.160.0-255,5738,246040,1,295763
11596,0.037766,172.31.36.0-255,66,246106,1,295763
11597,0.039395,172.217.160.0-255,5738,251844,1,295763
11598,0.039402,172.31.36.0-255,66,251910,1,295763
11599,0.040094,172.31.36.0-255,172,252082,1,295763
11600,0.040124,172.31.36.0-255,1114,253196,1,295763
11601,0.040194,172.31.36.0-255,1514,254710,1,295763
11602,0.040196,172.31.36.0-255,1514,256224,1,295763
11603,0.040197,172.31.36.0-255,1514,257738,1,295763
11604,0.040198,172.31.36.0-255,1514,259252,1,295763
11605,0.040226,172.31.36.0-255,1489,260741,1,295763
11606,0.041025,172.217.160.0-255,5738,266479,1,295763
11607,0.041032,172.31.36.0-255,66,266545,1,295763
11608,0.041634,104.244.42.0-255,66,266611,1,295763
11609,0.041643,104.244.42.0-255,66,266677,1,295763
11610,0.041787,104.244.42.0-255,66,266743,1,295763
11611,0.042654,172.217.160.0-255,5738,272481,1,295763
11612,0.042661,172.31.36.0-255,66,272547,1,295763
11613,0.044285,172.217.160.0-255,5738,278285,1,295763
11614,0.044292,172.31.36.0-255,66,278351,1,295763
11615,0.045915,172.217.160.0-255,5738,284089,1,295763
11616,0.045921,172.31.36.0-255,66,284155,1,295763
11617,0.047543,172.217.160.0-255,5738,289893,1,295763
11618,0.047549,172.31.36.0-255,66,289959,1,295763
11619,0.049208,172.217.160.0-255,5738,295697,1,295763
11620,0.04922,172.31.36.0-255,66,295763,1,295763
11621,0.0,74.125.24.0-255,152,152,1,268415
11622,2.6e-05,172.31.36.0-255,66,218,1,268415
11623,3.2e-05,74.125.24.0-255,1484,1702,1,268415
11624,3.6e-05,172.31.36.0-255,66,1768,1,268415
11625,4e-05,74.125.24.0-255,2902,4670,1,268415
11626,5.1e-05,172.31.36.0-255,66,4736,1,268415
11627,5.8e-05,74.125.24.0-255,7156,11892,1,268415
11628,6.1e-05,172.31.36.0-255,66,11958,1,268415
11629,6.5e-05,74.125.24.0-255,2053,14011,1,268415
11630,6.8e-05,172.31.36.0-255,66,14077,1,268415
11631,0.000109,172.31.36.0-255,66,14143,1,268415
11632,0.000116,74.125.24.0-255,5379,19522,1,268415
11633,0.000118,172.31.36.0-255,66,19588,1,268415
11634,0.000767,74.125.24.0-255,1484,21072,1,268415
11635,0.000774,172.31.36.0-255,66,21138,1,268415
11636,0.000784,74.125.24.0-255,2902,24040,1,268415
11637,0.000786,172.31.36.0-255,66,24106,1,268415
11638,0.000802,74.125.24.0-255,5738,29844,1,268415
11639,0.000805,172.31.36.0-255,66,29910,1,268415
11640,0.000812,74.125.24.0-255,7156,37066,1,268415
11641,0.000814,172.31.36.0-255,66,37132,1,268415
11642,0.000865,74.125.24.0-255,6797,43929,1,268415
11643,0.000868,172.31.36.0-255,66,43995,1,268415
11644,0.000875,74.125.24.0-255,7156,51151,1,268415
11645,0.000877,172.31.36.0-255,66,51217,1,268415
11646,0.000881,74.125.24.0-255,2822,54039,1,268415
11647,0.000883,172.31.36.0-255,66,54105,1,268415
11648,0.000886,74.125.24.0-255,131,54236,1,268415
11649,0.000888,172.31.36.0-255,66,54302,1,268415
11650,0.001,74.125.24.0-255,1484,55786,1,268415
11651,0.001005,172.31.36.0-255,66,55852,1,268415
11652,0.001011,74.125.24.0-255,2902,58754,1,268415
11653,0.001015,172.31.36.0-255,66,58820,1,268415
11654,0.001027,74.125.24.0-255,5738,64558,1,268415
11655,0.001031,172.31.36.0-255,66,64624,1,268415
11656,0.001034,74.125.24.0-255,1484,66108,1,268415
11657,0.00108,172.31.36.0-255,66,66174,1,268415
11658,0.001097,172.31.36.0-255,66,66240,1,268415
11659,0.00111,172.31.36.0-255,66,66306,1,268415
11660,0.001113,74.125.24.0-255,1484,67790,1,268415
11661,0.001149,74.125.24.0-255,5738,73528,1,268415
11662,0.001152,172.31.36.0-255,66,73594,1,268415
11663,0.00116,172.31.36.0-255,66,73660,1,268415
11664,0.001189,74.125.24.0-255,3602,77262,1,268415
11665,0.001191,172.31.36.0-255,66,77328,1,268415
11666,0.001196,74.125.24.0-255,4320,81648,1,268415
11667,0.001198,172.31.36.0-255,66,81714,1,268415
11668,0.001255,172.31.36.0-255,66,81780,1,268415
11669,0.00127,172.31.36.0-255,66,81846,1,268415
11670,0.001274,74.125.24.0-255,3602,85448,1,268415
11671,0.001276,172.31.36.0-255,66,85514,1,268415
11672,0.00161,74.125.24.0-255,1484,86998,1,268415
11673,0.001614,74.125.24.0-255,2902,89900,1,268415
11674,0.001617,172.31.36.0-255,66,89966,1,268415
11675,0.001641,74.125.24.0-255,5738,95704,1,268415
11676,0.001644,172.31.36.0-255,66,95770,1,268415
11677,0.001646,74.125.24.0-255,1484,97254,1,268415
11678,0.001683,172.31.36.0-255,66,97320,1,268415
11679,0.001699,172.31.36.0-255,66,97386,1,268415
11680,0.001741,74.125.24.0-255,1484,98870,1,268415
11681,0.001763,74.125.24.0-255,2902,101772,1,268415
11682,0.001766,172.31.36.0-255,66,101838,1,268415
11683,0.001771,74.125.24.0-255,5738,107576,1,268415
11684,0.001774,172.31.36.0-255,66,107642,1,268415
11685,0.001782,74.125.24.0-255,2902,110544,1,268415
11686,0.001784,172.31.36.0-255,66,110610,1,268415
11687,0.001826,172.31.36.0-255,66,110676,1,268415
11688,0.001831,74.125.24.0-255,4320,114996,1,268415
11689,0.001834,172.31.36.0-255,66,115062,1,268415
11690,0.001855,74.125.24.0-255,6438,121500,1,268415
11691,0.001871,172.31.36.0-255,66,121566,1,268415
11692,0.002069,74.125.24.0-255,1484,123050,1,268415
11693,0.002077,74.125.24.0-255,2902,125952,1,268415
11694,0.00208,172.31.36.0-255,66,126018,1,268415
11695,0.002087,74.125.24.0-255,5738,131756,1,268415
11696,0.00209,172.31.36.0-255,66,131822,1,268415
11697,0.002118,74.125.24.0-255,2902,134724,1,268415
11698,0.002121,172.31.36.0-255,66,134790,1,268415
11699,0.002162,172.31.36.0-255,66,134856,1,268415
11700,0.002169,74.125.24.0-255,7156,142012,1,268415
11701,0.002172,172.31.36.0-255,66,142078,1,268415
11702,0.002202,74.125.24.0-255,3602,145680,1,268415
11703,0.002206,172.31.36.0-255,66,145746,1,268415
11704,0.002592,74.125.24.0-255,1484,147230,1,268415
11705,0.002599,74.125.24.0-255,2902,150132,1,268415
11706,0.002603,172.31.36.0-255,66,150198,1,268415
11707,0.002626,74.125.24.0-255,5738,155936,1,268415
11708,0.002631,172.31.36.0-255,66,156002,1,268415
11709,0.005258,74.125.24.0-255,5738,161740,1,268415
11710,0.005265,172.31.36.0-255,66,161806,1,268415
11711,0.00787,74.125.24.0-255,5738,167544,1,268415
11712,0.007876,172.31.36.0-255,66,167610,1,268415
11713,0.010489,74.125.24.0-255,5738,173348,1,268415
11714,0.010495,172.31.36.0-255,66,173414,1,268415
11715,0.013085,74.125.24.0-255,5738,179152,1,268415
11716,0.013093,172.31.36.0-255,66,179218,1,268415
11717,0.015706,74.125.24.0-255,5738,184956,1,268415
11718,0.015717,172.31.36.0-255,66,185022,1,268415
11719,0.018295,74.125.24.0-255,4320,189342,1,268415
11720,0.018303,172.31.36.0-255,66,189408,1,268415
11721,0.018337,74.125.24.0-255,1484,190892,1,268415
11722,0.020902,74.125.24.0-255,4320,195212,1,268415
11723,0.020913,172.31.36.0-255,66,195278,1,268415
11724,0.023537,74.125.24.0-255,5738,201016,1,268415
11725,0.023545,172.31.36.0-255,66,201082,1,268415
11726,0.02615,74.125.24.0-255,5738,206820,1,268415
11727,0.026157,172.31.36.0-255,66,206886,1,268415
11728,0.028746,74.125.24.0-255,5738,212624,1,268415
11729,0.028753,172.31.36.0-255,66,212690,1,268415
11730,0.031346,74.125.24.0-255,5738,218428,1,268415
11731,0.031354,172.31.36.0-255,66,218494,1,268415
11732,0.033955,74.125.24.0-255,5738,224232,1,268415
11733,0.033962,172.31.36.0-255,66,224298,1,268415
11734,0.034751,172.31.36.0-255,172,224470,1,268415
11735,0.034779,172.31.36.0-255,1115,225585,1,268415
11736,0.034836,172.31.36.0-255,1514,227099,1,268415
11737,0.034838,172.31.36.0-255,1514,228613,1,268415
11738,0.03484,172.31.36.0-255,1514,230127,1,268415
11739,0.034845,172.31.36.0-255,1514,231641,1,268415
11740,0.034846,172.31.36.0-255,1488,233129,1,268415
11741,0.036295,104.244.42.0-255,66,233195,1,268415
11742,0.036336,104.244.42.0-255,66,233261,1,268415
11743,0.036379,104.244.42.0-255,66,233327,1,268415
11744,0.036553,74.125.24.0-255,5738,239065,1,268415
11745,0.036559,172.31.36.0-255,66,239131,1,268415
11746,0.039142,74.125.24.0-255,5738,244869,1,268415
11747,0.039147,172.31.36.0-255,66,244935,1,268415
11748,0.041716,74.125.24.0-255,5738,250673,1,268415
11749,0.041721,172.31.36.0-255,66,250739,1,268415
11750,0.04432,74.125.24.0-255,5738,256477,1,268415
11751,0.044326,172.31.36.0-255,66,256543,1,268415
11752,0.046922,74.125.24.0-255,2902,259445,1,268415
11753,0.046927,172.31.36.0-255,66,259511,1,268415
11754,0.046959,74.125.24.0-255,2902,262413,1,268415
11755,0.046965,172.31.36.0-255,66,262479,1,268415
11756,0.049514,74.125.24.0-255,2902,265381,1,268415
11757,0.04952,172.31.36.0-255,66,265447,1,268415
11758,0.049558,74.125.24.0-255,2902,268349,1,268415
11759,0.049561,172.31.36.0-255,66,268415,1,268415
11760,0.0,74.125.24.0-255,146,146,1,226708
11761,3.2e-05,172.31.36.0-255,66,212,1,226708
11762,3.9e-05,74.125.24.0-255,1484,1696,1,226708
11763,4.3e-05,172.31.36.0-255,66,1762,1,226708
11764,4.8e-05,74.125.24.0-255,2902,4664,1,226708
11765,5.1e-05,172.31.36.0-255,66,4730,1,226708
11766,5.8e-05,74.125.24.0-255,7156,11886,1,226708
11767,6e-05,172.31.36.0-255,66,11952,1,226708
11768,6.4e-05,74.125.24.0-255,2055,14007,1,226708
11769,6.5e-05,172.31.36.0-255,66,14073,1,226708
11770,0.000101,74.125.24.0-255,7156,21229,1,226708
11771,0.000104,172.31.36.0-255,66,21295,1,226708
11772,0.000125,74.125.24.0-255,4320,25615,1,226708
11773,0.000128,172.31.36.0-255,66,25681,1,226708
11774,0.000134,74.125.24.0-255,5379,31060,1,226708
11775,0.000137,172.31.36.0-255,66,31126,1,226708
11776,0.000189,74.125.24.0-255,1484,32610,1,226708
11777,0.000192,172.31.36.0-255,66,32676,1,226708
11778,0.000222,74.125.24.0-255,1484,34160,1,226708
11779,0.000225,172.31.36.0-255,66,34226,1,226708
11780,0.000231,74.125.24.0-255,2902,37128,1,226708
11781,0.000232,172.31.36.0-255,66,37194,1,226708
11782,0.000258,74.125.24.0-255,5738,42932,1,226708
11783,0.000261,172.31.36.0-255,66,42998,1,226708
11784,0.000268,74.125.24.0-255,7156,50154,1,226708
11785,0.000271,172.31.36.0-255,66,50220,1,226708
11786,0.000293,172.31.36.0-255,66,50286,1,226708
11787,0.000317,74.125.24.0-255,4320,54606,1,226708
11788,0.000319,172.31.36.0-255,66,54672,1,226708
11789,0.000322,74.125.24.0-255,1058,55730,1,226708
11790,0.000324,172.31.36.0-255,66,55796,1,226708
11791,0.000361,74.125.24.0-255,385,56181,1,226708
11792,0.000365,172.31.36.0-255,66,56247,1,226708
11793,0.000831,74.125.24.0-255,1484,57731,1,226708
11794,0.000836,172.31.36.0-255,66,57797,1,226708
11795,0.000842,74.125.24.0-255,2902,60699,1,226708
11796,0.000844,172.31.36.0-255,66,60765,1,226708
11797,0.000847,74.125.24.0-255,1484,62249,1,226708
11798,0.000848,172.31.36.0-255,66,62315,1,226708
11799,0.000877,74.125.24.0-255,4320,66635,1,226708
11800,0.000882,172.31.36.0-255,66,66701,1,226708
11801,0.000889,74.125.24.0-255,5738,72439,1,226708
11802,0.000891,172.31.36.0-255,66,72505,1,226708
11803,0.000898,74.125.24.0-255,7156,79661,1,226708
11804,0.000902,172.31.36.0-255,66,79727,1,226708
11805,0.000933,172.31.36.0-255,66,79793,1,226708
11806,0.002187,74.125.24.0-255,1484,81277,1,226708
11807,0.002196,172.31.36.0-255,66,81343,1,226708
11808,0.002205,74.125.24.0-255,2902,84245,1,226708
11809,0.002207,172.31.36.0-255,66,84311,1,226708
11810,0.002213,74.125.24.0-255,5738,90049,1,226708
11811,0.002215,172.31.36.0-255,66,90115,1,226708
11812,0.002244,74.125.24.0-255,7156,97271,1,226708
11813,0.002247,172.31.36.0-255,66,97337,1,226708
11814,0.002262,74.125.24.0-255,2902,100239,1,226708
11815,0.002264,172.31.36.0-255,66,100305,1,226708
11816,0.002288,172.31.36.0-255,66,100371,1,226708
11817,0.002292,74.125.24.0-255,2184,102555,1,226708
11818,0.002293,172.31.36.0-255,66,102621,1,226708
11819,0.00455,74.125.24.0-255,5738,108359,1,226708
11820,0.004552,172.31.36.0-255,66,108425,1,226708
11821,0.006838,74.125.24.0-255,5738,114163,1,226708
11822,0.006844,172.31.36.0-255,66,114229,1,226708
11823,0.009122,74.125.24.0-255,5738,119967,1,226708
11824,0.00913,172.31.36.0-255,66,120033,1,226708
11825,0.011428,74.125.24.0-255,5738,125771,1,226708
11826,0.011434,172.31.36.0-255,66,125837,1,226708
11827,0.013717,74.125.24.0-255,5738,131575,1,226708
11828,0.013723,172.31.36.0-255,66,131641,1,226708
11829,0.016016,74.125.24.0-255,5738,137379,1,226708
11830,0.016025,172.31.36.0-255,66,137445,1,226708
11831,0.018313,74.125.24.0-255,5738,143183,1,226708
11832,0.018324,172.31.36.0-255,66,143249,1,226708
11833,0.020591,74.125.24.0-255,5738,148987,1,226708
11834,0.020598,172.31.36.0-255,66,149053,1,226708
11835,0.022878,74.125.24.0-255,5738,154791,1,226708
11836,0.022885,172.31.36.0-255,66,154857,1,226708
11837,0.025152,74.125.24.0-255,5738,160595,1,226708
11838,0.02516,172.31.36.0-255,66,160661,1,226708
11839,0.027432,74.125.24.0-255,5738,166399,1,226708
11840,0.027438,172.31.36.0-255,66,166465,1,226708
11841,0.02972,74.125.24.0-255,2902,169367,1,226708
11842,0.029726,172.31.36.0-255,66,169433,1,226708
11843,0.029761,74.125.24.0-255,2902,172335,1,226708
11844,0.029764,172.31.36.0-255,66,172401,1,226708
11845,0.032021,74.125.24.0-255,2902,175303,1,226708
11846,0.032028,172.31.36.0-255,66,175369,1,226708
11847,0.032047,74.125.24.0-255,2902,178271,1,226708
11848,0.03205,172.31.36.0-255,66,178337,1,226708
11849,0.033457,172.31.36.0-255,172,178509,1,226708
11850,0.033486,172.31.36.0-255,1115,179624,1,226708
11851,0.03352,172.31.36.0-255,1514,181138,1,226708
11852,0.033521,172.31.36.0-255,1514,182652,1,226708
11853,0.033526,172.31.36.0-255,1514,184166,1,226708
11854,0.033527,172.31.36.0-255,1514,185680,1,226708
11855,0.033555,172.31.36.0-255,1488,187168,1,226708
11856,0.034316,74.125.24.0-255,5738,192906,1,226708
11857,0.034322,172.31.36.0-255,66,192972,1,226708
11858,0.035013,104.244.42.0-255,66,193038,1,226708
11859,0.035064,104.244.42.0-255,66,193104,1,226708
11860,0.035162,104.244.42.0-255,66,193170,1,226708
11861,0.036611,74.125.24.0-255,5738,198908,1,226708
11862,0.036616,172.31.36.0-255,66,198974,1,226708
11863,0.03889,74.125.24.0-255,4320,203294,1,226708
11864,0.038896,172.31.36.0-255,66,203360,1,226708
11865,0.038944,74.125.24.0-255,1484,204844,1,226708
11866,0.041168,74.125.24.0-255,4320,209164,1,226708
11867,0.041173,172.31.36.0-255,66,209230,1,226708
11868,0.043465,74.125.24.0-255,5738,214968,1,226708
11869,0.043471,172.31.36.0-255,66,215034,1,226708
11870,0.045727,74.125.24.0-255,1484,216518,1,226708
11871,0.045766,74.125.24.0-255,4320,220838,1,226708
11872,0.045772,172.31.36.0-255,66,220904,1,226708
11873,0.048082,74.125.24.0-255,5738,226642,1,226708
11874,0.048088,172.31.36.0-255,66,226708,1,226708
11875,0.0,172.31.36.0-255,66,66,1,66
11876,0.0,74.125.130.0-255,153,153,1,287234
11877,3.1e-05,172.31.36.0-255,66,219,1,287234
11878,3.8e-05,74.125.130.0-255,1484,1703,1,287234
11879,4.2e-05,172.31.36.0-255,66,1769,1,287234
11880,4.8e-05,74.125.130.0-255,2902,4671,1,287234
11881,5e-05,172.31.36.0-255,66,4737,1,287234
11882,5.7e-05,74.125.130.0-255,7156,11893,1,287234
11883,6e-05,172.31.36.0-255,66,11959,1,287234
11884,6.3e-05,74.125.130.0-255,1996,13955,1,287234
11885,6.6e-05,172.31.36.0-255,66,14021,1,287234
11886,0.000186,74.125.130.0-255,1484,15505,1,287234
11887,0.000191,172.31.36.0-255,66,15571,1,287234
11888,0.000205,74.125.130.0-255,2902,18473,1,287234
11889,0.000208,172.31.36.0-255,66,18539,1,287234
11890,0.000221,74.125.130.0-255,2902,21441,1,287234
11891,0.000225,172.31.36.0-255,66,21507,1,287234
11892,0.000243,74.125.130.0-255,1484,22991,1,287234
11893,0.000246,172.31.36.0-255,66,23057,1,287234
11894,0.000249,74.125.130.0-255,1484,24541,1,287234
11895,0.000251,172.31.36.0-255,66,24607,1,287234
11896,0.000273,74.125.130.0-255,6797,31404,1,287234
11897,0.000276,172.31.36.0-255,66,31470,1,287234
11898,0.000302,74.125.130.0-255,4320,35790,1,287234
11899,0.000306,172.31.36.0-255,66,35856,1,287234
11900,0.000325,74.125.130.0-255,4320,40176,1,287234
11901,0.000329,172.31.36.0-255,66,40242,1,287234
11902,0.00036,74.125.130.0-255,5738,45980,1,287234
11903,0.000364,172.31.36.0-255,66,46046,1,287234
11904,0.000382,74.125.130.0-255,2543,48589,1,287234
11905,0.000385,172.31.36.0-255,66,48655,1,287234
11906,0.000429,74.125.130.0-255,1484,50139,1,287234
11907,0.000432,172.31.36.0-255,66,50205,1,287234
11908,0.000437,74.125.130.0-255,2902,53107,1,287234
11909,0.000448,172.31.36.0-255,66,53173,1,287234
11910,0.000451,74.125.130.0-255,1484,54657,1,287234
11911,0.000454,74.125.130.0-255,1484,56141,1,287234
11912,0.000466,172.31.36.0-255,66,56207,1,287234
11913,0.000467,74.125.130.0-255,1484,57691,1,287234
11914,0.000479,74.125.130.0-255,1484,59175,1,287234
11915,0.000481,172.31.36.0-255,66,59241,1,287234
11916,0.000499,74.125.130.0-255,4320,63561,1,287234
11917,0.000504,74.125.130.0-255,2831,66392,1,287234
11918,0.000511,172.31.36.0-255,66,66458,1,287234
11919,0.00052,74.125.130.0-255,98,66556,1,287234
11920,0.000648,74.125.130.0-255,1484,68040,1,287234
11921,0.000654,172.31.36.0-255,66,68106,1,287234
11922,0.000682,74.125.130.0-255,2902,71008,1,287234
11923,0.000687,172.31.36.0-255,66,71074,1,287234
11924,0.000689,74.125.130.0-255,5738,76812,1,287234
11925,0.000694,172.31.36.0-255,66,76878,1,287234
11926,0.000736,172.31.36.0-255,66,76944,1,287234
11927,0.00074,172.31.36.0-255,66,77010,1,287234
11928,0.000748,74.125.130.0-255,1484,78494,1,287234
11929,0.000771,74.125.130.0-255,5379,83873,1,287234
11930,0.000775,172.31.36.0-255,66,83939,1,287234
11931,0.000965,74.125.130.0-255,1484,85423,1,287234
11932,0.000986,74.125.130.0-255,2902,88325,1,287234
11933,0.00099,172.31.36.0-255,66,88391,1,287234
11934,0.000994,74.125.130.0-255,1484,89875,1,287234
11935,0.001013,74.125.130.0-255,4320,94195,1,287234
11936,0.001016,74.125.130.0-255,1484,95679,1,287234
11937,0.001018,172.31.36.0-255,66,95745,1,287234
11938,0.00102,74.125.130.0-255,2902,98647,1,287234
11939,0.001023,172.31.36.0-255,66,98713,1,287234
11940,0.001043,74.125.130.0-255,5738,104451,1,287234
11941,0.001048,172.31.36.0-255,66,104517,1,287234
11942,0.001059,74.125.130.0-255,2902,107419,1,287234
11943,0.001063,172.31.36.0-255,66,107485,1,287234
11944,0.001078,74.125.130.0-255,7156,114641,1,287234
11945,0.00109,172.31.36.0-255,66,114707,1,287234
11946,0.001118,74.125.130.0-255,3602,118309,1,287234
11947,0.001121,172.31.36.0-255,66,118375,1,287234
11948,0.001208,74.125.130.0-255,1484,119859,1,287234
11949,0.001223,74.125.130.0-255,2902,122761,1,287234
11950,0.001229,172.31.36.0-255,66,122827,1,287234
11951,0.00124,74.125.130.0-255,5738,128565,1,287234
11952,0.001243,74.125.130.0-255,1484,130049,1,287234
11953,0.001254,172.31.36.0-255,66,130115,1,287234
11954,0.001282,172.31.36.0-255,66,130181,1,287234
11955,0.00129,74.125.130.0-255,7156,137337,1,287234
11956,0.001299,172.31.36.0-255,66,137403,1,287234
11957,0.001341,172.31.36.0-255,66,137469,1,287234
11958,0.001369,74.125.130.0-255,4320,141789,1,287234
11959,0.00137,172.31.36.0-255,66,141855,1,287234
11960,0.001375,172.31.36.0-255,66,141921,1,287234
11961,0.001405,172.31.36.0-255,66,141987,1,287234
11962,0.001438,74.125.130.0-255,1484,143471,1,287234
11963,0.00147,172.31.36.0-255,66,143537,1,287234
11964,0.001473,74.125.130.0-255,7156,150693,1,287234
11965,0.001477,74.125.130.0-255,2184,152877,1,287234
11966,0.001484,172.31.36.0-255,66,152943,1,287234
11967,0.001505,74.125.130.0-255,2902,155845,1,287234
11968,0.001512,172.31.36.0-255,66,155911,1,287234
11969,0.001519,74.125.130.0-255,4320,160231,1,287234
11970,0.001534,74.125.130.0-255,2902,163133,1,287234
11971,0.001537,172.31.36.0-255,66,163199,1,287234
11972,0.001545,172.31.36.0-255,66,163265,1,287234
11973,0.001559,172.31.36.0-255,66,163331,1,287234
11974,0.001615,172.31.36.0-255,66,163397,1,287234
11975,0.001707,74.125.130.0-255,1484,164881,1,287234
11976,0.001729,74.125.130.0-255,2902,167783,1,287234
11977,0.001732,74.125.130.0-255,1484,169267,1,287234
11978,0.001734,172.31.36.0-255,66,169333,1,287234
11979,0.001753,74.125.130.0-255,4320,173653,1,287234
11980,0.001764,172.31.36.0-255,66,173719,1,287234
11981,0.001783,74.125.130.0-255,5738,179457,1,287234
11982,0.001788,172.31.36.0-255,66,179523,1,287234
11983,0.00181,74.125.130.0-255,7156,186679,1,287234
11984,0.001816,172.31.36.0-255,66,186745,1,287234
11985,0.00185,172.31.36.0-255,66,186811,1,287234
11986,0.00202,74.125.130.0-255,1484,188295,1,287234
11987,0.002035,74.125.130.0-255,2902,191197,1,287234
11988,0.002038,172.31.36.0-255,66,191263,1,287234
11989,0.002042,74.125.130.0-255,1484,192747,1,287234
11990,0.002063,74.125.130.0-255,4320,197067,1,287234
11991,0.002067,74.125.130.0-255,2902,199969,1,287234
11992,0.002068,172.31.36.0-255,66,200035,1,287234
11993,0.002082,172.31.36.0-255,66,200101,1,287234
11994,0.002104,74.125.130.0-255,7156,207257,1,287234
11995,0.002104,172.31.36.0-255,66,207323,1,287234
11996,0.002109,172.31.36.0-255,66,207389,1,287234
11997,0.002122,74.125.130.0-255,1484,208873,1,287234
11998,0.002136,74.125.130.0-255,2184,211057,1,287234
11999,0.002145,172.31.36.0-255,66,211123,1,287234
12000,0.00217,74.125.130.0-255,2902,214025,1,287234
12001,0.002179,172.31.36.0-255,66,214091,1,287234
12002,0.002184,74.125.130.0-255,1484,215575,1,287234
12003,0.00219,74.125.130.0-255,5738,221313,1,287234
12004,0.002193,172.31.36.0-255,66,221379,1,287234
12005,0.00221,74.125.130.0-255,4320,225699,1,287234
12006,0.002214,172.31.36.0-255,66,225765,1,287234
12007,0.002225,74.125.130.0-255,7156,232921,1,287234
12008,0.002229,172.31.36.0-255,66,232987,1,287234
12009,0.002239,74.125.130.0-255,5738,238725,1,287234
12010,0.00225,172.31.36.0-255,66,238791,1,287234
12011,0.002252,74.125.130.0-255,4320,243111,1,287234
12012,0.002264,172.31.36.0-255,66,243177,1,287234
12013,0.002281,74.125.130.0-255,4320,247497,1,287234
12014,0.002284,172.31.36.0-255,66,247563,1,287234
12015,0.002304,74.125.130.0-255,4320,251883,1,287234
12016,0.002317,172.31.36.0-255,66,251949,1,287234
12017,0.002334,74.125.130.0-255,5738,257687,1,287234
12018,0.00234,172.31.36.0-255,66,257753,1,287234
12019,0.002353,74.125.130.0-255,4320,262073,1,287234
12020,0.002359,74.125.130.0-255,6438,268511,1,287234
12021,0.002359,172.31.36.0-255,66,268577,1,287234
12022,0.002363,172.31.36.0-255,66,268643,1,287234
12023,0.002385,74.125.130.0-255,1484,270127,1,287234
12024,0.002401,74.125.130.0-255,5738,275865,1,287234
12025,0.002408,172.31.36.0-255,66,275931,1,287234
12026,0.002432,74.125.130.0-255,1313,277244,1,287234
12027,0.002473,74.125.130.0-255,105,277349,1,287234
12028,0.003508,172.31.36.0-255,66,277415,1,287234
12029,0.003532,172.31.36.0-255,105,277520,1,287234
12030,0.006039,74.125.130.0-255,66,277586,1,287234
12031,0.025572,172.31.36.0-255,172,277758,1,287234
12032,0.025616,172.31.36.0-255,1113,278871,1,287234
12033,0.025651,172.31.36.0-255,1514,280385,1,287234
12034,0.025653,172.31.36.0-255,1514,281899,1,287234
12035,0.025659,172.31.36.0-255,1514,283413,1,287234
12036,0.02566,172.31.36.0-255,1514,284927,1,287234
12037,0.025678,172.31.36.0-255,1514,286441,1,287234
12038,0.025679,172.31.36.0-255,529,286970,1,287234
12039,0.027131,104.244.42.0-255,66,287036,1,287234
12040,0.027177,104.244.42.0-255,66,287102,1,287234
12041,0.02722,104.244.42.0-255,66,287168,1,287234
12042,0.027271,104.244.42.0-255,66,287234,1,287234
12043,0.0,74.125.68.0-255,150,150,1,332671
12044,3.1e-05,172.31.36.0-255,66,216,1,332671
12045,3.8e-05,74.125.68.0-255,1484,1700,1,332671
12046,4.2e-05,172.31.36.0-255,66,1766,1,332671
12047,4.4e-05,74.125.68.0-255,1484,3250,1,332671
12048,4.7e-05,172.31.36.0-255,66,3316,1,332671
12049,5.2e-05,74.125.68.0-255,2902,6218,1,332671
12050,5.4e-05,172.31.36.0-255,66,6284,1,332671
12051,8.6e-05,74.125.68.0-255,5738,12022,1,332671
12052,8.8e-05,172.31.36.0-255,66,12088,1,332671
12053,9.2e-05,74.125.68.0-255,2086,14174,1,332671
12054,9.3e-05,172.31.36.0-255,66,14240,1,332671
12055,9.7e-05,74.125.68.0-255,2902,17142,1,332671
12056,0.0001,172.31.36.0-255,66,17208,1,332671
12057,0.000153,74.125.68.0-255,4320,21528,1,332671
12058,0.000157,172.31.36.0-255,66,21594,1,332671
12059,0.000175,74.125.68.0-255,2902,24496,1,332671
12060,0.000178,172.31.36.0-255,66,24562,1,332671
12061,0.000189,172.31.36.0-255,66,24628,1,332671
12062,0.000193,74.125.68.0-255,2902,27530,1,332671
12063,0.000196,172.31.36.0-255,66,27596,1,332671
12064,0.000228,74.125.68.0-255,7156,34752,1,332671
12065,0.00023,172.31.36.0-255,66,34818,1,332671
12066,0.000263,74.125.68.0-255,5020,39838,1,332671
12067,0.000266,172.31.36.0-255,66,39904,1,332671
12068,0.000278,74.125.68.0-255,1484,41388,1,332671
12069,0.00028,172.31.36.0-255,66,41454,1,332671
12070,0.000285,74.125.68.0-255,2902,44356,1,332671
12071,0.000287,172.31.36.0-255,66,44422,1,332671
12072,0.000293,74.125.68.0-255,5738,50160,1,332671
12073,0.000295,172.31.36.0-255,66,50226,1,332671
12074,0.000318,74.125.68.0-255,2902,53128,1,332671
12075,0.000325,172.31.36.0-255,66,53194,1,332671
12076,0.000337,74.125.68.0-255,3961,57155,1,332671
12077,0.00034,74.125.68.0-255,394,57549,1,332671
12078,0.000345,172.31.36.0-255,66,57615,1,332671
12079,0.000504,74.125.68.0-255,1484,59099,1,332671
12080,0.000528,74.125.68.0-255,2902,62001,1,332671
12081,0.000534,74.125.68.0-255,5738,67739,1,332671
12082,0.000539,172.31.36.0-255,66,67805,1,332671
12083,0.000545,74.125.68.0-255,1484,69289,1,332671
12084,0.000562,74.125.68.0-255,5738,75027,1,332671
12085,0.00057,172.31.36.0-255,66,75093,1,332671
12086,0.000602,74.125.68.0-255,4320,79413,1,332671
12087,0.000616,172.31.36.0-255,66,79479,1,332671
12088,0.000647,172.31.36.0-255,66,79545,1,332671
12089,0.000658,74.125.68.0-255,2184,81729,1,332671
12090,0.000663,172.31.36.0-255,66,81795,1,332671
12091,0.001043,74.125.68.0-255,1484,83279,1,332671
12092,0.001049,74.125.68.0-255,1484,84763,1,332671
12093,0.001052,172.31.36.0-255,66,84829,1,332671
12094,0.001069,74.125.68.0-255,1484,86313,1,332671
12095,0.001076,74.125.68.0-255,5738,92051,1,332671
12096,0.001085,172.31.36.0-255,66,92117,1,332671
12097,0.001096,74.125.68.0-255,5738,97855,1,332671
12098,0.001104,172.31.36.0-255,66,97921,1,332671
12099,0.001118,74.125.68.0-255,7156,105077,1,332671
12100,0.001131,172.31.36.0-255,66,105143,1,332671
12101,0.00115,74.125.68.0-255,4320,109463,1,332671
12102,0.001156,172.31.36.0-255,66,109529,1,332671
12103,0.001165,74.125.68.0-255,4320,113849,1,332671
12104,0.001174,172.31.36.0-255,66,113915,1,332671
12105,0.001177,74.125.68.0-255,2184,116099,1,332671
12106,0.001193,172.31.36.0-255,66,116165,1,332671
12107,0.001547,74.125.68.0-255,1484,117649,1,332671
12108,0.001551,74.125.68.0-255,1484,119133,1,332671
12109,0.001554,172.31.36.0-255,66,119199,1,332671
12110,0.00157,74.125.68.0-255,1484,120683,1,332671
12111,0.001576,74.125.68.0-255,5738,126421,1,332671
12112,0.00158,172.31.36.0-255,66,126487,1,332671
12113,0.001606,74.125.68.0-255,2902,129389,1,332671
12114,0.001615,172.31.36.0-255,66,129455,1,332671
12115,0.001641,172.31.36.0-255,66,129521,1,332671
12116,0.001659,74.125.68.0-255,1484,131005,1,332671
12117,0.001689,172.31.36.0-255,66,131071,1,332671
12118,0.001701,74.125.68.0-255,2184,133255,1,332671
12119,0.001704,74.125.68.0-255,1484,134739,1,332671
12120,0.00171,172.31.36.0-255,66,134805,1,332671
12121,0.001717,74.125.68.0-255,1484,136289,1,332671
12122,0.001747,74.125.68.0-255,2902,139191,1,332671
12123,0.001755,172.31.36.0-255,66,139257,1,332671
12124,0.001768,74.125.68.0-255,7156,146413,1,332671
12125,0.001778,172.31.36.0-255,66,146479,1,332671
12126,0.001785,74.125.68.0-255,4320,150799,1,332671
12127,0.001788,74.125.68.0-255,2184,152983,1,332671
12128,0.001802,172.31.36.0-255,66,153049,1,332671
12129,0.002061,74.125.68.0-255,1484,154533,1,332671
12130,0.002064,74.125.68.0-255,1484,156017,1,332671
12131,0.002069,172.31.36.0-255,66,156083,1,332671
12132,0.002081,74.125.68.0-255,1484,157567,1,332671
12133,0.002087,74.125.68.0-255,2902,160469,1,332671
12134,0.0021,172.31.36.0-255,66,160535,1,332671
12135,0.002104,74.125.68.0-255,2902,163437,1,332671
12136,0.002115,172.31.36.0-255,66,163503,1,332671
12137,0.002117,74.125.68.0-255,1484,164987,1,332671
12138,0.002152,172.31.36.0-255,66,165053,1,332671
12139,0.002205,172.31.36.0-255,66,165119,1,332671
12140,0.002206,74.125.68.0-255,1484,166603,1,332671
12141,0.00221,74.125.68.0-255,2184,168787,1,332671
12142,0.002219,172.31.36.0-255,66,168853,1,332671
12143,0.002489,74.125.68.0-255,1484,170337,1,332671
12144,0.002505,74.125.68.0-255,2902,173239,1,332671
12145,0.002509,172.31.36.0-255,66,173305,1,332671
12146,0.002524,74.125.68.0-255,1484,174789,1,332671
12147,0.002541,74.125.68.0-255,4320,179109,1,332671
12148,0.002553,74.125.68.0-255,7156,186265,1,332671
12149,0.002575,74.125.68.0-255,4320,190585,1,332671
12150,0.00261,74.125.68.0-255,1484,192069,1,332671
12151,0.002613,74.125.68.0-255,1484,193553,1,332671
12152,0.002616,74.125.68.0-255,766,194319,1,332671
12153,0.002662,74.125.68.0-255,4320,198639,1,332671
12154,0.002689,74.125.68.0-255,5738,204377,1,332671
12155,0.002693,74.125.68.0-255,1484,205861,1,332671
12156,0.002706,74.125.68.0-255,2902,208763,1,332671
12157,0.002726,74.125.68.0-255,1484,210247,1,332671
12158,0.002729,74.125.68.0-255,1484,211731,1,332671
12159,0.002732,74.125.68.0-255,1484,213215,1,332671
12160,0.002761,74.125.68.0-255,4320,217535,1,332671
12161,0.002764,74.125.68.0-255,1484,219019,1,332671
12162,0.002767,74.125.68.0-255,1484,220503,1,332671
12163,0.002788,74.125.68.0-255,2902,223405,1,332671
12164,0.00281,74.125.68.0-255,5020,228425,1,332671
12165,0.002851,74.125.68.0-255,1484,229909,1,332671
12166,0.002856,74.125.68.0-255,1484,231393,1,332671
12167,0.002869,74.125.68.0-255,1484,232877,1,332671
12168,0.002873,74.125.68.0-255,1484,234361,1,332671
12169,0.0029,74.125.68.0-255,4320,238681,1,332671
12170,0.002922,74.125.68.0-255,7156,245837,1,332671
12171,0.002942,74.125.68.0-255,2902,248739,1,332671
12172,0.002945,74.125.68.0-255,1484,250223,1,332671
12173,0.002948,74.125.68.0-255,2902,253125,1,332671
12174,0.002978,74.125.68.0-255,5738,258863,1,332671
12175,0.002983,74.125.68.0-255,1484,260347,1,332671
12176,0.003002,74.125.68.0-255,2184,262531,1,332671
12177,0.003089,74.125.68.0-255,2902,265433,1,332671
12178,0.003092,74.125.68.0-255,1484,266917,1,332671
12179,0.003108,74.125.68.0-255,5738,272655,1,332671
12180,0.003125,74.125.68.0-255,2184,274839,1,332671
12181,0.003152,74.125.68.0-255,2902,277741,1,332671
12182,0.003157,74.125.68.0-255,2902,280643,1,332671
12183,0.00317,74.125.68.0-255,1484,282127,1,332671
12184,0.003174,74.125.68.0-255,2902,285029,1,332671
12185,0.003191,74.125.68.0-255,2902,287931,1,332671
12186,0.003193,74.125.68.0-255,1484,289415,1,332671
12187,0.00321,74.125.68.0-255,2902,292317,1,332671
12188,0.003228,74.125.68.0-255,5738,298055,1,332671
12189,0.00325,74.125.68.0-255,4320,302375,1,332671
12190,0.003257,74.125.68.0-255,6438,308813,1,332671
12191,0.00328,74.125.68.0-255,1484,310297,1,332671
12192,0.0033,74.125.68.0-255,5738,316035,1,332671
12193,0.003304,74.125.68.0-255,2902,318937,1,332671
12194,0.003354,74.125.68.0-255,4266,323203,1,332671
12195,0.003358,74.125.68.0-255,97,323300,1,332671
12196,0.003392,74.125.68.0-255,105,323405,1,332671
12197,0.005416,172.31.36.0-255,66,323471,1,332671
12198,0.010793,172.31.36.0-255,105,323576,1,332671
12199,0.013331,74.125.68.0-255,66,323642,1,332671
12200,0.030592,172.31.36.0-255,172,323814,1,332671
12201,0.030636,172.31.36.0-255,1114,324928,1,332671
12202,0.030675,172.31.36.0-255,1514,326442,1,332671
12203,0.030677,172.31.36.0-255,1514,327956,1,332671
12204,0.030678,172.31.36.0-255,1514,329470,1,332671
12205,0.030682,172.31.36.0-255,1514,330984,1,332671
12206,0.030684,172.31.36.0-255,1489,332473,1,332671
12207,0.03214,104.244.42.0-255,66,332539,1,332671
12208,0.032236,104.244.42.0-255,66,332605,1,332671
12209,0.0323,104.244.42.0-255,66,332671,1,332671
12210,0.0,172.217.194.0-255,152,152,1,255399
12211,3.4e-05,172.31.36.0-255,66,218,1,255399
12212,4.2e-05,172.217.194.0-255,1484,1702,1,255399
12213,4.6e-05,172.31.36.0-255,66,1768,1,255399
12214,5.1e-05,172.217.194.0-255,2902,4670,1,255399
12215,5.4e-05,172.31.36.0-255,66,4736,1,255399
12216,6.1e-05,172.217.194.0-255,7156,11892,1,255399
12217,6.4e-05,172.31.36.0-255,66,11958,1,255399
12218,8.8e-05,172.217.194.0-255,2090,14048,1,255399
12219,9.1e-05,172.31.36.0-255,66,14114,1,255399
12220,0.000163,172.217.194.0-255,1484,15598,1,255399
12221,0.000167,172.31.36.0-255,66,15664,1,255399
12222,0.000173,172.217.194.0-255,2902,18566,1,255399
12223,0.000176,172.31.36.0-255,66,18632,1,255399
12224,0.000182,172.217.194.0-255,5738,24370,1,255399
12225,0.000184,172.31.36.0-255,66,24436,1,255399
12226,0.000245,172.217.194.0-255,6797,31233,1,255399
12227,0.000248,172.31.36.0-255,66,31299,1,255399
12228,0.000308,172.217.194.0-255,1484,32783,1,255399
12229,0.000312,172.217.194.0-255,2902,35685,1,255399
12230,0.000313,172.31.36.0-255,66,35751,1,255399
12231,0.000317,172.31.36.0-255,66,35817,1,255399
12232,0.000328,172.217.194.0-255,1484,37301,1,255399
12233,0.000332,172.31.36.0-255,66,37367,1,255399
12234,0.00035,172.217.194.0-255,4320,41687,1,255399
12235,0.000353,172.31.36.0-255,66,41753,1,255399
12236,0.000391,172.217.194.0-255,1484,43237,1,255399
12237,0.000394,172.31.36.0-255,66,43303,1,255399
12238,0.000418,172.217.194.0-255,5379,48682,1,255399
12239,0.000421,172.31.36.0-255,66,48748,1,255399
12240,0.000498,172.217.194.0-255,1484,50232,1,255399
12241,0.000502,172.31.36.0-255,66,50298,1,255399
12242,0.000507,172.217.194.0-255,2902,53200,1,255399
12243,0.00051,172.31.36.0-255,66,53266,1,255399
12244,0.000511,172.217.194.0-255,2902,56168,1,255399
12245,0.000513,172.31.36.0-255,66,56234,1,255399
12246,0.000526,172.217.194.0-255,2902,59136,1,255399
12247,0.000528,172.31.36.0-255,66,59202,1,255399
12248,0.000531,172.217.194.0-255,1484,60686,1,255399
12249,0.00056,172.217.194.0-255,5379,66065,1,255399
12250,0.000563,172.31.36.0-255,66,66131,1,255399
12251,0.000566,172.217.194.0-255,362,66493,1,255399
12252,0.000755,172.31.36.0-255,66,66559,1,255399
12253,0.001073,172.217.194.0-255,1484,68043,1,255399
12254,0.001083,172.217.194.0-255,2902,70945,1,255399
12255,0.001088,172.31.36.0-255,66,71011,1,255399
12256,0.001095,172.217.194.0-255,5738,76749,1,255399
12257,0.001097,172.31.36.0-255,66,76815,1,255399
12258,0.001123,172.217.194.0-255,5738,82553,1,255399
12259,0.001125,172.31.36.0-255,66,82619,1,255399
12260,0.001146,172.217.194.0-255,4253,86872,1,255399
12261,0.001148,172.31.36.0-255,66,86938,1,255399
12262,0.001158,172.31.36.0-255,66,87004,1,255399
12263,0.001175,172.217.194.0-255,1484,88488,1,255399
12264,0.001188,172.217.194.0-255,2543,91031,1,255399
12265,0.001191,172.31.36.0-255,66,91097,1,255399
12266,0.001531,172.217.194.0-255,1484,92581,1,255399
12267,0.001538,172.217.194.0-255,2902,95483,1,255399
12268,0.001542,172.31.36.0-255,66,95549,1,255399
12269,0.001545,172.217.194.0-255,1484,97033,1,255399
12270,0.001563,172.217.194.0-255,4320,101353,1,255399
12271,0.001565,172.31.36.0-255,66,101419,1,255399
12272,0.001619,172.31.36.0-255,66,101485,1,255399
12273,0.001634,172.217.194.0-255,2902,104387,1,255399
12274,0.001636,172.31.36.0-255,66,104453,1,255399
12275,0.001639,172.217.194.0-255,1484,105937,1,255399
12276,0.00167,172.31.36.0-255,66,106003,1,255399
12277,0.00222,172.217.194.0-255,1484,107487,1,255399
12278,0.002225,172.217.194.0-255,2902,110389,1,255399
12279,0.002227,172.31.36.0-255,66,110455,1,255399
12280,0.002232,172.217.194.0-255,2902,113357,1,255399
12281,0.002234,172.31.36.0-255,66,113423,1,255399
12282,0.00225,172.217.194.0-255,2902,116325,1,255399
12283,0.002252,172.31.36.0-255,66,116391,1,255399
12284,0.002258,172.217.194.0-255,5738,122129,1,255399
12285,0.00226,172.31.36.0-255,66,122195,1,255399
12286,0.002274,172.31.36.0-255,66,122261,1,255399
12287,0.002276,172.217.194.0-255,1484,123745,1,255399
12288,0.002281,172.217.194.0-255,3602,127347,1,255399
12289,0.002283,172.31.36.0-255,66,127413,1,255399
12290,0.002383,172.217.194.0-255,1484,128897,1,255399
12291,0.002401,172.217.194.0-255,2902,131799,1,255399
12292,0.002403,172.31.36.0-255,66,131865,1,255399
12293,0.002422,172.217.194.0-255,5738,137603,1,255399
12294,0.002425,172.31.36.0-255,66,137669,1,255399
12295,0.002453,172.31.36.0-255,66,137735,1,255399
12296,0.002458,172.217.194.0-255,4320,142055,1,255399
12297,0.002459,172.31.36.0-255,66,142121,1,255399
12298,0.002494,172.217.194.0-255,5738,147859,1,255399
12299,0.002496,172.31.36.0-255,66,147925,1,255399
12300,0.002506,172.217.194.0-255,766,148691,1,255399
12301,0.002566,172.217.194.0-255,1484,150175,1,255399
12302,0.002569,172.31.36.0-255,66,150241,1,255399
12303,0.002572,172.217.194.0-255,1484,151725,1,255399
12304,0.002585,172.217.194.0-255,1484,153209,1,255399
12305,0.002587,172.31.36.0-255,66,153275,1,255399
12306,0.002593,172.217.194.0-255,5738,159013,1,255399
12307,0.002596,172.31.36.0-255,66,159079,1,255399
12308,0.002615,172.217.194.0-255,1484,160563,1,255399
12309,0.002628,172.217.194.0-255,5738,166301,1,255399
12310,0.002631,172.31.36.0-255,66,166367,1,255399
12311,0.002643,172.217.194.0-255,5738,172105,1,255399
12312,0.002645,172.31.36.0-255,66,172171,1,255399
12313,0.002671,172.217.194.0-255,5738,177909,1,255399
12314,0.002673,172.31.36.0-255,66,177975,1,255399
12315,0.002694,172.217.194.0-255,5020,182995,1,255399
12316,0.002696,172.31.36.0-255,66,183061,1,255399
12317,0.002727,172.217.194.0-255,1484,184545,1,255399
12318,0.00273,172.217.194.0-255,1484,186029,1,255399
12319,0.002732,172.31.36.0-255,66,186095,1,255399
12320,0.002735,172.217.194.0-255,1484,187579,1,255399
12321,0.00275,172.217.194.0-255,2902,190481,1,255399
12322,0.002752,172.31.36.0-255,66,190547,1,255399
12323,0.002757,172.217.194.0-255,2902,193449,1,255399
12324,0.002759,172.31.36.0-255,66,193515,1,255399
12325,0.002781,172.217.194.0-255,1484,194999,1,255399
12326,0.002811,172.31.36.0-255,66,195065,1,255399
12327,0.002818,172.217.194.0-255,7156,202221,1,255399
12328,0.00282,172.31.36.0-255,66,202287,1,255399
12329,0.002825,172.217.194.0-255,5020,207307,1,255399
12330,0.002827,172.31.36.0-255,66,207373,1,255399
12331,0.002922,172.217.194.0-255,1484,208857,1,255399
12332,0.002936,172.217.194.0-255,2902,211759,1,255399
12333,0.002939,172.31.36.0-255,66,211825,1,255399
12334,0.002946,172.217.194.0-255,5738,217563,1,255399
12335,0.002949,172.31.36.0-255,66,217629,1,255399
12336,0.002977,172.217.194.0-255,5738,223367,1,255399
12337,0.002981,172.31.36.0-255,66,223433,1,255399
12338,0.003008,172.217.194.0-255,7156,230589,1,255399
12339,0.003012,172.217.194.0-255,1484,232073,1,255399
12340,0.003025,172.217.194.0-255,5020,237093,1,255399
12341,0.003113,172.217.194.0-255,1484,238577,1,255399
12342,0.003197,172.31.36.0-255,66,238643,1,255399
12343,0.003234,172.31.36.0-255,66,238709,1,255399
12344,0.003243,172.217.194.0-255,2902,241611,1,255399
12345,0.003253,172.31.36.0-255,66,241677,1,255399
12346,0.003277,172.31.36.0-255,66,241743,1,255399
12347,0.003313,172.31.36.0-255,66,241809,1,255399
12348,0.003328,172.217.194.0-255,3602,245411,1,255399
12349,0.003333,172.217.194.0-255,1625,247036,1,255399
12350,0.003336,172.217.194.0-255,105,247141,1,255399
12351,0.003337,172.31.36.0-255,66,247207,1,255399
12352,0.007668,172.31.36.0-255,66,247273,1,255399
12353,0.007695,172.31.36.0-255,105,247378,1,255399
12354,0.009882,172.217.194.0-255,66,247444,1,255399
12355,0.041237,172.31.36.0-255,171,247615,1,255399
12356,0.041267,172.31.36.0-255,1139,248754,1,255399
12357,0.041325,172.31.36.0-255,1514,250268,1,255399
12358,0.041328,172.31.36.0-255,1514,251782,1,255399
12359,0.041334,172.31.36.0-255,1514,253296,1,255399
12360,0.041335,172.31.36.0-255,1514,254810,1,255399
12361,0.041362,172.31.36.0-255,325,255135,1,255399
12362,0.042834,104.244.42.0-255,66,255201,1,255399
12363,0.042845,104.244.42.0-255,66,255267,1,255399
12364,0.042913,104.244.42.0-255,66,255333,1,255399
12365,0.042916,104.244.42.0-255,66,255399,1,255399
12366,0.0,74.125.24.0-255,153,153,1,264706
12367,2.3e-05,172.31.36.0-255,66,219,1,264706
12368,3e-05,74.125.24.0-255,1484,1703,1,264706
12369,3.5e-05,172.31.36.0-255,66,1769,1,264706
12370,4.1e-05,74.125.24.0-255,2902,4671,1,264706
12371,4.5e-05,172.31.36.0-255,66,4737,1,264706
12372,6.2e-05,74.125.24.0-255,7156,11893,1,264706
12373,6.5e-05,172.31.36.0-255,66,11959,1,264706
12374,6.8e-05,74.125.24.0-255,1941,13900,1,264706
12375,7.1e-05,172.31.36.0-255,66,13966,1,264706
12376,0.000239,74.125.24.0-255,1484,15450,1,264706
12377,0.000244,172.31.36.0-255,66,15516,1,264706
12378,0.00025,74.125.24.0-255,2902,18418,1,264706
12379,0.000254,172.31.36.0-255,66,18484,1,264706
12380,0.000267,74.125.24.0-255,5738,24222,1,264706
12381,0.000271,172.31.36.0-255,66,24288,1,264706
12382,0.000303,74.125.24.0-255,6797,31085,1,264706
12383,0.000307,172.31.36.0-255,66,31151,1,264706
12384,0.000409,74.125.24.0-255,1484,32635,1,264706
12385,0.000413,172.31.36.0-255,66,32701,1,264706
12386,0.000419,74.125.24.0-255,2902,35603,1,264706
12387,0.000421,172.31.36.0-255,66,35669,1,264706
12388,0.000435,74.125.24.0-255,5738,41407,1,264706
12389,0.000437,74.125.24.0-255,1484,42891,1,264706
12390,0.00044,172.31.36.0-255,66,42957,1,264706
12391,0.000443,172.31.36.0-255,66,43023,1,264706
12392,0.000476,74.125.24.0-255,5379,48402,1,264706
12393,0.000494,172.31.36.0-255,66,48468,1,264706
12394,0.000498,74.125.24.0-255,1484,49952,1,264706
12395,0.0005,172.31.36.0-255,66,50018,1,264706
12396,0.000505,74.125.24.0-255,2902,52920,1,264706
12397,0.000507,172.31.36.0-255,66,52986,1,264706
12398,0.000513,74.125.24.0-255,4320,57306,1,264706
12399,0.000515,172.31.36.0-255,66,57372,1,264706
12400,0.000547,74.125.24.0-255,1484,58856,1,264706
12401,0.000552,74.125.24.0-255,1484,60340,1,264706
12402,0.000554,172.31.36.0-255,66,60406,1,264706
12403,0.000586,74.125.24.0-255,5708,66114,1,264706
12404,0.000589,172.31.36.0-255,66,66180,1,264706
12405,0.000593,74.125.24.0-255,110,66290,1,264706
12406,0.000626,74.125.24.0-255,1484,67774,1,264706
12407,0.00063,172.31.36.0-255,66,67840,1,264706
12408,0.000636,74.125.24.0-255,2902,70742,1,264706
12409,0.00064,172.31.36.0-255,66,70808,1,264706
12410,0.000658,74.125.24.0-255,7156,77964,1,264706
12411,0.000662,172.31.36.0-255,66,78030,1,264706
12412,0.000673,74.125.24.0-255,4320,82350,1,264706
12413,0.000676,172.31.36.0-255,66,82416,1,264706
12414,0.000702,74.125.24.0-255,814,83230,1,264706
12415,0.000739,74.125.24.0-255,1484,84714,1,264706
12416,0.000744,172.31.36.0-255,66,84780,1,264706
12417,0.000751,74.125.24.0-255,2902,87682,1,264706
12418,0.000754,172.31.36.0-255,66,87748,1,264706
12419,0.000776,74.125.24.0-255,1484,89232,1,264706
12420,0.000787,74.125.24.0-255,4320,93552,1,264706
12421,0.000789,172.31.36.0-255,66,93618,1,264706
12422,0.000818,74.125.24.0-255,6797,100415,1,264706
12423,0.000821,172.31.36.0-255,66,100481,1,264706
12424,0.001045,74.125.24.0-255,1484,101965,1,264706
12425,0.001052,74.125.24.0-255,2902,104867,1,264706
12426,0.001055,172.31.36.0-255,66,104933,1,264706
12427,0.001083,74.125.24.0-255,4320,109253,1,264706
12428,0.001086,172.31.36.0-255,66,109319,1,264706
12429,0.001117,74.125.24.0-255,1484,110803,1,264706
12430,0.00113,172.31.36.0-255,66,110869,1,264706
12431,0.001145,172.31.36.0-255,66,110935,1,264706
12432,0.001931,74.125.24.0-255,1484,112419,1,264706
12433,0.001942,74.125.24.0-255,2902,115321,1,264706
12434,0.001947,172.31.36.0-255,66,115387,1,264706
12435,0.001954,74.125.24.0-255,5738,121125,1,264706
12436,0.001956,172.31.36.0-255,66,121191,1,264706
12437,0.002006,172.31.36.0-255,66,121257,1,264706
12438,0.002049,172.31.36.0-255,66,121323,1,264706
12439,0.004102,74.125.24.0-255,5738,127061,1,264706
12440,0.004107,172.31.36.0-255,66,127127,1,264706
12441,0.006176,74.125.24.0-255,5738,132865,1,264706
12442,0.006179,172.31.36.0-255,66,132931,1,264706
12443,0.008258,74.125.24.0-255,5738,138669,1,264706
12444,0.008264,172.31.36.0-255,66,138735,1,264706
12445,0.010356,74.125.24.0-255,5738,144473,1,264706
12446,0.010367,172.31.36.0-255,66,144539,1,264706
12447,0.012494,74.125.24.0-255,5738,150277,1,264706
12448,0.012506,172.31.36.0-255,66,150343,1,264706
12449,0.01462,74.125.24.0-255,5738,156081,1,264706
12450,0.014631,172.31.36.0-255,66,156147,1,264706
12451,0.016747,74.125.24.0-255,5738,161885,1,264706
12452,0.016755,172.31.36.0-255,66,161951,1,264706
12453,0.018811,74.125.24.0-255,5738,167689,1,264706
12454,0.018818,172.31.36.0-255,66,167755,1,264706
12455,0.020873,74.125.24.0-255,5738,173493,1,264706
12456,0.02088,172.31.36.0-255,66,173559,1,264706
12457,0.022943,74.125.24.0-255,5738,179297,1,264706
12458,0.02295,172.31.36.0-255,66,179363,1,264706
12459,0.024998,74.125.24.0-255,5738,185101,1,264706
12460,0.025006,172.31.36.0-255,66,185167,1,264706
12461,0.02706,74.125.24.0-255,5738,190905,1,264706
12462,0.027068,172.31.36.0-255,66,190971,1,264706
12463,0.029121,74.125.24.0-255,5738,196709,1,264706
12464,0.029128,172.31.36.0-255,66,196775,1,264706
12465,0.029725,172.31.36.0-255,176,196951,1,264706
12466,0.029753,172.31.36.0-255,1114,198065,1,264706
12467,0.029806,172.31.36.0-255,1514,199579,1,264706
12468,0.029808,172.31.36.0-255,1514,201093,1,264706
12469,0.029814,172.31.36.0-255,1514,202607,1,264706
12470,0.029815,172.31.36.0-255,1514,204121,1,264706
12471,0.029849,172.31.36.0-255,1489,205610,1,264706
12472,0.0312,74.125.24.0-255,5738,211348,1,264706
12473,0.031211,172.31.36.0-255,66,211414,1,264706
12474,0.03126,104.244.42.0-255,66,211480,1,264706
12475,0.031308,104.244.42.0-255,66,211546,1,264706
12476,0.031393,104.244.42.0-255,66,211612,1,264706
12477,0.031448,104.244.42.0-255,66,211678,1,264706
12478,0.033256,74.125.24.0-255,5738,217416,1,264706
12479,0.033271,172.31.36.0-255,66,217482,1,264706
12480,0.035358,74.125.24.0-255,5738,223220,1,264706
12481,0.035374,172.31.36.0-255,66,223286,1,264706
12482,0.037452,74.125.24.0-255,5738,229024,1,264706
12483,0.037471,172.31.36.0-255,66,229090,1,264706
12484,0.039532,74.125.24.0-255,2902,231992,1,264706
12485,0.039543,172.31.36.0-255,66,232058,1,264706
12486,0.039571,74.125.24.0-255,2902,234960,1,264706
12487,0.039577,172.31.36.0-255,66,235026,1,264706
12488,0.041588,74.125.24.0-255,2902,237928,1,264706
12489,0.041599,172.31.36.0-255,66,237994,1,264706
12490,0.041646,74.125.24.0-255,2902,240896,1,264706
12491,0.041649,172.31.36.0-255,66,240962,1,264706
12492,0.043648,74.125.24.0-255,2902,243864,1,264706
12493,0.043661,172.31.36.0-255,66,243930,1,264706
12494,0.043708,74.125.24.0-255,2902,246832,1,264706
12495,0.043712,172.31.36.0-255,66,246898,1,264706
12496,0.045728,74.125.24.0-255,2902,249800,1,264706
12497,0.045741,172.31.36.0-255,66,249866,1,264706
12498,0.045789,74.125.24.0-255,2902,252768,1,264706
12499,0.045793,172.31.36.0-255,66,252834,1,264706
12500,0.047813,74.125.24.0-255,2902,255736,1,264706
12501,0.047819,172.31.36.0-255,66,255802,1,264706
12502,0.047853,74.125.24.0-255,2902,258704,1,264706
12503,0.047856,172.31.36.0-255,66,258770,1,264706
12504,0.04986,74.125.24.0-255,2902,261672,1,264706
12505,0.049866,172.31.36.0-255,66,261738,1,264706
12506,0.049911,74.125.24.0-255,2902,264640,1,264706
12507,0.049917,172.31.36.0-255,66,264706,1,264706
12508,0.0,172.217.194.0-255,152,152,1,196054
12509,2.8e-05,172.31.36.0-255,66,218,1,196054
12510,5.3e-05,172.217.194.0-255,1484,1702,1,196054
12511,5.6e-05,172.31.36.0-255,66,1768,1,196054
12512,5.9e-05,172.217.194.0-255,1484,3252,1,196054
12513,6.2e-05,172.31.36.0-255,66,3318,1,196054
12514,7.7e-05,172.217.194.0-255,1484,4802,1,196054
12515,8.1e-05,172.31.36.0-255,66,4868,1,196054
12516,8.5e-05,172.217.194.0-255,5738,10606,1,196054
12517,8.7e-05,172.31.36.0-255,66,10672,1,196054
12518,0.000113,172.217.194.0-255,4320,14992,1,196054
12519,0.000115,172.31.36.0-255,66,15058,1,196054
12520,0.000137,172.31.36.0-255,66,15124,1,196054
12521,0.00014,172.217.194.0-255,1484,16608,1,196054
12522,0.000142,172.31.36.0-255,66,16674,1,196054
12523,0.00016,172.31.36.0-255,66,16740,1,196054
12524,0.000167,172.217.194.0-255,5020,21760,1,196054
12525,0.000169,172.31.36.0-255,66,21826,1,196054
12526,0.000262,172.217.194.0-255,1484,23310,1,196054
12527,0.000267,172.31.36.0-255,66,23376,1,196054
12528,0.000272,172.217.194.0-255,2902,26278,1,196054
12529,0.000274,172.31.36.0-255,66,26344,1,196054
12530,0.000277,172.217.194.0-255,1484,27828,1,196054
12531,0.00028,172.31.36.0-255,66,27894,1,196054
12532,0.000304,172.217.194.0-255,4320,32214,1,196054
12533,0.000308,172.31.36.0-255,66,32280,1,196054
12534,0.000325,172.217.194.0-255,7119,39399,1,196054
12535,0.000328,172.31.36.0-255,66,39465,1,196054
12536,0.00038,172.217.194.0-255,1484,40949,1,196054
12537,0.000383,172.31.36.0-255,66,41015,1,196054
12538,0.000388,172.217.194.0-255,2902,43917,1,196054
12539,0.000392,172.31.36.0-255,66,43983,1,196054
12540,0.000407,172.217.194.0-255,5738,49721,1,196054
12541,0.000411,172.31.36.0-255,66,49787,1,196054
12542,0.000416,172.217.194.0-255,4320,54107,1,196054
12543,0.000418,172.31.36.0-255,66,54173,1,196054
12544,0.000432,172.217.194.0-255,1484,55657,1,196054
12545,0.000465,172.217.194.0-255,4320,59977,1,196054
12546,0.000468,172.31.36.0-255,66,60043,1,196054
12547,0.000492,172.31.36.0-255,66,60109,1,196054
12548,0.000499,172.217.194.0-255,5317,65426,1,196054
12549,0.000501,172.31.36.0-255,66,65492,1,196054
12550,0.000528,172.217.194.0-255,5738,71230,1,196054
12551,0.000531,172.31.36.0-255,66,71296,1,196054
12552,0.000539,172.217.194.0-255,7156,78452,1,196054
12553,0.000542,172.31.36.0-255,66,78518,1,196054
12554,0.000545,172.217.194.0-255,1484,80002,1,196054
12555,0.000582,172.31.36.0-255,66,80068,1,196054
12556,0.00059,172.217.194.0-255,6438,86506,1,196054
12557,0.000592,172.31.36.0-255,66,86572,1,196054
12558,0.000762,172.217.194.0-255,1484,88056,1,196054
12559,0.000779,172.217.194.0-255,2902,90958,1,196054
12560,0.000782,172.31.36.0-255,66,91024,1,196054
12561,0.000788,172.217.194.0-255,4320,95344,1,196054
12562,0.00079,172.31.36.0-255,66,95410,1,196054
12563,0.000801,172.217.194.0-255,1484,96894,1,196054
12564,0.000807,172.217.194.0-255,4320,101214,1,196054
12565,0.000809,172.31.36.0-255,66,101280,1,196054
12566,0.000832,172.31.36.0-255,66,101346,1,196054
12567,0.000843,172.31.36.0-255,66,101412,1,196054
12568,0.000874,172.217.194.0-255,4320,105732,1,196054
12569,0.000878,172.31.36.0-255,66,105798,1,196054
12570,0.000889,172.217.194.0-255,5738,111536,1,196054
12571,0.000892,172.31.36.0-255,66,111602,1,196054
12572,0.000904,172.217.194.0-255,2902,114504,1,196054
12573,0.000907,172.31.36.0-255,66,114570,1,196054
12574,0.000929,172.31.36.0-255,66,114636,1,196054
12575,0.000955,172.217.194.0-255,7156,121792,1,196054
12576,0.000958,172.31.36.0-255,66,121858,1,196054
12577,0.00099,172.217.194.0-255,5020,126878,1,196054
12578,0.000994,172.31.36.0-255,66,126944,1,196054
12579,0.001024,172.217.194.0-255,1484,128428,1,196054
12580,0.001035,172.217.194.0-255,1484,129912,1,196054
12581,0.001038,172.31.36.0-255,66,129978,1,196054
12582,0.001059,172.217.194.0-255,1484,131462,1,196054
12583,0.001066,172.217.194.0-255,5738,137200,1,196054
12584,0.00107,172.31.36.0-255,66,137266,1,196054
12585,0.001075,172.217.194.0-255,2902,140168,1,196054
12586,0.001078,172.31.36.0-255,66,140234,1,196054
12587,0.001107,172.31.36.0-255,66,140300,1,196054
12588,0.001136,172.217.194.0-255,2902,143202,1,196054
12589,0.00114,172.31.36.0-255,66,143268,1,196054
12590,0.001168,172.31.36.0-255,66,143334,1,196054
12591,0.001277,172.217.194.0-255,1484,144818,1,196054
12592,0.001298,172.217.194.0-255,2902,147720,1,196054
12593,0.001303,172.31.36.0-255,66,147786,1,196054
12594,0.001309,172.217.194.0-255,5738,153524,1,196054
12595,0.001312,172.31.36.0-255,66,153590,1,196054
12596,0.001353,172.31.36.0-255,66,153656,1,196054
12597,0.001364,172.31.36.0-255,66,153722,1,196054
12598,0.001417,172.217.194.0-255,766,154488,1,196054
12599,0.00142,172.217.194.0-255,1484,155972,1,196054
12600,0.001427,172.31.36.0-255,66,156038,1,196054
12601,0.00143,172.217.194.0-255,1484,157522,1,196054
12602,0.001446,172.217.194.0-255,2902,160424,1,196054
12603,0.00145,172.31.36.0-255,66,160490,1,196054
12604,0.001453,172.217.194.0-255,1484,161974,1,196054
12605,0.001469,172.217.194.0-255,2902,164876,1,196054
12606,0.001473,172.31.36.0-255,66,164942,1,196054
12607,0.001487,172.31.36.0-255,66,165008,1,196054
12608,0.001523,172.31.36.0-255,66,165074,1,196054
12609,0.00153,172.217.194.0-255,5738,170812,1,196054
12610,0.001532,172.31.36.0-255,66,170878,1,196054
12611,0.001558,172.217.194.0-255,5738,176616,1,196054
12612,0.001562,172.31.36.0-255,66,176682,1,196054
12613,0.001579,172.31.36.0-255,66,176748,1,196054
12614,0.001606,172.217.194.0-255,3602,180350,1,196054
12615,0.001609,172.31.36.0-255,66,180416,1,196054
12616,0.001628,172.31.36.0-255,66,180482,1,196054
12617,0.001652,172.217.194.0-255,2902,183384,1,196054
12618,0.001655,172.31.36.0-255,66,183450,1,196054
12619,0.001667,172.31.36.0-255,66,183516,1,196054
12620,0.001672,172.217.194.0-255,2902,186418,1,196054
12621,0.001682,172.31.36.0-255,66,186484,1,196054
12622,0.001708,172.31.36.0-255,66,186550,1,196054
12623,0.001726,172.31.36.0-255,66,186616,1,196054
12624,0.001739,172.217.194.0-255,105,186721,1,196054
12625,0.001745,172.31.36.0-255,66,186787,1,196054
12626,0.003594,172.31.36.0-255,105,186892,1,196054
12627,0.005864,172.217.194.0-255,66,186958,1,196054
12628,0.03643,172.31.36.0-255,172,187130,1,196054
12629,0.036465,172.31.36.0-255,1115,188245,1,196054
12630,0.036505,172.31.36.0-255,1514,189759,1,196054
12631,0.036507,172.31.36.0-255,1514,191273,1,196054
12632,0.036508,172.31.36.0-255,1514,192787,1,196054
12633,0.036509,172.31.36.0-255,1514,194301,1,196054
12634,0.036535,172.31.36.0-255,1489,195790,1,196054
12635,0.037981,104.244.42.0-255,66,195856,1,196054
12636,0.038015,104.244.42.0-255,66,195922,1,196054
12637,0.038072,104.244.42.0-255,66,195988,1,196054
12638,0.038118,104.244.42.0-255,66,196054,1,196054
12639,0.0,172.217.194.0-255,152,152,1,257791
12640,2.1e-05,172.31.36.0-255,66,218,1,257791
12641,2.8e-05,172.217.194.0-255,1484,1702,1,257791
12642,3.2e-05,172.31.36.0-255,66,1768,1,257791
12643,3.6e-05,172.217.194.0-255,2902,4670,1,257791
12644,3.9e-05,172.31.36.0-255,66,4736,1,257791
12645,4.6e-05,172.217.194.0-255,7156,11892,1,257791
12646,4.8e-05,172.31.36.0-255,66,11958,1,257791
12647,5.2e-05,172.217.194.0-255,2046,14004,1,257791
12648,5.5e-05,172.31.36.0-255,66,14070,1,257791
12649,8.2e-05,172.217.194.0-255,5738,19808,1,257791
12650,8.5e-05,172.31.36.0-255,66,19874,1,257791
12651,0.000106,172.217.194.0-255,5738,25612,1,257791
12652,0.00011,172.31.36.0-255,66,25678,1,257791
12653,0.000115,172.217.194.0-255,5379,31057,1,257791
12654,0.000117,172.31.36.0-255,66,31123,1,257791
12655,0.000195,172.217.194.0-255,1484,32607,1,257791
12656,0.000199,172.31.36.0-255,66,32673,1,257791
12657,0.000204,172.217.194.0-255,2902,35575,1,257791
12658,0.000206,172.31.36.0-255,66,35641,1,257791
12659,0.000231,172.217.194.0-255,5738,41379,1,257791
12660,0.000235,172.31.36.0-255,66,41445,1,257791
12661,0.000265,172.31.36.0-255,66,41511,1,257791
12662,0.000284,172.217.194.0-255,4320,45831,1,257791
12663,0.000287,172.31.36.0-255,66,45897,1,257791
12664,0.000293,172.217.194.0-255,7156,53053,1,257791
12665,0.000295,172.31.36.0-255,66,53119,1,257791
12666,0.000316,172.217.194.0-255,3602,56721,1,257791
12667,0.000319,172.31.36.0-255,66,56787,1,257791
12668,0.000639,172.217.194.0-255,347,57134,1,257791
12669,0.000644,172.31.36.0-255,66,57200,1,257791
12670,0.000684,172.217.194.0-255,116,57316,1,257791
12671,0.00081,172.217.194.0-255,1484,58800,1,257791
12672,0.000815,172.31.36.0-255,66,58866,1,257791
12673,0.00082,172.217.194.0-255,2902,61768,1,257791
12674,0.000826,172.217.194.0-255,5738,67506,1,257791
12675,0.000828,172.217.194.0-255,1484,68990,1,257791
12676,0.000836,172.31.36.0-255,66,69056,1,257791
12677,0.000868,172.217.194.0-255,4320,73376,1,257791
12678,0.000875,172.31.36.0-255,66,73442,1,257791
12679,0.000892,172.217.194.0-255,6750,80192,1,257791
12680,0.00092,172.31.36.0-255,66,80258,1,257791
12681,0.001315,172.217.194.0-255,1484,81742,1,257791
12682,0.001335,172.217.194.0-255,2902,84644,1,257791
12683,0.001339,172.31.36.0-255,66,84710,1,257791
12684,0.001346,172.217.194.0-255,5738,90448,1,257791
12685,0.001348,172.31.36.0-255,66,90514,1,257791
12686,0.001383,172.31.36.0-255,66,90580,1,257791
12687,0.001412,172.31.36.0-255,66,90646,1,257791
12688,0.001421,172.217.194.0-255,5020,95666,1,257791
12689,0.001452,172.217.194.0-255,1484,97150,1,257791
12690,0.001465,172.217.194.0-255,2902,100052,1,257791
12691,0.001469,172.217.194.0-255,2902,102954,1,257791
12692,0.001477,172.31.36.0-255,66,103020,1,257791
12693,0.001487,172.217.194.0-255,2902,105922,1,257791
12694,0.00149,172.217.194.0-255,1484,107406,1,257791
12695,0.001493,172.31.36.0-255,66,107472,1,257791
12696,0.001512,172.217.194.0-255,1484,108956,1,257791
12697,0.001536,172.31.36.0-255,66,109022,1,257791
12698,0.001547,172.217.194.0-255,5738,114760,1,257791
12699,0.001552,172.31.36.0-255,66,114826,1,257791
12700,0.001561,172.217.194.0-255,3602,118428,1,257791
12701,0.001596,172.31.36.0-255,66,118494,1,257791
12702,0.001606,172.217.194.0-255,5738,124232,1,257791
12703,0.001611,172.31.36.0-255,66,124298,1,257791
12704,0.001642,172.217.194.0-255,1484,125782,1,257791
12705,0.001656,172.31.36.0-255,66,125848,1,257791
12706,0.001662,172.217.194.0-255,5020,130868,1,257791
12707,0.001667,172.31.36.0-255,66,130934,1,257791
12708,0.003893,172.217.194.0-255,5738,136672,1,257791
12709,0.003901,172.31.36.0-255,66,136738,1,257791
12710,0.006165,172.217.194.0-255,5738,142476,1,257791
12711,0.006169,172.31.36.0-255,66,142542,1,257791
12712,0.008423,172.217.194.0-255,5738,148280,1,257791
12713,0.00843,172.31.36.0-255,66,148346,1,257791
12714,0.010673,172.217.194.0-255,5738,154084,1,257791
12715,0.010683,172.31.36.0-255,66,154150,1,257791
12716,0.012908,172.217.194.0-255,5738,159888,1,257791
12717,0.012915,172.31.36.0-255,66,159954,1,257791
12718,0.015238,172.217.194.0-255,5738,165692,1,257791
12719,0.01525,172.31.36.0-255,66,165758,1,257791
12720,0.017507,172.217.194.0-255,4320,170078,1,257791
12721,0.017514,172.31.36.0-255,66,170144,1,257791
12722,0.017529,172.217.194.0-255,1484,171628,1,257791
12723,0.01978,172.217.194.0-255,4320,175948,1,257791
12724,0.019789,172.31.36.0-255,66,176014,1,257791
12725,0.02203,172.217.194.0-255,5738,181752,1,257791
12726,0.022037,172.31.36.0-255,66,181818,1,257791
12727,0.024289,172.217.194.0-255,4320,186138,1,257791
12728,0.024296,172.31.36.0-255,66,186204,1,257791
12729,0.024315,172.217.194.0-255,1484,187688,1,257791
12730,0.026518,172.217.194.0-255,4320,192008,1,257791
12731,0.026525,172.31.36.0-255,66,192074,1,257791
12732,0.028779,172.217.194.0-255,5738,197812,1,257791
12733,0.028786,172.31.36.0-255,66,197878,1,257791
12734,0.031013,172.217.194.0-255,5738,203616,1,257791
12735,0.03102,172.31.36.0-255,66,203682,1,257791
12736,0.033254,172.217.194.0-255,5738,209420,1,257791
12737,0.033261,172.31.36.0-255,66,209486,1,257791
12738,0.035535,172.217.194.0-255,5738,215224,1,257791
12739,0.035542,172.31.36.0-255,66,215290,1,257791
12740,0.037781,172.217.194.0-255,5738,221028,1,257791
12741,0.037791,172.31.36.0-255,66,221094,1,257791
12742,0.038528,172.31.36.0-255,172,221266,1,257791
12743,0.038558,172.31.36.0-255,1113,222379,1,257791
12744,0.038623,172.31.36.0-255,1514,223893,1,257791
12745,0.038625,172.31.36.0-255,1514,225407,1,257791
12746,0.038629,172.31.36.0-255,1514,226921,1,257791
12747,0.03863,172.31.36.0-255,1514,228435,1,257791
12748,0.03865,172.31.36.0-255,1490,229925,1,257791
12749,0.040034,172.217.194.0-255,4320,234245,1,257791
12750,0.040042,172.31.36.0-255,66,234311,1,257791
12751,0.04006,172.217.194.0-255,1484,235795,1,257791
12752,0.040094,104.244.42.0-255,66,235861,1,257791
12753,0.040141,104.244.42.0-255,66,235927,1,257791
12754,0.0402,104.244.42.0-255,66,235993,1,257791
12755,0.042272,172.217.194.0-255,4320,240313,1,257791
12756,0.042278,172.31.36.0-255,66,240379,1,257791
12757,0.044533,172.217.194.0-255,5738,246117,1,257791
12758,0.044539,172.31.36.0-255,66,246183,1,257791
12759,0.046786,172.217.194.0-255,5738,251921,1,257791
12760,0.046792,172.31.36.0-255,66,251987,1,257791
12761,0.049025,172.217.194.0-255,5738,257725,1,257791
12762,0.04903,172.31.36.0-255,66,257791,1,257791
12763,0.0,74.125.24.0-255,156,156,1,328611
12764,2.1e-05,172.31.36.0-255,66,222,1,328611
12765,2.9e-05,74.125.24.0-255,1484,1706,1,328611
12766,3.3e-05,172.31.36.0-255,66,1772,1,328611
12767,3.9e-05,74.125.24.0-255,2902,4674,1,328611
12768,4.2e-05,172.31.36.0-255,66,4740,1,328611
12769,4.9e-05,74.125.24.0-255,7156,11896,1,328611
12770,5.3e-05,172.31.36.0-255,66,11962,1,328611
12771,5.7e-05,74.125.24.0-255,2083,14045,1,328611
12772,6.1e-05,172.31.36.0-255,66,14111,1,328611
12773,8.3e-05,74.125.24.0-255,1484,15595,1,328611
12774,8.6e-05,172.31.36.0-255,66,15661,1,328611
12775,0.000112,172.31.36.0-255,66,15727,1,328611
12776,0.000121,74.125.24.0-255,7156,22883,1,328611
12777,0.000123,172.31.36.0-255,66,22949,1,328611
12778,0.000143,74.125.24.0-255,7156,30105,1,328611
12779,0.000145,172.31.36.0-255,66,30171,1,328611
12780,0.00016,74.125.24.0-255,4320,34491,1,328611
12781,0.000162,172.31.36.0-255,66,34557,1,328611
12782,0.000178,74.125.24.0-255,3602,38159,1,328611
12783,0.000181,172.31.36.0-255,66,38225,1,328611
12784,0.000198,74.125.24.0-255,5738,43963,1,328611
12785,0.000201,172.31.36.0-255,66,44029,1,328611
12786,0.000222,74.125.24.0-255,2902,46931,1,328611
12787,0.000224,172.31.36.0-255,66,46997,1,328611
12788,0.000228,74.125.24.0-255,2902,49899,1,328611
12789,0.00023,172.31.36.0-255,66,49965,1,328611
12790,0.000258,74.125.24.0-255,1484,51449,1,328611
12791,0.000262,172.31.36.0-255,66,51515,1,328611
12792,0.000275,74.125.24.0-255,4315,55830,1,328611
12793,0.000277,172.31.36.0-255,66,55896,1,328611
12794,0.000341,74.125.24.0-255,1484,57380,1,328611
12795,0.000348,74.125.24.0-255,2902,60282,1,328611
12796,0.000351,172.31.36.0-255,66,60348,1,328611
12797,0.000375,74.125.24.0-255,4320,64668,1,328611
12798,0.000377,172.31.36.0-255,66,64734,1,328611
12799,0.000384,74.125.24.0-255,5738,70472,1,328611
12800,0.000386,172.31.36.0-255,66,70538,1,328611
12801,0.000426,172.31.36.0-255,66,70604,1,328611
12802,0.000429,74.125.24.0-255,1484,72088,1,328611
12803,0.000458,74.125.24.0-255,2902,74990,1,328611
12804,0.000461,172.31.36.0-255,66,75056,1,328611
12805,0.000466,74.125.24.0-255,2543,77599,1,328611
12806,0.000468,172.31.36.0-255,66,77665,1,328611
12807,0.000756,74.125.24.0-255,1484,79149,1,328611
12808,0.000763,74.125.24.0-255,2902,82051,1,328611
12809,0.000767,172.31.36.0-255,66,82117,1,328611
12810,0.000773,74.125.24.0-255,2902,85019,1,328611
12811,0.000775,172.31.36.0-255,66,85085,1,328611
12812,0.000794,74.125.24.0-255,2902,87987,1,328611
12813,0.000796,172.31.36.0-255,66,88053,1,328611
12814,0.000819,74.125.24.0-255,2902,90955,1,328611
12815,0.000822,172.31.36.0-255,66,91021,1,328611
12816,0.000842,74.125.24.0-255,3647,94668,1,328611
12817,0.000846,172.31.36.0-255,66,94734,1,328611
12818,0.000874,74.125.24.0-255,1484,96218,1,328611
12819,0.000879,74.125.24.0-255,2902,99120,1,328611
12820,0.000883,172.31.36.0-255,66,99186,1,328611
12821,0.000908,74.125.24.0-255,5738,104924,1,328611
12822,0.000911,172.31.36.0-255,66,104990,1,328611
12823,0.000918,74.125.24.0-255,5738,110728,1,328611
12824,0.000921,172.31.36.0-255,66,110794,1,328611
12825,0.000948,74.125.24.0-255,7156,117950,1,328611
12826,0.000952,172.31.36.0-255,66,118016,1,328611
12827,0.000972,74.125.24.0-255,4320,122336,1,328611
12828,0.000975,172.31.36.0-255,66,122402,1,328611
12829,0.001,74.125.24.0-255,6438,128840,1,328611
12830,0.001003,172.31.36.0-255,66,128906,1,328611
12831,0.001395,74.125.24.0-255,1484,130390,1,328611
12832,0.001415,74.125.24.0-255,2902,133292,1,328611
12833,0.001419,172.31.36.0-255,66,133358,1,328611
12834,0.001466,74.125.24.0-255,4320,137678,1,328611
12835,0.001468,172.31.36.0-255,66,137744,1,328611
12836,0.001479,172.31.36.0-255,66,137810,1,328611
12837,0.001492,172.31.36.0-255,66,137876,1,328611
12838,0.00153,74.125.24.0-255,6438,144314,1,328611
12839,0.001533,172.31.36.0-255,66,144380,1,328611
12840,0.001572,74.125.24.0-255,1484,145864,1,328611
12841,0.001589,74.125.24.0-255,2902,148766,1,328611
12842,0.001592,172.31.36.0-255,66,148832,1,328611
12843,0.0016,74.125.24.0-255,5738,154570,1,328611
12844,0.001602,172.31.36.0-255,66,154636,1,328611
12845,0.001661,172.31.36.0-255,66,154702,1,328611
12846,0.001676,172.31.36.0-255,66,154768,1,328611
12847,0.001768,74.125.24.0-255,1484,156252,1,328611
12848,0.00179,74.125.24.0-255,2902,159154,1,328611
12849,0.001794,172.31.36.0-255,66,159220,1,328611
12850,0.0018,74.125.24.0-255,4320,163540,1,328611
12851,0.001802,172.31.36.0-255,66,163606,1,328611
12852,0.001814,74.125.24.0-255,1484,165090,1,328611
12853,0.001837,74.125.24.0-255,2902,167992,1,328611
12854,0.00184,172.31.36.0-255,66,168058,1,328611
12855,0.001866,74.125.24.0-255,2902,170960,1,328611
12856,0.001869,172.31.36.0-255,66,171026,1,328611
12857,0.001877,74.125.24.0-255,7156,178182,1,328611
12858,0.001879,172.31.36.0-255,66,178248,1,328611
12859,0.001921,172.31.36.0-255,66,178314,1,328611
12860,0.002026,74.125.24.0-255,1484,179798,1,328611
12861,0.002033,74.125.24.0-255,1484,181282,1,328611
12862,0.002036,172.31.36.0-255,66,181348,1,328611
12863,0.002062,74.125.24.0-255,1484,182832,1,328611
12864,0.002069,74.125.24.0-255,5738,188570,1,328611
12865,0.002072,172.31.36.0-255,66,188636,1,328611
12866,0.00208,74.125.24.0-255,5738,194374,1,328611
12867,0.002082,172.31.36.0-255,66,194440,1,328611
12868,0.002097,74.125.24.0-255,1484,195924,1,328611
12869,0.004133,74.125.24.0-255,4320,200244,1,328611
12870,0.00414,172.31.36.0-255,66,200310,1,328611
12871,0.006167,74.125.24.0-255,5738,206048,1,328611
12872,0.006172,172.31.36.0-255,66,206114,1,328611
12873,0.008209,74.125.24.0-255,4320,210434,1,328611
12874,0.008214,172.31.36.0-255,66,210500,1,328611
12875,0.008231,74.125.24.0-255,1484,211984,1,328611
12876,0.010266,74.125.24.0-255,4320,216304,1,328611
12877,0.010273,172.31.36.0-255,66,216370,1,328611
12878,0.012343,74.125.24.0-255,5738,222108,1,328611
12879,0.012351,172.31.36.0-255,66,222174,1,328611
12880,0.014402,74.125.24.0-255,5738,227912,1,328611
12881,0.014412,172.31.36.0-255,66,227978,1,328611
12882,0.016452,74.125.24.0-255,5738,233716,1,328611
12883,0.016459,172.31.36.0-255,66,233782,1,328611
12884,0.01849,74.125.24.0-255,5738,239520,1,328611
12885,0.018498,172.31.36.0-255,66,239586,1,328611
12886,0.020555,74.125.24.0-255,5738,245324,1,328611
12887,0.020562,172.31.36.0-255,66,245390,1,328611
12888,0.022655,74.125.24.0-255,4320,249710,1,328611
12889,0.022663,172.31.36.0-255,66,249776,1,328611
12890,0.022683,74.125.24.0-255,1484,251260,1,328611
12891,0.024707,74.125.24.0-255,4320,255580,1,328611
12892,0.024714,172.31.36.0-255,66,255646,1,328611
12893,0.026761,74.125.24.0-255,5738,261384,1,328611
12894,0.026768,172.31.36.0-255,66,261450,1,328611
12895,0.028856,74.125.24.0-255,5738,267188,1,328611
12896,0.028863,172.31.36.0-255,66,267254,1,328611
12897,0.029758,172.31.36.0-255,164,267418,1,328611
12898,0.029798,172.31.36.0-255,1122,268540,1,328611
12899,0.02986,172.31.36.0-255,1514,270054,1,328611
12900,0.029862,172.31.36.0-255,319,270373,1,328611
12901,0.030918,74.125.24.0-255,5738,276111,1,328611
12902,0.030925,172.31.36.0-255,66,276177,1,328611
12903,0.031281,104.244.42.0-255,66,276243,1,328611
12904,0.031457,104.244.42.0-255,66,276309,1,328611
12905,0.031479,104.244.42.0-255,66,276375,1,328611
12906,0.032996,74.125.24.0-255,5738,282113,1,328611
12907,0.033,172.31.36.0-255,66,282179,1,328611
12908,0.035055,74.125.24.0-255,5738,287917,1,328611
12909,0.035061,172.31.36.0-255,66,287983,1,328611
12910,0.037125,74.125.24.0-255,5738,293721,1,328611
12911,0.037131,172.31.36.0-255,66,293787,1,328611
12912,0.039184,74.125.24.0-255,5738,299525,1,328611
12913,0.039189,172.31.36.0-255,66,299591,1,328611
12914,0.041225,74.125.24.0-255,5738,305329,1,328611
12915,0.041231,172.31.36.0-255,66,305395,1,328611
12916,0.043291,74.125.24.0-255,5738,311133,1,328611
12917,0.043298,172.31.36.0-255,66,311199,1,328611
12918,0.04535,74.125.24.0-255,5738,316937,1,328611
12919,0.045355,172.31.36.0-255,66,317003,1,328611
12920,0.047403,74.125.24.0-255,5738,322741,1,328611
12921,0.047409,172.31.36.0-255,66,322807,1,328611
12922,0.049465,74.125.24.0-255,5738,328545,1,328611
12923,0.049472,172.31.36.0-255,66,328611,1,328611
12924,0.0,172.31.36.0-255,66,66,1,66
12925,0.0,172.31.36.0-255,105,105,1,276
12926,0.001478,157.240.13.0-255,105,210,1,276
12927,0.001488,172.31.36.0-255,66,276,1,276
12928,0.0,172.217.27.0-255,148,148,1,256475
12929,2.2e-05,172.31.36.0-255,66,214,1,256475
12930,3e-05,172.217.27.0-255,1484,1698,1,256475
12931,3.5e-05,172.31.36.0-255,66,1764,1,256475
12932,4.1e-05,172.217.27.0-255,2902,4666,1,256475
12933,4.5e-05,172.31.36.0-255,66,4732,1,256475
12934,5.1e-05,172.217.27.0-255,4320,9052,1,256475
12935,5.4e-05,172.31.36.0-255,66,9118,1,256475
12936,8.2e-05,172.217.27.0-255,1484,10602,1,256475
12937,8.6e-05,172.31.36.0-255,66,10668,1,256475
12938,9.2e-05,172.217.27.0-255,3413,14081,1,256475
12939,9.5e-05,172.31.36.0-255,66,14147,1,256475
12940,0.0001,172.217.27.0-255,4320,18467,1,256475
12941,0.000103,172.31.36.0-255,66,18533,1,256475
12942,0.000116,172.31.36.0-255,66,18599,1,256475
12943,0.000121,172.217.27.0-255,2543,21142,1,256475
12944,0.000124,172.31.36.0-255,66,21208,1,256475
12945,0.000295,172.217.27.0-255,1484,22692,1,256475
12946,0.000299,172.31.36.0-255,66,22758,1,256475
12947,0.000305,172.217.27.0-255,2902,25660,1,256475
12948,0.000307,172.31.36.0-255,66,25726,1,256475
12949,0.000314,172.217.27.0-255,5738,31464,1,256475
12950,0.000317,172.31.36.0-255,66,31530,1,256475
12951,0.00035,172.217.27.0-255,6797,38327,1,256475
12952,0.000352,172.31.36.0-255,66,38393,1,256475
12953,0.000383,172.31.36.0-255,66,38459,1,256475
12954,0.000412,172.217.27.0-255,2902,41361,1,256475
12955,0.000414,172.31.36.0-255,66,41427,1,256475
12956,0.000432,172.217.27.0-255,1429,42856,1,256475
12957,0.000434,172.31.36.0-255,66,42922,1,256475
12958,0.001327,172.217.27.0-255,116,43038,1,256475
12959,0.001369,172.217.27.0-255,1484,44522,1,256475
12960,0.001374,172.31.36.0-255,66,44588,1,256475
12961,0.001379,172.217.27.0-255,1484,46072,1,256475
12962,0.001383,172.217.27.0-255,2902,48974,1,256475
12963,0.001411,172.217.27.0-255,5738,54712,1,256475
12964,0.001422,172.217.27.0-255,1484,56196,1,256475
12965,0.001465,172.217.27.0-255,7156,63352,1,256475
12966,0.001486,172.217.27.0-255,2184,65536,1,256475
12967,0.001529,172.217.27.0-255,2902,68438,1,256475
12968,0.001536,172.217.27.0-255,7156,75594,1,256475
12969,0.001566,172.217.27.0-255,5738,81332,1,256475
12970,0.001586,172.217.27.0-255,1484,82816,1,256475
12971,0.001593,172.217.27.0-255,7156,89972,1,256475
12972,0.001604,172.217.27.0-255,766,90738,1,256475
12973,0.001607,172.217.27.0-255,1484,92222,1,256475
12974,0.001613,172.217.27.0-255,4320,96542,1,256475
12975,0.001619,172.217.27.0-255,5738,102280,1,256475
12976,0.001638,172.217.27.0-255,4320,106600,1,256475
12977,0.001642,172.217.27.0-255,1484,108084,1,256475
12978,0.006862,172.31.36.0-255,66,108150,1,256475
12979,0.008548,172.217.27.0-255,5738,113888,1,256475
12980,0.008557,172.31.36.0-255,66,113954,1,256475
12981,0.010227,172.217.27.0-255,5738,119692,1,256475
12982,0.011583,172.31.36.0-255,66,119758,1,256475
12983,0.013251,172.217.27.0-255,5738,125496,1,256475
12984,0.013258,172.31.36.0-255,66,125562,1,256475
12985,0.014927,172.217.27.0-255,5738,131300,1,256475
12986,0.014934,172.31.36.0-255,66,131366,1,256475
12987,0.016603,172.217.27.0-255,5738,137104,1,256475
12988,0.016613,172.31.36.0-255,66,137170,1,256475
12989,0.018272,172.217.27.0-255,5738,142908,1,256475
12990,0.018278,172.31.36.0-255,66,142974,1,256475
12991,0.019945,172.217.27.0-255,5738,148712,1,256475
12992,0.019952,172.31.36.0-255,66,148778,1,256475
12993,0.021621,172.217.27.0-255,5738,154516,1,256475
12994,0.021628,172.31.36.0-255,66,154582,1,256475
12995,0.023288,172.217.27.0-255,5738,160320,1,256475
12996,0.023296,172.31.36.0-255,66,160386,1,256475
12997,0.024967,172.217.27.0-255,5738,166124,1,256475
12998,0.024974,172.31.36.0-255,66,166190,1,256475
12999,0.026648,172.217.27.0-255,5738,171928,1,256475
13000,0.026656,172.31.36.0-255,66,171994,1,256475
13001,0.028344,172.217.27.0-255,5738,177732,1,256475
13002,0.028351,172.31.36.0-255,66,177798,1,256475
13003,0.030013,172.217.27.0-255,5738,183536,1,256475
13004,0.03002,172.31.36.0-255,66,183602,1,256475
13005,0.031691,172.217.27.0-255,5738,189340,1,256475
13006,0.031698,172.31.36.0-255,66,189406,1,256475
13007,0.03337,172.217.27.0-255,5738,195144,1,256475
13008,0.033378,172.31.36.0-255,66,195210,1,256475
13009,0.035041,172.217.27.0-255,5738,200948,1,256475
13010,0.035048,172.31.36.0-255,66,201014,1,256475
13011,0.036724,172.217.27.0-255,5738,206752,1,256475
13012,0.036729,172.31.36.0-255,66,206818,1,256475
13013,0.037481,172.31.36.0-255,172,206990,1,256475
13014,0.037518,172.31.36.0-255,1113,208103,1,256475
13015,0.037584,172.31.36.0-255,1514,209617,1,256475
13016,0.037586,172.31.36.0-255,1514,211131,1,256475
13017,0.037591,172.31.36.0-255,1514,212645,1,256475
13018,0.037592,172.31.36.0-255,1514,214159,1,256475
13019,0.037621,172.31.36.0-255,1490,215649,1,256475
13020,0.038399,172.217.27.0-255,5738,221387,1,256475
13021,0.038406,172.31.36.0-255,66,221453,1,256475
13022,0.039022,104.244.42.0-255,66,221519,1,256475
13023,0.039077,104.244.42.0-255,66,221585,1,256475
13024,0.039216,104.244.42.0-255,66,221651,1,256475
13025,0.040066,172.217.27.0-255,5738,227389,1,256475
13026,0.040073,172.31.36.0-255,66,227455,1,256475
13027,0.041735,172.217.27.0-255,5738,233193,1,256475
13028,0.041742,172.31.36.0-255,66,233259,1,256475
13029,0.043449,172.217.27.0-255,5738,238997,1,256475
13030,0.043456,172.31.36.0-255,66,239063,1,256475
13031,0.045113,172.217.27.0-255,5738,244801,1,256475
13032,0.045119,172.31.36.0-255,66,244867,1,256475
13033,0.046785,172.217.27.0-255,5738,250605,1,256475
13034,0.046791,172.31.36.0-255,66,250671,1,256475
13035,0.048464,172.217.27.0-255,5738,256409,1,256475
13036,0.048471,172.31.36.0-255,66,256475,1,256475
13037,0.0,74.125.68.0-255,810,810,1,115442
13038,1.3e-05,74.125.68.0-255,1484,2294,1,115442
13039,2.1e-05,172.31.36.0-255,66,2360,1,115442
13040,3e-05,74.125.68.0-255,4320,6680,1,115442
13041,3.3e-05,172.31.36.0-255,66,6746,1,115442
13042,0.000154,74.125.68.0-255,1484,8230,1,115442
13043,0.000184,172.31.36.0-255,66,8296,1,115442
13044,0.000519,74.125.68.0-255,7156,15452,1,115442
13045,0.000525,172.31.36.0-255,66,15518,1,115442
13046,0.000549,74.125.68.0-255,2902,18420,1,115442
13047,0.000552,172.31.36.0-255,66,18486,1,115442
13048,0.000913,74.125.68.0-255,3961,22447,1,115442
13049,0.00092,172.31.36.0-255,66,22513,1,115442
13050,0.002286,74.125.68.0-255,5738,28251,1,115442
13051,0.002293,172.31.36.0-255,66,28317,1,115442
13052,0.002466,74.125.68.0-255,2902,31219,1,115442
13053,0.002892,74.125.68.0-255,5738,36957,1,115442
13054,0.002933,74.125.68.0-255,1484,38441,1,115442
13055,0.003615,74.125.68.0-255,4320,42761,1,115442
13056,0.003659,74.125.68.0-255,1484,44245,1,115442
13057,0.004274,74.125.68.0-255,7156,51401,1,115442
13058,0.004539,74.125.68.0-255,4320,55721,1,115442
13059,0.004568,74.125.68.0-255,7156,62877,1,115442
13060,0.007321,172.31.36.0-255,66,62943,1,115442
13061,0.007852,172.31.36.0-255,66,63009,1,115442
13062,0.009624,172.31.36.0-255,66,63075,1,115442
13063,0.009648,74.125.68.0-255,7156,70231,1,115442
13064,0.0098,74.125.68.0-255,5738,75969,1,115442
13065,0.010196,74.125.68.0-255,1734,77703,1,115442
13066,0.010228,74.125.68.0-255,5738,83441,1,115442
13067,0.01062,172.31.36.0-255,66,83507,1,115442
13068,0.010663,74.125.68.0-255,5738,89245,1,115442
13069,0.010668,172.31.36.0-255,66,89311,1,115442
13070,0.010704,172.31.36.0-255,66,89377,1,115442
13071,0.0111,74.125.68.0-255,7156,96533,1,115442
13072,0.011104,172.31.36.0-255,66,96599,1,115442
13073,0.011136,172.31.36.0-255,66,96665,1,115442
13074,0.011521,74.125.68.0-255,7156,103821,1,115442
13075,0.011527,172.31.36.0-255,66,103887,1,115442
13076,0.011547,74.125.68.0-255,1926,105813,1,115442
13077,0.01155,172.31.36.0-255,66,105879,1,115442
13078,0.011906,172.31.36.0-255,66,105945,1,115442
13079,0.012915,172.31.36.0-255,66,106011,1,115442
13080,0.012985,172.31.36.0-255,66,106077,1,115442
13081,0.013161,172.31.36.0-255,66,106143,1,115442
13082,0.013217,172.31.36.0-255,66,106209,1,115442
13083,0.013902,172.31.36.0-255,66,106275,1,115442
13084,0.01408,172.31.36.0-255,66,106341,1,115442
13085,0.014138,172.31.36.0-255,66,106407,1,115442
13086,0.014797,172.31.36.0-255,66,106473,1,115442
13087,0.014853,172.31.36.0-255,66,106539,1,115442
13088,0.015509,74.125.68.0-255,4320,110859,1,115442
13089,0.015514,172.31.36.0-255,66,110925,1,115442
13090,0.015545,172.31.36.0-255,66,110991,1,115442
13091,0.015952,172.31.36.0-255,105,111096,1,115442
13092,0.01817,74.125.68.0-255,66,111162,1,115442
13093,0.040708,172.31.36.0-255,167,111329,1,115442
13094,0.040741,172.31.36.0-255,1145,112474,1,115442
13095,0.040801,172.31.36.0-255,1514,113988,1,115442
13096,0.040802,172.31.36.0-255,1256,115244,1,115442
13097,0.042296,104.244.42.0-255,66,115310,1,115442
13098,0.04234,104.244.42.0-255,66,115376,1,115442
13099,0.042388,104.244.42.0-255,66,115442,1,115442
13100,0.0,172.217.194.0-255,147,147,1,224755
13101,2.7e-05,172.31.36.0-255,66,213,1,224755
13102,3.4e-05,172.217.194.0-255,1484,1697,1,224755
13103,3.9e-05,172.31.36.0-255,66,1763,1,224755
13104,4.4e-05,172.217.194.0-255,2902,4665,1,224755
13105,4.6e-05,172.31.36.0-255,66,4731,1,224755
13106,6.4e-05,172.217.194.0-255,7156,11887,1,224755
13107,6.8e-05,172.31.36.0-255,66,11953,1,224755
13108,7.3e-05,172.217.194.0-255,3453,15406,1,224755
13109,7.6e-05,172.31.36.0-255,66,15472,1,224755
13110,8.3e-05,172.217.194.0-255,4320,19792,1,224755
13111,8.5e-05,172.31.36.0-255,66,19858,1,224755
13112,0.000123,172.31.36.0-255,66,19924,1,224755
13113,0.000126,172.217.194.0-255,1125,21049,1,224755
13114,0.000128,172.31.36.0-255,66,21115,1,224755
13115,0.000206,172.217.194.0-255,1484,22599,1,224755
13116,0.000223,172.31.36.0-255,66,22665,1,224755
13117,0.000229,172.217.194.0-255,2902,25567,1,224755
13118,0.000232,172.31.36.0-255,66,25633,1,224755
13119,0.000238,172.217.194.0-255,5738,31371,1,224755
13120,0.00024,172.31.36.0-255,66,31437,1,224755
13121,0.000255,172.217.194.0-255,1484,32921,1,224755
13122,0.000259,172.31.36.0-255,66,32987,1,224755
13123,0.000296,172.31.36.0-255,66,33053,1,224755
13124,0.000306,172.31.36.0-255,66,33119,1,224755
13125,0.000309,172.217.194.0-255,348,33467,1,224755
13126,0.000311,172.31.36.0-255,66,33533,1,224755
13127,0.000364,172.217.194.0-255,429,33962,1,224755
13128,0.000367,172.31.36.0-255,66,34028,1,224755
13129,0.000545,172.217.194.0-255,1484,35512,1,224755
13130,0.000552,172.217.194.0-255,2902,38414,1,224755
13131,0.000555,172.31.36.0-255,66,38480,1,224755
13132,0.000562,172.217.194.0-255,4320,42800,1,224755
13133,0.000565,172.31.36.0-255,66,42866,1,224755
13134,0.000587,172.217.194.0-255,1484,44350,1,224755
13135,0.000593,172.217.194.0-255,4320,48670,1,224755
13136,0.000596,172.31.36.0-255,66,48736,1,224755
13137,0.000602,172.217.194.0-255,5738,54474,1,224755
13138,0.000604,172.31.36.0-255,66,54540,1,224755
13139,0.00062,172.217.194.0-255,5738,60278,1,224755
13140,0.000623,172.31.36.0-255,66,60344,1,224755
13141,0.000626,172.217.194.0-255,1484,61828,1,224755
13142,0.000644,172.217.194.0-255,6438,68266,1,224755
13143,0.000648,172.31.36.0-255,66,68332,1,224755
13144,0.000818,172.217.194.0-255,1484,69816,1,224755
13145,0.000823,172.217.194.0-255,2902,72718,1,224755
13146,0.000826,172.31.36.0-255,66,72784,1,224755
13147,0.000829,172.217.194.0-255,1484,74268,1,224755
13148,0.000851,172.217.194.0-255,4320,78588,1,224755
13149,0.000854,172.31.36.0-255,66,78654,1,224755
13150,0.000861,172.217.194.0-255,4320,82974,1,224755
13151,0.000863,172.31.36.0-255,66,83040,1,224755
13152,0.000903,172.31.36.0-255,66,83106,1,224755
13153,0.00092,172.31.36.0-255,66,83172,1,224755
13154,0.002001,172.217.194.0-255,1484,84656,1,224755
13155,0.002014,172.217.194.0-255,2902,87558,1,224755
13156,0.002018,172.31.36.0-255,66,87624,1,224755
13157,0.002025,172.217.194.0-255,5738,93362,1,224755
13158,0.002027,172.31.36.0-255,66,93428,1,224755
13159,0.002065,172.31.36.0-255,66,93494,1,224755
13160,0.002085,172.217.194.0-255,2902,96396,1,224755
13161,0.002088,172.31.36.0-255,66,96462,1,224755
13162,0.002093,172.217.194.0-255,2902,99364,1,224755
13163,0.002095,172.31.36.0-255,66,99430,1,224755
13164,0.00212,172.31.36.0-255,66,99496,1,224755
13165,0.004373,172.217.194.0-255,5738,105234,1,224755
13166,0.004378,172.31.36.0-255,66,105300,1,224755
13167,0.006629,172.217.194.0-255,5738,111038,1,224755
13168,0.006633,172.31.36.0-255,66,111104,1,224755
13169,0.008885,172.217.194.0-255,5738,116842,1,224755
13170,0.008893,172.31.36.0-255,66,116908,1,224755
13171,0.011289,172.217.194.0-255,5738,122646,1,224755
13172,0.011297,172.31.36.0-255,66,122712,1,224755
13173,0.01358,172.217.194.0-255,5738,128450,1,224755
13174,0.013589,172.31.36.0-255,66,128516,1,224755
13175,0.015864,172.217.194.0-255,5738,134254,1,224755
13176,0.015871,172.31.36.0-255,66,134320,1,224755
13177,0.018148,172.217.194.0-255,5738,140058,1,224755
13178,0.018161,172.31.36.0-255,66,140124,1,224755
13179,0.020431,172.217.194.0-255,5738,145862,1,224755
13180,0.020439,172.31.36.0-255,66,145928,1,224755
13181,0.022714,172.217.194.0-255,5738,151666,1,224755
13182,0.022721,172.31.36.0-255,66,151732,1,224755
13183,0.024983,172.217.194.0-255,5738,157470,1,224755
13184,0.024991,172.31.36.0-255,66,157536,1,224755
13185,0.027255,172.217.194.0-255,5738,163274,1,224755
13186,0.027264,172.31.36.0-255,66,163340,1,224755
13187,0.02956,172.217.194.0-255,5738,169078,1,224755
13188,0.029571,172.31.36.0-255,66,169144,1,224755
13189,0.031863,172.217.194.0-255,5738,174882,1,224755
13190,0.031875,172.31.36.0-255,66,174948,1,224755
13191,0.034182,172.217.194.0-255,5738,180686,1,224755
13192,0.034194,172.31.36.0-255,66,180752,1,224755
13193,0.036506,172.217.194.0-255,5738,186490,1,224755
13194,0.036518,172.31.36.0-255,66,186556,1,224755
13195,0.038822,172.217.194.0-255,5738,192294,1,224755
13196,0.038836,172.31.36.0-255,66,192360,1,224755
13197,0.041129,172.217.194.0-255,5738,198098,1,224755
13198,0.041139,172.31.36.0-255,66,198164,1,224755
13199,0.041579,172.31.36.0-255,188,198352,1,224755
13200,0.041618,172.31.36.0-255,958,199310,1,224755
13201,0.041667,172.31.36.0-255,1514,200824,1,224755
13202,0.041669,172.31.36.0-255,1514,202338,1,224755
13203,0.041674,172.31.36.0-255,1514,203852,1,224755
13204,0.041675,172.31.36.0-255,1514,205366,1,224755
13205,0.041696,172.31.36.0-255,1514,206880,1,224755
13206,0.041697,172.31.36.0-255,199,207079,1,224755
13207,0.043096,104.244.42.0-255,66,207145,1,224755
13208,0.043195,104.244.42.0-255,66,207211,1,224755
13209,0.0432,104.244.42.0-255,66,207277,1,224755
13210,0.043215,104.244.42.0-255,66,207343,1,224755
13211,0.043394,172.217.194.0-255,5738,213081,1,224755
13212,0.0434,172.31.36.0-255,66,213147,1,224755
13213,0.04566,172.217.194.0-255,5738,218885,1,224755
13214,0.045665,172.31.36.0-255,66,218951,1,224755
13215,0.047925,172.217.194.0-255,5738,224689,1,224755
13216,0.047933,172.31.36.0-255,66,224755,1,224755
13217,0.0,74.125.24.0-255,153,153,1,189549
13218,2.6e-05,172.31.36.0-255,66,219,1,189549
13219,3.3e-05,74.125.24.0-255,1484,1703,1,189549
13220,3.8e-05,172.31.36.0-255,66,1769,1,189549
13221,5.1e-05,74.125.24.0-255,2902,4671,1,189549
13222,5.5e-05,172.31.36.0-255,66,4737,1,189549
13223,9.8e-05,74.125.24.0-255,4320,9057,1,189549
13224,0.000102,172.31.36.0-255,66,9123,1,189549
13225,0.000129,74.125.24.0-255,1484,10607,1,189549
13226,0.000133,172.31.36.0-255,66,10673,1,189549
13227,0.000284,74.125.24.0-255,3392,14065,1,189549
13228,0.000291,172.31.36.0-255,66,14131,1,189549
13229,0.000379,74.125.24.0-255,4320,18451,1,189549
13230,0.000383,172.31.36.0-255,66,18517,1,189549
13231,0.000507,74.125.24.0-255,5738,24255,1,189549
13232,0.000512,172.31.36.0-255,66,24321,1,189549
13233,0.000545,74.125.24.0-255,4320,28641,1,189549
13234,0.000548,172.31.36.0-255,66,28707,1,189549
13235,0.000799,74.125.24.0-255,2543,31250,1,189549
13236,0.000805,172.31.36.0-255,66,31316,1,189549
13237,0.000875,74.125.24.0-255,2902,34218,1,189549
13238,0.000879,172.31.36.0-255,66,34284,1,189549
13239,0.000917,172.31.36.0-255,66,34350,1,189549
13240,0.000944,74.125.24.0-255,3961,38311,1,189549
13241,0.000947,172.31.36.0-255,66,38377,1,189549
13242,0.001639,74.125.24.0-255,1484,39861,1,189549
13243,0.001647,172.31.36.0-255,66,39927,1,189549
13244,0.001652,74.125.24.0-255,2902,42829,1,189549
13245,0.001654,172.31.36.0-255,66,42895,1,189549
13246,0.001732,74.125.24.0-255,2902,45797,1,189549
13247,0.001734,172.31.36.0-255,66,45863,1,189549
13248,0.001759,74.125.24.0-255,2902,48765,1,189549
13249,0.00189,74.125.24.0-255,2902,51667,1,189549
13250,0.00197,74.125.24.0-255,2902,54569,1,189549
13251,0.002573,74.125.24.0-255,1484,56053,1,189549
13252,0.002586,74.125.24.0-255,4320,60373,1,189549
13253,0.002597,74.125.24.0-255,2902,63275,1,189549
13254,0.002832,74.125.24.0-255,4320,67595,1,189549
13255,0.002852,74.125.24.0-255,4541,72136,1,189549
13256,0.003087,74.125.24.0-255,2902,75038,1,189549
13257,0.003973,74.125.24.0-255,5738,80776,1,189549
13258,0.00404,172.31.36.0-255,66,80842,1,189549
13259,0.006635,74.125.24.0-255,5738,86580,1,189549
13260,0.006644,172.31.36.0-255,66,86646,1,189549
13261,0.009246,74.125.24.0-255,5738,92384,1,189549
13262,0.009255,172.31.36.0-255,66,92450,1,189549
13263,0.011834,74.125.24.0-255,5738,98188,1,189549
13264,0.011842,172.31.36.0-255,66,98254,1,189549
13265,0.014397,74.125.24.0-255,5738,103992,1,189549
13266,0.014404,172.31.36.0-255,66,104058,1,189549
13267,0.016995,74.125.24.0-255,5738,109796,1,189549
13268,0.017003,172.31.36.0-255,66,109862,1,189549
13269,0.019593,74.125.24.0-255,5738,115600,1,189549
13270,0.019598,172.31.36.0-255,66,115666,1,189549
13271,0.022173,74.125.24.0-255,5738,121404,1,189549
13272,0.02218,172.31.36.0-255,66,121470,1,189549
13273,0.024734,74.125.24.0-255,5738,127208,1,189549
13274,0.024742,172.31.36.0-255,66,127274,1,189549
13275,0.0273,74.125.24.0-255,5738,133012,1,189549
13276,0.027308,172.31.36.0-255,66,133078,1,189549
13277,0.029862,74.125.24.0-255,5738,138816,1,189549
13278,0.029869,172.31.36.0-255,66,138882,1,189549
13279,0.032457,74.125.24.0-255,5738,144620,1,189549
13280,0.032465,172.31.36.0-255,66,144686,1,189549
13281,0.033191,172.31.36.0-255,192,144878,1,189549
13282,0.033219,172.31.36.0-255,1116,145994,1,189549
13283,0.033297,172.31.36.0-255,1514,147508,1,189549
13284,0.033299,172.31.36.0-255,1514,149022,1,189549
13285,0.033305,172.31.36.0-255,1514,150536,1,189549
13286,0.033307,172.31.36.0-255,1514,152050,1,189549
13287,0.033335,172.31.36.0-255,1487,153537,1,189549
13288,0.034754,104.244.42.0-255,66,153603,1,189549
13289,0.034761,104.244.42.0-255,66,153669,1,189549
13290,0.034887,104.244.42.0-255,66,153735,1,189549
13291,0.034942,104.244.42.0-255,66,153801,1,189549
13292,0.035029,74.125.24.0-255,2902,156703,1,189549
13293,0.035033,172.31.36.0-255,66,156769,1,189549
13294,0.035056,74.125.24.0-255,2902,159671,1,189549
13295,0.035059,172.31.36.0-255,66,159737,1,189549
13296,0.037598,74.125.24.0-255,2902,162639,1,189549
13297,0.037603,172.31.36.0-255,66,162705,1,189549
13298,0.037632,74.125.24.0-255,1484,164189,1,189549
13299,0.037641,74.125.24.0-255,1484,165673,1,189549
13300,0.037644,172.31.36.0-255,66,165739,1,189549
13301,0.040166,74.125.24.0-255,2902,168641,1,189549
13302,0.040174,172.31.36.0-255,66,168707,1,189549
13303,0.040212,74.125.24.0-255,1484,170191,1,189549
13304,0.040233,74.125.24.0-255,1484,171675,1,189549
13305,0.040236,172.31.36.0-255,66,171741,1,189549
13306,0.042775,74.125.24.0-255,2902,174643,1,189549
13307,0.042781,172.31.36.0-255,66,174709,1,189549
13308,0.042822,74.125.24.0-255,2902,177611,1,189549
13309,0.042825,172.31.36.0-255,66,177677,1,189549
13310,0.045357,74.125.24.0-255,2902,180579,1,189549
13311,0.045364,172.31.36.0-255,66,180645,1,189549
13312,0.045442,74.125.24.0-255,2902,183547,1,189549
13313,0.045447,172.31.36.0-255,66,183613,1,189549
13314,0.047948,74.125.24.0-255,2902,186515,1,189549
13315,0.047953,172.31.36.0-255,66,186581,1,189549
13316,0.048012,74.125.24.0-255,2902,189483,1,189549
13317,0.048016,172.31.36.0-255,66,189549,1,189549
13318,0.0,172.217.194.0-255,174,174,1,247758
13319,2.6e-05,172.31.36.0-255,66,240,1,247758
13320,3.4e-05,172.217.194.0-255,1484,1724,1,247758
13321,3.9e-05,172.31.36.0-255,66,1790,1,247758
13322,5.2e-05,172.217.194.0-255,2902,4692,1,247758
13323,5.6e-05,172.31.36.0-255,66,4758,1,247758
13324,6.4e-05,172.217.194.0-255,7156,11914,1,247758
13325,6.7e-05,172.31.36.0-255,66,11980,1,247758
13326,7.2e-05,172.217.194.0-255,2029,14009,1,247758
13327,7.5e-05,172.31.36.0-255,66,14075,1,247758
13328,0.00037,172.217.194.0-255,1484,15559,1,247758
13329,0.000376,172.31.36.0-255,66,15625,1,247758
13330,0.000383,172.217.194.0-255,2902,18527,1,247758
13331,0.000386,172.31.36.0-255,66,18593,1,247758
13332,0.000399,172.217.194.0-255,5738,24331,1,247758
13333,0.000401,172.31.36.0-255,66,24397,1,247758
13334,0.000409,172.217.194.0-255,6797,31194,1,247758
13335,0.000411,172.31.36.0-255,66,31260,1,247758
13336,0.000465,172.31.36.0-255,66,31326,1,247758
13337,0.000472,172.217.194.0-255,5738,37064,1,247758
13338,0.000475,172.31.36.0-255,66,37130,1,247758
13339,0.000501,172.217.194.0-255,4320,41450,1,247758
13340,0.000504,172.31.36.0-255,66,41516,1,247758
13341,0.000544,172.31.36.0-255,66,41582,1,247758
13342,0.000547,172.217.194.0-255,377,41959,1,247758
13343,0.000549,172.31.36.0-255,66,42025,1,247758
13344,0.000552,172.217.194.0-255,397,42422,1,247758
13345,0.00056,172.31.36.0-255,66,42488,1,247758
13346,0.000688,172.217.194.0-255,1484,43972,1,247758
13347,0.000694,172.217.194.0-255,2902,46874,1,247758
13348,0.000699,172.31.36.0-255,66,46940,1,247758
13349,0.000702,172.31.36.0-255,66,47006,1,247758
13350,0.00072,172.217.194.0-255,5738,52744,1,247758
13351,0.000723,172.31.36.0-255,66,52810,1,247758
13352,0.000736,172.31.36.0-255,66,52876,1,247758
13353,0.000748,172.217.194.0-255,2902,55778,1,247758
13354,0.000751,172.31.36.0-255,66,55844,1,247758
13355,0.000783,172.217.194.0-255,7156,63000,1,247758
13356,0.000786,172.31.36.0-255,66,63066,1,247758
13357,0.000816,172.217.194.0-255,3602,66668,1,247758
13358,0.000819,172.31.36.0-255,66,66734,1,247758
13359,0.0016,172.217.194.0-255,1484,68218,1,247758
13360,0.00161,172.217.194.0-255,2902,71120,1,247758
13361,0.001614,172.31.36.0-255,66,71186,1,247758
13362,0.001619,172.217.194.0-255,1484,72670,1,247758
13363,0.001638,172.217.194.0-255,4320,76990,1,247758
13364,0.00164,172.31.36.0-255,66,77056,1,247758
13365,0.001643,172.217.194.0-255,1484,78540,1,247758
13366,0.001655,172.31.36.0-255,66,78606,1,247758
13367,0.001687,172.217.194.0-255,2902,81508,1,247758
13368,0.001689,172.31.36.0-255,66,81574,1,247758
13369,0.001701,172.31.36.0-255,66,81640,1,247758
13370,0.002,172.217.194.0-255,1484,83124,1,247758
13371,0.002007,172.217.194.0-255,2902,86026,1,247758
13372,0.002011,172.31.36.0-255,66,86092,1,247758
13373,0.002019,172.217.194.0-255,5738,91830,1,247758
13374,0.002021,172.31.36.0-255,66,91896,1,247758
13375,0.002032,172.217.194.0-255,4320,96216,1,247758
13376,0.002035,172.31.36.0-255,66,96282,1,247758
13377,0.002065,172.217.194.0-255,2902,99184,1,247758
13378,0.002068,172.31.36.0-255,66,99250,1,247758
13379,0.002087,172.31.36.0-255,66,99316,1,247758
13380,0.002091,172.217.194.0-255,2184,101500,1,247758
13381,0.002093,172.31.36.0-255,66,101566,1,247758
13382,0.002098,172.217.194.0-255,2902,104468,1,247758
13383,0.0021,172.31.36.0-255,66,104534,1,247758
13384,0.002125,172.217.194.0-255,5738,110272,1,247758
13385,0.002127,172.31.36.0-255,66,110338,1,247758
13386,0.004238,172.217.194.0-255,5738,116076,1,247758
13387,0.004245,172.31.36.0-255,66,116142,1,247758
13388,0.006331,172.217.194.0-255,5738,121880,1,247758
13389,0.006334,172.31.36.0-255,66,121946,1,247758
13390,0.008432,172.217.194.0-255,5738,127684,1,247758
13391,0.008439,172.31.36.0-255,66,127750,1,247758
13392,0.010529,172.217.194.0-255,5738,133488,1,247758
13393,0.010537,172.31.36.0-255,66,133554,1,247758
13394,0.012664,172.217.194.0-255,5738,139292,1,247758
13395,0.012672,172.31.36.0-255,66,139358,1,247758
13396,0.014769,172.217.194.0-255,5738,145096,1,247758
13397,0.014777,172.31.36.0-255,66,145162,1,247758
13398,0.016879,172.217.194.0-255,5738,150900,1,247758
13399,0.016888,172.31.36.0-255,66,150966,1,247758
13400,0.01898,172.217.194.0-255,5738,156704,1,247758
13401,0.01899,172.31.36.0-255,66,156770,1,247758
13402,0.021082,172.217.194.0-255,2902,159672,1,247758
13403,0.021089,172.31.36.0-255,66,159738,1,247758
13404,0.021119,172.217.194.0-255,2902,162640,1,247758
13405,0.021122,172.31.36.0-255,66,162706,1,247758
13406,0.023172,172.217.194.0-255,2902,165608,1,247758
13407,0.023179,172.31.36.0-255,66,165674,1,247758
13408,0.023206,172.217.194.0-255,2902,168576,1,247758
13409,0.023209,172.31.36.0-255,66,168642,1,247758
13410,0.025254,172.217.194.0-255,2902,171544,1,247758
13411,0.025262,172.31.36.0-255,66,171610,1,247758
13412,0.025292,172.217.194.0-255,2902,174512,1,247758
13413,0.025295,172.31.36.0-255,66,174578,1,247758
13414,0.027351,172.217.194.0-255,2902,177480,1,247758
13415,0.02736,172.31.36.0-255,66,177546,1,247758
13416,0.027395,172.217.194.0-255,2902,180448,1,247758
13417,0.027398,172.31.36.0-255,66,180514,1,247758
13418,0.02949,172.217.194.0-255,5738,186252,1,247758
13419,0.029498,172.31.36.0-255,66,186318,1,247758
13420,0.031568,172.217.194.0-255,5738,192056,1,247758
13421,0.031574,172.31.36.0-255,66,192122,1,247758
13422,0.033658,172.217.194.0-255,5738,197860,1,247758
13423,0.033665,172.31.36.0-255,66,197926,1,247758
13424,0.035736,172.217.194.0-255,5738,203664,1,247758
13425,0.035744,172.31.36.0-255,66,203730,1,247758
13426,0.037833,172.217.194.0-255,5738,209468,1,247758
13427,0.03784,172.31.36.0-255,66,209534,1,247758
13428,0.038311,172.31.36.0-255,172,209706,1,247758
13429,0.03834,172.31.36.0-255,1113,210819,1,247758
13430,0.038409,172.31.36.0-255,1514,212333,1,247758
13431,0.038411,172.31.36.0-255,1514,213847,1,247758
13432,0.038412,172.31.36.0-255,1514,215361,1,247758
13433,0.038413,172.31.36.0-255,1514,216875,1,247758
13434,0.038441,172.31.36.0-255,1491,218366,1,247758
13435,0.03984,104.244.42.0-255,66,218432,1,247758
13436,0.039912,172.217.194.0-255,5738,224170,1,247758
13437,0.039918,172.31.36.0-255,66,224236,1,247758
13438,0.039941,104.244.42.0-255,66,224302,1,247758
13439,0.039975,104.244.42.0-255,66,224368,1,247758
13440,0.040743,104.244.42.0-255,108,224476,1,247758
13441,0.040752,172.31.36.0-255,66,224542,1,247758
13442,0.042034,172.217.194.0-255,5738,230280,1,247758
13443,0.042043,172.31.36.0-255,66,230346,1,247758
13444,0.044152,172.217.194.0-255,5738,236084,1,247758
13445,0.04416,172.31.36.0-255,66,236150,1,247758
13446,0.046241,172.217.194.0-255,5738,241888,1,247758
13447,0.046252,172.31.36.0-255,66,241954,1,247758
13448,0.04834,172.217.194.0-255,5738,247692,1,247758
13449,0.048347,172.31.36.0-255,66,247758,1,247758
13450,0.0,74.125.24.0-255,290,290,1,213066
13451,3e-05,172.31.36.0-255,66,356,1,213066
13452,3.9e-05,74.125.24.0-255,1484,1840,1,213066
13453,4.4e-05,172.31.36.0-255,66,1906,1,213066
13454,5.2e-05,74.125.24.0-255,4320,6226,1,213066
13455,6.5e-05,172.31.36.0-255,66,6292,1,213066
13456,7.8e-05,172.31.36.0-255,66,6358,1,213066
13457,9.3e-05,172.31.36.0-255,66,6424,1,213066
13458,0.000113,74.125.24.0-255,1484,7908,1,213066
13459,0.00012,172.31.36.0-255,66,7974,1,213066
13460,0.000125,74.125.24.0-255,2543,10517,1,213066
13461,0.000128,172.31.36.0-255,66,10583,1,213066
13462,0.00065,74.125.24.0-255,1484,12067,1,213066
13463,0.000657,74.125.24.0-255,2902,14969,1,213066
13464,0.00066,74.125.24.0-255,1484,16453,1,213066
13465,0.00067,172.31.36.0-255,66,16519,1,213066
13466,0.000674,172.31.36.0-255,66,16585,1,213066
13467,0.000677,172.31.36.0-255,66,16651,1,213066
13468,0.000689,74.125.24.0-255,4320,20971,1,213066
13469,0.000691,172.31.36.0-255,66,21037,1,213066
13470,0.000696,74.125.24.0-255,2902,23939,1,213066
13471,0.000698,172.31.36.0-255,66,24005,1,213066
13472,0.000725,74.125.24.0-255,2902,26907,1,213066
13473,0.000728,172.31.36.0-255,66,26973,1,213066
13474,0.000762,172.31.36.0-255,66,27039,1,213066
13475,0.000769,74.125.24.0-255,5738,32777,1,213066
13476,0.000772,172.31.36.0-255,66,32843,1,213066
13477,0.000801,74.125.24.0-255,4234,37077,1,213066
13478,0.000808,172.31.36.0-255,66,37143,1,213066
13479,0.001049,74.125.24.0-255,131,37274,1,213066
13480,0.001184,172.31.36.0-255,66,37340,1,213066
13481,0.001458,74.125.24.0-255,1484,38824,1,213066
13482,0.001483,74.125.24.0-255,2902,41726,1,213066
13483,0.001488,172.31.36.0-255,66,41792,1,213066
13484,0.001496,74.125.24.0-255,5738,47530,1,213066
13485,0.001498,172.31.36.0-255,66,47596,1,213066
13486,0.001524,74.125.24.0-255,1484,49080,1,213066
13487,0.001529,74.125.24.0-255,2902,51982,1,213066
13488,0.001532,172.31.36.0-255,66,52048,1,213066
13489,0.001559,74.125.24.0-255,2543,54591,1,213066
13490,0.001562,172.31.36.0-255,66,54657,1,213066
13491,0.001591,74.125.24.0-255,2902,57559,1,213066
13492,0.001593,172.31.36.0-255,66,57625,1,213066
13493,0.001602,74.125.24.0-255,7156,64781,1,213066
13494,0.001604,172.31.36.0-255,66,64847,1,213066
13495,0.001614,74.125.24.0-255,4320,69167,1,213066
13496,0.001616,172.31.36.0-255,66,69233,1,213066
13497,0.00167,172.31.36.0-255,66,69299,1,213066
13498,0.001677,74.125.24.0-255,6438,75737,1,213066
13499,0.001679,172.31.36.0-255,66,75803,1,213066
13500,0.001861,74.125.24.0-255,1484,77287,1,213066
13501,0.00187,74.125.24.0-255,2902,80189,1,213066
13502,0.001874,172.31.36.0-255,66,80255,1,213066
13503,0.001878,74.125.24.0-255,1484,81739,1,213066
13504,0.001909,74.125.24.0-255,4320,86059,1,213066
13505,0.001912,172.31.36.0-255,66,86125,1,213066
13506,0.001919,74.125.24.0-255,5738,91863,1,213066
13507,0.001921,172.31.36.0-255,66,91929,1,213066
13508,0.001967,74.125.24.0-255,2902,94831,1,213066
13509,0.00197,172.31.36.0-255,66,94897,1,213066
13510,0.002014,172.31.36.0-255,66,94963,1,213066
13511,0.002034,172.31.36.0-255,66,95029,1,213066
13512,0.002041,74.125.24.0-255,5738,100767,1,213066
13513,0.002043,172.31.36.0-255,66,100833,1,213066
13514,0.002046,74.125.24.0-255,766,101599,1,213066
13515,0.00242,74.125.24.0-255,1484,103083,1,213066
13516,0.002427,172.31.36.0-255,66,103149,1,213066
13517,0.002434,74.125.24.0-255,2902,106051,1,213066
13518,0.002437,172.31.36.0-255,66,106117,1,213066
13519,0.002445,74.125.24.0-255,1484,107601,1,213066
13520,0.002473,74.125.24.0-255,4320,111921,1,213066
13521,0.002476,172.31.36.0-255,66,111987,1,213066
13522,0.002479,74.125.24.0-255,1484,113471,1,213066
13523,0.002483,74.125.24.0-255,1484,114955,1,213066
13524,0.002485,172.31.36.0-255,66,115021,1,213066
13525,0.002518,74.125.24.0-255,4320,119341,1,213066
13526,0.002521,172.31.36.0-255,66,119407,1,213066
13527,0.002523,74.125.24.0-255,1484,120891,1,213066
13528,0.002526,74.125.24.0-255,1484,122375,1,213066
13529,0.002529,172.31.36.0-255,66,122441,1,213066
13530,0.002551,74.125.24.0-255,2902,125343,1,213066
13531,0.002554,172.31.36.0-255,66,125409,1,213066
13532,0.002592,74.125.24.0-255,7156,132565,1,213066
13533,0.002595,172.31.36.0-255,66,132631,1,213066
13534,0.0026,74.125.24.0-255,3602,136233,1,213066
13535,0.002602,172.31.36.0-255,66,136299,1,213066
13536,0.002657,172.31.36.0-255,66,136365,1,213066
13537,0.0027,172.31.36.0-255,66,136431,1,213066
13538,0.002706,74.125.24.0-255,5738,142169,1,213066
13539,0.002709,172.31.36.0-255,66,142235,1,213066
13540,0.002726,74.125.24.0-255,766,143001,1,213066
13541,0.002766,74.125.24.0-255,1484,144485,1,213066
13542,0.002769,172.31.36.0-255,66,144551,1,213066
13543,0.002773,74.125.24.0-255,1484,146035,1,213066
13544,0.002797,74.125.24.0-255,2902,148937,1,213066
13545,0.0028,172.31.36.0-255,66,149003,1,213066
13546,0.002834,74.125.24.0-255,5738,154741,1,213066
13547,0.002837,172.31.36.0-255,66,154807,1,213066
13548,0.002841,74.125.24.0-255,1484,156291,1,213066
13549,0.002893,172.31.36.0-255,66,156357,1,213066
13550,0.002911,172.31.36.0-255,66,156423,1,213066
13551,0.002914,74.125.24.0-255,766,157189,1,213066
13552,0.002962,74.125.24.0-255,2902,160091,1,213066
13553,0.002965,172.31.36.0-255,66,160157,1,213066
13554,0.003005,172.31.36.0-255,66,160223,1,213066
13555,0.003016,172.31.36.0-255,66,160289,1,213066
13556,0.003035,172.31.36.0-255,66,160355,1,213066
13557,0.003075,74.125.24.0-255,1484,161839,1,213066
13558,0.003103,74.125.24.0-255,2184,164023,1,213066
13559,0.003106,172.31.36.0-255,66,164089,1,213066
13560,0.003109,74.125.24.0-255,1484,165573,1,213066
13561,0.003116,74.125.24.0-255,5738,171311,1,213066
13562,0.003124,172.31.36.0-255,66,171377,1,213066
13563,0.003131,74.125.24.0-255,7156,178533,1,213066
13564,0.003134,172.31.36.0-255,66,178599,1,213066
13565,0.003141,74.125.24.0-255,7156,185755,1,213066
13566,0.003143,172.31.36.0-255,66,185821,1,213066
13567,0.003146,74.125.24.0-255,1484,187305,1,213066
13568,0.003157,172.31.36.0-255,66,187371,1,213066
13569,0.00316,74.125.24.0-255,1484,188855,1,213066
13570,0.003196,172.31.36.0-255,66,188921,1,213066
13571,0.003209,74.125.24.0-255,7156,196077,1,213066
13572,0.003211,172.31.36.0-255,66,196143,1,213066
13573,0.003258,172.31.36.0-255,66,196209,1,213066
13574,0.003285,172.31.36.0-255,66,196275,1,213066
13575,0.003299,172.31.36.0-255,66,196341,1,213066
13576,0.003341,74.125.24.0-255,7156,203497,1,213066
13577,0.003344,172.31.36.0-255,66,203563,1,213066
13578,0.003358,172.31.36.0-255,66,203629,1,213066
13579,0.003378,172.31.36.0-255,66,203695,1,213066
13580,0.003409,74.125.24.0-255,105,203800,1,213066
13581,0.008431,172.31.36.0-255,66,203866,1,213066
13582,0.008489,172.31.36.0-255,105,203971,1,213066
13583,0.010843,74.125.24.0-255,66,204037,1,213066
13584,0.045218,172.31.36.0-255,172,204209,1,213066
13585,0.045251,172.31.36.0-255,1114,205323,1,213066
13586,0.045318,172.31.36.0-255,1514,206837,1,213066
13587,0.045319,172.31.36.0-255,1514,208351,1,213066
13588,0.045324,172.31.36.0-255,1514,209865,1,213066
13589,0.045326,172.31.36.0-255,1514,211379,1,213066
13590,0.045349,172.31.36.0-255,1489,212868,1,213066
13591,0.046785,104.244.42.0-255,66,212934,1,213066
13592,0.046797,104.244.42.0-255,66,213000,1,213066
13593,0.046881,104.244.42.0-255,66,213066,1,213066
13594,0.0,74.125.24.0-255,146,146,1,235312
13595,3.2e-05,172.31.36.0-255,66,212,1,235312
13596,3.9e-05,74.125.24.0-255,1484,1696,1,235312
13597,4.3e-05,172.31.36.0-255,66,1762,1,235312
13598,4.7e-05,74.125.24.0-255,2902,4664,1,235312
13599,5.7e-05,172.31.36.0-255,66,4730,1,235312
13600,6.4e-05,74.125.24.0-255,7156,11886,1,235312
13601,6.7e-05,172.31.36.0-255,66,11952,1,235312
13602,7.1e-05,74.125.24.0-255,1987,13939,1,235312
13603,7.3e-05,172.31.36.0-255,66,14005,1,235312
13604,0.000133,74.125.24.0-255,2902,16907,1,235312
13605,0.000136,172.31.36.0-255,66,16973,1,235312
13606,0.000178,74.125.24.0-255,7156,24129,1,235312
13607,0.000182,172.31.36.0-255,66,24195,1,235312
13608,0.000189,74.125.24.0-255,6797,30992,1,235312
13609,0.000191,172.31.36.0-255,66,31058,1,235312
13610,0.000249,74.125.24.0-255,7156,38214,1,235312
13611,0.000253,172.31.36.0-255,66,38280,1,235312
13612,0.000256,74.125.24.0-255,1484,39764,1,235312
13613,0.000258,172.31.36.0-255,66,39830,1,235312
13614,0.000298,172.31.36.0-255,66,39896,1,235312
13615,0.000313,172.31.36.0-255,66,39962,1,235312
13616,0.000347,74.125.24.0-255,2543,42505,1,235312
13617,0.00035,172.31.36.0-255,66,42571,1,235312
13618,0.000353,74.125.24.0-255,649,43220,1,235312
13619,0.000356,172.31.36.0-255,66,43286,1,235312
13620,0.000724,74.125.24.0-255,1484,44770,1,235312
13621,0.000728,172.31.36.0-255,66,44836,1,235312
13622,0.000734,74.125.24.0-255,2902,47738,1,235312
13623,0.000736,172.31.36.0-255,66,47804,1,235312
13624,0.000739,74.125.24.0-255,1484,49288,1,235312
13625,0.000741,172.31.36.0-255,66,49354,1,235312
13626,0.000774,74.125.24.0-255,4320,53674,1,235312
13627,0.000779,172.31.36.0-255,66,53740,1,235312
13628,0.000804,74.125.24.0-255,4320,58060,1,235312
13629,0.000808,172.31.36.0-255,66,58126,1,235312
13630,0.000838,74.125.24.0-255,1991,60117,1,235312
13631,0.000841,172.31.36.0-255,66,60183,1,235312
13632,0.001223,74.125.24.0-255,1484,61667,1,235312
13633,0.001229,172.31.36.0-255,66,61733,1,235312
13634,0.001238,74.125.24.0-255,2902,64635,1,235312
13635,0.00124,172.31.36.0-255,66,64701,1,235312
13636,0.001255,74.125.24.0-255,5738,70439,1,235312
13637,0.001257,172.31.36.0-255,66,70505,1,235312
13638,0.001262,74.125.24.0-255,2902,73407,1,235312
13639,0.001264,172.31.36.0-255,66,73473,1,235312
13640,0.001307,172.31.36.0-255,66,73539,1,235312
13641,0.001343,172.31.36.0-255,66,73605,1,235312
13642,0.001793,74.125.24.0-255,1484,75089,1,235312
13643,0.001799,172.31.36.0-255,66,75155,1,235312
13644,0.001805,74.125.24.0-255,2902,78057,1,235312
13645,0.001807,172.31.36.0-255,66,78123,1,235312
13646,0.001818,74.125.24.0-255,5738,83861,1,235312
13647,0.00182,172.31.36.0-255,66,83927,1,235312
13648,0.001823,74.125.24.0-255,1484,85411,1,235312
13649,0.001824,172.31.36.0-255,66,85477,1,235312
13650,0.001867,172.31.36.0-255,66,85543,1,235312
13651,0.001926,172.31.36.0-255,66,85609,1,235312
13652,0.001939,172.31.36.0-255,66,85675,1,235312
13653,0.001962,74.125.24.0-255,1484,87159,1,235312
13654,0.001964,172.31.36.0-255,66,87225,1,235312
13655,0.001982,74.125.24.0-255,1484,88709,1,235312
13656,0.00205,74.125.24.0-255,1484,90193,1,235312
13657,0.002054,74.125.24.0-255,2902,93095,1,235312
13658,0.002057,74.125.24.0-255,1484,94579,1,235312
13659,0.00207,74.125.24.0-255,4320,98899,1,235312
13660,0.002086,74.125.24.0-255,1484,100383,1,235312
13661,0.002106,74.125.24.0-255,5738,106121,1,235312
13662,0.002116,74.125.24.0-255,2902,109023,1,235312
13663,0.002139,74.125.24.0-255,5738,114761,1,235312
13664,0.002175,74.125.24.0-255,4320,119081,1,235312
13665,0.00222,74.125.24.0-255,1484,120565,1,235312
13666,0.006529,172.31.36.0-255,66,120631,1,235312
13667,0.008852,74.125.24.0-255,5738,126369,1,235312
13668,0.008859,172.31.36.0-255,66,126435,1,235312
13669,0.011348,74.125.24.0-255,5738,132173,1,235312
13670,0.01141,172.31.36.0-255,66,132239,1,235312
13671,0.013737,74.125.24.0-255,5738,137977,1,235312
13672,0.013745,172.31.36.0-255,66,138043,1,235312
13673,0.01605,74.125.24.0-255,5738,143781,1,235312
13674,0.016059,172.31.36.0-255,66,143847,1,235312
13675,0.018371,74.125.24.0-255,5738,149585,1,235312
13676,0.018379,172.31.36.0-255,66,149651,1,235312
13677,0.020711,74.125.24.0-255,5738,155389,1,235312
13678,0.020719,172.31.36.0-255,66,155455,1,235312
13679,0.022989,74.125.24.0-255,5738,161193,1,235312
13680,0.022995,172.31.36.0-255,66,161259,1,235312
13681,0.025286,74.125.24.0-255,5738,166997,1,235312
13682,0.025294,172.31.36.0-255,66,167063,1,235312
13683,0.027636,74.125.24.0-255,5738,172801,1,235312
13684,0.027642,172.31.36.0-255,66,172867,1,235312
13685,0.029913,74.125.24.0-255,5738,178605,1,235312
13686,0.029921,172.31.36.0-255,66,178671,1,235312
13687,0.032249,74.125.24.0-255,5738,184409,1,235312
13688,0.032257,172.31.36.0-255,66,184475,1,235312
13689,0.034603,74.125.24.0-255,5738,190213,1,235312
13690,0.034609,172.31.36.0-255,66,190279,1,235312
13691,0.034794,172.31.36.0-255,188,190467,1,235312
13692,0.03482,172.31.36.0-255,958,191425,1,235312
13693,0.03486,172.31.36.0-255,1514,192939,1,235312
13694,0.034862,172.31.36.0-255,1514,194453,1,235312
13695,0.034863,172.31.36.0-255,1514,195967,1,235312
13696,0.034868,172.31.36.0-255,1514,197481,1,235312
13697,0.034869,172.31.36.0-255,1514,198995,1,235312
13698,0.03487,172.31.36.0-255,197,199192,1,235312
13699,0.03636,104.244.42.0-255,66,199258,1,235312
13700,0.036368,104.244.42.0-255,66,199324,1,235312
13701,0.036445,104.244.42.0-255,66,199390,1,235312
13702,0.03645,104.244.42.0-255,66,199456,1,235312
13703,0.036882,74.125.24.0-255,2902,202358,1,235312
13704,0.036886,172.31.36.0-255,66,202424,1,235312
13705,0.036917,74.125.24.0-255,2902,205326,1,235312
13706,0.036933,172.31.36.0-255,66,205392,1,235312
13707,0.037168,104.244.42.0-255,108,205500,1,235312
13708,0.037176,172.31.36.0-255,66,205566,1,235312
13709,0.039177,74.125.24.0-255,2902,208468,1,235312
13710,0.039182,172.31.36.0-255,66,208534,1,235312
13711,0.039214,74.125.24.0-255,1484,210018,1,235312
13712,0.039225,74.125.24.0-255,1484,211502,1,235312
13713,0.039234,172.31.36.0-255,66,211568,1,235312
13714,0.041508,74.125.24.0-255,2902,214470,1,235312
13715,0.041514,172.31.36.0-255,66,214536,1,235312
13716,0.04155,74.125.24.0-255,2902,217438,1,235312
13717,0.04157,172.31.36.0-255,66,217504,1,235312
13718,0.043789,74.125.24.0-255,2902,220406,1,235312
13719,0.043795,172.31.36.0-255,66,220472,1,235312
13720,0.043872,74.125.24.0-255,2902,223374,1,235312
13721,0.043894,172.31.36.0-255,66,223440,1,235312
13722,0.046075,74.125.24.0-255,2902,226342,1,235312
13723,0.046081,172.31.36.0-255,66,226408,1,235312
13724,0.046157,74.125.24.0-255,2902,229310,1,235312
13725,0.046165,172.31.36.0-255,66,229376,1,235312
13726,0.048361,74.125.24.0-255,2902,232278,1,235312
13727,0.048366,172.31.36.0-255,66,232344,1,235312
13728,0.048438,74.125.24.0-255,2902,235246,1,235312
13729,0.048453,172.31.36.0-255,66,235312,1,235312
13730,0.0,172.31.36.0-255,66,66,1,66
13731,0.0,172.217.194.0-255,143,143,1,157683
13732,3.9e-05,172.31.36.0-255,66,209,1,157683
13733,4.7e-05,172.217.194.0-255,1484,1693,1,157683
13734,5.2e-05,172.31.36.0-255,66,1759,1,157683
13735,5.7e-05,172.217.194.0-255,2902,4661,1,157683
13736,5.9e-05,172.31.36.0-255,66,4727,1,157683
13737,6.6e-05,172.217.194.0-255,7156,11883,1,157683
13738,6.9e-05,172.31.36.0-255,66,11949,1,157683
13739,8.6e-05,172.217.194.0-255,1484,13433,1,157683
13740,8.8e-05,172.31.36.0-255,66,13499,1,157683
13741,0.000108,172.31.36.0-255,66,13565,1,157683
13742,0.000121,172.217.194.0-255,2075,15640,1,157683
13743,0.000125,172.31.36.0-255,66,15706,1,157683
13744,0.000138,172.31.36.0-255,66,15772,1,157683
13745,0.000157,172.217.194.0-255,1484,17256,1,157683
13746,0.000159,172.31.36.0-255,66,17322,1,157683
13747,0.000192,172.31.36.0-255,66,17388,1,157683
13748,0.001267,172.217.194.0-255,1484,18872,1,157683
13749,0.001275,172.31.36.0-255,66,18938,1,157683
13750,0.001287,172.217.194.0-255,2902,21840,1,157683
13751,0.001289,172.31.36.0-255,66,21906,1,157683
13752,0.001296,172.217.194.0-255,5738,27644,1,157683
13753,0.001298,172.31.36.0-255,66,27710,1,157683
13754,0.001304,172.217.194.0-255,2902,30612,1,157683
13755,0.001306,172.31.36.0-255,66,30678,1,157683
13756,0.001331,172.217.194.0-255,4217,34895,1,157683
13757,0.001334,172.31.36.0-255,66,34961,1,157683
13758,0.00135,172.217.194.0-255,118,35079,1,157683
13759,0.001353,172.31.36.0-255,66,35145,1,157683
13760,0.005031,172.217.194.0-255,1484,36629,1,157683
13761,0.005055,172.217.194.0-255,2902,39531,1,157683
13762,0.005061,172.31.36.0-255,66,39597,1,157683
13763,0.005067,172.217.194.0-255,1484,41081,1,157683
13764,0.00736,172.217.194.0-255,4320,45401,1,157683
13765,0.007373,172.31.36.0-255,66,45467,1,157683
13766,0.009683,172.217.194.0-255,5738,51205,1,157683
13767,0.009698,172.31.36.0-255,66,51271,1,157683
13768,0.012073,172.217.194.0-255,5738,57009,1,157683
13769,0.012087,172.31.36.0-255,66,57075,1,157683
13770,0.014402,172.217.194.0-255,5738,62813,1,157683
13771,0.014415,172.31.36.0-255,66,62879,1,157683
13772,0.016716,172.217.194.0-255,5738,68617,1,157683
13773,0.01672,172.31.36.0-255,66,68683,1,157683
13774,0.019027,172.217.194.0-255,5738,74421,1,157683
13775,0.019036,172.31.36.0-255,66,74487,1,157683
13776,0.021368,172.217.194.0-255,5738,80225,1,157683
13777,0.021379,172.31.36.0-255,66,80291,1,157683
13778,0.023683,172.217.194.0-255,5738,86029,1,157683
13779,0.02369,172.31.36.0-255,66,86095,1,157683
13780,0.025999,172.217.194.0-255,5738,91833,1,157683
13781,0.026007,172.31.36.0-255,66,91899,1,157683
13782,0.028278,172.217.194.0-255,4320,96219,1,157683
13783,0.028286,172.31.36.0-255,66,96285,1,157683
13784,0.028311,172.217.194.0-255,1484,97769,1,157683
13785,0.030597,172.217.194.0-255,4320,102089,1,157683
13786,0.030605,172.31.36.0-255,66,102155,1,157683
13787,0.032891,172.217.194.0-255,5738,107893,1,157683
13788,0.032901,172.31.36.0-255,66,107959,1,157683
13789,0.034152,172.31.36.0-255,172,108131,1,157683
13790,0.034183,172.31.36.0-255,1115,109246,1,157683
13791,0.034256,172.31.36.0-255,1514,110760,1,157683
13792,0.034258,172.31.36.0-255,1514,112274,1,157683
13793,0.034264,172.31.36.0-255,1514,113788,1,157683
13794,0.034265,172.31.36.0-255,1514,115302,1,157683
13795,0.034296,172.31.36.0-255,1489,116791,1,157683
13796,0.035225,172.217.194.0-255,5738,122529,1,157683
13797,0.035233,172.31.36.0-255,66,122595,1,157683
13798,0.035735,104.244.42.0-255,66,122661,1,157683
13799,0.035763,104.244.42.0-255,66,122727,1,157683
13800,0.035816,104.244.42.0-255,66,122793,1,157683
13801,0.035865,104.244.42.0-255,66,122859,1,157683
13802,0.037527,172.217.194.0-255,5738,128597,1,157683
13803,0.037534,172.31.36.0-255,66,128663,1,157683
13804,0.039846,172.217.194.0-255,5738,134401,1,157683
13805,0.039853,172.31.36.0-255,66,134467,1,157683
13806,0.042174,172.217.194.0-255,5738,140205,1,157683
13807,0.042181,172.31.36.0-255,66,140271,1,157683
13808,0.044491,172.217.194.0-255,5738,146009,1,157683
13809,0.044497,172.31.36.0-255,66,146075,1,157683
13810,0.046792,172.217.194.0-255,5738,151813,1,157683
13811,0.046797,172.31.36.0-255,66,151879,1,157683
13812,0.049077,172.217.194.0-255,5738,157617,1,157683
13813,0.049083,172.31.36.0-255,66,157683,1,157683
13814,0.0,74.125.68.0-255,153,153,1,191302
13815,2.2e-05,172.31.36.0-255,66,219,1,191302
13816,3e-05,74.125.68.0-255,1484,1703,1,191302
13817,3.4e-05,172.31.36.0-255,66,1769,1,191302
13818,4e-05,74.125.68.0-255,2902,4671,1,191302
13819,4.4e-05,172.31.36.0-255,66,4737,1,191302
13820,5.2e-05,74.125.68.0-255,7156,11893,1,191302
13821,5.6e-05,172.31.36.0-255,66,11959,1,191302
13822,0.000105,74.125.68.0-255,2002,13961,1,191302
13823,0.000108,172.31.36.0-255,66,14027,1,191302
13824,0.000374,74.125.68.0-255,1484,15511,1,191302
13825,0.00038,172.31.36.0-255,66,15577,1,191302
13826,0.000386,74.125.68.0-255,2902,18479,1,191302
13827,0.000389,172.31.36.0-255,66,18545,1,191302
13828,0.000417,74.125.68.0-255,4320,22865,1,191302
13829,0.000421,172.31.36.0-255,66,22931,1,191302
13830,0.000424,74.125.68.0-255,1484,24415,1,191302
13831,0.000426,172.31.36.0-255,66,24481,1,191302
13832,0.000448,74.125.68.0-255,4320,28801,1,191302
13833,0.000451,172.31.36.0-255,66,28867,1,191302
13834,0.00047,74.125.68.0-255,2543,31410,1,191302
13835,0.000472,172.31.36.0-255,66,31476,1,191302
13836,0.000803,74.125.68.0-255,1484,32960,1,191302
13837,0.000808,172.31.36.0-255,66,33026,1,191302
13838,0.000857,74.125.68.0-255,2902,35928,1,191302
13839,0.00086,172.31.36.0-255,66,35994,1,191302
13840,0.000863,74.125.68.0-255,1484,37478,1,191302
13841,0.000865,172.31.36.0-255,66,37544,1,191302
13842,0.00088,74.125.68.0-255,2902,40446,1,191302
13843,0.000882,172.31.36.0-255,66,40512,1,191302
13844,0.00091,74.125.68.0-255,5738,46250,1,191302
13845,0.000913,172.31.36.0-255,66,46316,1,191302
13846,0.000924,74.125.68.0-255,1484,47800,1,191302
13847,0.000944,74.125.68.0-255,3961,51761,1,191302
13848,0.000946,172.31.36.0-255,66,51827,1,191302
13849,0.000954,74.125.68.0-255,5738,57565,1,191302
13850,0.000956,172.31.36.0-255,66,57631,1,191302
13851,0.000985,74.125.68.0-255,1484,59115,1,191302
13852,0.00101,74.125.68.0-255,6797,65912,1,191302
13853,0.001013,172.31.36.0-255,66,65978,1,191302
13854,0.003343,74.125.68.0-255,5738,71716,1,191302
13855,0.003351,172.31.36.0-255,66,71782,1,191302
13856,0.005687,74.125.68.0-255,5738,77520,1,191302
13857,0.005692,172.31.36.0-255,66,77586,1,191302
13858,0.008026,74.125.68.0-255,5738,83324,1,191302
13859,0.008034,172.31.36.0-255,66,83390,1,191302
13860,0.010369,74.125.68.0-255,5738,89128,1,191302
13861,0.010379,172.31.36.0-255,66,89194,1,191302
13862,0.012744,74.125.68.0-255,5738,94932,1,191302
13863,0.012751,172.31.36.0-255,66,94998,1,191302
13864,0.015085,74.125.68.0-255,5738,100736,1,191302
13865,0.015093,172.31.36.0-255,66,100802,1,191302
13866,0.017436,74.125.68.0-255,5738,106540,1,191302
13867,0.017445,172.31.36.0-255,66,106606,1,191302
13868,0.019784,74.125.68.0-255,5738,112344,1,191302
13869,0.019793,172.31.36.0-255,66,112410,1,191302
13870,0.022136,74.125.68.0-255,1484,113894,1,191302
13871,0.022158,74.125.68.0-255,4320,118214,1,191302
13872,0.022164,172.31.36.0-255,66,118280,1,191302
13873,0.024508,74.125.68.0-255,5738,124018,1,191302
13874,0.024515,172.31.36.0-255,66,124084,1,191302
13875,0.026847,74.125.68.0-255,5738,129822,1,191302
13876,0.026855,172.31.36.0-255,66,129888,1,191302
13877,0.029184,74.125.68.0-255,5738,135626,1,191302
13878,0.029193,172.31.36.0-255,66,135692,1,191302
13879,0.031522,74.125.68.0-255,5738,141430,1,191302
13880,0.03153,172.31.36.0-255,66,141496,1,191302
13881,0.033865,74.125.68.0-255,5738,147234,1,191302
13882,0.033874,172.31.36.0-255,66,147300,1,191302
13883,0.036217,74.125.68.0-255,5738,153038,1,191302
13884,0.036225,172.31.36.0-255,66,153104,1,191302
13885,0.038572,74.125.68.0-255,5738,158842,1,191302
13886,0.038578,172.31.36.0-255,66,158908,1,191302
13887,0.04091,74.125.68.0-255,5738,164646,1,191302
13888,0.040917,172.31.36.0-255,66,164712,1,191302
13889,0.043253,74.125.68.0-255,5738,170450,1,191302
13890,0.043261,172.31.36.0-255,66,170516,1,191302
13891,0.045586,74.125.68.0-255,5738,176254,1,191302
13892,0.045594,172.31.36.0-255,66,176320,1,191302
13893,0.046604,172.31.36.0-255,188,176508,1,191302
13894,0.046635,172.31.36.0-255,958,177466,1,191302
13895,0.046699,172.31.36.0-255,1514,178980,1,191302
13896,0.046701,172.31.36.0-255,1514,180494,1,191302
13897,0.046702,172.31.36.0-255,1514,182008,1,191302
13898,0.046703,172.31.36.0-255,1514,183522,1,191302
13899,0.046729,172.31.36.0-255,1514,185036,1,191302
13900,0.04673,172.31.36.0-255,198,185234,1,191302
13901,0.047949,74.125.68.0-255,5738,190972,1,191302
13902,0.047955,172.31.36.0-255,66,191038,1,191302
13903,0.048187,104.244.42.0-255,66,191104,1,191302
13904,0.048194,104.244.42.0-255,66,191170,1,191302
13905,0.04827,104.244.42.0-255,66,191236,1,191302
13906,0.048276,104.244.42.0-255,66,191302,1,191302
13907,0.0,74.125.24.0-255,153,153,1,311382
13908,1.7e-05,172.31.36.0-255,66,219,1,311382
13909,4.4e-05,74.125.24.0-255,1484,1703,1,311382
13910,4.8e-05,172.31.36.0-255,66,1769,1,311382
13911,5.4e-05,74.125.24.0-255,2902,4671,1,311382
13912,5.7e-05,172.31.36.0-255,66,4737,1,311382
13913,6.6e-05,74.125.24.0-255,7156,11893,1,311382
13914,6.9e-05,172.31.36.0-255,66,11959,1,311382
13915,0.000114,172.31.36.0-255,66,12025,1,311382
13916,0.000134,74.125.24.0-255,2902,14927,1,311382
13917,0.000136,172.31.36.0-255,66,14993,1,311382
13918,0.000157,74.125.24.0-255,3961,18954,1,311382
13919,0.00016,172.31.36.0-255,66,19020,1,311382
13920,0.000179,74.125.24.0-255,1484,20504,1,311382
13921,0.000181,172.31.36.0-255,66,20570,1,311382
13922,0.000211,74.125.24.0-255,2902,23472,1,311382
13923,0.000213,172.31.36.0-255,66,23538,1,311382
13924,0.00022,74.125.24.0-255,5738,29276,1,311382
13925,0.000223,172.31.36.0-255,66,29342,1,311382
13926,0.000232,74.125.24.0-255,7156,36498,1,311382
13927,0.000236,172.31.36.0-255,66,36564,1,311382
13928,0.000272,74.125.24.0-255,4320,40884,1,311382
13929,0.000276,172.31.36.0-255,66,40950,1,311382
13930,0.0003,74.125.24.0-255,4320,45270,1,311382
13931,0.000302,172.31.36.0-255,66,45336,1,311382
13932,0.000315,172.31.36.0-255,66,45402,1,311382
13933,0.000348,74.125.24.0-255,131,45533,1,311382
13934,0.00035,172.31.36.0-255,66,45599,1,311382
13935,0.000415,74.125.24.0-255,1484,47083,1,311382
13936,0.000419,172.31.36.0-255,66,47149,1,311382
13937,0.000422,74.125.24.0-255,1484,48633,1,311382
13938,0.00044,74.125.24.0-255,4320,52953,1,311382
13939,0.000442,172.31.36.0-255,66,53019,1,311382
13940,0.000485,74.125.24.0-255,5738,58757,1,311382
13941,0.000488,172.31.36.0-255,66,58823,1,311382
13942,0.000507,74.125.24.0-255,3658,62481,1,311382
13943,0.00051,172.31.36.0-255,66,62547,1,311382
13944,0.000543,74.125.24.0-255,1484,64031,1,311382
13945,0.000548,74.125.24.0-255,2902,66933,1,311382
13946,0.00055,172.31.36.0-255,66,66999,1,311382
13947,0.000556,74.125.24.0-255,4320,71319,1,311382
13948,0.000559,172.31.36.0-255,66,71385,1,311382
13949,0.000571,74.125.24.0-255,1484,72869,1,311382
13950,0.000586,74.125.24.0-255,4320,77189,1,311382
13951,0.000589,172.31.36.0-255,66,77255,1,311382
13952,0.000634,172.31.36.0-255,66,77321,1,311382
13953,0.000649,172.31.36.0-255,66,77387,1,311382
13954,0.000813,74.125.24.0-255,1484,78871,1,311382
13955,0.00082,74.125.24.0-255,2902,81773,1,311382
13956,0.000824,172.31.36.0-255,66,81839,1,311382
13957,0.000849,74.125.24.0-255,4320,86159,1,311382
13958,0.000852,172.31.36.0-255,66,86225,1,311382
13959,0.000859,74.125.24.0-255,7156,93381,1,311382
13960,0.000862,172.31.36.0-255,66,93447,1,311382
13961,0.000884,74.125.24.0-255,1484,94931,1,311382
13962,0.000889,74.125.24.0-255,2902,97833,1,311382
13963,0.000892,172.31.36.0-255,66,97899,1,311382
13964,0.000927,172.31.36.0-255,66,97965,1,311382
13965,0.001274,74.125.24.0-255,1484,99449,1,311382
13966,0.001285,74.125.24.0-255,2902,102351,1,311382
13967,0.00129,172.31.36.0-255,66,102417,1,311382
13968,0.001294,74.125.24.0-255,1484,103901,1,311382
13969,0.001299,74.125.24.0-255,2902,106803,1,311382
13970,0.001301,172.31.36.0-255,66,106869,1,311382
13971,0.001347,74.125.24.0-255,5738,112607,1,311382
13972,0.001351,172.31.36.0-255,66,112673,1,311382
13973,0.001391,74.125.24.0-255,7156,119829,1,311382
13974,0.001395,172.31.36.0-255,66,119895,1,311382
13975,0.001417,74.125.24.0-255,5738,125633,1,311382
13976,0.001421,172.31.36.0-255,66,125699,1,311382
13977,0.001448,74.125.24.0-255,5738,131437,1,311382
13978,0.001451,172.31.36.0-255,66,131503,1,311382
13979,0.001454,74.125.24.0-255,766,132269,1,311382
13980,0.001737,74.125.24.0-255,1484,133753,1,311382
13981,0.001742,172.31.36.0-255,66,133819,1,311382
13982,0.001747,74.125.24.0-255,2902,136721,1,311382
13983,0.00175,172.31.36.0-255,66,136787,1,311382
13984,0.001757,74.125.24.0-255,5738,142525,1,311382
13985,0.001759,172.31.36.0-255,66,142591,1,311382
13986,0.001766,74.125.24.0-255,5738,148329,1,311382
13987,0.001768,172.31.36.0-255,66,148395,1,311382
13988,0.00182,172.31.36.0-255,66,148461,1,311382
13989,0.001834,172.31.36.0-255,66,148527,1,311382
13990,0.001841,74.125.24.0-255,7156,155683,1,311382
13991,0.001844,172.31.36.0-255,66,155749,1,311382
13992,0.00187,74.125.24.0-255,5738,161487,1,311382
13993,0.001874,172.31.36.0-255,66,161553,1,311382
13994,0.001888,172.31.36.0-255,66,161619,1,311382
13995,0.001979,74.125.24.0-255,1484,163103,1,311382
13996,0.001997,74.125.24.0-255,2902,166005,1,311382
13997,0.002001,172.31.36.0-255,66,166071,1,311382
13998,0.002023,74.125.24.0-255,4320,170391,1,311382
13999,0.002026,172.31.36.0-255,66,170457,1,311382
14000,0.002032,74.125.24.0-255,4320,174777,1,311382
14001,0.002035,172.31.36.0-255,66,174843,1,311382
14002,0.00205,74.125.24.0-255,4320,179163,1,311382
14003,0.002053,172.31.36.0-255,66,179229,1,311382
14004,0.002069,74.125.24.0-255,4320,183549,1,311382
14005,0.002071,172.31.36.0-255,66,183615,1,311382
14006,0.002113,172.31.36.0-255,66,183681,1,311382
14007,0.002121,74.125.24.0-255,1484,185165,1,311382
14008,0.002147,172.31.36.0-255,66,185231,1,311382
14009,0.004232,74.125.24.0-255,5738,190969,1,311382
14010,0.004243,172.31.36.0-255,66,191035,1,311382
14011,0.006339,74.125.24.0-255,5738,196773,1,311382
14012,0.006353,172.31.36.0-255,66,196839,1,311382
14013,0.008436,74.125.24.0-255,5738,202577,1,311382
14014,0.008442,172.31.36.0-255,66,202643,1,311382
14015,0.010545,74.125.24.0-255,5738,208381,1,311382
14016,0.010552,172.31.36.0-255,66,208447,1,311382
14017,0.012649,74.125.24.0-255,5738,214185,1,311382
14018,0.012658,172.31.36.0-255,66,214251,1,311382
14019,0.014753,74.125.24.0-255,5738,219989,1,311382
14020,0.014764,172.31.36.0-255,66,220055,1,311382
14021,0.016843,74.125.24.0-255,5738,225793,1,311382
14022,0.016853,172.31.36.0-255,66,225859,1,311382
14023,0.018933,74.125.24.0-255,5738,231597,1,311382
14024,0.018948,172.31.36.0-255,66,231663,1,311382
14025,0.021069,74.125.24.0-255,5738,237401,1,311382
14026,0.021083,172.31.36.0-255,66,237467,1,311382
14027,0.023183,74.125.24.0-255,5738,243205,1,311382
14028,0.023195,172.31.36.0-255,66,243271,1,311382
14029,0.025309,74.125.24.0-255,5738,249009,1,311382
14030,0.02532,172.31.36.0-255,66,249075,1,311382
14031,0.027414,74.125.24.0-255,5738,254813,1,311382
14032,0.027422,172.31.36.0-255,66,254879,1,311382
14033,0.029534,74.125.24.0-255,5738,260617,1,311382
14034,0.029542,172.31.36.0-255,66,260683,1,311382
14035,0.03161,74.125.24.0-255,5738,266421,1,311382
14036,0.03162,172.31.36.0-255,66,266487,1,311382
14037,0.033691,74.125.24.0-255,5738,272225,1,311382
14038,0.033701,172.31.36.0-255,66,272291,1,311382
14039,0.035778,74.125.24.0-255,5738,278029,1,311382
14040,0.035789,172.31.36.0-255,66,278095,1,311382
14041,0.037874,74.125.24.0-255,5738,283833,1,311382
14042,0.037883,172.31.36.0-255,66,283899,1,311382
14043,0.039986,74.125.24.0-255,5738,289637,1,311382
14044,0.040002,172.31.36.0-255,66,289703,1,311382
14045,0.042112,74.125.24.0-255,5738,295441,1,311382
14046,0.042126,172.31.36.0-255,66,295507,1,311382
14047,0.044223,74.125.24.0-255,5738,301245,1,311382
14048,0.044231,172.31.36.0-255,66,301311,1,311382
14049,0.045183,172.31.36.0-255,172,301483,1,311382
14050,0.045219,172.31.36.0-255,1114,302597,1,311382
14051,0.045285,172.31.36.0-255,1514,304111,1,311382
14052,0.045287,172.31.36.0-255,1514,305625,1,311382
14053,0.045288,172.31.36.0-255,1514,307139,1,311382
14054,0.045289,172.31.36.0-255,1514,308653,1,311382
14055,0.045291,172.31.36.0-255,1490,310143,1,311382
14056,0.046306,74.125.24.0-255,804,310947,1,311382
14057,0.046472,172.31.36.0-255,66,311013,1,311382
14058,0.046509,172.31.36.0-255,105,311118,1,311382
14059,0.046731,104.244.42.0-255,66,311184,1,311382
14060,0.046751,104.244.42.0-255,66,311250,1,311382
14061,0.046845,104.244.42.0-255,66,311316,1,311382
14062,0.048557,74.125.24.0-255,66,311382,1,311382
14063,0.0,74.125.200.0-255,143,143,1,323143
14064,2.5e-05,172.31.36.0-255,66,209,1,323143
14065,3.2e-05,74.125.200.0-255,1484,1693,1,323143
14066,3.7e-05,172.31.36.0-255,66,1759,1,323143
14067,4.1e-05,74.125.200.0-255,1484,3243,1,323143
14068,4.4e-05,172.31.36.0-255,66,3309,1,323143
14069,6.9e-05,74.125.200.0-255,2902,6211,1,323143
14070,7.2e-05,172.31.36.0-255,66,6277,1,323143
14071,7.9e-05,74.125.200.0-255,5738,12015,1,323143
14072,8.2e-05,172.31.36.0-255,66,12081,1,323143
14073,8.5e-05,74.125.200.0-255,1484,13565,1,323143
14074,8.7e-05,172.31.36.0-255,66,13631,1,323143
14075,0.00014,74.125.200.0-255,628,14259,1,323143
14076,0.000143,172.31.36.0-255,66,14325,1,323143
14077,0.000214,74.125.200.0-255,1484,15809,1,323143
14078,0.000217,172.31.36.0-255,66,15875,1,323143
14079,0.000239,74.125.200.0-255,2902,18777,1,323143
14080,0.000242,172.31.36.0-255,66,18843,1,323143
14081,0.000246,74.125.200.0-255,1484,20327,1,323143
14082,0.000248,172.31.36.0-255,66,20393,1,323143
14083,0.000271,74.125.200.0-255,2902,23295,1,323143
14084,0.000274,172.31.36.0-255,66,23361,1,323143
14085,0.00029,74.125.200.0-255,4320,27681,1,323143
14086,0.000292,172.31.36.0-255,66,27747,1,323143
14087,0.000315,74.125.200.0-255,3961,31708,1,323143
14088,0.000317,172.31.36.0-255,66,31774,1,323143
14089,0.000364,74.125.200.0-255,2902,34676,1,323143
14090,0.000367,172.31.36.0-255,66,34742,1,323143
14091,0.000387,74.125.200.0-255,4320,39062,1,323143
14092,0.00039,172.31.36.0-255,66,39128,1,323143
14093,0.0004,172.31.36.0-255,66,39194,1,323143
14094,0.000403,74.125.200.0-255,1125,40319,1,323143
14095,0.000421,74.125.200.0-255,1484,41803,1,323143
14096,0.000423,172.31.36.0-255,66,41869,1,323143
14097,0.000441,74.125.200.0-255,2902,44771,1,323143
14098,0.000444,172.31.36.0-255,66,44837,1,323143
14099,0.000447,74.125.200.0-255,1484,46321,1,323143
14100,0.000466,74.125.200.0-255,2902,49223,1,323143
14101,0.000468,172.31.36.0-255,66,49289,1,323143
14102,0.000499,74.125.200.0-255,5738,55027,1,323143
14103,0.000501,172.31.36.0-255,66,55093,1,323143
14104,0.000514,74.125.200.0-255,2543,57636,1,323143
14105,0.000518,172.31.36.0-255,66,57702,1,323143
14106,0.000554,74.125.200.0-255,411,58113,1,323143
14107,0.000592,74.125.200.0-255,1484,59597,1,323143
14108,0.000594,172.31.36.0-255,66,59663,1,323143
14109,0.000624,74.125.200.0-255,2902,62565,1,323143
14110,0.000627,172.31.36.0-255,66,62631,1,323143
14111,0.000644,74.125.200.0-255,1484,64115,1,323143
14112,0.000661,74.125.200.0-255,5738,69853,1,323143
14113,0.000664,172.31.36.0-255,66,69919,1,323143
14114,0.000687,74.125.200.0-255,4320,74239,1,323143
14115,0.00069,172.31.36.0-255,66,74305,1,323143
14116,0.000695,74.125.200.0-255,4320,78625,1,323143
14117,0.000697,172.31.36.0-255,66,78691,1,323143
14118,0.000703,74.125.200.0-255,4320,83011,1,323143
14119,0.000705,172.31.36.0-255,66,83077,1,323143
14120,0.000737,172.31.36.0-255,66,83143,1,323143
14121,0.00074,74.125.200.0-255,331,83474,1,323143
14122,0.000889,74.125.200.0-255,1484,84958,1,323143
14123,0.000894,172.31.36.0-255,66,85024,1,323143
14124,0.0009,74.125.200.0-255,2902,87926,1,323143
14125,0.000902,172.31.36.0-255,66,87992,1,323143
14126,0.000906,74.125.200.0-255,2902,90894,1,323143
14127,0.000908,172.31.36.0-255,66,90960,1,323143
14128,0.000913,74.125.200.0-255,4320,95280,1,323143
14129,0.000916,172.31.36.0-255,66,95346,1,323143
14130,0.000969,172.31.36.0-255,66,95412,1,323143
14131,0.000973,74.125.200.0-255,2902,98314,1,323143
14132,0.000975,172.31.36.0-255,66,98380,1,323143
14133,0.001014,74.125.200.0-255,7156,105536,1,323143
14134,0.001016,172.31.36.0-255,66,105602,1,323143
14135,0.001036,74.125.200.0-255,3602,109204,1,323143
14136,0.001038,172.31.36.0-255,66,109270,1,323143
14137,0.001072,74.125.200.0-255,1484,110754,1,323143
14138,0.0011,74.125.200.0-255,2902,113656,1,323143
14139,0.001103,172.31.36.0-255,66,113722,1,323143
14140,0.001107,74.125.200.0-255,1484,115206,1,323143
14141,0.001126,74.125.200.0-255,4320,119526,1,323143
14142,0.001129,172.31.36.0-255,66,119592,1,323143
14143,0.001135,74.125.200.0-255,4320,123912,1,323143
14144,0.001137,172.31.36.0-255,66,123978,1,323143
14145,0.001157,74.125.200.0-255,2902,126880,1,323143
14146,0.001159,172.31.36.0-255,66,126946,1,323143
14147,0.00117,172.31.36.0-255,66,127012,1,323143
14148,0.001181,172.31.36.0-255,66,127078,1,323143
14149,0.001235,74.125.200.0-255,1484,128562,1,323143
14150,0.001253,74.125.200.0-255,2902,131464,1,323143
14151,0.001257,172.31.36.0-255,66,131530,1,323143
14152,0.00126,74.125.200.0-255,1484,133014,1,323143
14153,0.001265,74.125.200.0-255,2902,135916,1,323143
14154,0.001267,172.31.36.0-255,66,135982,1,323143
14155,0.001284,74.125.200.0-255,5738,141720,1,323143
14156,0.001287,172.31.36.0-255,66,141786,1,323143
14157,0.001331,74.125.200.0-255,1484,143270,1,323143
14158,0.001347,74.125.200.0-255,2902,146172,1,323143
14159,0.00135,172.31.36.0-255,66,146238,1,323143
14160,0.001372,74.125.200.0-255,5738,151976,1,323143
14161,0.001375,172.31.36.0-255,66,152042,1,323143
14162,0.001386,172.31.36.0-255,66,152108,1,323143
14163,0.001417,74.125.200.0-255,7156,159264,1,323143
14164,0.001421,172.31.36.0-255,66,159330,1,323143
14165,0.001425,74.125.200.0-255,2902,162232,1,323143
14166,0.001428,172.31.36.0-255,66,162298,1,323143
14167,0.001448,74.125.200.0-255,5738,168036,1,323143
14168,0.001451,172.31.36.0-255,66,168102,1,323143
14169,0.001468,74.125.200.0-255,2902,171004,1,323143
14170,0.001471,172.31.36.0-255,66,171070,1,323143
14171,0.001492,172.31.36.0-255,66,171136,1,323143
14172,0.001512,74.125.200.0-255,1484,172620,1,323143
14173,0.001533,74.125.200.0-255,5020,177640,1,323143
14174,0.001537,172.31.36.0-255,66,177706,1,323143
14175,0.001567,74.125.200.0-255,2902,180608,1,323143
14176,0.00157,172.31.36.0-255,66,180674,1,323143
14177,0.001594,74.125.200.0-255,4320,184994,1,323143
14178,0.001597,172.31.36.0-255,66,185060,1,323143
14179,0.001612,172.31.36.0-255,66,185126,1,323143
14180,0.001618,74.125.200.0-255,2902,188028,1,323143
14181,0.001621,172.31.36.0-255,66,188094,1,323143
14182,0.00166,172.31.36.0-255,66,188160,1,323143
14183,0.001666,74.125.200.0-255,5020,193180,1,323143
14184,0.001668,172.31.36.0-255,66,193246,1,323143
14185,0.001685,74.125.200.0-255,1484,194730,1,323143
14186,0.001706,74.125.200.0-255,4320,199050,1,323143
14187,0.001709,172.31.36.0-255,66,199116,1,323143
14188,0.001717,74.125.200.0-255,7156,206272,1,323143
14189,0.001719,172.31.36.0-255,66,206338,1,323143
14190,0.001736,74.125.200.0-255,1484,207822,1,323143
14191,0.001748,172.31.36.0-255,66,207888,1,323143
14192,0.001798,74.125.200.0-255,7156,215044,1,323143
14193,0.001801,172.31.36.0-255,66,215110,1,323143
14194,0.001823,74.125.200.0-255,2184,217294,1,323143
14195,0.001827,172.31.36.0-255,66,217360,1,323143
14196,0.002117,74.125.200.0-255,1484,218844,1,323143
14197,0.002122,74.125.200.0-255,1484,220328,1,323143
14198,0.002126,172.31.36.0-255,66,220394,1,323143
14199,0.002151,74.125.200.0-255,1484,221878,1,323143
14200,0.002158,74.125.200.0-255,5738,227616,1,323143
14201,0.002161,172.31.36.0-255,66,227682,1,323143
14202,0.002167,74.125.200.0-255,5738,233420,1,323143
14203,0.002169,172.31.36.0-255,66,233486,1,323143
14204,0.002174,74.125.200.0-255,2902,236388,1,323143
14205,0.002177,172.31.36.0-255,66,236454,1,323143
14206,0.002194,74.125.200.0-255,4320,240774,1,323143
14207,0.002197,172.31.36.0-255,66,240840,1,323143
14208,0.002212,74.125.200.0-255,2902,243742,1,323143
14209,0.002214,172.31.36.0-255,66,243808,1,323143
14210,0.002234,172.31.36.0-255,66,243874,1,323143
14211,0.002293,74.125.200.0-255,1484,245358,1,323143
14212,0.002297,74.125.200.0-255,1484,246842,1,323143
14213,0.002299,172.31.36.0-255,66,246908,1,323143
14214,0.002317,74.125.200.0-255,1484,248392,1,323143
14215,0.002321,74.125.200.0-255,2902,251294,1,323143
14216,0.002326,172.31.36.0-255,66,251360,1,323143
14217,0.002337,74.125.200.0-255,4320,255680,1,323143
14218,0.00234,172.31.36.0-255,66,255746,1,323143
14219,0.002344,74.125.200.0-255,2902,258648,1,323143
14220,0.002346,172.31.36.0-255,66,258714,1,323143
14221,0.002379,74.125.200.0-255,5738,264452,1,323143
14222,0.002383,172.31.36.0-255,66,264518,1,323143
14223,0.002389,74.125.200.0-255,7156,271674,1,323143
14224,0.002392,172.31.36.0-255,66,271740,1,323143
14225,0.002395,74.125.200.0-255,1484,273224,1,323143
14226,0.002423,74.125.200.0-255,6438,279662,1,323143
14227,0.002426,172.31.36.0-255,66,279728,1,323143
14228,0.00243,74.125.200.0-255,2902,282630,1,323143
14229,0.002432,172.31.36.0-255,66,282696,1,323143
14230,0.002449,74.125.200.0-255,2902,285598,1,323143
14231,0.002452,172.31.36.0-255,66,285664,1,323143
14232,0.002484,172.31.36.0-255,66,285730,1,323143
14233,0.002491,74.125.200.0-255,5738,291468,1,323143
14234,0.002494,172.31.36.0-255,66,291534,1,323143
14235,0.002501,74.125.200.0-255,7156,298690,1,323143
14236,0.002503,172.31.36.0-255,66,298756,1,323143
14237,0.002518,74.125.200.0-255,3602,302358,1,323143
14238,0.00252,172.31.36.0-255,66,302424,1,323143
14239,0.005059,74.125.200.0-255,1484,303908,1,323143
14240,0.005076,74.125.200.0-255,4320,308228,1,323143
14241,0.00508,172.31.36.0-255,66,308294,1,323143
14242,0.007645,74.125.200.0-255,5582,313876,1,323143
14243,0.007652,172.31.36.0-255,66,313942,1,323143
14244,0.015002,172.31.36.0-255,105,314047,1,323143
14245,0.017537,74.125.200.0-255,66,314113,1,323143
14246,0.040121,172.31.36.0-255,172,314285,1,323143
14247,0.040154,172.31.36.0-255,1115,315400,1,323143
14248,0.040219,172.31.36.0-255,1514,316914,1,323143
14249,0.04022,172.31.36.0-255,1514,318428,1,323143
14250,0.040225,172.31.36.0-255,1514,319942,1,323143
14251,0.040227,172.31.36.0-255,1514,321456,1,323143
14252,0.040245,172.31.36.0-255,1489,322945,1,323143
14253,0.041673,104.244.42.0-255,66,323011,1,323143
14254,0.041691,104.244.42.0-255,66,323077,1,323143
14255,0.041822,104.244.42.0-255,66,323143,1,323143
14256,0.0,172.217.194.0-255,153,153,1,270326
14257,2.9e-05,172.31.36.0-255,66,219,1,270326
14258,5.6e-05,172.217.194.0-255,1484,1703,1,270326
14259,6e-05,172.31.36.0-255,66,1769,1,270326
14260,6.6e-05,172.217.194.0-255,2902,4671,1,270326
14261,6.9e-05,172.31.36.0-255,66,4737,1,270326
14262,7.6e-05,172.217.194.0-255,7156,11893,1,270326
14263,7.9e-05,172.31.36.0-255,66,11959,1,270326
14264,8.2e-05,172.217.194.0-255,2103,14062,1,270326
14265,8.4e-05,172.31.36.0-255,66,14128,1,270326
14266,0.000129,172.217.194.0-255,1484,15612,1,270326
14267,0.000133,172.31.36.0-255,66,15678,1,270326
14268,0.000138,172.217.194.0-255,2902,18580,1,270326
14269,0.00014,172.31.36.0-255,66,18646,1,270326
14270,0.000143,172.217.194.0-255,1484,20130,1,270326
14271,0.000145,172.31.36.0-255,66,20196,1,270326
14272,0.00017,172.217.194.0-255,4320,24516,1,270326
14273,0.000172,172.31.36.0-255,66,24582,1,270326
14274,0.000182,172.217.194.0-255,6797,31379,1,270326
14275,0.000184,172.31.36.0-255,66,31445,1,270326
14276,0.000305,172.217.194.0-255,1484,32929,1,270326
14277,0.000309,172.31.36.0-255,66,32995,1,270326
14278,0.000315,172.217.194.0-255,2902,35897,1,270326
14279,0.000318,172.31.36.0-255,66,35963,1,270326
14280,0.000324,172.217.194.0-255,5738,41701,1,270326
14281,0.000326,172.31.36.0-255,66,41767,1,270326
14282,0.000353,172.217.194.0-255,6797,48564,1,270326
14283,0.000356,172.31.36.0-255,66,48630,1,270326
14284,0.00036,172.217.194.0-255,1484,50114,1,270326
14285,0.000362,172.31.36.0-255,66,50180,1,270326
14286,0.000397,172.31.36.0-255,66,50246,1,270326
14287,0.000401,172.217.194.0-255,2543,52789,1,270326
14288,0.000403,172.31.36.0-255,66,52855,1,270326
14289,0.000406,172.217.194.0-255,363,53218,1,270326
14290,0.00049,172.217.194.0-255,380,53598,1,270326
14291,0.000765,172.217.194.0-255,1484,55082,1,270326
14292,0.00077,172.31.36.0-255,66,55148,1,270326
14293,0.000775,172.217.194.0-255,2902,58050,1,270326
14294,0.000778,172.31.36.0-255,66,58116,1,270326
14295,0.000783,172.217.194.0-255,2902,61018,1,270326
14296,0.000785,172.31.36.0-255,66,61084,1,270326
14297,0.000809,172.217.194.0-255,2902,63986,1,270326
14298,0.000812,172.31.36.0-255,66,64052,1,270326
14299,0.000826,172.31.36.0-255,66,64118,1,270326
14300,0.000862,172.31.36.0-255,66,64184,1,270326
14301,0.001212,172.217.194.0-255,1484,65668,1,270326
14302,0.001222,172.217.194.0-255,2902,68570,1,270326
14303,0.001226,172.31.36.0-255,66,68636,1,270326
14304,0.001234,172.217.194.0-255,5738,74374,1,270326
14305,0.001236,172.31.36.0-255,66,74440,1,270326
14306,0.001243,172.217.194.0-255,7156,81596,1,270326
14307,0.001246,172.31.36.0-255,66,81662,1,270326
14308,0.001292,172.31.36.0-255,66,81728,1,270326
14309,0.001297,172.217.194.0-255,2184,83912,1,270326
14310,0.001299,172.31.36.0-255,66,83978,1,270326
14311,0.001365,172.217.194.0-255,1484,85462,1,270326
14312,0.001371,172.217.194.0-255,2902,88364,1,270326
14313,0.001373,172.31.36.0-255,66,88430,1,270326
14314,0.001377,172.217.194.0-255,1484,89914,1,270326
14315,0.001399,172.217.194.0-255,4320,94234,1,270326
14316,0.001401,172.31.36.0-255,66,94300,1,270326
14317,0.001405,172.217.194.0-255,1484,95784,1,270326
14318,0.001416,172.31.36.0-255,66,95850,1,270326
14319,0.001442,172.217.194.0-255,7156,103006,1,270326
14320,0.001445,172.31.36.0-255,66,103072,1,270326
14321,0.001461,172.217.194.0-255,6438,109510,1,270326
14322,0.001463,172.31.36.0-255,66,109576,1,270326
14323,0.001533,172.217.194.0-255,1484,111060,1,270326
14324,0.001548,172.217.194.0-255,2902,113962,1,270326
14325,0.001552,172.31.36.0-255,66,114028,1,270326
14326,0.001558,172.217.194.0-255,4320,118348,1,270326
14327,0.00156,172.31.36.0-255,66,118414,1,270326
14328,0.001574,172.217.194.0-255,1484,119898,1,270326
14329,0.001586,172.31.36.0-255,66,119964,1,270326
14330,0.001611,172.217.194.0-255,4320,124284,1,270326
14331,0.001615,172.31.36.0-255,66,124350,1,270326
14332,0.001625,172.31.36.0-255,66,124416,1,270326
14333,0.001681,172.217.194.0-255,2184,126600,1,270326
14334,0.001686,172.31.36.0-255,66,126666,1,270326
14335,0.001792,172.217.194.0-255,1484,128150,1,270326
14336,0.001808,172.217.194.0-255,2902,131052,1,270326
14337,0.001811,172.31.36.0-255,66,131118,1,270326
14338,0.001817,172.217.194.0-255,5738,136856,1,270326
14339,0.001819,172.31.36.0-255,66,136922,1,270326
14340,0.00187,172.31.36.0-255,66,136988,1,270326
14341,0.00188,172.31.36.0-255,66,137054,1,270326
14342,0.001894,172.217.194.0-255,1484,138538,1,270326
14343,0.001897,172.217.194.0-255,766,139304,1,270326
14344,0.001899,172.31.36.0-255,66,139370,1,270326
14345,0.001945,172.217.194.0-255,1484,140854,1,270326
14346,0.001962,172.217.194.0-255,2902,143756,1,270326
14347,0.001964,172.31.36.0-255,66,143822,1,270326
14348,0.001978,172.217.194.0-255,5738,149560,1,270326
14349,0.00198,172.31.36.0-255,66,149626,1,270326
14350,0.001998,172.217.194.0-255,4320,153946,1,270326
14351,0.002001,172.31.36.0-255,66,154012,1,270326
14352,0.002028,172.31.36.0-255,66,154078,1,270326
14353,0.002039,172.31.36.0-255,66,154144,1,270326
14354,0.002202,172.217.194.0-255,1484,155628,1,270326
14355,0.002206,172.217.194.0-255,2902,158530,1,270326
14356,0.002208,172.31.36.0-255,66,158596,1,270326
14357,0.002229,172.217.194.0-255,5738,164334,1,270326
14358,0.002232,172.31.36.0-255,66,164400,1,270326
14359,0.002234,172.217.194.0-255,1484,165884,1,270326
14360,0.002259,172.31.36.0-255,66,165950,1,270326
14361,0.002265,172.217.194.0-255,5738,171688,1,270326
14362,0.002267,172.31.36.0-255,66,171754,1,270326
14363,0.002287,172.217.194.0-255,5020,176774,1,270326
14364,0.00229,172.31.36.0-255,66,176840,1,270326
14365,0.002317,172.217.194.0-255,2902,179742,1,270326
14366,0.002319,172.31.36.0-255,66,179808,1,270326
14367,0.002323,172.217.194.0-255,2902,182710,1,270326
14368,0.002325,172.31.36.0-255,66,182776,1,270326
14369,0.002337,172.217.194.0-255,1484,184260,1,270326
14370,0.002358,172.217.194.0-255,7156,191416,1,270326
14371,0.002361,172.31.36.0-255,66,191482,1,270326
14372,0.002376,172.217.194.0-255,1484,192966,1,270326
14373,0.002383,172.217.194.0-255,7156,200122,1,270326
14374,0.002385,172.31.36.0-255,66,200188,1,270326
14375,0.002419,172.31.36.0-255,66,200254,1,270326
14376,0.002437,172.217.194.0-255,1484,201738,1,270326
14377,0.002442,172.217.194.0-255,2902,204640,1,270326
14378,0.002444,172.31.36.0-255,66,204706,1,270326
14379,0.00245,172.217.194.0-255,5738,210444,1,270326
14380,0.002452,172.31.36.0-255,66,210510,1,270326
14381,0.002488,172.31.36.0-255,66,210576,1,270326
14382,0.002516,172.217.194.0-255,2902,213478,1,270326
14383,0.002518,172.31.36.0-255,66,213544,1,270326
14384,0.002543,172.31.36.0-255,66,213610,1,270326
14385,0.002569,172.217.194.0-255,1484,215094,1,270326
14386,0.002585,172.217.194.0-255,2902,217996,1,270326
14387,0.002588,172.31.36.0-255,66,218062,1,270326
14388,0.005057,172.217.194.0-255,1484,219546,1,270326
14389,0.005144,172.217.194.0-255,4320,223866,1,270326
14390,0.005149,172.31.36.0-255,66,223932,1,270326
14391,0.007675,172.217.194.0-255,5738,229670,1,270326
14392,0.00768,172.31.36.0-255,66,229736,1,270326
14393,0.010223,172.217.194.0-255,5738,235474,1,270326
14394,0.01023,172.31.36.0-255,66,235540,1,270326
14395,0.012772,172.217.194.0-255,5738,241278,1,270326
14396,0.01278,172.31.36.0-255,66,241344,1,270326
14397,0.015326,172.217.194.0-255,5738,247082,1,270326
14398,0.015335,172.31.36.0-255,66,247148,1,270326
14399,0.017885,172.217.194.0-255,5738,252886,1,270326
14400,0.017895,172.31.36.0-255,66,252952,1,270326
14401,0.020398,172.217.194.0-255,5738,258690,1,270326
14402,0.020405,172.31.36.0-255,66,258756,1,270326
14403,0.022945,172.217.194.0-255,2238,260994,1,270326
14404,0.022951,172.31.36.0-255,66,261060,1,270326
14405,0.023131,172.31.36.0-255,105,261165,1,270326
14406,0.025627,172.217.194.0-255,66,261231,1,270326
14407,0.040003,172.31.36.0-255,172,261403,1,270326
14408,0.040035,172.31.36.0-255,1114,262517,1,270326
14409,0.040099,172.31.36.0-255,1514,264031,1,270326
14410,0.040101,172.31.36.0-255,1514,265545,1,270326
14411,0.040102,172.31.36.0-255,1514,267059,1,270326
14412,0.040103,172.31.36.0-255,1514,268573,1,270326
14413,0.040132,172.31.36.0-255,1489,270062,1,270326
14414,0.041523,104.244.42.0-255,66,270128,1,270326
14415,0.041539,104.244.42.0-255,66,270194,1,270326
14416,0.041636,104.244.42.0-255,66,270260,1,270326
14417,0.041664,104.244.42.0-255,66,270326,1,270326
14418,0.0,172.217.194.0-255,153,153,1,210019
14419,2.6e-05,172.31.36.0-255,66,219,1,210019
14420,3.2e-05,172.217.194.0-255,1484,1703,1,210019
14421,3.6e-05,172.31.36.0-255,66,1769,1,210019
14422,4.1e-05,172.217.194.0-255,2902,4671,1,210019
14423,4.5e-05,172.31.36.0-255,66,4737,1,210019
14424,6e-05,172.217.194.0-255,7156,11893,1,210019
14425,6.2e-05,172.31.36.0-255,66,11959,1,210019
14426,6.6e-05,172.217.194.0-255,2145,14104,1,210019
14427,6.9e-05,172.31.36.0-255,66,14170,1,210019
14428,0.000173,172.217.194.0-255,1484,15654,1,210019
14429,0.000181,172.31.36.0-255,66,15720,1,210019
14430,0.000186,172.217.194.0-255,2902,18622,1,210019
14431,0.000189,172.31.36.0-255,66,18688,1,210019
14432,0.000195,172.217.194.0-255,5738,24426,1,210019
14433,0.000204,172.31.36.0-255,66,24492,1,210019
14434,0.000252,172.31.36.0-255,66,24558,1,210019
14435,0.000273,172.31.36.0-255,66,24624,1,210019
14436,0.000278,172.217.194.0-255,2902,27526,1,210019
14437,0.00028,172.31.36.0-255,66,27592,1,210019
14438,0.000321,172.31.36.0-255,66,27658,1,210019
14439,0.000324,172.217.194.0-255,399,28057,1,210019
14440,0.000326,172.31.36.0-255,66,28123,1,210019
14441,0.000533,172.217.194.0-255,376,28499,1,210019
14442,0.000538,172.31.36.0-255,66,28565,1,210019
14443,0.000892,172.217.194.0-255,1484,30049,1,210019
14444,0.000897,172.31.36.0-255,66,30115,1,210019
14445,0.000904,172.217.194.0-255,2902,33017,1,210019
14446,0.000907,172.31.36.0-255,66,33083,1,210019
14447,0.000912,172.217.194.0-255,2902,35985,1,210019
14448,0.000914,172.31.36.0-255,66,36051,1,210019
14449,0.000951,172.217.194.0-255,2902,38953,1,210019
14450,0.000959,172.31.36.0-255,66,39019,1,210019
14451,0.000967,172.217.194.0-255,7156,46175,1,210019
14452,0.00097,172.31.36.0-255,66,46241,1,210019
14453,0.000984,172.31.36.0-255,66,46307,1,210019
14454,0.000988,172.217.194.0-255,2184,48491,1,210019
14455,0.000991,172.31.36.0-255,66,48557,1,210019
14456,0.00141,172.217.194.0-255,1484,50041,1,210019
14457,0.001419,172.217.194.0-255,2902,52943,1,210019
14458,0.001423,172.31.36.0-255,66,53009,1,210019
14459,0.00143,172.217.194.0-255,5738,58747,1,210019
14460,0.001431,172.31.36.0-255,66,58813,1,210019
14461,0.001438,172.217.194.0-255,7156,65969,1,210019
14462,0.001445,172.31.36.0-255,66,66035,1,210019
14463,0.001483,172.31.36.0-255,66,66101,1,210019
14464,0.001487,172.217.194.0-255,2184,68285,1,210019
14465,0.001489,172.31.36.0-255,66,68351,1,210019
14466,0.002328,172.217.194.0-255,1484,69835,1,210019
14467,0.002345,172.217.194.0-255,2902,72737,1,210019
14468,0.002347,172.31.36.0-255,66,72803,1,210019
14469,0.002352,172.217.194.0-255,2902,75705,1,210019
14470,0.002353,172.31.36.0-255,66,75771,1,210019
14471,0.002374,172.217.194.0-255,2902,78673,1,210019
14472,0.002376,172.31.36.0-255,66,78739,1,210019
14473,0.00238,172.217.194.0-255,2902,81641,1,210019
14474,0.002386,172.31.36.0-255,66,81707,1,210019
14475,0.002423,172.31.36.0-255,66,81773,1,210019
14476,0.002429,172.217.194.0-255,7156,88929,1,210019
14477,0.002431,172.31.36.0-255,66,88995,1,210019
14478,0.002463,172.217.194.0-255,3602,92597,1,210019
14479,0.002465,172.31.36.0-255,66,92663,1,210019
14480,0.002583,172.217.194.0-255,1484,94147,1,210019
14481,0.002594,172.217.194.0-255,1484,95631,1,210019
14482,0.002597,172.31.36.0-255,66,95697,1,210019
14483,0.002608,172.217.194.0-255,1484,97181,1,210019
14484,0.002618,172.217.194.0-255,5738,102919,1,210019
14485,0.002621,172.31.36.0-255,66,102985,1,210019
14486,0.002655,172.31.36.0-255,66,103051,1,210019
14487,0.00526,172.217.194.0-255,5738,108789,1,210019
14488,0.005267,172.31.36.0-255,66,108855,1,210019
14489,0.007871,172.217.194.0-255,5738,114593,1,210019
14490,0.007877,172.31.36.0-255,66,114659,1,210019
14491,0.010501,172.217.194.0-255,5738,120397,1,210019
14492,0.010508,172.31.36.0-255,66,120463,1,210019
14493,0.013122,172.217.194.0-255,5738,126201,1,210019
14494,0.013129,172.31.36.0-255,66,126267,1,210019
14495,0.015744,172.217.194.0-255,5738,132005,1,210019
14496,0.015755,172.31.36.0-255,66,132071,1,210019
14497,0.018352,172.217.194.0-255,5738,137809,1,210019
14498,0.018361,172.31.36.0-255,66,137875,1,210019
14499,0.021012,172.217.194.0-255,5738,143613,1,210019
14500,0.021019,172.31.36.0-255,66,143679,1,210019
14501,0.022347,172.31.36.0-255,167,143846,1,210019
14502,0.022376,172.31.36.0-255,1114,144960,1,210019
14503,0.022407,172.31.36.0-255,1514,146474,1,210019
14504,0.022408,172.31.36.0-255,327,146801,1,210019
14505,0.023636,172.217.194.0-255,5738,152539,1,210019
14506,0.023642,172.31.36.0-255,66,152605,1,210019
14507,0.023877,104.244.42.0-255,66,152671,1,210019
14508,0.023885,104.244.42.0-255,66,152737,1,210019
14509,0.023941,104.244.42.0-255,66,152803,1,210019
14510,0.026237,172.217.194.0-255,5738,158541,1,210019
14511,0.026243,172.31.36.0-255,66,158607,1,210019
14512,0.028857,172.217.194.0-255,5738,164345,1,210019
14513,0.028862,172.31.36.0-255,66,164411,1,210019
14514,0.031464,172.217.194.0-255,5738,170149,1,210019
14515,0.031471,172.31.36.0-255,66,170215,1,210019
14516,0.034068,172.217.194.0-255,4320,174535,1,210019
14517,0.034073,172.31.36.0-255,66,174601,1,210019
14518,0.034098,172.217.194.0-255,1484,176085,1,210019
14519,0.036687,172.217.194.0-255,4320,180405,1,210019
14520,0.036693,172.31.36.0-255,66,180471,1,210019
14521,0.039347,172.217.194.0-255,5738,186209,1,210019
14522,0.039353,172.31.36.0-255,66,186275,1,210019
14523,0.041937,172.217.194.0-255,2902,189177,1,210019
14524,0.041942,172.31.36.0-255,66,189243,1,210019
14525,0.041971,172.217.194.0-255,2902,192145,1,210019
14526,0.041974,172.31.36.0-255,66,192211,1,210019
14527,0.044563,172.217.194.0-255,2902,195113,1,210019
14528,0.044569,172.31.36.0-255,66,195179,1,210019
14529,0.044603,172.217.194.0-255,2902,198081,1,210019
14530,0.044606,172.31.36.0-255,66,198147,1,210019
14531,0.047188,172.217.194.0-255,2902,201049,1,210019
14532,0.047195,172.31.36.0-255,66,201115,1,210019
14533,0.047235,172.217.194.0-255,2902,204017,1,210019
14534,0.047238,172.31.36.0-255,66,204083,1,210019
14535,0.049789,172.217.194.0-255,2902,206985,1,210019
14536,0.049796,172.31.36.0-255,66,207051,1,210019
14537,0.049832,172.217.194.0-255,2902,209953,1,210019
14538,0.049835,172.31.36.0-255,66,210019,1,210019
14539,0.0,74.125.24.0-255,153,153,1,200585
14540,3.5e-05,172.31.36.0-255,66,219,1,200585
14541,4.2e-05,74.125.24.0-255,1484,1703,1,200585
14542,4.7e-05,172.31.36.0-255,66,1769,1,200585
14543,5.2e-05,74.125.24.0-255,2902,4671,1,200585
14544,6.3e-05,172.31.36.0-255,66,4737,1,200585
14545,7e-05,74.125.24.0-255,7156,11893,1,200585
14546,7.3e-05,172.31.36.0-255,66,11959,1,200585
14547,8.4e-05,172.31.36.0-255,66,12025,1,200585
14548,0.000124,74.125.24.0-255,5738,17763,1,200585
14549,0.000127,172.31.36.0-255,66,17829,1,200585
14550,0.000155,74.125.24.0-255,5379,23208,1,200585
14551,0.000159,172.31.36.0-255,66,23274,1,200585
14552,0.000162,74.125.24.0-255,1484,24758,1,200585
14553,0.000163,172.31.36.0-255,66,24824,1,200585
14554,0.000189,74.125.24.0-255,1484,26308,1,200585
14555,0.000193,172.31.36.0-255,66,26374,1,200585
14556,0.000199,74.125.24.0-255,4320,30694,1,200585
14557,0.000201,172.31.36.0-255,66,30760,1,200585
14558,0.000213,172.31.36.0-255,66,30826,1,200585
14559,0.000239,74.125.24.0-255,5738,36564,1,200585
14560,0.000242,172.31.36.0-255,66,36630,1,200585
14561,0.000275,172.31.36.0-255,66,36696,1,200585
14562,0.00028,74.125.24.0-255,2518,39214,1,200585
14563,0.000283,172.31.36.0-255,66,39280,1,200585
14564,0.000287,74.125.24.0-255,111,39391,1,200585
14565,0.000289,172.31.36.0-255,66,39457,1,200585
14566,0.002076,74.125.24.0-255,1484,40941,1,200585
14567,0.002083,172.31.36.0-255,66,41007,1,200585
14568,0.002093,74.125.24.0-255,2902,43909,1,200585
14569,0.002106,74.125.24.0-255,4320,48229,1,200585
14570,0.002118,74.125.24.0-255,1484,49713,1,200585
14571,0.002129,74.125.24.0-255,2902,52615,1,200585
14572,0.002149,74.125.24.0-255,4320,56935,1,200585
14573,0.002152,74.125.24.0-255,1484,58419,1,200585
14574,0.002163,74.125.24.0-255,1484,59903,1,200585
14575,0.002181,74.125.24.0-255,2902,62805,1,200585
14576,0.002203,74.125.24.0-255,5738,68543,1,200585
14577,0.002206,74.125.24.0-255,2902,71445,1,200585
14578,0.002209,74.125.24.0-255,1484,72929,1,200585
14579,0.002211,74.125.24.0-255,766,73695,1,200585
14580,0.00278,74.125.24.0-255,329,74024,1,200585
14581,0.002821,74.125.24.0-255,1484,75508,1,200585
14582,0.002839,74.125.24.0-255,4320,79828,1,200585
14583,0.002861,74.125.24.0-255,2902,82730,1,200585
14584,0.002875,74.125.24.0-255,5738,88468,1,200585
14585,0.002926,74.125.24.0-255,2902,91370,1,200585
14586,0.002932,74.125.24.0-255,5020,96390,1,200585
14587,0.003227,74.125.24.0-255,1484,97874,1,200585
14588,0.003241,74.125.24.0-255,2902,100776,1,200585
14589,0.003244,74.125.24.0-255,1484,102260,1,200585
14590,0.00326,74.125.24.0-255,4320,106580,1,200585
14591,0.003277,74.125.24.0-255,2902,109482,1,200585
14592,0.003323,74.125.24.0-255,7156,116638,1,200585
14593,0.003344,74.125.24.0-255,5020,121658,1,200585
14594,0.00374,74.125.24.0-255,1484,123142,1,200585
14595,0.003758,74.125.24.0-255,2902,126044,1,200585
14596,0.003761,74.125.24.0-255,1484,127528,1,200585
14597,0.003777,74.125.24.0-255,4320,131848,1,200585
14598,0.003832,74.125.24.0-255,4320,136168,1,200585
14599,0.003845,74.125.24.0-255,4320,140488,1,200585
14600,0.003863,74.125.24.0-255,1484,141972,1,200585
14601,0.003932,74.125.24.0-255,6438,148410,1,200585
14602,0.003943,74.125.24.0-255,1484,149894,1,200585
14603,0.004004,74.125.24.0-255,4320,154214,1,200585
14604,0.004044,74.125.24.0-255,2902,157116,1,200585
14605,0.004098,74.125.24.0-255,4320,161436,1,200585
14606,0.0042,74.125.24.0-255,4320,165756,1,200585
14607,0.004207,74.125.24.0-255,6438,172194,1,200585
14608,0.004209,74.125.24.0-255,1484,173678,1,200585
14609,0.004215,74.125.24.0-255,5738,179416,1,200585
14610,0.004299,74.125.24.0-255,7156,186572,1,200585
14611,0.004314,74.125.24.0-255,4641,191213,1,200585
14612,0.004317,74.125.24.0-255,105,191318,1,200585
14613,0.005267,172.31.36.0-255,66,191384,1,200585
14614,0.008795,172.31.36.0-255,105,191489,1,200585
14615,0.010858,74.125.24.0-255,66,191555,1,200585
14616,0.037369,172.31.36.0-255,172,191727,1,200585
14617,0.037397,172.31.36.0-255,1115,192842,1,200585
14618,0.037453,172.31.36.0-255,1514,194356,1,200585
14619,0.037455,172.31.36.0-255,1514,195870,1,200585
14620,0.037456,172.31.36.0-255,1514,197384,1,200585
14621,0.037461,172.31.36.0-255,1514,198898,1,200585
14622,0.037462,172.31.36.0-255,1489,200387,1,200585
14623,0.038899,104.244.42.0-255,66,200453,1,200585
14624,0.038951,104.244.42.0-255,66,200519,1,200585
14625,0.039092,104.244.42.0-255,66,200585,1,200585
14626,0.0,172.217.194.0-255,153,153,1,177986
14627,1.5e-05,172.31.36.0-255,66,219,1,177986
14628,3.8e-05,172.217.194.0-255,1484,1703,1,177986
14629,4.3e-05,172.31.36.0-255,66,1769,1,177986
14630,4.8e-05,172.217.194.0-255,2902,4671,1,177986
14631,5.1e-05,172.31.36.0-255,66,4737,1,177986
14632,8.8e-05,172.217.194.0-255,2902,7639,1,177986
14633,9.1e-05,172.31.36.0-255,66,7705,1,177986
14634,0.000178,172.217.194.0-255,4320,12025,1,177986
14635,0.000181,172.31.36.0-255,66,12091,1,177986
14636,0.000207,172.217.194.0-255,6269,18360,1,177986
14637,0.00021,172.31.36.0-255,66,18426,1,177986
14638,0.000386,172.31.36.0-255,66,18492,1,177986
14639,0.000402,172.217.194.0-255,3961,22453,1,177986
14640,0.000404,172.31.36.0-255,66,22519,1,177986
14641,0.000625,172.217.194.0-255,4320,26839,1,177986
14642,0.000629,172.31.36.0-255,66,26905,1,177986
14643,0.000632,172.31.36.0-255,66,26971,1,177986
14644,0.000896,172.31.36.0-255,66,27037,1,177986
14645,0.000924,172.31.36.0-255,66,27103,1,177986
14646,0.001268,172.217.194.0-255,384,27487,1,177986
14647,0.001273,172.31.36.0-255,66,27553,1,177986
14648,0.001314,172.31.36.0-255,66,27619,1,177986
14649,0.001343,172.217.194.0-255,7156,34775,1,177986
14650,0.001346,172.31.36.0-255,66,34841,1,177986
14651,0.001766,172.31.36.0-255,66,34907,1,177986
14652,0.001958,172.217.194.0-255,2902,37809,1,177986
14653,0.00196,172.31.36.0-255,66,37875,1,177986
14654,0.002639,172.217.194.0-255,4320,42195,1,177986
14655,0.003558,172.217.194.0-255,4320,46515,1,177986
14656,0.006117,172.31.36.0-255,66,46581,1,177986
14657,0.008145,172.217.194.0-255,5738,52319,1,177986
14658,0.008154,172.31.36.0-255,66,52385,1,177986
14659,0.01019,172.217.194.0-255,5738,58123,1,177986
14660,0.010199,172.31.36.0-255,66,58189,1,177986
14661,0.012264,172.217.194.0-255,5738,63927,1,177986
14662,0.012275,172.31.36.0-255,66,63993,1,177986
14663,0.014296,172.217.194.0-255,5738,69731,1,177986
14664,0.014307,172.31.36.0-255,66,69797,1,177986
14665,0.01633,172.217.194.0-255,5738,75535,1,177986
14666,0.016338,172.31.36.0-255,66,75601,1,177986
14667,0.018338,172.217.194.0-255,5738,81339,1,177986
14668,0.018348,172.31.36.0-255,66,81405,1,177986
14669,0.020366,172.217.194.0-255,5738,87143,1,177986
14670,0.020373,172.31.36.0-255,66,87209,1,177986
14671,0.022402,172.217.194.0-255,5738,92947,1,177986
14672,0.022413,172.31.36.0-255,66,93013,1,177986
14673,0.024444,172.217.194.0-255,5738,98751,1,177986
14674,0.024452,172.31.36.0-255,66,98817,1,177986
14675,0.026469,172.217.194.0-255,5738,104555,1,177986
14676,0.026477,172.31.36.0-255,66,104621,1,177986
14677,0.028486,172.217.194.0-255,5738,110359,1,177986
14678,0.028495,172.31.36.0-255,66,110425,1,177986
14679,0.030519,172.217.194.0-255,5738,116163,1,177986
14680,0.030529,172.31.36.0-255,66,116229,1,177986
14681,0.032545,172.217.194.0-255,5738,121967,1,177986
14682,0.032554,172.31.36.0-255,66,122033,1,177986
14683,0.034603,172.217.194.0-255,5738,127771,1,177986
14684,0.034623,172.31.36.0-255,66,127837,1,177986
14685,0.036689,172.217.194.0-255,5738,133575,1,177986
14686,0.036708,172.31.36.0-255,66,133641,1,177986
14687,0.038729,172.217.194.0-255,5738,139379,1,177986
14688,0.03874,172.31.36.0-255,66,139445,1,177986
14689,0.040742,172.217.194.0-255,5738,145183,1,177986
14690,0.040751,172.31.36.0-255,66,145249,1,177986
14691,0.041591,172.31.36.0-255,188,145437,1,177986
14692,0.041625,172.31.36.0-255,958,146395,1,177986
14693,0.041708,172.31.36.0-255,1514,147909,1,177986
14694,0.041709,172.31.36.0-255,1514,149423,1,177986
14695,0.041711,172.31.36.0-255,1514,150937,1,177986
14696,0.041712,172.31.36.0-255,1514,152451,1,177986
14697,0.041743,172.31.36.0-255,1514,153965,1,177986
14698,0.041744,172.31.36.0-255,200,154165,1,177986
14699,0.042763,172.217.194.0-255,5738,159903,1,177986
14700,0.042776,172.31.36.0-255,66,159969,1,177986
14701,0.042901,172.31.36.0-255,101,160070,1,177986
14702,0.043153,104.244.42.0-255,66,160136,1,177986
14703,0.043161,104.244.42.0-255,66,160202,1,177986
14704,0.043268,104.244.42.0-255,66,160268,1,177986
14705,0.043274,104.244.42.0-255,66,160334,1,177986
14706,0.044111,104.244.42.0-255,108,160442,1,177986
14707,0.044122,172.31.36.0-255,66,160508,1,177986
14708,0.044807,172.217.194.0-255,5738,166246,1,177986
14709,0.044812,172.31.36.0-255,66,166312,1,177986
14710,0.044869,172.217.194.0-255,66,166378,1,177986
14711,0.046846,172.217.194.0-255,5738,172116,1,177986
14712,0.046853,172.31.36.0-255,66,172182,1,177986
14713,0.048869,172.217.194.0-255,5738,177920,1,177986
14714,0.048876,172.31.36.0-255,66,177986,1,177986
14715,0.0,74.125.200.0-255,142,142,1,373728
14716,3.4e-05,172.31.36.0-255,66,208,1,373728
14717,4.1e-05,74.125.200.0-255,1484,1692,1,373728
14718,4.6e-05,172.31.36.0-255,66,1758,1,373728
14719,5.1e-05,74.125.200.0-255,2902,4660,1,373728
14720,5.3e-05,172.31.36.0-255,66,4726,1,373728
14721,7.4e-05,74.125.200.0-255,2902,7628,1,373728
14722,7.7e-05,172.31.36.0-255,66,7694,1,373728
14723,9.2e-05,74.125.200.0-255,4320,12014,1,373728
14724,9.5e-05,172.31.36.0-255,66,12080,1,373728
14725,0.000131,74.125.200.0-255,1484,13564,1,373728
14726,0.000134,172.31.36.0-255,66,13630,1,373728
14727,0.000163,74.125.200.0-255,2021,15651,1,373728
14728,0.000166,172.31.36.0-255,66,15717,1,373728
14729,0.000169,74.125.200.0-255,1484,17201,1,373728
14730,0.00017,172.31.36.0-255,66,17267,1,373728
14731,0.000177,74.125.200.0-255,2902,20169,1,373728
14732,0.000179,172.31.36.0-255,66,20235,1,373728
14733,0.000184,74.125.200.0-255,1484,21719,1,373728
14734,0.000186,172.31.36.0-255,66,21785,1,373728
14735,0.000212,74.125.200.0-255,4320,26105,1,373728
14736,0.000214,172.31.36.0-255,66,26171,1,373728
14737,0.00022,74.125.200.0-255,5379,31550,1,373728
14738,0.000222,172.31.36.0-255,66,31616,1,373728
14739,0.000299,74.125.200.0-255,1484,33100,1,373728
14740,0.000303,172.31.36.0-255,66,33166,1,373728
14741,0.00031,74.125.200.0-255,2902,36068,1,373728
14742,0.000314,172.31.36.0-255,66,36134,1,373728
14743,0.000317,74.125.200.0-255,1484,37618,1,373728
14744,0.000319,172.31.36.0-255,66,37684,1,373728
14745,0.000323,74.125.200.0-255,1484,39168,1,373728
14746,0.000325,172.31.36.0-255,66,39234,1,373728
14747,0.000353,74.125.200.0-255,1484,40718,1,373728
14748,0.000361,74.125.200.0-255,5738,46456,1,373728
14749,0.000364,172.31.36.0-255,66,46522,1,373728
14750,0.00037,74.125.200.0-255,3961,50483,1,373728
14751,0.000372,172.31.36.0-255,66,50549,1,373728
14752,0.000398,74.125.200.0-255,4320,54869,1,373728
14753,0.000401,172.31.36.0-255,66,54935,1,373728
14754,0.000407,74.125.200.0-255,4320,59255,1,373728
14755,0.00041,172.31.36.0-255,66,59321,1,373728
14756,0.000427,74.125.200.0-255,5738,65059,1,373728
14757,0.00043,172.31.36.0-255,66,65125,1,373728
14758,0.000433,74.125.200.0-255,1125,66250,1,373728
14759,0.000466,74.125.200.0-255,398,66648,1,373728
14760,0.000685,74.125.200.0-255,346,66994,1,373728
14761,0.000689,172.31.36.0-255,66,67060,1,373728
14762,0.000792,74.125.200.0-255,1484,68544,1,373728
14763,0.000798,74.125.200.0-255,2902,71446,1,373728
14764,0.000801,172.31.36.0-255,66,71512,1,373728
14765,0.000825,74.125.200.0-255,5738,77250,1,373728
14766,0.000828,172.31.36.0-255,66,77316,1,373728
14767,0.000856,74.125.200.0-255,4320,81636,1,373728
14768,0.000859,172.31.36.0-255,66,81702,1,373728
14769,0.000878,74.125.200.0-255,2543,84245,1,373728
14770,0.000881,172.31.36.0-255,66,84311,1,373728
14771,0.000894,74.125.200.0-255,1484,85795,1,373728
14772,0.000906,74.125.200.0-255,1484,87279,1,373728
14773,0.00091,172.31.36.0-255,66,87345,1,373728
14774,0.000926,74.125.200.0-255,1484,88829,1,373728
14775,0.000932,74.125.200.0-255,5738,94567,1,373728
14776,0.000935,172.31.36.0-255,66,94633,1,373728
14777,0.000941,74.125.200.0-255,5738,100371,1,373728
14778,0.000943,172.31.36.0-255,66,100437,1,373728
14779,0.000957,74.125.200.0-255,1125,101562,1,373728
14780,0.001052,172.31.36.0-255,66,101628,1,373728
14781,0.001282,74.125.200.0-255,1484,103112,1,373728
14782,0.001291,74.125.200.0-255,1484,104596,1,373728
14783,0.001295,172.31.36.0-255,66,104662,1,373728
14784,0.001323,74.125.200.0-255,2902,107564,1,373728
14785,0.001327,172.31.36.0-255,66,107630,1,373728
14786,0.001331,74.125.200.0-255,1484,109114,1,373728
14787,0.001351,74.125.200.0-255,4320,113434,1,373728
14788,0.001354,172.31.36.0-255,66,113500,1,373728
14789,0.001358,74.125.200.0-255,2902,116402,1,373728
14790,0.00136,172.31.36.0-255,66,116468,1,373728
14791,0.001387,74.125.200.0-255,4320,120788,1,373728
14792,0.001391,172.31.36.0-255,66,120854,1,373728
14793,0.001423,172.31.36.0-255,66,120920,1,373728
14794,0.001464,74.125.200.0-255,4320,125240,1,373728
14795,0.001468,172.31.36.0-255,66,125306,1,373728
14796,0.001488,74.125.200.0-255,2184,127490,1,373728
14797,0.001491,172.31.36.0-255,66,127556,1,373728
14798,0.00155,74.125.200.0-255,1484,129040,1,373728
14799,0.001557,74.125.200.0-255,2902,131942,1,373728
14800,0.001561,172.31.36.0-255,66,132008,1,373728
14801,0.001577,74.125.200.0-255,5738,137746,1,373728
14802,0.00158,172.31.36.0-255,66,137812,1,373728
14803,0.001602,74.125.200.0-255,1484,139296,1,373728
14804,0.001655,74.125.200.0-255,4320,143616,1,373728
14805,0.001659,172.31.36.0-255,66,143682,1,373728
14806,0.001679,74.125.200.0-255,1484,145166,1,373728
14807,0.00169,172.31.36.0-255,66,145232,1,373728
14808,0.001701,172.31.36.0-255,66,145298,1,373728
14809,0.001712,172.31.36.0-255,66,145364,1,373728
14810,0.001718,74.125.200.0-255,7156,152520,1,373728
14811,0.001721,172.31.36.0-255,66,152586,1,373728
14812,0.00175,74.125.200.0-255,4320,156906,1,373728
14813,0.001756,172.31.36.0-255,66,156972,1,373728
14814,0.00177,172.31.36.0-255,66,157038,1,373728
14815,0.001773,74.125.200.0-255,766,157804,1,373728
14816,0.001822,74.125.200.0-255,1484,159288,1,373728
14817,0.001824,172.31.36.0-255,66,159354,1,373728
14818,0.001829,74.125.200.0-255,1484,160838,1,373728
14819,0.001843,74.125.200.0-255,1484,162322,1,373728
14820,0.001846,172.31.36.0-255,66,162388,1,373728
14821,0.001859,74.125.200.0-255,2902,165290,1,373728
14822,0.001861,172.31.36.0-255,66,165356,1,373728
14823,0.001865,74.125.200.0-255,1484,166840,1,373728
14824,0.001884,74.125.200.0-255,2902,169742,1,373728
14825,0.001887,172.31.36.0-255,66,169808,1,373728
14826,0.00189,74.125.200.0-255,1484,171292,1,373728
14827,0.001901,74.125.200.0-255,1484,172776,1,373728
14828,0.001903,172.31.36.0-255,66,172842,1,373728
14829,0.001925,74.125.200.0-255,5738,178580,1,373728
14830,0.001928,172.31.36.0-255,66,178646,1,373728
14831,0.001933,74.125.200.0-255,4320,182966,1,373728
14832,0.001935,172.31.36.0-255,66,183032,1,373728
14833,0.001977,172.31.36.0-255,66,183098,1,373728
14834,0.002026,74.125.200.0-255,1484,184582,1,373728
14835,0.002043,74.125.200.0-255,2902,187484,1,373728
14836,0.002046,172.31.36.0-255,66,187550,1,373728
14837,0.002052,74.125.200.0-255,5738,193288,1,373728
14838,0.002054,172.31.36.0-255,66,193354,1,373728
14839,0.002064,74.125.200.0-255,2902,196256,1,373728
14840,0.002066,172.31.36.0-255,66,196322,1,373728
14841,0.002091,74.125.200.0-255,5738,202060,1,373728
14842,0.002093,172.31.36.0-255,66,202126,1,373728
14843,0.002113,74.125.200.0-255,4320,206446,1,373728
14844,0.002116,172.31.36.0-255,66,206512,1,373728
14845,0.002121,74.125.200.0-255,4320,210832,1,373728
14846,0.002124,172.31.36.0-255,66,210898,1,373728
14847,0.002143,74.125.200.0-255,6438,217336,1,373728
14848,0.002157,74.125.200.0-255,4320,221656,1,373728
14849,0.002166,172.31.36.0-255,66,221722,1,373728
14850,0.002184,74.125.200.0-255,7156,228878,1,373728
14851,0.002189,74.125.200.0-255,4320,233198,1,373728
14852,0.002205,74.125.200.0-255,2902,236100,1,373728
14853,0.002208,172.31.36.0-255,66,236166,1,373728
14854,0.002216,74.125.200.0-255,2902,239068,1,373728
14855,0.002221,172.31.36.0-255,66,239134,1,373728
14856,0.00223,74.125.200.0-255,4320,243454,1,373728
14857,0.002253,74.125.200.0-255,7156,250610,1,373728
14858,0.002256,74.125.200.0-255,766,251376,1,373728
14859,0.002258,172.31.36.0-255,66,251442,1,373728
14860,0.002264,172.31.36.0-255,66,251508,1,373728
14861,0.004529,74.125.200.0-255,5738,257246,1,373728
14862,0.004536,172.31.36.0-255,66,257312,1,373728
14863,0.006804,74.125.200.0-255,1484,258796,1,373728
14864,0.006829,74.125.200.0-255,4320,263116,1,373728
14865,0.006834,172.31.36.0-255,66,263182,1,373728
14866,0.009113,74.125.200.0-255,5738,268920,1,373728
14867,0.00912,172.31.36.0-255,66,268986,1,373728
14868,0.011399,74.125.200.0-255,5738,274724,1,373728
14869,0.011408,172.31.36.0-255,66,274790,1,373728
14870,0.013719,74.125.200.0-255,5738,280528,1,373728
14871,0.013726,172.31.36.0-255,66,280594,1,373728
14872,0.016018,74.125.200.0-255,5738,286332,1,373728
14873,0.016027,172.31.36.0-255,66,286398,1,373728
14874,0.018302,74.125.200.0-255,5738,292136,1,373728
14875,0.018311,172.31.36.0-255,66,292202,1,373728
14876,0.020604,74.125.200.0-255,5738,297940,1,373728
14877,0.020614,172.31.36.0-255,66,298006,1,373728
14878,0.02289,74.125.200.0-255,5738,303744,1,373728
14879,0.022897,172.31.36.0-255,66,303810,1,373728
14880,0.025175,74.125.200.0-255,5738,309548,1,373728
14881,0.025184,172.31.36.0-255,66,309614,1,373728
14882,0.027464,74.125.200.0-255,5738,315352,1,373728
14883,0.02747,172.31.36.0-255,66,315418,1,373728
14884,0.029744,74.125.200.0-255,5738,321156,1,373728
14885,0.029751,172.31.36.0-255,66,321222,1,373728
14886,0.032044,74.125.200.0-255,5738,326960,1,373728
14887,0.032052,172.31.36.0-255,66,327026,1,373728
14888,0.033905,172.31.36.0-255,172,327198,1,373728
14889,0.033961,172.31.36.0-255,1115,328313,1,373728
14890,0.034044,172.31.36.0-255,1514,329827,1,373728
14891,0.034047,172.31.36.0-255,1514,331341,1,373728
14892,0.034048,172.31.36.0-255,1514,332855,1,373728
14893,0.034049,172.31.36.0-255,1514,334369,1,373728
14894,0.034081,172.31.36.0-255,1489,335858,1,373728
14895,0.034327,74.125.200.0-255,5738,341596,1,373728
14896,0.034333,172.31.36.0-255,66,341662,1,373728
14897,0.035459,104.244.42.0-255,66,341728,1,373728
14898,0.035555,104.244.42.0-255,66,341794,1,373728
14899,0.03565,104.244.42.0-255,66,341860,1,373728
14900,0.035757,104.244.42.0-255,66,341926,1,373728
14901,0.036591,74.125.200.0-255,1484,343410,1,373728
14902,0.036606,74.125.200.0-255,4320,347730,1,373728
14903,0.03661,172.31.36.0-255,66,347796,1,373728
14904,0.038877,74.125.200.0-255,5738,353534,1,373728
14905,0.038884,172.31.36.0-255,66,353600,1,373728
14906,0.041168,74.125.200.0-255,5738,359338,1,373728
14907,0.041175,172.31.36.0-255,66,359404,1,373728
14908,0.043457,74.125.200.0-255,5738,365142,1,373728
14909,0.043464,172.31.36.0-255,66,365208,1,373728
14910,0.045753,74.125.200.0-255,5738,370946,1,373728
14911,0.045759,172.31.36.0-255,66,371012,1,373728
14912,0.048044,74.125.200.0-255,2545,373557,1,373728
14913,0.048051,172.31.36.0-255,66,373623,1,373728
14914,0.048217,172.31.36.0-255,105,373728,1,373728
14915,0.0,74.125.24.0-255,318,318,1,249020
14916,2.2e-05,172.31.36.0-255,66,384,1,249020
14917,2.9e-05,74.125.24.0-255,1484,1868,1,249020
14918,3.3e-05,172.31.36.0-255,66,1934,1,249020
14919,4.9e-05,74.125.24.0-255,4320,6254,1,249020
14920,5.3e-05,172.31.36.0-255,66,6320,1,249020
14921,6.5e-05,172.31.36.0-255,66,6386,1,249020
14922,7.2e-05,74.125.24.0-255,7156,13542,1,249020
14923,7.5e-05,172.31.36.0-255,66,13608,1,249020
14924,9.5e-05,74.125.24.0-255,1484,15092,1,249020
14925,9.8e-05,172.31.36.0-255,66,15158,1,249020
14926,0.000114,172.31.36.0-255,66,15224,1,249020
14927,0.000195,74.125.24.0-255,1484,16708,1,249020
14928,0.000198,172.31.36.0-255,66,16774,1,249020
14929,0.000218,74.125.24.0-255,2902,19676,1,249020
14930,0.000221,172.31.36.0-255,66,19742,1,249020
14931,0.000226,74.125.24.0-255,4320,24062,1,249020
14932,0.000229,172.31.36.0-255,66,24128,1,249020
14933,0.000264,74.125.24.0-255,1484,25612,1,249020
14934,0.000266,172.31.36.0-255,66,25678,1,249020
14935,0.000274,74.125.24.0-255,6797,32475,1,249020
14936,0.000276,172.31.36.0-255,66,32541,1,249020
14937,0.000371,74.125.24.0-255,1484,34025,1,249020
14938,0.000374,172.31.36.0-255,66,34091,1,249020
14939,0.000393,74.125.24.0-255,2902,36993,1,249020
14940,0.000396,172.31.36.0-255,66,37059,1,249020
14941,0.000401,74.125.24.0-255,4320,41379,1,249020
14942,0.000403,172.31.36.0-255,66,41445,1,249020
14943,0.000431,74.125.24.0-255,1484,42929,1,249020
14944,0.000434,172.31.36.0-255,66,42995,1,249020
14945,0.000461,74.125.24.0-255,7126,50121,1,249020
14946,0.000464,172.31.36.0-255,66,50187,1,249020
14947,0.000543,74.125.24.0-255,1484,51671,1,249020
14948,0.00055,74.125.24.0-255,2902,54573,1,249020
14949,0.000554,172.31.36.0-255,66,54639,1,249020
14950,0.000583,74.125.24.0-255,5738,60377,1,249020
14951,0.000599,172.31.36.0-255,66,60443,1,249020
14952,0.000605,74.125.24.0-255,5738,66181,1,249020
14953,0.000608,172.31.36.0-255,66,66247,1,249020
14954,0.000629,74.125.24.0-255,1484,67731,1,249020
14955,0.000658,172.31.36.0-255,66,67797,1,249020
14956,0.000662,74.125.24.0-255,2902,70699,1,249020
14957,0.000665,172.31.36.0-255,66,70765,1,249020
14958,0.000693,74.125.24.0-255,1385,72150,1,249020
14959,0.000768,74.125.24.0-255,1484,73634,1,249020
14960,0.000772,172.31.36.0-255,66,73700,1,249020
14961,0.000778,74.125.24.0-255,2902,76602,1,249020
14962,0.000781,172.31.36.0-255,66,76668,1,249020
14963,0.000785,74.125.24.0-255,2902,79570,1,249020
14964,0.000792,172.31.36.0-255,66,79636,1,249020
14965,0.000832,74.125.24.0-255,2902,82538,1,249020
14966,0.000835,172.31.36.0-255,66,82604,1,249020
14967,0.00084,74.125.24.0-255,2902,85506,1,249020
14968,0.000842,172.31.36.0-255,66,85572,1,249020
14969,0.000855,172.31.36.0-255,66,85638,1,249020
14970,0.000861,74.125.24.0-255,5738,91376,1,249020
14971,0.000864,172.31.36.0-255,66,91442,1,249020
14972,0.000903,172.31.36.0-255,66,91508,1,249020
14973,0.000906,74.125.24.0-255,1484,92992,1,249020
14974,0.000939,172.31.36.0-255,66,93058,1,249020
14975,0.000977,172.31.36.0-255,66,93124,1,249020
14976,0.001003,74.125.24.0-255,2902,96026,1,249020
14977,0.001006,172.31.36.0-255,66,96092,1,249020
14978,0.001034,74.125.24.0-255,3241,99333,1,249020
14979,0.001038,172.31.36.0-255,66,99399,1,249020
14980,0.001136,74.125.24.0-255,1484,100883,1,249020
14981,0.001142,74.125.24.0-255,2902,103785,1,249020
14982,0.001144,172.31.36.0-255,66,103851,1,249020
14983,0.001148,74.125.24.0-255,1484,105335,1,249020
14984,0.001177,74.125.24.0-255,4320,109655,1,249020
14985,0.001192,172.31.36.0-255,66,109721,1,249020
14986,0.001196,172.31.36.0-255,66,109787,1,249020
14987,0.001204,74.125.24.0-255,1484,111271,1,249020
14988,0.001222,172.31.36.0-255,66,111337,1,249020
14989,0.001463,74.125.24.0-255,1484,112821,1,249020
14990,0.001478,74.125.24.0-255,2902,115723,1,249020
14991,0.001482,172.31.36.0-255,66,115789,1,249020
14992,0.001489,74.125.24.0-255,4320,120109,1,249020
14993,0.001491,172.31.36.0-255,66,120175,1,249020
14994,0.001519,74.125.24.0-255,1484,121659,1,249020
14995,0.001527,74.125.24.0-255,7156,128815,1,249020
14996,0.001529,172.31.36.0-255,66,128881,1,249020
14997,0.0016,172.31.36.0-255,66,128947,1,249020
14998,0.001629,74.125.24.0-255,2902,131849,1,249020
14999,0.001632,172.31.36.0-255,66,131915,1,249020
15000,0.001637,74.125.24.0-255,2184,134099,1,249020
15001,0.001639,172.31.36.0-255,66,134165,1,249020
15002,0.001642,74.125.24.0-255,1484,135649,1,249020
15003,0.001651,74.125.24.0-255,2902,138551,1,249020
15004,0.001653,172.31.36.0-255,66,138617,1,249020
15005,0.001661,74.125.24.0-255,5738,144355,1,249020
15006,0.001663,172.31.36.0-255,66,144421,1,249020
15007,0.001675,74.125.24.0-255,7156,151577,1,249020
15008,0.001678,172.31.36.0-255,66,151643,1,249020
15009,0.001729,172.31.36.0-255,66,151709,1,249020
15010,0.001742,172.31.36.0-255,66,151775,1,249020
15011,0.001753,172.31.36.0-255,66,151841,1,249020
15012,0.001799,172.31.36.0-255,66,151907,1,249020
15013,0.001823,74.125.24.0-255,1484,153391,1,249020
15014,0.001828,74.125.24.0-255,2902,156293,1,249020
15015,0.00183,172.31.36.0-255,66,156359,1,249020
15016,0.001837,74.125.24.0-255,5738,162097,1,249020
15017,0.001839,172.31.36.0-255,66,162163,1,249020
15018,0.001847,74.125.24.0-255,1484,163647,1,249020
15019,0.001886,172.31.36.0-255,66,163713,1,249020
15020,0.001893,74.125.24.0-255,5738,169451,1,249020
15021,0.001895,172.31.36.0-255,66,169517,1,249020
15022,0.001932,74.125.24.0-255,2902,172419,1,249020
15023,0.001942,172.31.36.0-255,66,172485,1,249020
15024,0.001947,74.125.24.0-255,2184,174669,1,249020
15025,0.001949,172.31.36.0-255,66,174735,1,249020
15026,0.001978,74.125.24.0-255,5738,180473,1,249020
15027,0.001983,74.125.24.0-255,2902,183375,1,249020
15028,0.002,74.125.24.0-255,4320,187695,1,249020
15029,0.002003,74.125.24.0-255,1484,189179,1,249020
15030,0.002032,74.125.24.0-255,1484,190663,1,249020
15031,0.002037,172.31.36.0-255,66,190729,1,249020
15032,0.002051,74.125.24.0-255,5020,195749,1,249020
15033,0.002077,172.31.36.0-255,66,195815,1,249020
15034,0.004129,74.125.24.0-255,5738,201553,1,249020
15035,0.004136,172.31.36.0-255,66,201619,1,249020
15036,0.006238,74.125.24.0-255,5738,207357,1,249020
15037,0.006251,172.31.36.0-255,66,207423,1,249020
15038,0.008379,74.125.24.0-255,5738,213161,1,249020
15039,0.008394,172.31.36.0-255,66,213227,1,249020
15040,0.010518,74.125.24.0-255,5738,218965,1,249020
15041,0.010534,172.31.36.0-255,66,219031,1,249020
15042,0.012604,74.125.24.0-255,5738,224769,1,249020
15043,0.01262,172.31.36.0-255,66,224835,1,249020
15044,0.014675,74.125.24.0-255,5738,230573,1,249020
15045,0.014684,172.31.36.0-255,66,230639,1,249020
15046,0.016688,74.125.24.0-255,5738,236377,1,249020
15047,0.016695,172.31.36.0-255,66,236443,1,249020
15048,0.018743,74.125.24.0-255,3071,239514,1,249020
15049,0.01875,172.31.36.0-255,66,239580,1,249020
15050,0.019191,172.31.36.0-255,105,239685,1,249020
15051,0.021217,74.125.24.0-255,66,239751,1,249020
15052,0.04642,172.31.36.0-255,172,239923,1,249020
15053,0.046457,172.31.36.0-255,1114,241037,1,249020
15054,0.046526,172.31.36.0-255,1514,242551,1,249020
15055,0.046528,172.31.36.0-255,1514,244065,1,249020
15056,0.046529,172.31.36.0-255,1514,245579,1,249020
15057,0.04653,172.31.36.0-255,1514,247093,1,249020
15058,0.04656,172.31.36.0-255,1489,248582,1,249020
15059,0.047968,104.244.42.0-255,66,248648,1,249020
15060,0.047978,104.244.42.0-255,66,248714,1,249020
15061,0.048222,104.244.42.0-255,66,248780,1,249020
15062,0.048228,104.244.42.0-255,66,248846,1,249020
15063,0.048661,104.244.42.0-255,108,248954,1,249020
15064,0.048672,172.31.36.0-255,66,249020,1,249020
15065,0.0,74.125.68.0-255,152,152,1,311714
15066,1.5e-05,172.31.36.0-255,66,218,1,311714
15067,2.1e-05,74.125.68.0-255,1484,1702,1,311714
15068,2.6e-05,172.31.36.0-255,66,1768,1,311714
15069,3.1e-05,74.125.68.0-255,2902,4670,1,311714
15070,3.4e-05,172.31.36.0-255,66,4736,1,311714
15071,4.1e-05,74.125.68.0-255,5738,10474,1,311714
15072,4.3e-05,172.31.36.0-255,66,10540,1,311714
15073,6.2e-05,74.125.68.0-255,2902,13442,1,311714
15074,6.4e-05,172.31.36.0-255,66,13508,1,311714
15075,8.7e-05,74.125.68.0-255,584,14092,1,311714
15076,8.9e-05,172.31.36.0-255,66,14158,1,311714
15077,0.000174,74.125.68.0-255,1484,15642,1,311714
15078,0.000177,172.31.36.0-255,66,15708,1,311714
15079,0.000181,74.125.68.0-255,1484,17192,1,311714
15080,0.000183,172.31.36.0-255,66,17258,1,311714
15081,0.000199,74.125.68.0-255,1484,18742,1,311714
15082,0.000201,172.31.36.0-255,66,18808,1,311714
15083,0.000208,74.125.68.0-255,5738,24546,1,311714
15084,0.000211,172.31.36.0-255,66,24612,1,311714
15085,0.000215,74.125.68.0-255,2902,27514,1,311714
15086,0.000216,172.31.36.0-255,66,27580,1,311714
15087,0.00023,74.125.68.0-255,3961,31541,1,311714
15088,0.000233,172.31.36.0-255,66,31607,1,311714
15089,0.000262,74.125.68.0-255,2902,34509,1,311714
15090,0.000265,172.31.36.0-255,66,34575,1,311714
15091,0.000287,74.125.68.0-255,4320,38895,1,311714
15092,0.000289,172.31.36.0-255,66,38961,1,311714
15093,0.000309,74.125.68.0-255,5738,44699,1,311714
15094,0.000311,172.31.36.0-255,66,44765,1,311714
15095,0.000322,74.125.68.0-255,2902,47667,1,311714
15096,0.000324,172.31.36.0-255,66,47733,1,311714
15097,0.000327,74.125.68.0-255,1125,48858,1,311714
15098,0.000603,74.125.68.0-255,1484,50342,1,311714
15099,0.000607,172.31.36.0-255,66,50408,1,311714
15100,0.000611,74.125.68.0-255,1484,51892,1,311714
15101,0.000627,74.125.68.0-255,1484,53376,1,311714
15102,0.000629,172.31.36.0-255,66,53442,1,311714
15103,0.000649,74.125.68.0-255,1484,54926,1,311714
15104,0.000657,74.125.68.0-255,5738,60664,1,311714
15105,0.000659,172.31.36.0-255,66,60730,1,311714
15106,0.000664,74.125.68.0-255,2902,63632,1,311714
15107,0.000666,172.31.36.0-255,66,63698,1,311714
15108,0.000706,74.125.68.0-255,3961,67659,1,311714
15109,0.000709,172.31.36.0-255,66,67725,1,311714
15110,0.000712,74.125.68.0-255,1484,69209,1,311714
15111,0.000727,74.125.68.0-255,2902,72111,1,311714
15112,0.000731,172.31.36.0-255,66,72177,1,311714
15113,0.000751,74.125.68.0-255,5738,77915,1,311714
15114,0.000754,172.31.36.0-255,66,77981,1,311714
15115,0.000778,74.125.68.0-255,5379,83360,1,311714
15116,0.000781,172.31.36.0-255,66,83426,1,311714
15117,0.000821,74.125.68.0-255,2902,86328,1,311714
15118,0.000824,172.31.36.0-255,66,86394,1,311714
15119,0.000839,74.125.68.0-255,2902,89296,1,311714
15120,0.000841,172.31.36.0-255,66,89362,1,311714
15121,0.000849,74.125.68.0-255,7156,96518,1,311714
15122,0.000852,172.31.36.0-255,66,96584,1,311714
15123,0.000885,74.125.68.0-255,4542,101126,1,311714
15124,0.000888,172.31.36.0-255,66,101192,1,311714
15125,0.001115,74.125.68.0-255,1484,102676,1,311714
15126,0.001131,74.125.68.0-255,2902,105578,1,311714
15127,0.001134,172.31.36.0-255,66,105644,1,311714
15128,0.001164,74.125.68.0-255,4320,109964,1,311714
15129,0.001166,172.31.36.0-255,66,110030,1,311714
15130,0.001184,74.125.68.0-255,1484,111514,1,311714
15131,0.001187,74.125.68.0-255,1484,112998,1,311714
15132,0.001189,172.31.36.0-255,66,113064,1,311714
15133,0.001208,74.125.68.0-255,2902,115966,1,311714
15134,0.001211,172.31.36.0-255,66,116032,1,311714
15135,0.001232,74.125.68.0-255,2902,118934,1,311714
15136,0.001234,172.31.36.0-255,66,119000,1,311714
15137,0.001239,74.125.68.0-255,4320,123320,1,311714
15138,0.001241,172.31.36.0-255,66,123386,1,311714
15139,0.001273,74.125.68.0-255,4320,127706,1,311714
15140,0.001276,172.31.36.0-255,66,127772,1,311714
15141,0.001294,74.125.68.0-255,2902,130674,1,311714
15142,0.001296,172.31.36.0-255,66,130740,1,311714
15143,0.001351,74.125.68.0-255,5020,135760,1,311714
15144,0.001355,172.31.36.0-255,66,135826,1,311714
15145,0.001402,74.125.68.0-255,1484,137310,1,311714
15146,0.001417,74.125.68.0-255,2902,140212,1,311714
15147,0.00142,172.31.36.0-255,66,140278,1,311714
15148,0.001423,74.125.68.0-255,1484,141762,1,311714
15149,0.001453,74.125.68.0-255,2902,144664,1,311714
15150,0.001456,172.31.36.0-255,66,144730,1,311714
15151,0.001472,74.125.68.0-255,1484,146214,1,311714
15152,0.001484,74.125.68.0-255,2902,149116,1,311714
15153,0.001487,172.31.36.0-255,66,149182,1,311714
15154,0.001505,74.125.68.0-255,2902,152084,1,311714
15155,0.001508,172.31.36.0-255,66,152150,1,311714
15156,0.001527,74.125.68.0-255,2902,155052,1,311714
15157,0.001532,172.31.36.0-255,66,155118,1,311714
15158,0.001553,74.125.68.0-255,2902,158020,1,311714
15159,0.001556,172.31.36.0-255,66,158086,1,311714
15160,0.001561,74.125.68.0-255,4320,162406,1,311714
15161,0.001564,172.31.36.0-255,66,162472,1,311714
15162,0.001584,74.125.68.0-255,4320,166792,1,311714
15163,0.001586,172.31.36.0-255,66,166858,1,311714
15164,0.001599,74.125.68.0-255,3602,170460,1,311714
15165,0.001602,172.31.36.0-255,66,170526,1,311714
15166,0.003546,74.125.68.0-255,1484,172010,1,311714
15167,0.003564,74.125.68.0-255,4320,176330,1,311714
15168,0.003568,172.31.36.0-255,66,176396,1,311714
15169,0.005525,74.125.68.0-255,2902,179298,1,311714
15170,0.005529,172.31.36.0-255,66,179364,1,311714
15171,0.005548,74.125.68.0-255,2902,182266,1,311714
15172,0.00555,172.31.36.0-255,66,182332,1,311714
15173,0.007491,74.125.68.0-255,2902,185234,1,311714
15174,0.007498,172.31.36.0-255,66,185300,1,311714
15175,0.00752,74.125.68.0-255,2902,188202,1,311714
15176,0.007523,172.31.36.0-255,66,188268,1,311714
15177,0.009516,74.125.68.0-255,5738,194006,1,311714
15178,0.009527,172.31.36.0-255,66,194072,1,311714
15179,0.011521,74.125.68.0-255,5738,199810,1,311714
15180,0.011534,172.31.36.0-255,66,199876,1,311714
15181,0.013548,74.125.68.0-255,5738,205614,1,311714
15182,0.013566,172.31.36.0-255,66,205680,1,311714
15183,0.015573,74.125.68.0-255,5738,211418,1,311714
15184,0.01559,172.31.36.0-255,66,211484,1,311714
15185,0.0176,74.125.68.0-255,5738,217222,1,311714
15186,0.017615,172.31.36.0-255,66,217288,1,311714
15187,0.019591,74.125.68.0-255,5738,223026,1,311714
15188,0.019599,172.31.36.0-255,66,223092,1,311714
15189,0.021581,74.125.68.0-255,5738,228830,1,311714
15190,0.021592,172.31.36.0-255,66,228896,1,311714
15191,0.023556,74.125.68.0-255,5738,234634,1,311714
15192,0.023564,172.31.36.0-255,66,234700,1,311714
15193,0.025535,74.125.68.0-255,5738,240438,1,311714
15194,0.025543,172.31.36.0-255,66,240504,1,311714
15195,0.027516,74.125.68.0-255,5738,246242,1,311714
15196,0.027525,172.31.36.0-255,66,246308,1,311714
15197,0.029512,74.125.68.0-255,5738,252046,1,311714
15198,0.029518,172.31.36.0-255,66,252112,1,311714
15199,0.031496,74.125.68.0-255,5738,257850,1,311714
15200,0.031503,172.31.36.0-255,66,257916,1,311714
15201,0.033476,74.125.68.0-255,5738,263654,1,311714
15202,0.033484,172.31.36.0-255,66,263720,1,311714
15203,0.035455,74.125.68.0-255,5738,269458,1,311714
15204,0.035462,172.31.36.0-255,66,269524,1,311714
15205,0.035798,172.31.36.0-255,188,269712,1,311714
15206,0.035829,172.31.36.0-255,959,270671,1,311714
15207,0.035904,172.31.36.0-255,217,270888,1,311714
15208,0.037315,104.244.42.0-255,66,270954,1,311714
15209,0.037382,104.244.42.0-255,66,271020,1,311714
15210,0.037438,74.125.68.0-255,5738,276758,1,311714
15211,0.037443,172.31.36.0-255,66,276824,1,311714
15212,0.037461,104.244.42.0-255,66,276890,1,311714
15213,0.039426,74.125.68.0-255,5738,282628,1,311714
15214,0.039434,172.31.36.0-255,66,282694,1,311714
15215,0.041418,74.125.68.0-255,5738,288432,1,311714
15216,0.041425,172.31.36.0-255,66,288498,1,311714
15217,0.043408,74.125.68.0-255,5738,294236,1,311714
15218,0.043417,172.31.36.0-255,66,294302,1,311714
15219,0.04545,74.125.68.0-255,5738,300040,1,311714
15220,0.045457,172.31.36.0-255,66,300106,1,311714
15221,0.047476,74.125.68.0-255,5738,305844,1,311714
15222,0.047483,172.31.36.0-255,66,305910,1,311714
15223,0.049469,74.125.68.0-255,5738,311648,1,311714
15224,0.049475,172.31.36.0-255,66,311714,1,311714
15225,0.0,74.125.24.0-255,153,153,1,190909
15226,3.2e-05,172.31.36.0-255,66,219,1,190909
15227,3.9e-05,74.125.24.0-255,1484,1703,1,190909
15228,4.4e-05,172.31.36.0-255,66,1769,1,190909
15229,5.5e-05,74.125.24.0-255,2902,4671,1,190909
15230,5.9e-05,172.31.36.0-255,66,4737,1,190909
15231,6.7e-05,74.125.24.0-255,7156,11893,1,190909
15232,7e-05,172.31.36.0-255,66,11959,1,190909
15233,7.3e-05,74.125.24.0-255,1484,13443,1,190909
15234,7.6e-05,172.31.36.0-255,66,13509,1,190909
15235,8.9e-05,74.125.24.0-255,629,14138,1,190909
15236,9.2e-05,172.31.36.0-255,66,14204,1,190909
15237,0.000127,74.125.24.0-255,4320,18524,1,190909
15238,0.00013,172.31.36.0-255,66,18590,1,190909
15239,0.000167,74.125.24.0-255,4320,22910,1,190909
15240,0.000172,172.31.36.0-255,66,22976,1,190909
15241,0.000177,74.125.24.0-255,2902,25878,1,190909
15242,0.000178,172.31.36.0-255,66,25944,1,190909
15243,0.000213,74.125.24.0-255,5379,31323,1,190909
15244,0.000217,172.31.36.0-255,66,31389,1,190909
15245,0.000316,74.125.24.0-255,1484,32873,1,190909
15246,0.000322,172.31.36.0-255,66,32939,1,190909
15247,0.000328,74.125.24.0-255,2902,35841,1,190909
15248,0.000331,172.31.36.0-255,66,35907,1,190909
15249,0.000343,74.125.24.0-255,5738,41645,1,190909
15250,0.000346,172.31.36.0-255,66,41711,1,190909
15251,0.000378,74.125.24.0-255,2902,44613,1,190909
15252,0.000384,172.31.36.0-255,66,44679,1,190909
15253,0.000417,74.125.24.0-255,5379,50058,1,190909
15254,0.000422,172.31.36.0-255,66,50124,1,190909
15255,0.000439,172.31.36.0-255,66,50190,1,190909
15256,0.000445,74.125.24.0-255,4320,54510,1,190909
15257,0.000453,172.31.36.0-255,66,54576,1,190909
15258,0.000495,74.125.24.0-255,2897,57473,1,190909
15259,0.000519,172.31.36.0-255,66,57539,1,190909
15260,0.00068,74.125.24.0-255,331,57870,1,190909
15261,0.000887,172.31.36.0-255,66,57936,1,190909
15262,0.001091,74.125.24.0-255,1484,59420,1,190909
15263,0.001113,74.125.24.0-255,2902,62322,1,190909
15264,0.00112,74.125.24.0-255,5738,68060,1,190909
15265,0.00115,172.31.36.0-255,66,68126,1,190909
15266,0.001157,172.31.36.0-255,66,68192,1,190909
15267,0.001193,74.125.24.0-255,7156,75348,1,190909
15268,0.0012,172.31.36.0-255,66,75414,1,190909
15269,0.001216,74.125.24.0-255,3602,79016,1,190909
15270,0.001225,172.31.36.0-255,66,79082,1,190909
15271,0.001486,74.125.24.0-255,1484,80566,1,190909
15272,0.001505,74.125.24.0-255,2902,83468,1,190909
15273,0.00151,172.31.36.0-255,66,83534,1,190909
15274,0.001518,74.125.24.0-255,5738,89272,1,190909
15275,0.001534,172.31.36.0-255,66,89338,1,190909
15276,0.001562,172.31.36.0-255,66,89404,1,190909
15277,0.001566,172.31.36.0-255,66,89470,1,190909
15278,0.001616,74.125.24.0-255,766,90236,1,190909
15279,0.001765,172.31.36.0-255,66,90302,1,190909
15280,0.004131,74.125.24.0-255,4320,94622,1,190909
15281,0.004182,172.31.36.0-255,66,94688,1,190909
15282,0.004327,74.125.24.0-255,1484,96172,1,190909
15283,0.006732,74.125.24.0-255,4320,100492,1,190909
15284,0.008614,172.31.36.0-255,66,100558,1,190909
15285,0.011174,74.125.24.0-255,5738,106296,1,190909
15286,0.011187,172.31.36.0-255,66,106362,1,190909
15287,0.013736,74.125.24.0-255,5738,112100,1,190909
15288,0.015724,172.31.36.0-255,66,112166,1,190909
15289,0.018306,74.125.24.0-255,5738,117904,1,190909
15290,0.01832,172.31.36.0-255,66,117970,1,190909
15291,0.020886,74.125.24.0-255,5738,123708,1,190909
15292,0.023263,172.31.36.0-255,66,123774,1,190909
15293,0.025826,74.125.24.0-255,5738,129512,1,190909
15294,0.025835,172.31.36.0-255,66,129578,1,190909
15295,0.025883,172.31.36.0-255,172,129750,1,190909
15296,0.025913,172.31.36.0-255,1114,130864,1,190909
15297,0.025988,172.31.36.0-255,1514,132378,1,190909
15298,0.025989,172.31.36.0-255,1514,133892,1,190909
15299,0.025996,172.31.36.0-255,1514,135406,1,190909
15300,0.025997,172.31.36.0-255,1514,136920,1,190909
15301,0.026024,172.31.36.0-255,1489,138409,1,190909
15302,0.027457,104.244.42.0-255,66,138475,1,190909
15303,0.027494,104.244.42.0-255,66,138541,1,190909
15304,0.02755,104.244.42.0-255,66,138607,1,190909
15305,0.027612,104.244.42.0-255,66,138673,1,190909
15306,0.028387,74.125.24.0-255,5738,144411,1,190909
15307,0.028394,172.31.36.0-255,66,144477,1,190909
15308,0.030967,74.125.24.0-255,5738,150215,1,190909
15309,0.030974,172.31.36.0-255,66,150281,1,190909
15310,0.033527,74.125.24.0-255,5738,156019,1,190909
15311,0.033533,172.31.36.0-255,66,156085,1,190909
15312,0.036099,74.125.24.0-255,5738,161823,1,190909
15313,0.036107,172.31.36.0-255,66,161889,1,190909
15314,0.038672,74.125.24.0-255,5738,167627,1,190909
15315,0.038679,172.31.36.0-255,66,167693,1,190909
15316,0.041247,74.125.24.0-255,5738,173431,1,190909
15317,0.041254,172.31.36.0-255,66,173497,1,190909
15318,0.043798,74.125.24.0-255,5738,179235,1,190909
15319,0.043805,172.31.36.0-255,66,179301,1,190909
15320,0.046373,74.125.24.0-255,5738,185039,1,190909
15321,0.04638,172.31.36.0-255,66,185105,1,190909
15322,0.048912,74.125.24.0-255,5738,190843,1,190909
15323,0.048919,172.31.36.0-255,66,190909,1,190909
15324,0.0,74.125.130.0-255,152,152,1,209982
15325,2.5e-05,172.31.36.0-255,66,218,1,209982
15326,3.1e-05,74.125.130.0-255,1484,1702,1,209982
15327,3.5e-05,172.31.36.0-255,66,1768,1,209982
15328,3.8e-05,74.125.130.0-255,1484,3252,1,209982
15329,4e-05,172.31.36.0-255,66,3318,1,209982
15330,6.8e-05,74.125.130.0-255,1484,4802,1,209982
15331,7e-05,172.31.36.0-255,66,4868,1,209982
15332,7.3e-05,74.125.130.0-255,1484,6352,1,209982
15333,7.4e-05,172.31.36.0-255,66,6418,1,209982
15334,9e-05,74.125.130.0-255,5738,12156,1,209982
15335,9.3e-05,172.31.36.0-255,66,12222,1,209982
15336,0.000119,74.125.130.0-255,5738,17960,1,209982
15337,0.000123,172.31.36.0-255,66,18026,1,209982
15338,0.000151,74.125.130.0-255,2038,20064,1,209982
15339,0.000154,172.31.36.0-255,66,20130,1,209982
15340,0.000182,74.125.130.0-255,5738,25868,1,209982
15341,0.000185,172.31.36.0-255,66,25934,1,209982
15342,0.000211,74.125.130.0-255,2902,28836,1,209982
15343,0.000214,172.31.36.0-255,66,28902,1,209982
15344,0.000218,74.125.130.0-255,2543,31445,1,209982
15345,0.000221,172.31.36.0-255,66,31511,1,209982
15346,0.000641,74.125.130.0-255,1484,32995,1,209982
15347,0.000647,172.31.36.0-255,66,33061,1,209982
15348,0.000675,74.125.130.0-255,1484,34545,1,209982
15349,0.000678,172.31.36.0-255,66,34611,1,209982
15350,0.000682,74.125.130.0-255,1484,36095,1,209982
15351,0.000684,172.31.36.0-255,66,36161,1,209982
15352,0.000707,74.125.130.0-255,1484,37645,1,209982
15353,0.000714,172.31.36.0-255,66,37711,1,209982
15354,0.000721,74.125.130.0-255,5738,43449,1,209982
15355,0.000724,172.31.36.0-255,66,43515,1,209982
15356,0.000727,74.125.130.0-255,1484,44999,1,209982
15357,0.000758,74.125.130.0-255,2902,47901,1,209982
15358,0.000762,172.31.36.0-255,66,47967,1,209982
15359,0.000791,74.125.130.0-255,2902,50869,1,209982
15360,0.000796,74.125.130.0-255,4320,55189,1,209982
15361,0.000806,172.31.36.0-255,66,55255,1,209982
15362,0.000809,172.31.36.0-255,66,55321,1,209982
15363,0.000868,74.125.130.0-255,2902,58223,1,209982
15364,0.000872,172.31.36.0-255,66,58289,1,209982
15365,0.000891,74.125.130.0-255,4320,62609,1,209982
15366,0.000894,172.31.36.0-255,66,62675,1,209982
15367,0.0009,74.125.130.0-255,3602,66277,1,209982
15368,0.000902,172.31.36.0-255,66,66343,1,209982
15369,0.00097,74.125.130.0-255,648,66991,1,209982
15370,0.000992,74.125.130.0-255,1484,68475,1,209982
15371,0.000996,172.31.36.0-255,66,68541,1,209982
15372,0.001018,74.125.130.0-255,4320,72861,1,209982
15373,0.001021,172.31.36.0-255,66,72927,1,209982
15374,0.001025,74.125.130.0-255,2902,75829,1,209982
15375,0.001027,172.31.36.0-255,66,75895,1,209982
15376,0.001033,74.125.130.0-255,4320,80215,1,209982
15377,0.001036,172.31.36.0-255,66,80281,1,209982
15378,0.001083,172.31.36.0-255,66,80347,1,209982
15379,0.001088,74.125.130.0-255,2902,83249,1,209982
15380,0.00109,172.31.36.0-255,66,83315,1,209982
15381,0.001093,74.125.130.0-255,1484,84799,1,209982
15382,0.001127,74.125.130.0-255,2902,87701,1,209982
15383,0.001131,172.31.36.0-255,66,87767,1,209982
15384,0.001135,74.125.130.0-255,2902,90669,1,209982
15385,0.001137,172.31.36.0-255,66,90735,1,209982
15386,0.001181,74.125.130.0-255,2184,92919,1,209982
15387,0.001184,172.31.36.0-255,66,92985,1,209982
15388,0.003614,74.125.130.0-255,2902,95887,1,209982
15389,0.003619,172.31.36.0-255,66,95953,1,209982
15390,0.003657,74.125.130.0-255,2902,98855,1,209982
15391,0.00366,172.31.36.0-255,66,98921,1,209982
15392,0.00611,74.125.130.0-255,2902,101823,1,209982
15393,0.006116,172.31.36.0-255,66,101889,1,209982
15394,0.006145,74.125.130.0-255,2902,104791,1,209982
15395,0.006148,172.31.36.0-255,66,104857,1,209982
15396,0.008629,74.125.130.0-255,5738,110595,1,209982
15397,0.008636,172.31.36.0-255,66,110661,1,209982
15398,0.01115,74.125.130.0-255,5738,116399,1,209982
15399,0.011158,172.31.36.0-255,66,116465,1,209982
15400,0.013658,74.125.130.0-255,5738,122203,1,209982
15401,0.013668,172.31.36.0-255,66,122269,1,209982
15402,0.016169,74.125.130.0-255,5738,128007,1,209982
15403,0.016177,172.31.36.0-255,66,128073,1,209982
15404,0.018686,74.125.130.0-255,5738,133811,1,209982
15405,0.018693,172.31.36.0-255,66,133877,1,209982
15406,0.021185,74.125.130.0-255,4320,138197,1,209982
15407,0.021192,172.31.36.0-255,66,138263,1,209982
15408,0.021222,74.125.130.0-255,1484,139747,1,209982
15409,0.023684,74.125.130.0-255,4320,144067,1,209982
15410,0.023691,172.31.36.0-255,66,144133,1,209982
15411,0.026186,74.125.130.0-255,5738,149871,1,209982
15412,0.026194,172.31.36.0-255,66,149937,1,209982
15413,0.027941,172.31.36.0-255,172,150109,1,209982
15414,0.027997,172.31.36.0-255,1113,151222,1,209982
15415,0.028065,172.31.36.0-255,1514,152736,1,209982
15416,0.028067,172.31.36.0-255,1514,154250,1,209982
15417,0.028068,172.31.36.0-255,1514,155764,1,209982
15418,0.028068,172.31.36.0-255,1514,157278,1,209982
15419,0.028096,172.31.36.0-255,1490,158768,1,209982
15420,0.028696,74.125.130.0-255,5738,164506,1,209982
15421,0.028702,172.31.36.0-255,66,164572,1,209982
15422,0.029482,104.244.42.0-255,66,164638,1,209982
15423,0.029578,104.244.42.0-255,66,164704,1,209982
15424,0.029628,104.244.42.0-255,66,164770,1,209982
15425,0.029769,104.244.42.0-255,66,164836,1,209982
15426,0.031201,74.125.130.0-255,5738,170574,1,209982
15427,0.031205,172.31.36.0-255,66,170640,1,209982
15428,0.033745,74.125.130.0-255,1484,172124,1,209982
15429,0.033764,74.125.130.0-255,4320,176444,1,209982
15430,0.033769,172.31.36.0-255,66,176510,1,209982
15431,0.036564,74.125.130.0-255,5738,182248,1,209982
15432,0.036571,172.31.36.0-255,66,182314,1,209982
15433,0.039066,74.125.130.0-255,5738,188052,1,209982
15434,0.039073,172.31.36.0-255,66,188118,1,209982
15435,0.041574,74.125.130.0-255,5738,193856,1,209982
15436,0.04158,172.31.36.0-255,66,193922,1,209982
15437,0.044067,74.125.130.0-255,5738,199660,1,209982
15438,0.044074,172.31.36.0-255,66,199726,1,209982
15439,0.046574,74.125.130.0-255,4320,204046,1,209982
15440,0.04658,172.31.36.0-255,66,204112,1,209982
15441,0.046611,74.125.130.0-255,1484,205596,1,209982
15442,0.049077,74.125.130.0-255,4320,209916,1,209982
15443,0.049081,172.31.36.0-255,66,209982,1,209982
15444,0.0,74.125.130.0-255,152,152,1,222098
15445,1.9e-05,172.31.36.0-255,66,218,1,222098
15446,2.6e-05,74.125.130.0-255,1484,1702,1,222098
15447,3e-05,172.31.36.0-255,66,1768,1,222098
15448,4.4e-05,74.125.130.0-255,2902,4670,1,222098
15449,4.8e-05,172.31.36.0-255,66,4736,1,222098
15450,5.7e-05,74.125.130.0-255,7156,11892,1,222098
15451,6e-05,172.31.36.0-255,66,11958,1,222098
15452,9.3e-05,74.125.130.0-255,2058,14016,1,222098
15453,9.6e-05,172.31.36.0-255,66,14082,1,222098
15454,0.000282,74.125.130.0-255,1484,15566,1,222098
15455,0.000288,172.31.36.0-255,66,15632,1,222098
15456,0.000293,74.125.130.0-255,1484,17116,1,222098
15457,0.000295,172.31.36.0-255,66,17182,1,222098
15458,0.000325,74.125.130.0-255,2902,20084,1,222098
15459,0.000328,172.31.36.0-255,66,20150,1,222098
15460,0.000335,74.125.130.0-255,5738,25888,1,222098
15461,0.000337,172.31.36.0-255,66,25954,1,222098
15462,0.000367,74.125.130.0-255,5379,31333,1,222098
15463,0.00037,172.31.36.0-255,66,31399,1,222098
15464,0.000377,74.125.130.0-255,5738,37137,1,222098
15465,0.000379,172.31.36.0-255,66,37203,1,222098
15466,0.00041,74.125.130.0-255,4320,41523,1,222098
15467,0.000413,172.31.36.0-255,66,41589,1,222098
15468,0.00044,74.125.130.0-255,7156,48745,1,222098
15469,0.000443,172.31.36.0-255,66,48811,1,222098
15470,0.000457,172.31.36.0-255,66,48877,1,222098
15471,0.000463,74.125.130.0-255,3602,52479,1,222098
15472,0.000465,172.31.36.0-255,66,52545,1,222098
15473,0.000491,74.125.130.0-255,395,52940,1,222098
15474,0.000494,172.31.36.0-255,66,53006,1,222098
15475,0.000623,74.125.130.0-255,1484,54490,1,222098
15476,0.000649,74.125.130.0-255,2902,57392,1,222098
15477,0.000654,172.31.36.0-255,66,57458,1,222098
15478,0.000659,74.125.130.0-255,2902,60360,1,222098
15479,0.000661,172.31.36.0-255,66,60426,1,222098
15480,0.000667,74.125.130.0-255,4320,64746,1,222098
15481,0.000669,172.31.36.0-255,66,64812,1,222098
15482,0.000719,172.31.36.0-255,66,64878,1,222098
15483,0.000725,74.125.130.0-255,4320,69198,1,222098
15484,0.000727,172.31.36.0-255,66,69264,1,222098
15485,0.000757,74.125.130.0-255,4320,73584,1,222098
15486,0.00076,172.31.36.0-255,66,73650,1,222098
15487,0.000791,74.125.130.0-255,5020,78670,1,222098
15488,0.000794,172.31.36.0-255,66,78736,1,222098
15489,0.001038,74.125.130.0-255,379,79115,1,222098
15490,0.001543,172.31.36.0-255,66,79181,1,222098
15491,0.001588,74.125.130.0-255,1484,80665,1,222098
15492,0.001592,74.125.130.0-255,1484,82149,1,222098
15493,0.001595,172.31.36.0-255,66,82215,1,222098
15494,0.001622,74.125.130.0-255,1484,83699,1,222098
15495,0.001628,74.125.130.0-255,4320,88019,1,222098
15496,0.00163,172.31.36.0-255,66,88085,1,222098
15497,0.001655,172.31.36.0-255,66,88151,1,222098
15498,0.001662,74.125.130.0-255,5738,93889,1,222098
15499,0.001664,172.31.36.0-255,66,93955,1,222098
15500,0.00171,74.125.130.0-255,2902,96857,1,222098
15501,0.001712,172.31.36.0-255,66,96923,1,222098
15502,0.001762,172.31.36.0-255,66,96989,1,222098
15503,0.004126,74.125.130.0-255,5738,102727,1,222098
15504,0.004133,172.31.36.0-255,66,102793,1,222098
15505,0.006503,74.125.130.0-255,5738,108531,1,222098
15506,0.006509,172.31.36.0-255,66,108597,1,222098
15507,0.008899,74.125.130.0-255,5738,114335,1,222098
15508,0.008906,172.31.36.0-255,66,114401,1,222098
15509,0.011277,74.125.130.0-255,5738,120139,1,222098
15510,0.011286,172.31.36.0-255,66,120205,1,222098
15511,0.013662,74.125.130.0-255,5738,125943,1,222098
15512,0.013669,172.31.36.0-255,66,126009,1,222098
15513,0.016031,74.125.130.0-255,5738,131747,1,222098
15514,0.016039,172.31.36.0-255,66,131813,1,222098
15515,0.018397,74.125.130.0-255,5738,137551,1,222098
15516,0.018405,172.31.36.0-255,66,137617,1,222098
15517,0.020769,74.125.130.0-255,5738,143355,1,222098
15518,0.020776,172.31.36.0-255,66,143421,1,222098
15519,0.023154,74.125.130.0-255,5738,149159,1,222098
15520,0.023167,172.31.36.0-255,66,149225,1,222098
15521,0.025534,74.125.130.0-255,5738,154963,1,222098
15522,0.025543,172.31.36.0-255,66,155029,1,222098
15523,0.027932,74.125.130.0-255,5738,160767,1,222098
15524,0.02794,172.31.36.0-255,66,160833,1,222098
15525,0.030312,74.125.130.0-255,5738,166571,1,222098
15526,0.030322,172.31.36.0-255,66,166637,1,222098
15527,0.032689,74.125.130.0-255,5738,172375,1,222098
15528,0.032697,172.31.36.0-255,66,172441,1,222098
15529,0.035065,74.125.130.0-255,5738,178179,1,222098
15530,0.035074,172.31.36.0-255,66,178245,1,222098
15531,0.037235,172.31.36.0-255,172,178417,1,222098
15532,0.037267,172.31.36.0-255,1115,179532,1,222098
15533,0.037339,172.31.36.0-255,1514,181046,1,222098
15534,0.037341,172.31.36.0-255,1514,182560,1,222098
15535,0.037342,172.31.36.0-255,1514,184074,1,222098
15536,0.037343,172.31.36.0-255,1514,185588,1,222098
15537,0.03737,172.31.36.0-255,1488,187076,1,222098
15538,0.037437,74.125.130.0-255,5738,192814,1,222098
15539,0.037443,172.31.36.0-255,66,192880,1,222098
15540,0.038811,104.244.42.0-255,66,192946,1,222098
15541,0.03882,104.244.42.0-255,66,193012,1,222098
15542,0.038935,104.244.42.0-255,66,193078,1,222098
15543,0.039821,74.125.130.0-255,5738,198816,1,222098
15544,0.039827,172.31.36.0-255,66,198882,1,222098
15545,0.042197,74.125.130.0-255,5738,204620,1,222098
15546,0.042206,172.31.36.0-255,66,204686,1,222098
15547,0.044611,74.125.130.0-255,5738,210424,1,222098
15548,0.044618,172.31.36.0-255,66,210490,1,222098
15549,0.046986,74.125.130.0-255,5738,216228,1,222098
15550,0.046993,172.31.36.0-255,66,216294,1,222098
15551,0.049364,74.125.130.0-255,5738,222032,1,222098
15552,0.049371,172.31.36.0-255,66,222098,1,222098
15553,0.0,172.31.36.0-255,230,230,1,296
15554,0.007096,172.217.194.0-255,66,296,1,296
15555,0.0,172.217.24.0-255,153,153,1,225284
15556,3e-05,172.31.36.0-255,66,219,1,225284
15557,3.6e-05,172.217.24.0-255,1484,1703,1,225284
15558,3.9e-05,172.31.36.0-255,66,1769,1,225284
15559,4.3e-05,172.217.24.0-255,2902,4671,1,225284
15560,4.5e-05,172.31.36.0-255,66,4737,1,225284
15561,4.9e-05,172.217.24.0-255,4320,9057,1,225284
15562,5.9e-05,172.31.36.0-255,66,9123,1,225284
15563,8.7e-05,172.217.24.0-255,5738,14861,1,225284
15564,9.7e-05,172.31.36.0-255,66,14927,1,225284
15565,0.000123,172.217.24.0-255,3438,18365,1,225284
15566,0.000126,172.31.36.0-255,66,18431,1,225284
15567,0.000137,172.31.36.0-255,66,18497,1,225284
15568,0.000165,172.217.24.0-255,2543,21040,1,225284
15569,0.000167,172.31.36.0-255,66,21106,1,225284
15570,0.000283,172.217.24.0-255,1484,22590,1,225284
15571,0.000289,172.31.36.0-255,66,22656,1,225284
15572,0.000292,172.217.24.0-255,1484,24140,1,225284
15573,0.000294,172.31.36.0-255,66,24206,1,225284
15574,0.000298,172.217.24.0-255,2902,27108,1,225284
15575,0.0003,172.31.36.0-255,66,27174,1,225284
15576,0.00031,172.217.24.0-255,4320,31494,1,225284
15577,0.000313,172.31.36.0-255,66,31560,1,225284
15578,0.000346,172.217.24.0-255,1484,33044,1,225284
15579,0.000349,172.31.36.0-255,66,33110,1,225284
15580,0.000355,172.217.24.0-255,5379,38489,1,225284
15581,0.000357,172.31.36.0-255,66,38555,1,225284
15582,0.000516,172.217.24.0-255,1484,40039,1,225284
15583,0.000521,172.31.36.0-255,66,40105,1,225284
15584,0.000525,172.217.24.0-255,1484,41589,1,225284
15585,0.000527,172.31.36.0-255,66,41655,1,225284
15586,0.000531,172.217.24.0-255,2902,44557,1,225284
15587,0.00054,172.31.36.0-255,66,44623,1,225284
15588,0.000545,172.217.24.0-255,5738,50361,1,225284
15589,0.000548,172.31.36.0-255,66,50427,1,225284
15590,0.0006,172.217.24.0-255,5706,56133,1,225284
15591,0.000604,172.31.36.0-255,66,56199,1,225284
15592,0.001617,172.217.24.0-255,116,56315,1,225284
15593,0.001883,172.217.24.0-255,1484,57799,1,225284
15594,0.001889,172.31.36.0-255,66,57865,1,225284
15595,0.001895,172.217.24.0-255,2902,60767,1,225284
15596,0.001897,172.31.36.0-255,66,60833,1,225284
15597,0.001908,172.217.24.0-255,4320,65153,1,225284
15598,0.00191,172.31.36.0-255,66,65219,1,225284
15599,0.001917,172.217.24.0-255,5738,70957,1,225284
15600,0.001919,172.31.36.0-255,66,71023,1,225284
15601,0.001957,172.31.36.0-255,66,71089,1,225284
15602,0.001965,172.217.24.0-255,1484,72573,1,225284
15603,0.001988,172.217.24.0-255,4320,76893,1,225284
15604,0.001991,172.31.36.0-255,66,76959,1,225284
15605,0.003921,172.217.24.0-255,5738,82697,1,225284
15606,0.00393,172.31.36.0-255,66,82763,1,225284
15607,0.005866,172.217.24.0-255,5738,88501,1,225284
15608,0.005873,172.31.36.0-255,66,88567,1,225284
15609,0.007812,172.217.24.0-255,5738,94305,1,225284
15610,0.007817,172.31.36.0-255,66,94371,1,225284
15611,0.009978,172.217.24.0-255,5738,100109,1,225284
15612,0.010024,172.31.36.0-255,66,100175,1,225284
15613,0.011988,172.217.24.0-255,5738,105913,1,225284
15614,0.011996,172.31.36.0-255,66,105979,1,225284
15615,0.013942,172.217.24.0-255,5738,111717,1,225284
15616,0.013949,172.31.36.0-255,66,111783,1,225284
15617,0.015896,172.217.24.0-255,5738,117521,1,225284
15618,0.015907,172.31.36.0-255,66,117587,1,225284
15619,0.018113,172.217.24.0-255,5738,123325,1,225284
15620,0.018121,172.31.36.0-255,66,123391,1,225284
15621,0.02006,172.217.24.0-255,5738,129129,1,225284
15622,0.020068,172.31.36.0-255,66,129195,1,225284
15623,0.021998,172.217.24.0-255,5738,134933,1,225284
15624,0.022004,172.31.36.0-255,66,134999,1,225284
15625,0.023951,172.217.24.0-255,5738,140737,1,225284
15626,0.02396,172.31.36.0-255,66,140803,1,225284
15627,0.02521,172.31.36.0-255,172,140975,1,225284
15628,0.025241,172.31.36.0-255,1115,142090,1,225284
15629,0.025308,172.31.36.0-255,1514,143604,1,225284
15630,0.02531,172.31.36.0-255,1514,145118,1,225284
15631,0.025311,172.31.36.0-255,1514,146632,1,225284
15632,0.025313,172.31.36.0-255,1514,148146,1,225284
15633,0.025338,172.31.36.0-255,1488,149634,1,225284
15634,0.025897,172.217.24.0-255,5738,155372,1,225284
15635,0.025903,172.31.36.0-255,66,155438,1,225284
15636,0.026733,104.244.42.0-255,66,155504,1,225284
15637,0.026763,104.244.42.0-255,66,155570,1,225284
15638,0.026877,104.244.42.0-255,66,155636,1,225284
15639,0.02785,172.217.24.0-255,5738,161374,1,225284
15640,0.027856,172.31.36.0-255,66,161440,1,225284
15641,0.0298,172.217.24.0-255,5738,167178,1,225284
15642,0.029811,172.31.36.0-255,66,167244,1,225284
15643,0.031761,172.217.24.0-255,5738,172982,1,225284
15644,0.031769,172.31.36.0-255,66,173048,1,225284
15645,0.033739,172.217.24.0-255,5738,178786,1,225284
15646,0.033746,172.31.36.0-255,66,178852,1,225284
15647,0.035721,172.217.24.0-255,5738,184590,1,225284
15648,0.035728,172.31.36.0-255,66,184656,1,225284
15649,0.037682,172.217.24.0-255,5738,190394,1,225284
15650,0.037688,172.31.36.0-255,66,190460,1,225284
15651,0.039661,172.217.24.0-255,5738,196198,1,225284
15652,0.039669,172.31.36.0-255,66,196264,1,225284
15653,0.041603,172.217.24.0-255,5738,202002,1,225284
15654,0.041609,172.31.36.0-255,66,202068,1,225284
15655,0.043553,172.217.24.0-255,5738,207806,1,225284
15656,0.043562,172.31.36.0-255,66,207872,1,225284
15657,0.045509,172.217.24.0-255,5738,213610,1,225284
15658,0.04552,172.31.36.0-255,66,213676,1,225284
15659,0.047469,172.217.24.0-255,5738,219414,1,225284
15660,0.047476,172.31.36.0-255,66,219480,1,225284
15661,0.04943,172.217.24.0-255,5738,225218,1,225284
15662,0.049438,172.31.36.0-255,66,225284,1,225284
15663,0.0,74.125.24.0-255,152,152,1,199237
15664,3.3e-05,172.31.36.0-255,66,218,1,199237
15665,4.1e-05,74.125.24.0-255,1484,1702,1,199237
15666,4.5e-05,172.31.36.0-255,66,1768,1,199237
15667,5e-05,74.125.24.0-255,2902,4670,1,199237
15668,5.2e-05,172.31.36.0-255,66,4736,1,199237
15669,5.9e-05,74.125.24.0-255,7156,11892,1,199237
15670,6.2e-05,172.31.36.0-255,66,11958,1,199237
15671,0.000113,74.125.24.0-255,1484,13442,1,199237
15672,0.000116,172.31.36.0-255,66,13508,1,199237
15673,0.000152,74.125.24.0-255,2902,16410,1,199237
15674,0.000155,172.31.36.0-255,66,16476,1,199237
15675,0.000181,172.31.36.0-255,66,16542,1,199237
15676,0.000274,74.125.24.0-255,3961,20503,1,199237
15677,0.000279,172.31.36.0-255,66,20569,1,199237
15678,0.000325,74.125.24.0-255,4320,24889,1,199237
15679,0.000329,172.31.36.0-255,66,24955,1,199237
15680,0.000364,74.125.24.0-255,2902,27857,1,199237
15681,0.000367,172.31.36.0-255,66,27923,1,199237
15682,0.000391,74.125.24.0-255,7156,35079,1,199237
15683,0.000395,172.31.36.0-255,66,35145,1,199237
15684,0.000478,74.125.24.0-255,7156,42301,1,199237
15685,0.000482,172.31.36.0-255,66,42367,1,199237
15686,0.000507,172.31.36.0-255,66,42433,1,199237
15687,0.000647,74.125.24.0-255,109,42542,1,199237
15688,0.000651,172.31.36.0-255,66,42608,1,199237
15689,0.000654,74.125.24.0-255,332,42940,1,199237
15690,0.000656,172.31.36.0-255,66,43006,1,199237
15691,0.00075,74.125.24.0-255,1484,44490,1,199237
15692,0.000754,172.31.36.0-255,66,44556,1,199237
15693,0.000759,74.125.24.0-255,2902,47458,1,199237
15694,0.000761,172.31.36.0-255,66,47524,1,199237
15695,0.000774,74.125.24.0-255,2902,50426,1,199237
15696,0.000776,172.31.36.0-255,66,50492,1,199237
15697,0.000797,74.125.24.0-255,2902,53394,1,199237
15698,0.0008,172.31.36.0-255,66,53460,1,199237
15699,0.000844,74.125.24.0-255,7156,60616,1,199237
15700,0.000847,172.31.36.0-255,66,60682,1,199237
15701,0.000869,74.125.24.0-255,5738,66420,1,199237
15702,0.000872,172.31.36.0-255,66,66486,1,199237
15703,0.000975,74.125.24.0-255,7156,73642,1,199237
15704,0.00098,172.31.36.0-255,66,73708,1,199237
15705,0.001041,74.125.24.0-255,3602,77310,1,199237
15706,0.001044,172.31.36.0-255,66,77376,1,199237
15707,0.001758,74.125.24.0-255,1484,78860,1,199237
15708,0.00177,74.125.24.0-255,2902,81762,1,199237
15709,0.001775,172.31.36.0-255,66,81828,1,199237
15710,0.001785,74.125.24.0-255,5738,87566,1,199237
15711,0.001787,172.31.36.0-255,66,87632,1,199237
15712,0.00186,172.31.36.0-255,66,87698,1,199237
15713,0.001985,172.31.36.0-255,66,87764,1,199237
15714,0.004553,74.125.24.0-255,4320,92084,1,199237
15715,0.004557,172.31.36.0-255,66,92150,1,199237
15716,0.004573,74.125.24.0-255,1484,93634,1,199237
15717,0.007152,74.125.24.0-255,4320,97954,1,199237
15718,0.007158,172.31.36.0-255,66,98020,1,199237
15719,0.009926,74.125.24.0-255,5738,103758,1,199237
15720,0.009979,172.31.36.0-255,66,103824,1,199237
15721,0.012596,74.125.24.0-255,5738,109562,1,199237
15722,0.012603,172.31.36.0-255,66,109628,1,199237
15723,0.015206,74.125.24.0-255,4320,113948,1,199237
15724,0.015213,172.31.36.0-255,66,114014,1,199237
15725,0.015232,74.125.24.0-255,1484,115498,1,199237
15726,0.017842,74.125.24.0-255,4320,119818,1,199237
15727,0.017853,172.31.36.0-255,66,119884,1,199237
15728,0.020461,74.125.24.0-255,5738,125622,1,199237
15729,0.020469,172.31.36.0-255,66,125688,1,199237
15730,0.023033,74.125.24.0-255,2902,128590,1,199237
15731,0.02304,172.31.36.0-255,66,128656,1,199237
15732,0.023064,74.125.24.0-255,2902,131558,1,199237
15733,0.023067,172.31.36.0-255,66,131624,1,199237
15734,0.025641,74.125.24.0-255,2902,134526,1,199237
15735,0.025648,172.31.36.0-255,66,134592,1,199237
15736,0.025678,74.125.24.0-255,2902,137494,1,199237
15737,0.025682,172.31.36.0-255,66,137560,1,199237
15738,0.028249,74.125.24.0-255,5738,143298,1,199237
15739,0.028256,172.31.36.0-255,66,143364,1,199237
15740,0.030827,74.125.24.0-255,5738,149102,1,199237
15741,0.030834,172.31.36.0-255,66,149168,1,199237
15742,0.033017,172.31.36.0-255,188,149356,1,199237
15743,0.033061,172.31.36.0-255,958,150314,1,199237
15744,0.033143,172.31.36.0-255,1514,151828,1,199237
15745,0.033145,172.31.36.0-255,1514,153342,1,199237
15746,0.03315,172.31.36.0-255,1514,154856,1,199237
15747,0.033151,172.31.36.0-255,1514,156370,1,199237
15748,0.033174,172.31.36.0-255,1514,157884,1,199237
15749,0.033175,172.31.36.0-255,197,158081,1,199237
15750,0.033412,74.125.24.0-255,5738,163819,1,199237
15751,0.033418,172.31.36.0-255,66,163885,1,199237
15752,0.034689,104.244.42.0-255,66,163951,1,199237
15753,0.034698,104.244.42.0-255,66,164017,1,199237
15754,0.03474,104.244.42.0-255,66,164083,1,199237
15755,0.034745,104.244.42.0-255,66,164149,1,199237
15756,0.035982,74.125.24.0-255,5738,169887,1,199237
15757,0.035987,172.31.36.0-255,66,169953,1,199237
15758,0.038551,74.125.24.0-255,5738,175691,1,199237
15759,0.038557,172.31.36.0-255,66,175757,1,199237
15760,0.041121,74.125.24.0-255,5738,181495,1,199237
15761,0.041127,172.31.36.0-255,66,181561,1,199237
15762,0.04372,74.125.24.0-255,5738,187299,1,199237
15763,0.043725,172.31.36.0-255,66,187365,1,199237
15764,0.046332,74.125.24.0-255,2902,190267,1,199237
15765,0.046338,172.31.36.0-255,66,190333,1,199237
15766,0.046364,74.125.24.0-255,2902,193235,1,199237
15767,0.046367,172.31.36.0-255,66,193301,1,199237
15768,0.048919,74.125.24.0-255,2902,196203,1,199237
15769,0.048925,172.31.36.0-255,66,196269,1,199237
15770,0.048965,74.125.24.0-255,2902,199171,1,199237
15771,0.048968,172.31.36.0-255,66,199237,1,199237
15772,0.0,172.31.36.0-255,66,66,1,66
15773,0.0,74.125.24.0-255,153,153,1,255103
15774,3.4e-05,172.31.36.0-255,66,219,1,255103
15775,4.1e-05,74.125.24.0-255,1484,1703,1,255103
15776,4.6e-05,172.31.36.0-255,66,1769,1,255103
15777,5.1e-05,74.125.24.0-255,2902,4671,1,255103
15778,5.4e-05,172.31.36.0-255,66,4737,1,255103
15779,6.1e-05,74.125.24.0-255,7156,11893,1,255103
15780,6.3e-05,172.31.36.0-255,66,11959,1,255103
15781,9.6e-05,74.125.24.0-255,1974,13933,1,255103
15782,9.9e-05,172.31.36.0-255,66,13999,1,255103
15783,0.000103,74.125.24.0-255,2902,16901,1,255103
15784,0.000106,172.31.36.0-255,66,16967,1,255103
15785,0.000126,74.125.24.0-255,5738,22705,1,255103
15786,0.000129,172.31.36.0-255,66,22771,1,255103
15787,0.000151,74.125.24.0-255,1484,24255,1,255103
15788,0.000155,172.31.36.0-255,66,24321,1,255103
15789,0.000163,74.125.24.0-255,6797,31118,1,255103
15790,0.000165,172.31.36.0-255,66,31184,1,255103
15791,0.000229,74.125.24.0-255,1484,32668,1,255103
15792,0.000231,172.31.36.0-255,66,32734,1,255103
15793,0.000252,74.125.24.0-255,2902,35636,1,255103
15794,0.000255,172.31.36.0-255,66,35702,1,255103
15795,0.000259,74.125.24.0-255,2902,38604,1,255103
15796,0.000262,172.31.36.0-255,66,38670,1,255103
15797,0.000278,74.125.24.0-255,2902,41572,1,255103
15798,0.00028,172.31.36.0-255,66,41638,1,255103
15799,0.000296,74.125.24.0-255,2902,44540,1,255103
15800,0.000298,172.31.36.0-255,66,44606,1,255103
15801,0.00032,74.125.24.0-255,3961,48567,1,255103
15802,0.000324,172.31.36.0-255,66,48633,1,255103
15803,0.000417,74.125.24.0-255,1484,50117,1,255103
15804,0.000422,172.31.36.0-255,66,50183,1,255103
15805,0.000427,74.125.24.0-255,2902,53085,1,255103
15806,0.000435,172.31.36.0-255,66,53151,1,255103
15807,0.000445,74.125.24.0-255,4320,57471,1,255103
15808,0.000451,172.31.36.0-255,66,57537,1,255103
15809,0.00046,74.125.24.0-255,1484,59021,1,255103
15810,0.000465,74.125.24.0-255,2902,61923,1,255103
15811,0.000469,172.31.36.0-255,66,61989,1,255103
15812,0.000483,74.125.24.0-255,2902,64891,1,255103
15813,0.000494,172.31.36.0-255,66,64957,1,255103
15814,0.00052,74.125.24.0-255,1705,66662,1,255103
15815,0.000523,172.31.36.0-255,66,66728,1,255103
15816,0.000816,74.125.24.0-255,1484,68212,1,255103
15817,0.000834,74.125.24.0-255,2902,71114,1,255103
15818,0.000837,172.31.36.0-255,66,71180,1,255103
15819,0.000843,74.125.24.0-255,5738,76918,1,255103
15820,0.000847,74.125.24.0-255,2902,79820,1,255103
15821,0.000852,172.31.36.0-255,66,79886,1,255103
15822,0.000889,74.125.24.0-255,2902,82788,1,255103
15823,0.000892,172.31.36.0-255,66,82854,1,255103
15824,0.000918,74.125.24.0-255,6438,89292,1,255103
15825,0.000939,172.31.36.0-255,66,89358,1,255103
15826,0.001823,74.125.24.0-255,1484,90842,1,255103
15827,0.001831,74.125.24.0-255,2902,93744,1,255103
15828,0.001835,172.31.36.0-255,66,93810,1,255103
15829,0.001855,74.125.24.0-255,5738,99548,1,255103
15830,0.001859,74.125.24.0-255,2902,102450,1,255103
15831,0.00188,74.125.24.0-255,1484,103934,1,255103
15832,0.001914,74.125.24.0-255,2902,106836,1,255103
15833,0.002051,74.125.24.0-255,1484,108320,1,255103
15834,0.002063,74.125.24.0-255,1484,109804,1,255103
15835,0.002073,74.125.24.0-255,1484,111288,1,255103
15836,0.002087,74.125.24.0-255,4320,115608,1,255103
15837,0.002098,74.125.24.0-255,1484,117092,1,255103
15838,0.002113,74.125.24.0-255,4320,121412,1,255103
15839,0.002148,74.125.24.0-255,2902,124314,1,255103
15840,0.002164,74.125.24.0-255,4320,128634,1,255103
15841,0.002182,74.125.24.0-255,3602,132236,1,255103
15842,0.002267,74.125.24.0-255,1484,133720,1,255103
15843,0.002281,74.125.24.0-255,2902,136622,1,255103
15844,0.006637,172.31.36.0-255,66,136688,1,255103
15845,0.008956,74.125.24.0-255,5738,142426,1,255103
15846,0.008971,172.31.36.0-255,66,142492,1,255103
15847,0.01124,74.125.24.0-255,5738,148230,1,255103
15848,0.011256,172.31.36.0-255,66,148296,1,255103
15849,0.013516,74.125.24.0-255,5738,154034,1,255103
15850,0.013526,172.31.36.0-255,66,154100,1,255103
15851,0.015854,74.125.24.0-255,5738,159838,1,255103
15852,0.015861,172.31.36.0-255,66,159904,1,255103
15853,0.018107,74.125.24.0-255,2902,162806,1,255103
15854,0.018114,172.31.36.0-255,66,162872,1,255103
15855,0.018132,74.125.24.0-255,2902,165774,1,255103
15856,0.018305,172.31.36.0-255,66,165840,1,255103
15857,0.02041,74.125.24.0-255,2902,168742,1,255103
15858,0.020418,172.31.36.0-255,66,168808,1,255103
15859,0.020539,74.125.24.0-255,2902,171710,1,255103
15860,0.020543,172.31.36.0-255,66,171776,1,255103
15861,0.022658,74.125.24.0-255,2902,174678,1,255103
15862,0.022666,172.31.36.0-255,66,174744,1,255103
15863,0.022776,74.125.24.0-255,2902,177646,1,255103
15864,0.022782,172.31.36.0-255,66,177712,1,255103
15865,0.024925,74.125.24.0-255,2902,180614,1,255103
15866,0.024934,172.31.36.0-255,66,180680,1,255103
15867,0.02504,74.125.24.0-255,2902,183582,1,255103
15868,0.02505,172.31.36.0-255,66,183648,1,255103
15869,0.02722,74.125.24.0-255,2902,186550,1,255103
15870,0.027227,172.31.36.0-255,66,186616,1,255103
15871,0.027297,74.125.24.0-255,1484,188100,1,255103
15872,0.027315,74.125.24.0-255,1484,189584,1,255103
15873,0.027328,172.31.36.0-255,66,189650,1,255103
15874,0.029469,74.125.24.0-255,2902,192552,1,255103
15875,0.029476,172.31.36.0-255,66,192618,1,255103
15876,0.029581,74.125.24.0-255,2902,195520,1,255103
15877,0.029586,172.31.36.0-255,66,195586,1,255103
15878,0.031739,74.125.24.0-255,2902,198488,1,255103
15879,0.031746,172.31.36.0-255,66,198554,1,255103
15880,0.03181,74.125.24.0-255,2902,201456,1,255103
15881,0.031834,172.31.36.0-255,66,201522,1,255103
15882,0.034031,74.125.24.0-255,2902,204424,1,255103
15883,0.034038,172.31.36.0-255,66,204490,1,255103
15884,0.034095,74.125.24.0-255,2902,207392,1,255103
15885,0.034156,172.31.36.0-255,66,207458,1,255103
15886,0.036285,74.125.24.0-255,2902,210360,1,255103
15887,0.036292,172.31.36.0-255,66,210426,1,255103
15888,0.036407,74.125.24.0-255,2902,213328,1,255103
15889,0.036413,172.31.36.0-255,66,213394,1,255103
15890,0.038522,74.125.24.0-255,2902,216296,1,255103
15891,0.038532,172.31.36.0-255,66,216362,1,255103
15892,0.038643,74.125.24.0-255,2902,219264,1,255103
15893,0.038649,172.31.36.0-255,66,219330,1,255103
15894,0.040797,74.125.24.0-255,2902,222232,1,255103
15895,0.040803,172.31.36.0-255,66,222298,1,255103
15896,0.040882,74.125.24.0-255,2902,225200,1,255103
15897,0.04089,172.31.36.0-255,66,225266,1,255103
15898,0.043127,74.125.24.0-255,2902,228168,1,255103
15899,0.043133,172.31.36.0-255,66,228234,1,255103
15900,0.043156,74.125.24.0-255,2902,231136,1,255103
15901,0.043368,172.31.36.0-255,203,231339,1,255103
15902,0.043396,172.31.36.0-255,1116,232455,1,255103
15903,0.04345,172.31.36.0-255,1514,233969,1,255103
15904,0.043451,172.31.36.0-255,1514,235483,1,255103
15905,0.043453,172.31.36.0-255,1514,236997,1,255103
15906,0.043458,172.31.36.0-255,1514,238511,1,255103
15907,0.043459,172.31.36.0-255,1488,239999,1,255103
15908,0.04348,172.31.36.0-255,66,240065,1,255103
15909,0.044905,104.244.42.0-255,66,240131,1,255103
15910,0.044955,104.244.42.0-255,66,240197,1,255103
15911,0.045097,104.244.42.0-255,66,240263,1,255103
15912,0.04538,74.125.24.0-255,2902,243165,1,255103
15913,0.045386,172.31.36.0-255,66,243231,1,255103
15914,0.045718,74.125.24.0-255,2902,246133,1,255103
15915,0.045723,172.31.36.0-255,66,246199,1,255103
15916,0.047628,74.125.24.0-255,2902,249101,1,255103
15917,0.047632,172.31.36.0-255,66,249167,1,255103
15918,0.04794,74.125.24.0-255,2902,252069,1,255103
15919,0.047944,172.31.36.0-255,66,252135,1,255103
15920,0.049874,74.125.24.0-255,2902,255037,1,255103
15921,0.049881,172.31.36.0-255,66,255103,1,255103
15922,0.0,74.125.24.0-255,153,153,1,299409
15923,2.6e-05,172.31.36.0-255,66,219,1,299409
15924,3.3e-05,74.125.24.0-255,1484,1703,1,299409
15925,3.8e-05,172.31.36.0-255,66,1769,1,299409
15926,4.2e-05,74.125.24.0-255,2902,4671,1,299409
15927,4.4e-05,172.31.36.0-255,66,4737,1,299409
15928,5.2e-05,74.125.24.0-255,7156,11893,1,299409
15929,5.4e-05,172.31.36.0-255,66,11959,1,299409
15930,5.8e-05,74.125.24.0-255,2000,13959,1,299409
15931,6e-05,172.31.36.0-255,66,14025,1,299409
15932,0.000141,74.125.24.0-255,1484,15509,1,299409
15933,0.000146,172.31.36.0-255,66,15575,1,299409
15934,0.000151,74.125.24.0-255,2902,18477,1,299409
15935,0.000154,172.31.36.0-255,66,18543,1,299409
15936,0.000193,74.125.24.0-255,5738,24281,1,299409
15937,0.000197,172.31.36.0-255,66,24347,1,299409
15938,0.000202,74.125.24.0-255,2902,27249,1,299409
15939,0.000204,172.31.36.0-255,66,27315,1,299409
15940,0.000221,74.125.24.0-255,3961,31276,1,299409
15941,0.000225,172.31.36.0-255,66,31342,1,299409
15942,0.0003,74.125.24.0-255,1484,32826,1,299409
15943,0.000304,172.31.36.0-255,66,32892,1,299409
15944,0.000333,74.125.24.0-255,2902,35794,1,299409
15945,0.000336,172.31.36.0-255,66,35860,1,299409
15946,0.000342,74.125.24.0-255,5738,41598,1,299409
15947,0.000344,172.31.36.0-255,66,41664,1,299409
15948,0.000348,74.125.24.0-255,1484,43148,1,299409
15949,0.00035,172.31.36.0-255,66,43214,1,299409
15950,0.000376,172.31.36.0-255,66,43280,1,299409
15951,0.000389,172.31.36.0-255,66,43346,1,299409
15952,0.000418,74.125.24.0-255,1429,44775,1,299409
15953,0.000436,74.125.24.0-255,377,45152,1,299409
15954,0.000439,172.31.36.0-255,66,45218,1,299409
15955,0.000735,74.125.24.0-255,1484,46702,1,299409
15956,0.000741,74.125.24.0-255,2902,49604,1,299409
15957,0.000744,172.31.36.0-255,66,49670,1,299409
15958,0.00075,74.125.24.0-255,4320,53990,1,299409
15959,0.000752,172.31.36.0-255,66,54056,1,299409
15960,0.000764,74.125.24.0-255,1484,55540,1,299409
15961,0.000784,74.125.24.0-255,4320,59860,1,299409
15962,0.000786,172.31.36.0-255,66,59926,1,299409
15963,0.000815,172.31.36.0-255,66,59992,1,299409
15964,0.000823,74.125.24.0-255,7156,67148,1,299409
15965,0.000825,172.31.36.0-255,66,67214,1,299409
15966,0.000839,74.125.24.0-255,3602,70816,1,299409
15967,0.000842,172.31.36.0-255,66,70882,1,299409
15968,0.000945,74.125.24.0-255,1484,72366,1,299409
15969,0.000951,74.125.24.0-255,2902,75268,1,299409
15970,0.000954,172.31.36.0-255,66,75334,1,299409
15971,0.00098,74.125.24.0-255,5738,81072,1,299409
15972,0.000983,172.31.36.0-255,66,81138,1,299409
15973,0.000988,74.125.24.0-255,2902,84040,1,299409
15974,0.000992,172.31.36.0-255,66,84106,1,299409
15975,0.00102,172.31.36.0-255,66,84172,1,299409
15976,0.001032,172.31.36.0-255,66,84238,1,299409
15977,0.001059,74.125.24.0-255,1484,85722,1,299409
15978,0.001065,74.125.24.0-255,2902,88624,1,299409
15979,0.001068,172.31.36.0-255,66,88690,1,299409
15980,0.001091,74.125.24.0-255,5738,94428,1,299409
15981,0.001095,172.31.36.0-255,66,94494,1,299409
15982,0.001099,74.125.24.0-255,2902,97396,1,299409
15983,0.001102,172.31.36.0-255,66,97462,1,299409
15984,0.001134,172.31.36.0-255,66,97528,1,299409
15985,0.001141,74.125.24.0-255,7156,104684,1,299409
15986,0.001143,172.31.36.0-255,66,104750,1,299409
15987,0.001165,74.125.24.0-255,3602,108352,1,299409
15988,0.001168,172.31.36.0-255,66,108418,1,299409
15989,0.001227,74.125.24.0-255,1484,109902,1,299409
15990,0.001231,74.125.24.0-255,1484,111386,1,299409
15991,0.001234,172.31.36.0-255,66,111452,1,299409
15992,0.001249,74.125.24.0-255,1484,112936,1,299409
15993,0.001255,74.125.24.0-255,5738,118674,1,299409
15994,0.00126,172.31.36.0-255,66,118740,1,299409
15995,0.001295,172.31.36.0-255,66,118806,1,299409
15996,0.00132,74.125.24.0-255,5738,124544,1,299409
15997,0.001323,172.31.36.0-255,66,124610,1,299409
15998,0.001355,172.31.36.0-255,66,124676,1,299409
15999,0.001358,74.125.24.0-255,1484,126160,1,299409
16000,0.0014,74.125.24.0-255,1484,127644,1,299409
16001,0.001403,172.31.36.0-255,66,127710,1,299409
16002,0.00143,74.125.24.0-255,1484,129194,1,299409
16003,0.001437,74.125.24.0-255,5738,134932,1,299409
16004,0.00144,172.31.36.0-255,66,134998,1,299409
16005,0.001453,172.31.36.0-255,66,135064,1,299409
16006,0.001464,172.31.36.0-255,66,135130,1,299409
16007,0.001485,74.125.24.0-255,2184,137314,1,299409
16008,0.001489,172.31.36.0-255,66,137380,1,299409
16009,0.001947,74.125.24.0-255,1484,138864,1,299409
16010,0.001954,74.125.24.0-255,2902,141766,1,299409
16011,0.001957,172.31.36.0-255,66,141832,1,299409
16012,0.001986,74.125.24.0-255,5738,147570,1,299409
16013,0.00199,172.31.36.0-255,66,147636,1,299409
16014,0.002006,74.125.24.0-255,2902,150538,1,299409
16015,0.00201,172.31.36.0-255,66,150604,1,299409
16016,0.003976,74.125.24.0-255,5738,156342,1,299409
16017,0.003983,172.31.36.0-255,66,156408,1,299409
16018,0.005956,74.125.24.0-255,5738,162146,1,299409
16019,0.005962,172.31.36.0-255,66,162212,1,299409
16020,0.007931,74.125.24.0-255,5738,167950,1,299409
16021,0.007936,172.31.36.0-255,66,168016,1,299409
16022,0.009921,74.125.24.0-255,5738,173754,1,299409
16023,0.009927,172.31.36.0-255,66,173820,1,299409
16024,0.011926,74.125.24.0-255,5738,179558,1,299409
16025,0.011934,172.31.36.0-255,66,179624,1,299409
16026,0.013915,74.125.24.0-255,5738,185362,1,299409
16027,0.013923,172.31.36.0-255,66,185428,1,299409
16028,0.01591,74.125.24.0-255,5738,191166,1,299409
16029,0.01592,172.31.36.0-255,66,191232,1,299409
16030,0.017905,74.125.24.0-255,5738,196970,1,299409
16031,0.017912,172.31.36.0-255,66,197036,1,299409
16032,0.019895,74.125.24.0-255,5738,202774,1,299409
16033,0.019902,172.31.36.0-255,66,202840,1,299409
16034,0.02188,74.125.24.0-255,5738,208578,1,299409
16035,0.021885,172.31.36.0-255,66,208644,1,299409
16036,0.023854,74.125.24.0-255,5738,214382,1,299409
16037,0.023863,172.31.36.0-255,66,214448,1,299409
16038,0.025849,74.125.24.0-255,5738,220186,1,299409
16039,0.025856,172.31.36.0-255,66,220252,1,299409
16040,0.027827,74.125.24.0-255,5738,225990,1,299409
16041,0.027833,172.31.36.0-255,66,226056,1,299409
16042,0.029798,74.125.24.0-255,5738,231794,1,299409
16043,0.029804,172.31.36.0-255,66,231860,1,299409
16044,0.031784,74.125.24.0-255,5738,237598,1,299409
16045,0.03179,172.31.36.0-255,66,237664,1,299409
16046,0.03376,74.125.24.0-255,5738,243402,1,299409
16047,0.033764,172.31.36.0-255,66,243468,1,299409
16048,0.034366,172.31.36.0-255,188,243656,1,299409
16049,0.034401,172.31.36.0-255,958,244614,1,299409
16050,0.034473,172.31.36.0-255,1514,246128,1,299409
16051,0.034475,172.31.36.0-255,1514,247642,1,299409
16052,0.03448,172.31.36.0-255,1514,249156,1,299409
16053,0.034481,172.31.36.0-255,1514,250670,1,299409
16054,0.034505,172.31.36.0-255,1514,252184,1,299409
16055,0.034506,172.31.36.0-255,199,252383,1,299409
16056,0.035752,74.125.24.0-255,5738,258121,1,299409
16057,0.035758,172.31.36.0-255,66,258187,1,299409
16058,0.035891,104.244.42.0-255,66,258253,1,299409
16059,0.035997,104.244.42.0-255,66,258319,1,299409
16060,0.036003,104.244.42.0-255,66,258385,1,299409
16061,0.036167,104.244.42.0-255,66,258451,1,299409
16062,0.037741,74.125.24.0-255,2902,261353,1,299409
16063,0.037745,172.31.36.0-255,66,261419,1,299409
16064,0.037769,74.125.24.0-255,2902,264321,1,299409
16065,0.037772,172.31.36.0-255,66,264387,1,299409
16066,0.039711,74.125.24.0-255,2902,267289,1,299409
16067,0.039716,172.31.36.0-255,66,267355,1,299409
16068,0.039746,74.125.24.0-255,2902,270257,1,299409
16069,0.039748,172.31.36.0-255,66,270323,1,299409
16070,0.041701,74.125.24.0-255,5738,276061,1,299409
16071,0.041706,172.31.36.0-255,66,276127,1,299409
16072,0.043665,74.125.24.0-255,5738,281865,1,299409
16073,0.043669,172.31.36.0-255,66,281931,1,299409
16074,0.045642,74.125.24.0-255,5738,287669,1,299409
16075,0.045647,172.31.36.0-255,66,287735,1,299409
16076,0.047648,74.125.24.0-255,5738,293473,1,299409
16077,0.047654,172.31.36.0-255,66,293539,1,299409
16078,0.049634,74.125.24.0-255,4320,297859,1,299409
16079,0.049638,172.31.36.0-255,66,297925,1,299409
16080,0.049664,74.125.24.0-255,1484,299409,1,299409
16081,0.0,74.125.24.0-255,297,297,1,259639
16082,2.8e-05,172.31.36.0-255,66,363,1,259639
16083,3.4e-05,74.125.24.0-255,1484,1847,1,259639
16084,3.9e-05,172.31.36.0-255,66,1913,1,259639
16085,4.4e-05,74.125.24.0-255,4320,6233,1,259639
16086,5.6e-05,172.31.36.0-255,66,6299,1,259639
16087,6.7e-05,172.31.36.0-255,66,6365,1,259639
16088,0.000491,74.125.24.0-255,1484,7849,1,259639
16089,0.000497,172.31.36.0-255,66,7915,1,259639
16090,0.000507,74.125.24.0-255,2902,10817,1,259639
16091,0.000509,172.31.36.0-255,66,10883,1,259639
16092,0.000524,74.125.24.0-255,5738,16621,1,259639
16093,0.000527,172.31.36.0-255,66,16687,1,259639
16094,0.000575,172.31.36.0-255,66,16753,1,259639
16095,0.000586,172.31.36.0-255,66,16819,1,259639
16096,0.000628,74.125.24.0-255,7156,23975,1,259639
16097,0.000632,172.31.36.0-255,66,24041,1,259639
16098,0.000664,172.31.36.0-255,66,24107,1,259639
16099,0.000667,74.125.24.0-255,396,24503,1,259639
16100,0.000668,172.31.36.0-255,66,24569,1,259639
16101,0.000672,74.125.24.0-255,113,24682,1,259639
16102,0.000674,172.31.36.0-255,66,24748,1,259639
16103,0.000969,74.125.24.0-255,1484,26232,1,259639
16104,0.000975,172.31.36.0-255,66,26298,1,259639
16105,0.000983,74.125.24.0-255,2902,29200,1,259639
16106,0.000986,172.31.36.0-255,66,29266,1,259639
16107,0.001,74.125.24.0-255,5738,35004,1,259639
16108,0.001003,172.31.36.0-255,66,35070,1,259639
16109,0.001027,74.125.24.0-255,1484,36554,1,259639
16110,0.001057,172.31.36.0-255,66,36620,1,259639
16111,0.001061,74.125.24.0-255,1484,38104,1,259639
16112,0.001066,74.125.24.0-255,4320,42424,1,259639
16113,0.001069,172.31.36.0-255,66,42490,1,259639
16114,0.001097,74.125.24.0-255,5020,47510,1,259639
16115,0.001101,172.31.36.0-255,66,47576,1,259639
16116,0.001107,74.125.24.0-255,4320,51896,1,259639
16117,0.001109,172.31.36.0-255,66,51962,1,259639
16118,0.001152,74.125.24.0-255,6004,57966,1,259639
16119,0.001156,172.31.36.0-255,66,58032,1,259639
16120,0.001164,74.125.24.0-255,7156,65188,1,259639
16121,0.001166,172.31.36.0-255,66,65254,1,259639
16122,0.001215,172.31.36.0-255,66,65320,1,259639
16123,0.001245,74.125.24.0-255,2184,67504,1,259639
16124,0.001248,172.31.36.0-255,66,67570,1,259639
16125,0.001542,74.125.24.0-255,1484,69054,1,259639
16126,0.001545,74.125.24.0-255,1484,70538,1,259639
16127,0.001547,172.31.36.0-255,66,70604,1,259639
16128,0.001568,74.125.24.0-255,1484,72088,1,259639
16129,0.001574,74.125.24.0-255,5738,77826,1,259639
16130,0.001576,172.31.36.0-255,66,77892,1,259639
16131,0.001581,74.125.24.0-255,4320,82212,1,259639
16132,0.001584,172.31.36.0-255,66,82278,1,259639
16133,0.001602,74.125.24.0-255,1484,83762,1,259639
16134,0.001613,172.31.36.0-255,66,83828,1,259639
16135,0.001646,74.125.24.0-255,4320,88148,1,259639
16136,0.001649,172.31.36.0-255,66,88214,1,259639
16137,0.001655,74.125.24.0-255,5020,93234,1,259639
16138,0.001658,172.31.36.0-255,66,93300,1,259639
16139,0.001732,74.125.24.0-255,1484,94784,1,259639
16140,0.001735,74.125.24.0-255,1484,96268,1,259639
16141,0.001737,172.31.36.0-255,66,96334,1,259639
16142,0.001755,74.125.24.0-255,1484,97818,1,259639
16143,0.001761,74.125.24.0-255,5738,103556,1,259639
16144,0.001764,172.31.36.0-255,66,103622,1,259639
16145,0.001808,172.31.36.0-255,66,103688,1,259639
16146,0.001834,74.125.24.0-255,1484,105172,1,259639
16147,0.001857,172.31.36.0-255,66,105238,1,259639
16148,0.001977,74.125.24.0-255,1484,106722,1,259639
16149,0.001982,74.125.24.0-255,2902,109624,1,259639
16150,0.001985,172.31.36.0-255,66,109690,1,259639
16151,0.001989,74.125.24.0-255,1484,111174,1,259639
16152,0.002015,74.125.24.0-255,4320,115494,1,259639
16153,0.002019,172.31.36.0-255,66,115560,1,259639
16154,0.002032,172.31.36.0-255,66,115626,1,259639
16155,0.002054,74.125.24.0-255,2902,118528,1,259639
16156,0.002057,172.31.36.0-255,66,118594,1,259639
16157,0.002069,172.31.36.0-255,66,118660,1,259639
16158,0.002072,74.125.24.0-255,766,119426,1,259639
16159,0.002158,74.125.24.0-255,1484,120910,1,259639
16160,0.002162,172.31.36.0-255,66,120976,1,259639
16161,0.002168,74.125.24.0-255,2902,123878,1,259639
16162,0.002171,172.31.36.0-255,66,123944,1,259639
16163,0.002176,74.125.24.0-255,4320,128264,1,259639
16164,0.002185,172.31.36.0-255,66,128330,1,259639
16165,0.002219,74.125.24.0-255,1484,129814,1,259639
16166,0.00223,74.125.24.0-255,7156,136970,1,259639
16167,0.002234,172.31.36.0-255,66,137036,1,259639
16168,0.002244,172.31.36.0-255,66,137102,1,259639
16169,0.002255,172.31.36.0-255,66,137168,1,259639
16170,0.004602,74.125.24.0-255,5738,142906,1,259639
16171,0.004609,172.31.36.0-255,66,142972,1,259639
16172,0.006932,74.125.24.0-255,5738,148710,1,259639
16173,0.006939,172.31.36.0-255,66,148776,1,259639
16174,0.009311,74.125.24.0-255,5738,154514,1,259639
16175,0.009318,172.31.36.0-255,66,154580,1,259639
16176,0.011684,74.125.24.0-255,5738,160318,1,259639
16177,0.011692,172.31.36.0-255,66,160384,1,259639
16178,0.013989,74.125.24.0-255,5738,166122,1,259639
16179,0.013996,172.31.36.0-255,66,166188,1,259639
16180,0.016304,74.125.24.0-255,5738,171926,1,259639
16181,0.016312,172.31.36.0-255,66,171992,1,259639
16182,0.018613,74.125.24.0-255,4320,176312,1,259639
16183,0.018621,172.31.36.0-255,66,176378,1,259639
16184,0.018651,74.125.24.0-255,1484,177862,1,259639
16185,0.020908,74.125.24.0-255,4320,182182,1,259639
16186,0.020914,172.31.36.0-255,66,182248,1,259639
16187,0.023267,74.125.24.0-255,5738,187986,1,259639
16188,0.023282,172.31.36.0-255,66,188052,1,259639
16189,0.025593,74.125.24.0-255,5738,193790,1,259639
16190,0.025605,172.31.36.0-255,66,193856,1,259639
16191,0.027904,74.125.24.0-255,5738,199594,1,259639
16192,0.027913,172.31.36.0-255,66,199660,1,259639
16193,0.030208,74.125.24.0-255,5738,205398,1,259639
16194,0.030217,172.31.36.0-255,66,205464,1,259639
16195,0.032539,74.125.24.0-255,5738,211202,1,259639
16196,0.032547,172.31.36.0-255,66,211268,1,259639
16197,0.034836,74.125.24.0-255,4320,215588,1,259639
16198,0.034843,172.31.36.0-255,66,215654,1,259639
16199,0.034872,74.125.24.0-255,1484,217138,1,259639
16200,0.035133,172.31.36.0-255,172,217310,1,259639
16201,0.03519,172.31.36.0-255,1114,218424,1,259639
16202,0.035417,172.31.36.0-255,1514,219938,1,259639
16203,0.035419,172.31.36.0-255,1514,221452,1,259639
16204,0.035426,172.31.36.0-255,1514,222966,1,259639
16205,0.035427,172.31.36.0-255,1514,224480,1,259639
16206,0.035448,172.31.36.0-255,1489,225969,1,259639
16207,0.036661,104.244.42.0-255,66,226035,1,259639
16208,0.036755,104.244.42.0-255,66,226101,1,259639
16209,0.037005,104.244.42.0-255,66,226167,1,259639
16210,0.037058,104.244.42.0-255,66,226233,1,259639
16211,0.037119,74.125.24.0-255,4320,230553,1,259639
16212,0.037124,172.31.36.0-255,66,230619,1,259639
16213,0.039423,74.125.24.0-255,5738,236357,1,259639
16214,0.039429,172.31.36.0-255,66,236423,1,259639
16215,0.041724,74.125.24.0-255,5738,242161,1,259639
16216,0.04173,172.31.36.0-255,66,242227,1,259639
16217,0.044034,74.125.24.0-255,5738,247965,1,259639
16218,0.044039,172.31.36.0-255,66,248031,1,259639
16219,0.046372,74.125.24.0-255,5738,253769,1,259639
16220,0.046378,172.31.36.0-255,66,253835,1,259639
16221,0.048684,74.125.24.0-255,5738,259573,1,259639
16222,0.048689,172.31.36.0-255,66,259639,1,259639
16223,0.0,172.217.194.0-255,153,153,1,231413
16224,2.1e-05,172.31.36.0-255,66,219,1,231413
16225,2.8e-05,172.217.194.0-255,1484,1703,1,231413
16226,3.1e-05,172.31.36.0-255,66,1769,1,231413
16227,3.6e-05,172.217.194.0-255,2902,4671,1,231413
16228,3.9e-05,172.31.36.0-255,66,4737,1,231413
16229,6.3e-05,172.217.194.0-255,7156,11893,1,231413
16230,6.6e-05,172.31.36.0-255,66,11959,1,231413
16231,7.1e-05,172.217.194.0-255,3438,15397,1,231413
16232,7.3e-05,172.31.36.0-255,66,15463,1,231413
16233,0.000101,172.217.194.0-255,4320,19783,1,231413
16234,0.000103,172.31.36.0-255,66,19849,1,231413
16235,0.000108,172.217.194.0-255,4320,24169,1,231413
16236,0.00011,172.31.36.0-255,66,24235,1,231413
16237,0.000127,172.217.194.0-255,5738,29973,1,231413
16238,0.000129,172.31.36.0-255,66,30039,1,231413
16239,0.000131,172.217.194.0-255,1125,31164,1,231413
16240,0.000134,172.31.36.0-255,66,31230,1,231413
16241,0.001003,172.217.194.0-255,1484,32714,1,231413
16242,0.00101,172.31.36.0-255,66,32780,1,231413
16243,0.001019,172.217.194.0-255,2902,35682,1,231413
16244,0.001021,172.31.36.0-255,66,35748,1,231413
16245,0.001025,172.217.194.0-255,1484,37232,1,231413
16246,0.001027,172.31.36.0-255,66,37298,1,231413
16247,0.001056,172.217.194.0-255,4320,41618,1,231413
16248,0.001058,172.31.36.0-255,66,41684,1,231413
16249,0.001066,172.217.194.0-255,7156,48840,1,231413
16250,0.001068,172.31.36.0-255,66,48906,1,231413
16251,0.001118,172.217.194.0-255,2902,51808,1,231413
16252,0.001121,172.31.36.0-255,66,51874,1,231413
16253,0.001163,172.217.194.0-255,7156,59030,1,231413
16254,0.001165,172.31.36.0-255,66,59096,1,231413
16255,0.001183,172.217.194.0-255,4320,63416,1,231413
16256,0.001185,172.31.36.0-255,66,63482,1,231413
16257,0.00119,172.217.194.0-255,2184,65666,1,231413
16258,0.001192,172.31.36.0-255,66,65732,1,231413
16259,0.001551,172.217.194.0-255,648,66380,1,231413
16260,0.001586,172.217.194.0-255,1484,67864,1,231413
16261,0.001591,172.31.36.0-255,66,67930,1,231413
16262,0.001607,172.217.194.0-255,4320,72250,1,231413
16263,0.00161,172.31.36.0-255,66,72316,1,231413
16264,0.001627,172.217.194.0-255,7156,79472,1,231413
16265,0.00163,172.31.36.0-255,66,79538,1,231413
16266,0.00167,172.217.194.0-255,2902,82440,1,231413
16267,0.001673,172.31.36.0-255,66,82506,1,231413
16268,0.001704,172.31.36.0-255,66,82572,1,231413
16269,0.001727,172.217.194.0-255,5020,87592,1,231413
16270,0.00173,172.31.36.0-255,66,87658,1,231413
16271,0.003742,172.217.194.0-255,5738,93396,1,231413
16272,0.003751,172.31.36.0-255,66,93462,1,231413
16273,0.00576,172.217.194.0-255,5738,99200,1,231413
16274,0.005766,172.31.36.0-255,66,99266,1,231413
16275,0.007792,172.217.194.0-255,5738,105004,1,231413
16276,0.007801,172.31.36.0-255,66,105070,1,231413
16277,0.009835,172.217.194.0-255,5738,110808,1,231413
16278,0.009844,172.31.36.0-255,66,110874,1,231413
16279,0.01189,172.217.194.0-255,5738,116612,1,231413
16280,0.011904,172.31.36.0-255,66,116678,1,231413
16281,0.013947,172.217.194.0-255,5738,122416,1,231413
16282,0.013955,172.31.36.0-255,66,122482,1,231413
16283,0.016024,172.217.194.0-255,5738,128220,1,231413
16284,0.016032,172.31.36.0-255,66,128286,1,231413
16285,0.018048,172.217.194.0-255,5738,134024,1,231413
16286,0.018058,172.31.36.0-255,66,134090,1,231413
16287,0.020092,172.217.194.0-255,5738,139828,1,231413
16288,0.020099,172.31.36.0-255,66,139894,1,231413
16289,0.022149,172.217.194.0-255,5738,145632,1,231413
16290,0.022157,172.31.36.0-255,66,145698,1,231413
16291,0.024216,172.217.194.0-255,5738,151436,1,231413
16292,0.024224,172.31.36.0-255,66,151502,1,231413
16293,0.026184,172.31.36.0-255,176,151678,1,231413
16294,0.026237,172.217.194.0-255,5738,157416,1,231413
16295,0.026242,172.31.36.0-255,66,157482,1,231413
16296,0.026271,172.31.36.0-255,1113,158595,1,231413
16297,0.026429,172.31.36.0-255,1514,160109,1,231413
16298,0.026432,172.31.36.0-255,1514,161623,1,231413
16299,0.026433,172.31.36.0-255,1514,163137,1,231413
16300,0.026434,172.31.36.0-255,1514,164651,1,231413
16301,0.026466,172.31.36.0-255,1490,166141,1,231413
16302,0.027717,104.244.42.0-255,66,166207,1,231413
16303,0.027802,104.244.42.0-255,66,166273,1,231413
16304,0.027996,104.244.42.0-255,66,166339,1,231413
16305,0.02826,172.217.194.0-255,2902,169241,1,231413
16306,0.028264,172.31.36.0-255,66,169307,1,231413
16307,0.028298,172.217.194.0-255,2902,172209,1,231413
16308,0.028302,172.31.36.0-255,66,172275,1,231413
16309,0.02845,104.244.42.0-255,108,172383,1,231413
16310,0.028459,172.31.36.0-255,66,172449,1,231413
16311,0.030289,172.217.194.0-255,2902,175351,1,231413
16312,0.030294,172.31.36.0-255,66,175417,1,231413
16313,0.030327,172.217.194.0-255,2902,178319,1,231413
16314,0.03033,172.31.36.0-255,66,178385,1,231413
16315,0.03233,172.217.194.0-255,2902,181287,1,231413
16316,0.032336,172.31.36.0-255,66,181353,1,231413
16317,0.032356,172.217.194.0-255,2902,184255,1,231413
16318,0.032359,172.31.36.0-255,66,184321,1,231413
16319,0.034364,172.217.194.0-255,2902,187223,1,231413
16320,0.034371,172.31.36.0-255,66,187289,1,231413
16321,0.034391,172.217.194.0-255,2902,190191,1,231413
16322,0.034393,172.31.36.0-255,66,190257,1,231413
16323,0.036374,172.217.194.0-255,2902,193159,1,231413
16324,0.03638,172.31.36.0-255,66,193225,1,231413
16325,0.036416,172.217.194.0-255,2902,196127,1,231413
16326,0.036421,172.31.36.0-255,66,196193,1,231413
16327,0.038395,172.217.194.0-255,2902,199095,1,231413
16328,0.038399,172.31.36.0-255,66,199161,1,231413
16329,0.038427,172.217.194.0-255,2902,202063,1,231413
16330,0.038429,172.31.36.0-255,66,202129,1,231413
16331,0.040446,172.217.194.0-255,2902,205031,1,231413
16332,0.040465,172.31.36.0-255,66,205097,1,231413
16333,0.040486,172.217.194.0-255,2902,207999,1,231413
16334,0.040489,172.31.36.0-255,66,208065,1,231413
16335,0.042489,172.217.194.0-255,2902,210967,1,231413
16336,0.042496,172.31.36.0-255,66,211033,1,231413
16337,0.042522,172.217.194.0-255,2902,213935,1,231413
16338,0.042525,172.31.36.0-255,66,214001,1,231413
16339,0.044542,172.217.194.0-255,5738,219739,1,231413
16340,0.044551,172.31.36.0-255,66,219805,1,231413
16341,0.046658,172.217.194.0-255,5738,225543,1,231413
16342,0.046667,172.31.36.0-255,66,225609,1,231413
16343,0.048674,172.217.194.0-255,5738,231347,1,231413
16344,0.048682,172.31.36.0-255,66,231413,1,231413
16345,0.0,74.125.200.0-255,153,153,1,260920
16346,3.6e-05,172.31.36.0-255,66,219,1,260920
16347,4.3e-05,74.125.200.0-255,1484,1703,1,260920
16348,4.7e-05,172.31.36.0-255,66,1769,1,260920
16349,5.2e-05,74.125.200.0-255,2902,4671,1,260920
16350,5.5e-05,172.31.36.0-255,66,4737,1,260920
16351,7.9e-05,74.125.200.0-255,1484,6221,1,260920
16352,8.2e-05,172.31.36.0-255,66,6287,1,260920
16353,8.7e-05,74.125.200.0-255,2902,9189,1,260920
16354,9e-05,172.31.36.0-255,66,9255,1,260920
16355,0.000107,74.125.200.0-255,2902,12157,1,260920
16356,0.000111,172.31.36.0-255,66,12223,1,260920
16357,0.000132,74.125.200.0-255,1989,14212,1,260920
16358,0.000135,172.31.36.0-255,66,14278,1,260920
16359,0.00022,74.125.200.0-255,1484,15762,1,260920
16360,0.000224,172.31.36.0-255,66,15828,1,260920
16361,0.000229,74.125.200.0-255,2902,18730,1,260920
16362,0.000232,172.31.36.0-255,66,18796,1,260920
16363,0.000264,74.125.200.0-255,5738,24534,1,260920
16364,0.000267,172.31.36.0-255,66,24600,1,260920
16365,0.000274,74.125.200.0-255,6797,31397,1,260920
16366,0.000276,172.31.36.0-255,66,31463,1,260920
16367,0.000305,74.125.200.0-255,2902,34365,1,260920
16368,0.000308,172.31.36.0-255,66,34431,1,260920
16369,0.000337,74.125.200.0-255,4320,38751,1,260920
16370,0.000341,172.31.36.0-255,66,38817,1,260920
16371,0.000386,172.31.36.0-255,66,38883,1,260920
16372,0.000405,74.125.200.0-255,1125,40008,1,260920
16373,0.000408,172.31.36.0-255,66,40074,1,260920
16374,0.000432,74.125.200.0-255,1484,41558,1,260920
16375,0.000435,172.31.36.0-255,66,41624,1,260920
16376,0.000456,74.125.200.0-255,4320,45944,1,260920
16377,0.000459,172.31.36.0-255,66,46010,1,260920
16378,0.000464,74.125.200.0-255,2902,48912,1,260920
16379,0.000466,172.31.36.0-255,66,48978,1,260920
16380,0.00048,74.125.200.0-255,2902,51880,1,260920
16381,0.000484,172.31.36.0-255,66,51946,1,260920
16382,0.000506,74.125.200.0-255,2902,54848,1,260920
16383,0.000509,172.31.36.0-255,66,54914,1,260920
16384,0.000523,74.125.200.0-255,3132,58046,1,260920
16385,0.000528,172.31.36.0-255,66,58112,1,260920
16386,0.0006,74.125.200.0-255,1484,59596,1,260920
16387,0.000605,74.125.200.0-255,1484,61080,1,260920
16388,0.000608,172.31.36.0-255,66,61146,1,260920
16389,0.00063,74.125.200.0-255,1484,62630,1,260920
16390,0.000637,74.125.200.0-255,5738,68368,1,260920
16391,0.000641,172.31.36.0-255,66,68434,1,260920
16392,0.000678,74.125.200.0-255,2902,71336,1,260920
16393,0.000683,172.31.36.0-255,66,71402,1,260920
16394,0.000703,74.125.200.0-255,3412,74814,1,260920
16395,0.000705,172.31.36.0-255,66,74880,1,260920
16396,0.000988,74.125.200.0-255,1484,76364,1,260920
16397,0.001003,74.125.200.0-255,2902,79266,1,260920
16398,0.001007,172.31.36.0-255,66,79332,1,260920
16399,0.001019,74.125.200.0-255,2902,82234,1,260920
16400,0.001021,172.31.36.0-255,66,82300,1,260920
16401,0.001037,74.125.200.0-255,2902,85202,1,260920
16402,0.00104,172.31.36.0-255,66,85268,1,260920
16403,0.001048,74.125.200.0-255,7156,92424,1,260920
16404,0.00105,172.31.36.0-255,66,92490,1,260920
16405,0.001066,74.125.200.0-255,1484,93974,1,260920
16406,0.001091,172.31.36.0-255,66,94040,1,260920
16407,0.001124,74.125.200.0-255,2184,96224,1,260920
16408,0.001128,172.31.36.0-255,66,96290,1,260920
16409,0.001854,74.125.200.0-255,1484,97774,1,260920
16410,0.001865,74.125.200.0-255,2902,100676,1,260920
16411,0.001869,172.31.36.0-255,66,100742,1,260920
16412,0.001878,74.125.200.0-255,5738,106480,1,260920
16413,0.001882,172.31.36.0-255,66,106546,1,260920
16414,0.001913,74.125.200.0-255,6797,113343,1,260920
16415,0.001915,172.31.36.0-255,66,113409,1,260920
16416,0.003884,74.125.200.0-255,4320,117729,1,260920
16417,0.003887,172.31.36.0-255,66,117795,1,260920
16418,0.003899,74.125.200.0-255,1484,119279,1,260920
16419,0.005864,74.125.200.0-255,4320,123599,1,260920
16420,0.005866,172.31.36.0-255,66,123665,1,260920
16421,0.007868,74.125.200.0-255,5738,129403,1,260920
16422,0.007875,172.31.36.0-255,66,129469,1,260920
16423,0.009922,74.125.200.0-255,5738,135207,1,260920
16424,0.00993,172.31.36.0-255,66,135273,1,260920
16425,0.011921,74.125.200.0-255,5738,141011,1,260920
16426,0.011929,172.31.36.0-255,66,141077,1,260920
16427,0.013915,74.125.200.0-255,5738,146815,1,260920
16428,0.013922,172.31.36.0-255,66,146881,1,260920
16429,0.015904,74.125.200.0-255,5738,152619,1,260920
16430,0.015913,172.31.36.0-255,66,152685,1,260920
16431,0.017899,74.125.200.0-255,5738,158423,1,260920
16432,0.017907,172.31.36.0-255,66,158489,1,260920
16433,0.019893,74.125.200.0-255,5738,164227,1,260920
16434,0.0199,172.31.36.0-255,66,164293,1,260920
16435,0.02188,74.125.200.0-255,5738,170031,1,260920
16436,0.021887,172.31.36.0-255,66,170097,1,260920
16437,0.023864,74.125.200.0-255,5738,175835,1,260920
16438,0.023871,172.31.36.0-255,66,175901,1,260920
16439,0.02586,74.125.200.0-255,5738,181639,1,260920
16440,0.025867,172.31.36.0-255,66,181705,1,260920
16441,0.027848,74.125.200.0-255,5738,187443,1,260920
16442,0.027856,172.31.36.0-255,66,187509,1,260920
16443,0.029843,74.125.200.0-255,5738,193247,1,260920
16444,0.029851,172.31.36.0-255,66,193313,1,260920
16445,0.031831,74.125.200.0-255,5738,199051,1,260920
16446,0.031838,172.31.36.0-255,66,199117,1,260920
16447,0.032773,172.31.36.0-255,314,199431,1,260920
16448,0.032804,172.31.36.0-255,1114,200545,1,260920
16449,0.032855,172.31.36.0-255,1514,202059,1,260920
16450,0.032857,172.31.36.0-255,1514,203573,1,260920
16451,0.032858,172.31.36.0-255,1514,205087,1,260920
16452,0.032859,172.31.36.0-255,1514,206601,1,260920
16453,0.032886,172.31.36.0-255,1489,208090,1,260920
16454,0.033875,74.125.200.0-255,5738,213828,1,260920
16455,0.033883,172.31.36.0-255,66,213894,1,260920
16456,0.034313,104.244.42.0-255,66,213960,1,260920
16457,0.034348,104.244.42.0-255,66,214026,1,260920
16458,0.034429,104.244.42.0-255,66,214092,1,260920
16459,0.034474,104.244.42.0-255,66,214158,1,260920
16460,0.035865,74.125.200.0-255,5738,219896,1,260920
16461,0.035872,172.31.36.0-255,66,219962,1,260920
16462,0.037848,74.125.200.0-255,5738,225700,1,260920
16463,0.037853,172.31.36.0-255,66,225766,1,260920
16464,0.039836,74.125.200.0-255,5738,231504,1,260920
16465,0.039841,172.31.36.0-255,66,231570,1,260920
16466,0.041816,74.125.200.0-255,5738,237308,1,260920
16467,0.041821,172.31.36.0-255,66,237374,1,260920
16468,0.043795,74.125.200.0-255,2902,240276,1,260920
16469,0.043816,172.31.36.0-255,66,240342,1,260920
16470,0.043834,74.125.200.0-255,2902,243244,1,260920
16471,0.043838,172.31.36.0-255,66,243310,1,260920
16472,0.045796,74.125.200.0-255,2902,246212,1,260920
16473,0.045802,172.31.36.0-255,66,246278,1,260920
16474,0.045836,74.125.200.0-255,2902,249180,1,260920
16475,0.045839,172.31.36.0-255,66,249246,1,260920
16476,0.047775,74.125.200.0-255,1484,250730,1,260920
16477,0.047811,74.125.200.0-255,4320,255050,1,260920
16478,0.047819,172.31.36.0-255,66,255116,1,260920
16479,0.049819,74.125.200.0-255,5738,260854,1,260920
16480,0.049826,172.31.36.0-255,66,260920,1,260920
16481,0.0,172.217.194.0-255,143,143,1,318298
16482,2.4e-05,172.31.36.0-255,66,209,1,318298
16483,3.1e-05,172.217.194.0-255,1484,1693,1,318298
16484,3.6e-05,172.31.36.0-255,66,1759,1,318298
16485,4.2e-05,172.217.194.0-255,2902,4661,1,318298
16486,4.5e-05,172.31.36.0-255,66,4727,1,318298
16487,5.3e-05,172.217.194.0-255,7156,11883,1,318298
16488,5.6e-05,172.31.36.0-255,66,11949,1,318298
16489,9.2e-05,172.31.36.0-255,66,12015,1,318298
16490,0.0001,172.217.194.0-255,6797,18812,1,318298
16491,0.000102,172.31.36.0-255,66,18878,1,318298
16492,0.000194,172.217.194.0-255,1484,20362,1,318298
16493,0.000197,172.31.36.0-255,66,20428,1,318298
16494,0.000217,172.217.194.0-255,2902,23330,1,318298
16495,0.000219,172.31.36.0-255,66,23396,1,318298
16496,0.000226,172.217.194.0-255,5738,29134,1,318298
16497,0.000229,172.31.36.0-255,66,29200,1,318298
16498,0.000256,172.217.194.0-255,5738,34938,1,318298
16499,0.000259,172.31.36.0-255,66,35004,1,318298
16500,0.000275,172.217.194.0-255,1125,36129,1,318298
16501,0.000277,172.31.36.0-255,66,36195,1,318298
16502,0.000542,172.217.194.0-255,1484,37679,1,318298
16503,0.000546,172.31.36.0-255,66,37745,1,318298
16504,0.000551,172.217.194.0-255,2902,40647,1,318298
16505,0.000554,172.31.36.0-255,66,40713,1,318298
16506,0.000572,172.217.194.0-255,5738,46451,1,318298
16507,0.000574,172.31.36.0-255,66,46517,1,318298
16508,0.000592,172.217.194.0-255,4320,50837,1,318298
16509,0.000595,172.31.36.0-255,66,50903,1,318298
16510,0.000616,172.217.194.0-255,2543,53446,1,318298
16511,0.000619,172.31.36.0-255,66,53512,1,318298
16512,0.000685,172.217.194.0-255,1484,54996,1,318298
16513,0.00069,172.217.194.0-255,1484,56480,1,318298
16514,0.000693,172.31.36.0-255,66,56546,1,318298
16515,0.000714,172.217.194.0-255,1484,58030,1,318298
16516,0.000721,172.217.194.0-255,5738,63768,1,318298
16517,0.000723,172.31.36.0-255,66,63834,1,318298
16518,0.000754,172.217.194.0-255,6797,70631,1,318298
16519,0.000757,172.31.36.0-255,66,70697,1,318298
16520,0.000774,172.217.194.0-255,2902,73599,1,318298
16521,0.000777,172.31.36.0-255,66,73665,1,318298
16522,0.000804,172.217.194.0-255,7156,80821,1,318298
16523,0.000809,172.31.36.0-255,66,80887,1,318298
16524,0.000826,172.217.194.0-255,6797,87684,1,318298
16525,0.000828,172.31.36.0-255,66,87750,1,318298
16526,0.000859,172.217.194.0-255,649,88399,1,318298
16527,0.000995,172.217.194.0-255,1484,89883,1,318298
16528,0.001001,172.31.36.0-255,66,89949,1,318298
16529,0.001007,172.217.194.0-255,2902,92851,1,318298
16530,0.00101,172.31.36.0-255,66,92917,1,318298
16531,0.001017,172.217.194.0-255,5738,98655,1,318298
16532,0.001019,172.31.36.0-255,66,98721,1,318298
16533,0.001026,172.217.194.0-255,5738,104459,1,318298
16534,0.001029,172.31.36.0-255,66,104525,1,318298
16535,0.00106,172.217.194.0-255,7156,111681,1,318298
16536,0.001062,172.31.36.0-255,66,111747,1,318298
16537,0.001067,172.217.194.0-255,2902,114649,1,318298
16538,0.001068,172.31.36.0-255,66,114715,1,318298
16539,0.001093,172.31.36.0-255,66,114781,1,318298
16540,0.001143,172.217.194.0-255,1484,116265,1,318298
16541,0.001148,172.217.194.0-255,1484,117749,1,318298
16542,0.00115,172.31.36.0-255,66,117815,1,318298
16543,0.001168,172.217.194.0-255,1484,119299,1,318298
16544,0.001174,172.217.194.0-255,5738,125037,1,318298
16545,0.001177,172.31.36.0-255,66,125103,1,318298
16546,0.001221,172.31.36.0-255,66,125169,1,318298
16547,0.001265,172.217.194.0-255,7156,132325,1,318298
16548,0.001268,172.31.36.0-255,66,132391,1,318298
16549,0.00129,172.217.194.0-255,3602,135993,1,318298
16550,0.001293,172.31.36.0-255,66,136059,1,318298
16551,0.001615,172.217.194.0-255,1484,137543,1,318298
16552,0.00162,172.217.194.0-255,2902,140445,1,318298
16553,0.001624,172.31.36.0-255,66,140511,1,318298
16554,0.001649,172.217.194.0-255,5738,146249,1,318298
16555,0.001652,172.31.36.0-255,66,146315,1,318298
16556,0.001655,172.217.194.0-255,1484,147799,1,318298
16557,0.001669,172.217.194.0-255,2902,150701,1,318298
16558,0.001671,172.31.36.0-255,66,150767,1,318298
16559,0.001688,172.217.194.0-255,5738,156505,1,318298
16560,0.001691,172.31.36.0-255,66,156571,1,318298
16561,0.001705,172.31.36.0-255,66,156637,1,318298
16562,0.001852,172.217.194.0-255,1484,158121,1,318298
16563,0.001867,172.217.194.0-255,2902,161023,1,318298
16564,0.00187,172.31.36.0-255,66,161089,1,318298
16565,0.001877,172.217.194.0-255,5738,166827,1,318298
16566,0.001879,172.31.36.0-255,66,166893,1,318298
16567,0.001883,172.217.194.0-255,1484,168377,1,318298
16568,0.00191,172.217.194.0-255,4320,172697,1,318298
16569,0.001913,172.31.36.0-255,66,172763,1,318298
16570,0.001921,172.217.194.0-255,7156,179919,1,318298
16571,0.001923,172.31.36.0-255,66,179985,1,318298
16572,0.001942,172.217.194.0-255,1484,181469,1,318298
16573,0.001975,172.31.36.0-255,66,181535,1,318298
16574,0.001996,172.217.194.0-255,1484,183019,1,318298
16575,0.002014,172.217.194.0-255,2902,185921,1,318298
16576,0.002017,172.31.36.0-255,66,185987,1,318298
16577,0.002021,172.217.194.0-255,1484,187471,1,318298
16578,0.002037,172.217.194.0-255,4320,191791,1,318298
16579,0.00204,172.31.36.0-255,66,191857,1,318298
16580,0.002042,172.217.194.0-255,1484,193341,1,318298
16581,0.002071,172.31.36.0-255,66,193407,1,318298
16582,0.002103,172.217.194.0-255,7156,200563,1,318298
16583,0.002107,172.31.36.0-255,66,200629,1,318298
16584,0.002137,172.31.36.0-255,66,200695,1,318298
16585,0.002152,172.31.36.0-255,66,200761,1,318298
16586,0.002166,172.31.36.0-255,66,200827,1,318298
16587,0.002191,172.217.194.0-255,1484,202311,1,318298
16588,0.00221,172.217.194.0-255,2184,204495,1,318298
16589,0.002213,172.31.36.0-255,66,204561,1,318298
16590,0.004664,172.217.194.0-255,1484,206045,1,318298
16591,0.004729,172.217.194.0-255,4320,210365,1,318298
16592,0.004735,172.31.36.0-255,66,210431,1,318298
16593,0.007261,172.217.194.0-255,5738,216169,1,318298
16594,0.007269,172.31.36.0-255,66,216235,1,318298
16595,0.009811,172.217.194.0-255,5738,221973,1,318298
16596,0.009819,172.31.36.0-255,66,222039,1,318298
16597,0.01236,172.217.194.0-255,5738,227777,1,318298
16598,0.012369,172.31.36.0-255,66,227843,1,318298
16599,0.014901,172.217.194.0-255,5738,233581,1,318298
16600,0.01491,172.31.36.0-255,66,233647,1,318298
16601,0.017466,172.217.194.0-255,5738,239385,1,318298
16602,0.017475,172.31.36.0-255,66,239451,1,318298
16603,0.020004,172.217.194.0-255,5738,245189,1,318298
16604,0.020023,172.31.36.0-255,66,245255,1,318298
16605,0.022594,172.217.194.0-255,5738,250993,1,318298
16606,0.022613,172.31.36.0-255,66,251059,1,318298
16607,0.025148,172.217.194.0-255,5738,256797,1,318298
16608,0.025161,172.31.36.0-255,66,256863,1,318298
16609,0.027692,172.217.194.0-255,5738,262601,1,318298
16610,0.027711,172.31.36.0-255,66,262667,1,318298
16611,0.030263,172.217.194.0-255,5738,268405,1,318298
16612,0.030282,172.31.36.0-255,66,268471,1,318298
16613,0.03283,172.217.194.0-255,5738,274209,1,318298
16614,0.032844,172.31.36.0-255,66,274275,1,318298
16615,0.035394,172.217.194.0-255,5738,280013,1,318298
16616,0.035407,172.31.36.0-255,66,280079,1,318298
16617,0.037945,172.217.194.0-255,5738,285817,1,318298
16618,0.037955,172.31.36.0-255,66,285883,1,318298
16619,0.040531,172.217.194.0-255,5738,291621,1,318298
16620,0.04054,172.31.36.0-255,66,291687,1,318298
16621,0.043074,172.217.194.0-255,5738,297425,1,318298
16622,0.043085,172.31.36.0-255,66,297491,1,318298
16623,0.044497,172.31.36.0-255,210,297701,1,318298
16624,0.044532,172.31.36.0-255,958,298659,1,318298
16625,0.0446,172.31.36.0-255,1514,300173,1,318298
16626,0.044602,172.31.36.0-255,1514,301687,1,318298
16627,0.044608,172.31.36.0-255,1514,303201,1,318298
16628,0.044609,172.31.36.0-255,1514,304715,1,318298
16629,0.044627,172.31.36.0-255,1514,306229,1,318298
16630,0.044628,172.31.36.0-255,197,306426,1,318298
16631,0.045594,172.217.194.0-255,5738,312164,1,318298
16632,0.045602,172.31.36.0-255,66,312230,1,318298
16633,0.046067,104.244.42.0-255,66,312296,1,318298
16634,0.046075,104.244.42.0-255,66,312362,1,318298
16635,0.046182,104.244.42.0-255,66,312428,1,318298
16636,0.046228,104.244.42.0-255,66,312494,1,318298
16637,0.048145,172.217.194.0-255,5738,318232,1,318298
16638,0.048152,172.31.36.0-255,66,318298,1,318298
16639,0.0,172.217.194.0-255,153,153,1,227884
16640,2.3e-05,172.31.36.0-255,66,219,1,227884
16641,3e-05,172.217.194.0-255,1484,1703,1,227884
16642,3.5e-05,172.31.36.0-255,66,1769,1,227884
16643,4e-05,172.217.194.0-255,2902,4671,1,227884
16644,4.3e-05,172.31.36.0-255,66,4737,1,227884
16645,5.8e-05,172.217.194.0-255,5738,10475,1,227884
16646,6.1e-05,172.31.36.0-255,66,10541,1,227884
16647,0.000102,172.217.194.0-255,3522,14063,1,227884
16648,0.000106,172.31.36.0-255,66,14129,1,227884
16649,0.000153,172.217.194.0-255,1484,15613,1,227884
16650,0.000156,172.31.36.0-255,66,15679,1,227884
16651,0.000162,172.217.194.0-255,2902,18581,1,227884
16652,0.000164,172.31.36.0-255,66,18647,1,227884
16653,0.000167,172.217.194.0-255,1484,20131,1,227884
16654,0.000174,172.31.36.0-255,66,20197,1,227884
16655,0.000208,172.217.194.0-255,4320,24517,1,227884
16656,0.000211,172.31.36.0-255,66,24583,1,227884
16657,0.000218,172.217.194.0-255,6797,31380,1,227884
16658,0.00022,172.31.36.0-255,66,31446,1,227884
16659,0.000257,172.31.36.0-255,66,31512,1,227884
16660,0.000271,172.31.36.0-255,66,31578,1,227884
16661,0.000324,172.31.36.0-255,66,31644,1,227884
16662,0.000368,172.217.194.0-255,645,32289,1,227884
16663,0.000371,172.31.36.0-255,66,32355,1,227884
16664,0.000461,172.217.194.0-255,1484,33839,1,227884
16665,0.000465,172.31.36.0-255,66,33905,1,227884
16666,0.00047,172.217.194.0-255,2902,36807,1,227884
16667,0.000472,172.31.36.0-255,66,36873,1,227884
16668,0.000514,172.217.194.0-255,5738,42611,1,227884
16669,0.000517,172.31.36.0-255,66,42677,1,227884
16670,0.000524,172.217.194.0-255,7156,49833,1,227884
16671,0.000526,172.31.36.0-255,66,49899,1,227884
16672,0.000531,172.217.194.0-255,2902,52801,1,227884
16673,0.000534,172.31.36.0-255,66,52867,1,227884
16674,0.000569,172.31.36.0-255,66,52933,1,227884
16675,0.000573,172.217.194.0-255,2184,55117,1,227884
16676,0.000575,172.31.36.0-255,66,55183,1,227884
16677,0.000579,172.217.194.0-255,2902,58085,1,227884
16678,0.000581,172.31.36.0-255,66,58151,1,227884
16679,0.000618,172.217.194.0-255,7156,65307,1,227884
16680,0.000621,172.31.36.0-255,66,65373,1,227884
16681,0.000631,172.31.36.0-255,66,65439,1,227884
16682,0.000676,172.31.36.0-255,66,65505,1,227884
16683,0.00069,172.217.194.0-255,3602,69107,1,227884
16684,0.000692,172.31.36.0-255,66,69173,1,227884
16685,0.000709,172.31.36.0-255,66,69239,1,227884
16686,0.000742,172.217.194.0-255,4320,73559,1,227884
16687,0.000745,172.31.36.0-255,66,73625,1,227884
16688,0.00076,172.31.36.0-255,66,73691,1,227884
16689,0.000764,172.217.194.0-255,2184,75875,1,227884
16690,0.000766,172.31.36.0-255,66,75941,1,227884
16691,0.001455,172.217.194.0-255,1484,77425,1,227884
16692,0.001462,172.217.194.0-255,1484,78909,1,227884
16693,0.001466,172.31.36.0-255,66,78975,1,227884
16694,0.00148,172.217.194.0-255,1484,80459,1,227884
16695,0.00149,172.217.194.0-255,4320,84779,1,227884
16696,0.001503,172.31.36.0-255,66,84845,1,227884
16697,0.001506,172.31.36.0-255,66,84911,1,227884
16698,0.001565,172.31.36.0-255,66,84977,1,227884
16699,0.001854,172.217.194.0-255,1484,86461,1,227884
16700,0.001861,172.217.194.0-255,2902,89363,1,227884
16701,0.001865,172.31.36.0-255,66,89429,1,227884
16702,0.001869,172.217.194.0-255,1484,90913,1,227884
16703,0.001893,172.217.194.0-255,4320,95233,1,227884
16704,0.001895,172.31.36.0-255,66,95299,1,227884
16705,0.001929,172.31.36.0-255,66,95365,1,227884
16706,0.001962,172.217.194.0-255,4320,99685,1,227884
16707,0.001965,172.31.36.0-255,66,99751,1,227884
16708,0.001977,172.31.36.0-255,66,99817,1,227884
16709,0.002066,172.217.194.0-255,1484,101301,1,227884
16710,0.002112,172.217.194.0-255,1484,102785,1,227884
16711,0.002114,172.31.36.0-255,66,102851,1,227884
16712,0.002139,172.217.194.0-255,1484,104335,1,227884
16713,0.002145,172.217.194.0-255,5738,110073,1,227884
16714,0.002147,172.31.36.0-255,66,110139,1,227884
16715,0.002167,172.31.36.0-255,66,110205,1,227884
16716,0.002178,172.31.36.0-255,66,110271,1,227884
16717,0.002181,172.217.194.0-255,766,111037,1,227884
16718,0.00222,172.217.194.0-255,1484,112521,1,227884
16719,0.002223,172.31.36.0-255,66,112587,1,227884
16720,0.002228,172.217.194.0-255,2902,115489,1,227884
16721,0.00223,172.31.36.0-255,66,115555,1,227884
16722,0.002258,172.217.194.0-255,1484,117039,1,227884
16723,0.002266,172.217.194.0-255,7156,124195,1,227884
16724,0.002274,172.217.194.0-255,7156,131351,1,227884
16725,0.002304,172.217.194.0-255,5020,136371,1,227884
16726,0.002362,172.217.194.0-255,2902,139273,1,227884
16727,0.002413,172.217.194.0-255,4320,143593,1,227884
16728,0.002447,172.217.194.0-255,1484,145077,1,227884
16729,0.002461,172.217.194.0-255,1484,146561,1,227884
16730,0.0084,172.31.36.0-255,66,146627,1,227884
16731,0.010788,172.217.194.0-255,5738,152365,1,227884
16732,0.010796,172.31.36.0-255,66,152431,1,227884
16733,0.013175,172.217.194.0-255,5738,158169,1,227884
16734,0.013184,172.31.36.0-255,66,158235,1,227884
16735,0.015592,172.217.194.0-255,5738,163973,1,227884
16736,0.015601,172.31.36.0-255,66,164039,1,227884
16737,0.017975,172.217.194.0-255,5738,169777,1,227884
16738,0.017985,172.31.36.0-255,66,169843,1,227884
16739,0.020379,172.217.194.0-255,5738,175581,1,227884
16740,0.020386,172.31.36.0-255,66,175647,1,227884
16741,0.02275,172.217.194.0-255,5738,181385,1,227884
16742,0.022758,172.31.36.0-255,66,181451,1,227884
16743,0.025134,172.217.194.0-255,5738,187189,1,227884
16744,0.025142,172.31.36.0-255,66,187255,1,227884
16745,0.027495,172.217.194.0-255,5738,192993,1,227884
16746,0.027503,172.31.36.0-255,66,193059,1,227884
16747,0.029861,172.217.194.0-255,5738,198797,1,227884
16748,0.029869,172.31.36.0-255,66,198863,1,227884
16749,0.032247,172.217.194.0-255,5738,204601,1,227884
16750,0.032257,172.31.36.0-255,66,204667,1,227884
16751,0.034636,172.217.194.0-255,5738,210405,1,227884
16752,0.034644,172.31.36.0-255,66,210471,1,227884
16753,0.036993,172.217.194.0-255,5738,216209,1,227884
16754,0.037001,172.31.36.0-255,66,216275,1,227884
16755,0.039378,172.217.194.0-255,2169,218444,1,227884
16756,0.03939,172.31.36.0-255,66,218510,1,227884
16757,0.039883,172.31.36.0-255,105,218615,1,227884
16758,0.042134,172.31.36.0-255,172,218787,1,227884
16759,0.042167,172.31.36.0-255,1114,219901,1,227884
16760,0.042234,172.217.194.0-255,66,219967,1,227884
16761,0.042296,172.31.36.0-255,1514,221481,1,227884
16762,0.042298,172.31.36.0-255,1514,222995,1,227884
16763,0.042299,172.31.36.0-255,1514,224509,1,227884
16764,0.0423,172.31.36.0-255,1514,226023,1,227884
16765,0.042328,172.31.36.0-255,1489,227512,1,227884
16766,0.043691,104.244.42.0-255,66,227578,1,227884
16767,0.043736,104.244.42.0-255,66,227644,1,227884
16768,0.043901,104.244.42.0-255,66,227710,1,227884
16769,0.044461,104.244.42.0-255,108,227818,1,227884
16770,0.044468,172.31.36.0-255,66,227884,1,227884
16771,0.0,172.217.194.0-255,153,153,1,167907
16772,3.4e-05,172.31.36.0-255,66,219,1,167907
16773,4.1e-05,172.217.194.0-255,1484,1703,1,167907
16774,4.6e-05,172.31.36.0-255,66,1769,1,167907
16775,5.8e-05,172.217.194.0-255,2902,4671,1,167907
16776,6.1e-05,172.31.36.0-255,66,4737,1,167907
16777,6.7e-05,172.217.194.0-255,4320,9057,1,167907
16778,6.9e-05,172.31.36.0-255,66,9123,1,167907
16779,7.6e-05,172.217.194.0-255,7156,16279,1,167907
16780,7.9e-05,172.31.36.0-255,66,16345,1,167907
16781,0.000106,172.217.194.0-255,2037,18382,1,167907
16782,0.000109,172.31.36.0-255,66,18448,1,167907
16783,0.000123,172.31.36.0-255,66,18514,1,167907
16784,0.000187,172.217.194.0-255,1484,19998,1,167907
16785,0.00019,172.31.36.0-255,66,20064,1,167907
16786,0.000197,172.217.194.0-255,2902,22966,1,167907
16787,0.000198,172.31.36.0-255,66,23032,1,167907
16788,0.000214,172.217.194.0-255,5738,28770,1,167907
16789,0.000216,172.31.36.0-255,66,28836,1,167907
16790,0.000268,172.31.36.0-255,66,28902,1,167907
16791,0.000273,172.217.194.0-255,2902,31804,1,167907
16792,0.000275,172.31.36.0-255,66,31870,1,167907
16793,0.000308,172.217.194.0-255,7056,38926,1,167907
16794,0.000313,172.31.36.0-255,66,38992,1,167907
16795,0.000316,172.217.194.0-255,429,39421,1,167907
16796,0.000318,172.31.36.0-255,66,39487,1,167907
16797,0.000415,172.217.194.0-255,1484,40971,1,167907
16798,0.000421,172.31.36.0-255,66,41037,1,167907
16799,0.000426,172.217.194.0-255,2902,43939,1,167907
16800,0.000428,172.31.36.0-255,66,44005,1,167907
16801,0.000441,172.217.194.0-255,5738,49743,1,167907
16802,0.000444,172.31.36.0-255,66,49809,1,167907
16803,0.000448,172.217.194.0-255,2902,52711,1,167907
16804,0.000452,172.31.36.0-255,66,52777,1,167907
16805,0.000503,172.31.36.0-255,66,52843,1,167907
16806,0.000514,172.31.36.0-255,66,52909,1,167907
16807,0.000518,172.217.194.0-255,2184,55093,1,167907
16808,0.00052,172.31.36.0-255,66,55159,1,167907
16809,0.000976,172.217.194.0-255,1484,56643,1,167907
16810,0.000983,172.217.194.0-255,2902,59545,1,167907
16811,0.000986,172.31.36.0-255,66,59611,1,167907
16812,0.000992,172.217.194.0-255,4320,63931,1,167907
16813,0.000995,172.31.36.0-255,66,63997,1,167907
16814,0.001011,172.217.194.0-255,1484,65481,1,167907
16815,0.001044,172.31.36.0-255,66,65547,1,167907
16816,0.001049,172.217.194.0-255,2902,68449,1,167907
16817,0.001051,172.31.36.0-255,66,68515,1,167907
16818,0.001094,172.31.36.0-255,66,68581,1,167907
16819,0.00113,172.217.194.0-255,1484,70065,1,167907
16820,0.001142,172.217.194.0-255,2902,72967,1,167907
16821,0.001145,172.31.36.0-255,66,73033,1,167907
16822,0.001175,172.217.194.0-255,5738,78771,1,167907
16823,0.001178,172.31.36.0-255,66,78837,1,167907
16824,0.001181,172.217.194.0-255,1484,80321,1,167907
16825,0.001219,172.31.36.0-255,66,80387,1,167907
16826,0.001237,172.31.36.0-255,66,80453,1,167907
16827,0.001299,172.217.194.0-255,1484,81937,1,167907
16828,0.001304,172.217.194.0-255,2902,84839,1,167907
16829,0.001307,172.31.36.0-255,66,84905,1,167907
16830,0.00131,172.217.194.0-255,1484,86389,1,167907
16831,0.001337,172.217.194.0-255,4320,90709,1,167907
16832,0.00134,172.31.36.0-255,66,90775,1,167907
16833,0.001353,172.31.36.0-255,66,90841,1,167907
16834,0.001366,172.31.36.0-255,66,90907,1,167907
16835,0.001404,172.217.194.0-255,4320,95227,1,167907
16836,0.001408,172.31.36.0-255,66,95293,1,167907
16837,0.001455,172.31.36.0-255,66,95359,1,167907
16838,0.001465,172.31.36.0-255,66,95425,1,167907
16839,0.001492,172.217.194.0-255,1484,96909,1,167907
16840,0.001514,172.217.194.0-255,2902,99811,1,167907
16841,0.001517,172.31.36.0-255,66,99877,1,167907
16842,0.001521,172.217.194.0-255,2902,102779,1,167907
16843,0.001524,172.31.36.0-255,66,102845,1,167907
16844,0.001545,172.217.194.0-255,2902,105747,1,167907
16845,0.001552,172.31.36.0-255,66,105813,1,167907
16846,0.001559,172.217.194.0-255,7156,112969,1,167907
16847,0.001562,172.31.36.0-255,66,113035,1,167907
16848,0.001574,172.217.194.0-255,7156,120191,1,167907
16849,0.001577,172.31.36.0-255,66,120257,1,167907
16850,0.001602,172.217.194.0-255,7156,127413,1,167907
16851,0.001605,172.31.36.0-255,66,127479,1,167907
16852,0.00161,172.217.194.0-255,2184,129663,1,167907
16853,0.001612,172.31.36.0-255,66,129729,1,167907
16854,0.001746,172.217.194.0-255,1484,131213,1,167907
16855,0.001751,172.217.194.0-255,2902,134115,1,167907
16856,0.001755,172.31.36.0-255,66,134181,1,167907
16857,0.001785,172.217.194.0-255,5738,139919,1,167907
16858,0.001789,172.31.36.0-255,66,139985,1,167907
16859,0.001794,172.217.194.0-255,4320,144305,1,167907
16860,0.001797,172.31.36.0-255,66,144371,1,167907
16861,0.001801,172.217.194.0-255,2902,147273,1,167907
16862,0.001805,172.31.36.0-255,66,147339,1,167907
16863,0.001837,172.31.36.0-255,66,147405,1,167907
16864,0.001847,172.31.36.0-255,66,147471,1,167907
16865,0.001889,172.217.194.0-255,1484,148955,1,167907
16866,0.001895,172.217.194.0-255,2902,151857,1,167907
16867,0.001898,172.31.36.0-255,66,151923,1,167907
16868,0.001903,172.217.194.0-255,2902,154825,1,167907
16869,0.001906,172.31.36.0-255,66,154891,1,167907
16870,0.001936,172.217.194.0-255,2902,157793,1,167907
16871,0.001939,172.31.36.0-255,66,157859,1,167907
16872,0.001954,172.31.36.0-255,66,157925,1,167907
16873,0.001964,172.31.36.0-255,66,157991,1,167907
16874,0.002013,172.31.36.0-255,66,158057,1,167907
16875,0.002053,172.31.36.0-255,66,158123,1,167907
16876,0.002067,172.31.36.0-255,66,158189,1,167907
16877,0.00212,172.31.36.0-255,66,158255,1,167907
16878,0.00216,172.31.36.0-255,66,158321,1,167907
16879,0.002175,172.31.36.0-255,66,158387,1,167907
16880,0.002178,172.217.194.0-255,105,158492,1,167907
16881,0.003689,172.31.36.0-255,66,158558,1,167907
16882,0.003717,172.31.36.0-255,105,158663,1,167907
16883,0.005977,172.217.194.0-255,66,158729,1,167907
16884,0.042087,172.31.36.0-255,188,158917,1,167907
16885,0.04212,172.31.36.0-255,958,159875,1,167907
16886,0.042165,172.31.36.0-255,1514,161389,1,167907
16887,0.042167,172.31.36.0-255,1514,162903,1,167907
16888,0.042168,172.31.36.0-255,1514,164417,1,167907
16889,0.042169,172.31.36.0-255,1514,165931,1,167907
16890,0.042196,172.31.36.0-255,1514,167445,1,167907
16891,0.042198,172.31.36.0-255,198,167643,1,167907
16892,0.043706,104.244.42.0-255,66,167709,1,167907
16893,0.043783,104.244.42.0-255,66,167775,1,167907
16894,0.043904,104.244.42.0-255,66,167841,1,167907
16895,0.043908,104.244.42.0-255,66,167907,1,167907
16896,0.0,74.125.130.0-255,150,150,1,296834
16897,2.3e-05,172.31.36.0-255,66,216,1,296834
16898,3.1e-05,74.125.130.0-255,1484,1700,1,296834
16899,3.6e-05,172.31.36.0-255,66,1766,1,296834
16900,4.9e-05,74.125.130.0-255,2902,4668,1,296834
16901,5.3e-05,172.31.36.0-255,66,4734,1,296834
16902,8e-05,74.125.130.0-255,4320,9054,1,296834
16903,8.3e-05,172.31.36.0-255,66,9120,1,296834
16904,0.000114,74.125.130.0-255,4939,14059,1,296834
16905,0.000118,172.31.36.0-255,66,14125,1,296834
16906,0.000137,74.125.130.0-255,5738,19863,1,296834
16907,0.00014,172.31.36.0-255,66,19929,1,296834
16908,0.000143,74.125.130.0-255,1484,21413,1,296834
16909,0.000145,172.31.36.0-255,66,21479,1,296834
16910,0.00018,74.125.130.0-255,2902,24381,1,296834
16911,0.000183,172.31.36.0-255,66,24447,1,296834
16912,0.00019,74.125.130.0-255,5738,30185,1,296834
16913,0.000192,172.31.36.0-255,66,30251,1,296834
16914,0.000195,74.125.130.0-255,1125,31376,1,296834
16915,0.000201,172.31.36.0-255,66,31442,1,296834
16916,0.000777,74.125.130.0-255,1484,32926,1,296834
16917,0.000784,172.31.36.0-255,66,32992,1,296834
16918,0.000806,74.125.130.0-255,2902,35894,1,296834
16919,0.000809,172.31.36.0-255,66,35960,1,296834
16920,0.000839,74.125.130.0-255,4320,40280,1,296834
16921,0.000841,172.31.36.0-255,66,40346,1,296834
16922,0.000868,172.31.36.0-255,66,40412,1,296834
16923,0.000906,74.125.130.0-255,1484,41896,1,296834
16924,0.000909,172.31.36.0-255,66,41962,1,296834
16925,0.000938,74.125.130.0-255,5738,47700,1,296834
16926,0.000941,172.31.36.0-255,66,47766,1,296834
16927,0.000945,74.125.130.0-255,2902,50668,1,296834
16928,0.000948,172.31.36.0-255,66,50734,1,296834
16929,0.000973,74.125.130.0-255,5738,56472,1,296834
16930,0.000979,172.31.36.0-255,66,56538,1,296834
16931,0.000982,74.125.130.0-255,1376,57914,1,296834
16932,0.001163,74.125.130.0-255,403,58317,1,296834
16933,0.001168,172.31.36.0-255,66,58383,1,296834
16934,0.001409,74.125.130.0-255,1484,59867,1,296834
16935,0.00143,74.125.130.0-255,1484,61351,1,296834
16936,0.001435,172.31.36.0-255,66,61417,1,296834
16937,0.001465,74.125.130.0-255,1484,62901,1,296834
16938,0.001472,74.125.130.0-255,5738,68639,1,296834
16939,0.001474,172.31.36.0-255,66,68705,1,296834
16940,0.001478,74.125.130.0-255,1484,70189,1,296834
16941,0.001483,74.125.130.0-255,2902,73091,1,296834
16942,0.001485,172.31.36.0-255,66,73157,1,296834
16943,0.001522,74.125.130.0-255,5738,78895,1,296834
16944,0.001525,172.31.36.0-255,66,78961,1,296834
16945,0.001529,74.125.130.0-255,1484,80445,1,296834
16946,0.001533,74.125.130.0-255,2902,83347,1,296834
16947,0.001535,172.31.36.0-255,66,83413,1,296834
16948,0.001563,74.125.130.0-255,4320,87733,1,296834
16949,0.001566,172.31.36.0-255,66,87799,1,296834
16950,0.001581,74.125.130.0-255,1484,89283,1,296834
16951,0.001584,74.125.130.0-255,1484,90767,1,296834
16952,0.001586,172.31.36.0-255,66,90833,1,296834
16953,0.001627,74.125.130.0-255,2184,93017,1,296834
16954,0.00163,172.31.36.0-255,66,93083,1,296834
16955,0.001768,74.125.130.0-255,1484,94567,1,296834
16956,0.001789,74.125.130.0-255,2902,97469,1,296834
16957,0.001793,172.31.36.0-255,66,97535,1,296834
16958,0.001823,74.125.130.0-255,5738,103273,1,296834
16959,0.001827,172.31.36.0-255,66,103339,1,296834
16960,0.00183,74.125.130.0-255,1484,104823,1,296834
16961,0.00185,74.125.130.0-255,2902,107725,1,296834
16962,0.001852,172.31.36.0-255,66,107791,1,296834
16963,0.001887,74.125.130.0-255,5738,113529,1,296834
16964,0.00189,172.31.36.0-255,66,113595,1,296834
16965,0.001893,74.125.130.0-255,1484,115079,1,296834
16966,0.001898,74.125.130.0-255,2902,117981,1,296834
16967,0.0019,172.31.36.0-255,66,118047,1,296834
16968,0.001941,74.125.130.0-255,5738,123785,1,296834
16969,0.001944,172.31.36.0-255,66,123851,1,296834
16970,0.001948,74.125.130.0-255,1484,125335,1,296834
16971,0.001952,74.125.130.0-255,2184,127519,1,296834
16972,0.001954,172.31.36.0-255,66,127585,1,296834
16973,0.001985,74.125.130.0-255,1484,129069,1,296834
16974,0.001998,74.125.130.0-255,2902,131971,1,296834
16975,0.002001,172.31.36.0-255,66,132037,1,296834
16976,0.002027,74.125.130.0-255,4320,136357,1,296834
16977,0.002029,172.31.36.0-255,66,136423,1,296834
16978,0.002055,74.125.130.0-255,1484,137907,1,296834
16979,0.002059,74.125.130.0-255,1484,139391,1,296834
16980,0.002061,172.31.36.0-255,66,139457,1,296834
16981,0.002089,172.31.36.0-255,66,139523,1,296834
16982,0.002094,74.125.130.0-255,2902,142425,1,296834
16983,0.002097,172.31.36.0-255,66,142491,1,296834
16984,0.002124,74.125.130.0-255,4320,146811,1,296834
16985,0.002127,172.31.36.0-255,66,146877,1,296834
16986,0.002146,74.125.130.0-255,4320,151197,1,296834
16987,0.002152,172.31.36.0-255,66,151263,1,296834
16988,0.002177,74.125.130.0-255,1484,152747,1,296834
16989,0.002181,74.125.130.0-255,766,153513,1,296834
16990,0.002183,172.31.36.0-255,66,153579,1,296834
16991,0.002411,74.125.130.0-255,1484,155063,1,296834
16992,0.00243,74.125.130.0-255,2902,157965,1,296834
16993,0.002434,172.31.36.0-255,66,158031,1,296834
16994,0.002466,74.125.130.0-255,2902,160933,1,296834
16995,0.002469,172.31.36.0-255,66,160999,1,296834
16996,0.002475,74.125.130.0-255,4320,165319,1,296834
16997,0.002478,172.31.36.0-255,66,165385,1,296834
16998,0.002498,74.125.130.0-255,2902,168287,1,296834
16999,0.002501,172.31.36.0-255,66,168353,1,296834
17000,0.002523,74.125.130.0-255,2902,171255,1,296834
17001,0.002525,172.31.36.0-255,66,171321,1,296834
17002,0.002532,74.125.130.0-255,7156,178477,1,296834
17003,0.002535,172.31.36.0-255,66,178543,1,296834
17004,0.002568,74.125.130.0-255,2902,181445,1,296834
17005,0.002571,172.31.36.0-255,66,181511,1,296834
17006,0.002577,74.125.130.0-255,4320,185831,1,296834
17007,0.002579,172.31.36.0-255,66,185897,1,296834
17008,0.002613,74.125.130.0-255,2184,188081,1,296834
17009,0.002616,172.31.36.0-255,66,188147,1,296834
17010,0.005191,74.125.130.0-255,2902,191049,1,296834
17011,0.005199,172.31.36.0-255,66,191115,1,296834
17012,0.005231,74.125.130.0-255,2902,194017,1,296834
17013,0.005234,172.31.36.0-255,66,194083,1,296834
17014,0.007816,74.125.130.0-255,2902,196985,1,296834
17015,0.007822,172.31.36.0-255,66,197051,1,296834
17016,0.007853,74.125.130.0-255,2902,199953,1,296834
17017,0.007856,172.31.36.0-255,66,200019,1,296834
17018,0.010443,74.125.130.0-255,2902,202921,1,296834
17019,0.01045,172.31.36.0-255,66,202987,1,296834
17020,0.010477,74.125.130.0-255,2902,205889,1,296834
17021,0.01048,172.31.36.0-255,66,205955,1,296834
17022,0.013062,74.125.130.0-255,2902,208857,1,296834
17023,0.013071,172.31.36.0-255,66,208923,1,296834
17024,0.013106,74.125.130.0-255,2902,211825,1,296834
17025,0.013109,172.31.36.0-255,66,211891,1,296834
17026,0.015699,74.125.130.0-255,2902,214793,1,296834
17027,0.015708,172.31.36.0-255,66,214859,1,296834
17028,0.015742,74.125.130.0-255,2902,217761,1,296834
17029,0.015745,172.31.36.0-255,66,217827,1,296834
17030,0.018337,74.125.130.0-255,2902,220729,1,296834
17031,0.018347,172.31.36.0-255,66,220795,1,296834
17032,0.018376,74.125.130.0-255,2902,223697,1,296834
17033,0.018379,172.31.36.0-255,66,223763,1,296834
17034,0.020976,74.125.130.0-255,2902,226665,1,296834
17035,0.020984,172.31.36.0-255,66,226731,1,296834
17036,0.021013,74.125.130.0-255,2902,229633,1,296834
17037,0.021017,172.31.36.0-255,66,229699,1,296834
17038,0.023694,74.125.130.0-255,5738,235437,1,296834
17039,0.023711,172.31.36.0-255,66,235503,1,296834
17040,0.026333,74.125.130.0-255,5738,241241,1,296834
17041,0.026342,172.31.36.0-255,66,241307,1,296834
17042,0.028969,74.125.130.0-255,5738,247045,1,296834
17043,0.028979,172.31.36.0-255,66,247111,1,296834
17044,0.031622,74.125.130.0-255,5738,252849,1,296834
17045,0.031632,172.31.36.0-255,66,252915,1,296834
17046,0.034271,74.125.130.0-255,5738,258653,1,296834
17047,0.034281,172.31.36.0-255,66,258719,1,296834
17048,0.036916,74.125.130.0-255,5738,264457,1,296834
17049,0.036926,172.31.36.0-255,66,264523,1,296834
17050,0.039573,74.125.130.0-255,5738,270261,1,296834
17051,0.039583,172.31.36.0-255,66,270327,1,296834
17052,0.04026,172.31.36.0-255,172,270499,1,296834
17053,0.040311,172.31.36.0-255,1114,271613,1,296834
17054,0.040385,172.31.36.0-255,1514,273127,1,296834
17055,0.040411,172.31.36.0-255,1514,274641,1,296834
17056,0.040413,172.31.36.0-255,1514,276155,1,296834
17057,0.040434,172.31.36.0-255,1514,277669,1,296834
17058,0.040437,172.31.36.0-255,1489,279158,1,296834
17059,0.04183,104.244.42.0-255,66,279224,1,296834
17060,0.041877,104.244.42.0-255,66,279290,1,296834
17061,0.041968,104.244.42.0-255,66,279356,1,296834
17062,0.042015,104.244.42.0-255,66,279422,1,296834
17063,0.042201,74.125.130.0-255,5738,285160,1,296834
17064,0.042211,172.31.36.0-255,66,285226,1,296834
17065,0.04485,74.125.130.0-255,5738,290964,1,296834
17066,0.044858,172.31.36.0-255,66,291030,1,296834
17067,0.047489,74.125.130.0-255,5738,296768,1,296834
17068,0.047497,172.31.36.0-255,66,296834,1,296834
17069,0.0,74.125.24.0-255,152,152,1,193874
17070,1.9e-05,172.31.36.0-255,66,218,1,193874
17071,2.7e-05,74.125.24.0-255,1484,1702,1,193874
17072,3.2e-05,172.31.36.0-255,66,1768,1,193874
17073,4.5e-05,74.125.24.0-255,2902,4670,1,193874
17074,4.7e-05,172.31.36.0-255,66,4736,1,193874
17075,5.5e-05,74.125.24.0-255,5738,10474,1,193874
17076,5.8e-05,172.31.36.0-255,66,10540,1,193874
17077,0.000111,74.125.24.0-255,3428,13968,1,193874
17078,0.000115,172.31.36.0-255,66,14034,1,193874
17079,0.000346,74.125.24.0-255,1484,15518,1,193874
17080,0.000353,172.31.36.0-255,66,15584,1,193874
17081,0.00036,74.125.24.0-255,2902,18486,1,193874
17082,0.000362,172.31.36.0-255,66,18552,1,193874
17083,0.000374,74.125.24.0-255,5738,24290,1,193874
17084,0.000376,172.31.36.0-255,66,24356,1,193874
17085,0.000384,74.125.24.0-255,6797,31153,1,193874
17086,0.000386,172.31.36.0-255,66,31219,1,193874
17087,0.000418,74.125.24.0-255,1484,32703,1,193874
17088,0.000421,172.31.36.0-255,66,32769,1,193874
17089,0.000427,74.125.24.0-255,2902,35671,1,193874
17090,0.000428,172.31.36.0-255,66,35737,1,193874
17091,0.000432,74.125.24.0-255,1484,37221,1,193874
17092,0.000434,172.31.36.0-255,66,37287,1,193874
17093,0.000463,74.125.24.0-255,4320,41607,1,193874
17094,0.000465,172.31.36.0-255,66,41673,1,193874
17095,0.000472,74.125.24.0-255,5738,47411,1,193874
17096,0.000475,172.31.36.0-255,66,47477,1,193874
17097,0.000502,74.125.24.0-255,1125,48602,1,193874
17098,0.000504,172.31.36.0-255,66,48668,1,193874
17099,0.00062,74.125.24.0-255,1484,50152,1,193874
17100,0.000624,172.31.36.0-255,66,50218,1,193874
17101,0.000629,74.125.24.0-255,2902,53120,1,193874
17102,0.000631,172.31.36.0-255,66,53186,1,193874
17103,0.000637,74.125.24.0-255,5738,58924,1,193874
17104,0.000639,172.31.36.0-255,66,58990,1,193874
17105,0.000666,74.125.24.0-255,1484,60474,1,193874
17106,0.000683,74.125.24.0-255,5692,66166,1,193874
17107,0.000685,172.31.36.0-255,66,66232,1,193874
17108,0.000724,74.125.24.0-255,113,66345,1,193874
17109,0.000844,74.125.24.0-255,1484,67829,1,193874
17110,0.000848,172.31.36.0-255,66,67895,1,193874
17111,0.000853,74.125.24.0-255,2902,70797,1,193874
17112,0.000855,172.31.36.0-255,66,70863,1,193874
17113,0.000892,74.125.24.0-255,5738,76601,1,193874
17114,0.000895,172.31.36.0-255,66,76667,1,193874
17115,0.000901,74.125.24.0-255,5738,82405,1,193874
17116,0.000903,172.31.36.0-255,66,82471,1,193874
17117,0.000957,172.31.36.0-255,66,82537,1,193874
17118,0.00099,172.31.36.0-255,66,82603,1,193874
17119,0.001565,74.125.24.0-255,1484,84087,1,193874
17120,0.001572,74.125.24.0-255,2902,86989,1,193874
17121,0.001576,172.31.36.0-255,66,87055,1,193874
17122,0.001582,74.125.24.0-255,4320,91375,1,193874
17123,0.001584,172.31.36.0-255,66,91441,1,193874
17124,0.001608,74.125.24.0-255,1484,92925,1,193874
17125,0.001626,172.31.36.0-255,66,92991,1,193874
17126,0.001666,172.31.36.0-255,66,93057,1,193874
17127,0.001865,74.125.24.0-255,1484,94541,1,193874
17128,0.00187,74.125.24.0-255,2902,97443,1,193874
17129,0.001875,172.31.36.0-255,66,97509,1,193874
17130,0.001884,74.125.24.0-255,1484,98993,1,193874
17131,0.001903,74.125.24.0-255,4320,103313,1,193874
17132,0.001905,172.31.36.0-255,66,103379,1,193874
17133,0.001913,74.125.24.0-255,5738,109117,1,193874
17134,0.001914,172.31.36.0-255,66,109183,1,193874
17135,0.001941,74.125.24.0-255,7156,116339,1,193874
17136,0.001944,172.31.36.0-255,66,116405,1,193874
17137,0.001984,172.31.36.0-255,66,116471,1,193874
17138,0.001996,172.31.36.0-255,66,116537,1,193874
17139,0.00201,172.31.36.0-255,66,116603,1,193874
17140,0.002042,74.125.24.0-255,7156,123759,1,193874
17141,0.002049,172.31.36.0-255,66,123825,1,193874
17142,0.002053,74.125.24.0-255,766,124591,1,193874
17143,0.002056,74.125.24.0-255,1484,126075,1,193874
17144,0.002058,172.31.36.0-255,66,126141,1,193874
17145,0.002064,74.125.24.0-255,4320,130461,1,193874
17146,0.002066,172.31.36.0-255,66,130527,1,193874
17147,0.002115,172.31.36.0-255,66,130593,1,193874
17148,0.002121,74.125.24.0-255,5738,136331,1,193874
17149,0.002123,172.31.36.0-255,66,136397,1,193874
17150,0.002129,74.125.24.0-255,5738,142135,1,193874
17151,0.002131,172.31.36.0-255,66,142201,1,193874
17152,0.00218,172.31.36.0-255,66,142267,1,193874
17153,0.002191,172.31.36.0-255,66,142333,1,193874
17154,0.002217,74.125.24.0-255,7156,149489,1,193874
17155,0.002219,172.31.36.0-255,66,149555,1,193874
17156,0.002275,172.31.36.0-255,66,149621,1,193874
17157,0.002289,172.31.36.0-255,66,149687,1,193874
17158,0.002344,172.31.36.0-255,66,149753,1,193874
17159,0.002389,74.125.24.0-255,3602,153355,1,193874
17160,0.002393,172.31.36.0-255,66,153421,1,193874
17161,0.002424,172.31.36.0-255,66,153487,1,193874
17162,0.002448,172.31.36.0-255,66,153553,1,193874
17163,0.002494,172.31.36.0-255,66,153619,1,193874
17164,0.004841,74.125.24.0-255,5738,159357,1,193874
17165,0.00486,172.31.36.0-255,66,159423,1,193874
17166,0.007177,74.125.24.0-255,5738,165161,1,193874
17167,0.007187,172.31.36.0-255,66,165227,1,193874
17168,0.009479,74.125.24.0-255,5738,170965,1,193874
17169,0.009483,172.31.36.0-255,66,171031,1,193874
17170,0.011804,74.125.24.0-255,5738,176769,1,193874
17171,0.011811,172.31.36.0-255,66,176835,1,193874
17172,0.014099,74.125.24.0-255,5738,182573,1,193874
17173,0.014106,172.31.36.0-255,66,182639,1,193874
17174,0.016439,74.125.24.0-255,1901,184540,1,193874
17175,0.016455,172.31.36.0-255,66,184606,1,193874
17176,0.017449,172.31.36.0-255,105,184711,1,193874
17177,0.019714,74.125.24.0-255,66,184777,1,193874
17178,0.037731,172.31.36.0-255,172,184949,1,193874
17179,0.037764,172.31.36.0-255,1114,186063,1,193874
17180,0.037843,172.31.36.0-255,1514,187577,1,193874
17181,0.037845,172.31.36.0-255,1514,189091,1,193874
17182,0.037846,172.31.36.0-255,1514,190605,1,193874
17183,0.037847,172.31.36.0-255,1514,192119,1,193874
17184,0.037873,172.31.36.0-255,1491,193610,1,193874
17185,0.039209,104.244.42.0-255,66,193676,1,193874
17186,0.039246,104.244.42.0-255,66,193742,1,193874
17187,0.03937,104.244.42.0-255,66,193808,1,193874
17188,0.039435,104.244.42.0-255,66,193874,1,193874
17189,0.0,74.125.68.0-255,153,153,1,301098
17190,3.3e-05,172.31.36.0-255,66,219,1,301098
17191,4.2e-05,74.125.68.0-255,1484,1703,1,301098
17192,4.7e-05,172.31.36.0-255,66,1769,1,301098
17193,5.2e-05,74.125.68.0-255,2902,4671,1,301098
17194,5.5e-05,172.31.36.0-255,66,4737,1,301098
17195,6.1e-05,74.125.68.0-255,4320,9057,1,301098
17196,6.4e-05,172.31.36.0-255,66,9123,1,301098
17197,7e-05,74.125.68.0-255,4885,14008,1,301098
17198,7.3e-05,172.31.36.0-255,66,14074,1,301098
17199,0.000147,74.125.68.0-255,1484,15558,1,301098
17200,0.00015,172.31.36.0-255,66,15624,1,301098
17201,0.000156,74.125.68.0-255,2902,18526,1,301098
17202,0.000158,172.31.36.0-255,66,18592,1,301098
17203,0.000161,74.125.68.0-255,1484,20076,1,301098
17204,0.000163,172.31.36.0-255,66,20142,1,301098
17205,0.000183,74.125.68.0-255,4320,24462,1,301098
17206,0.000187,172.31.36.0-255,66,24528,1,301098
17207,0.000216,74.125.68.0-255,6797,31325,1,301098
17208,0.000219,172.31.36.0-255,66,31391,1,301098
17209,0.000318,74.125.68.0-255,1484,32875,1,301098
17210,0.000322,172.31.36.0-255,66,32941,1,301098
17211,0.000344,74.125.68.0-255,2902,35843,1,301098
17212,0.000348,172.31.36.0-255,66,35909,1,301098
17213,0.000357,74.125.68.0-255,5738,41647,1,301098
17214,0.000359,172.31.36.0-255,66,41713,1,301098
17215,0.00039,74.125.68.0-255,6797,48510,1,301098
17216,0.000396,172.31.36.0-255,66,48576,1,301098
17217,0.000408,74.125.68.0-255,2902,51478,1,301098
17218,0.00041,172.31.36.0-255,66,51544,1,301098
17219,0.000431,74.125.68.0-255,7156,58700,1,301098
17220,0.000434,172.31.36.0-255,66,58766,1,301098
17221,0.000466,74.125.68.0-255,6797,65563,1,301098
17222,0.000469,172.31.36.0-255,66,65629,1,301098
17223,0.000551,74.125.68.0-255,393,66022,1,301098
17224,0.000587,74.125.68.0-255,350,66372,1,301098
17225,0.000782,74.125.68.0-255,1484,67856,1,301098
17226,0.000787,172.31.36.0-255,66,67922,1,301098
17227,0.000792,74.125.68.0-255,2902,70824,1,301098
17228,0.000795,172.31.36.0-255,66,70890,1,301098
17229,0.000798,74.125.68.0-255,1484,72374,1,301098
17230,0.000823,74.125.68.0-255,2902,75276,1,301098
17231,0.000826,172.31.36.0-255,66,75342,1,301098
17232,0.000843,74.125.68.0-255,5738,81080,1,301098
17233,0.000847,172.31.36.0-255,66,81146,1,301098
17234,0.000866,74.125.68.0-255,1484,82630,1,301098
17235,0.000903,74.125.68.0-255,2902,85532,1,301098
17236,0.000906,172.31.36.0-255,66,85598,1,301098
17237,0.000912,74.125.68.0-255,4320,89918,1,301098
17238,0.000914,172.31.36.0-255,66,89984,1,301098
17239,0.00093,74.125.68.0-255,1484,91468,1,301098
17240,0.000933,74.125.68.0-255,1484,92952,1,301098
17241,0.000936,172.31.36.0-255,66,93018,1,301098
17242,0.000941,74.125.68.0-255,2902,95920,1,301098
17243,0.000944,172.31.36.0-255,66,95986,1,301098
17244,0.000991,74.125.68.0-255,5020,101006,1,301098
17245,0.000994,172.31.36.0-255,66,101072,1,301098
17246,0.001195,74.125.68.0-255,1484,102556,1,301098
17247,0.00121,74.125.68.0-255,2902,105458,1,301098
17248,0.001214,172.31.36.0-255,66,105524,1,301098
17249,0.001234,74.125.68.0-255,2902,108426,1,301098
17250,0.001237,172.31.36.0-255,66,108492,1,301098
17251,0.001254,74.125.68.0-255,1484,109976,1,301098
17252,0.001259,74.125.68.0-255,2902,112878,1,301098
17253,0.001261,172.31.36.0-255,66,112944,1,301098
17254,0.001283,74.125.68.0-255,5738,118682,1,301098
17255,0.001285,172.31.36.0-255,66,118748,1,301098
17256,0.001288,74.125.68.0-255,1484,120232,1,301098
17257,0.001327,74.125.68.0-255,7156,127388,1,301098
17258,0.00133,172.31.36.0-255,66,127454,1,301098
17259,0.001348,74.125.68.0-255,4320,131774,1,301098
17260,0.001351,172.31.36.0-255,66,131840,1,301098
17261,0.001372,74.125.68.0-255,3602,135442,1,301098
17262,0.001375,172.31.36.0-255,66,135508,1,301098
17263,0.001417,74.125.68.0-255,4320,139828,1,301098
17264,0.00142,172.31.36.0-255,66,139894,1,301098
17265,0.001423,74.125.68.0-255,1484,141378,1,301098
17266,0.001439,74.125.68.0-255,2902,144280,1,301098
17267,0.001442,172.31.36.0-255,66,144346,1,301098
17268,0.001462,74.125.68.0-255,5738,150084,1,301098
17269,0.001465,172.31.36.0-255,66,150150,1,301098
17270,0.001484,74.125.68.0-255,4320,154470,1,301098
17271,0.001487,172.31.36.0-255,66,154536,1,301098
17272,0.001491,74.125.68.0-255,2902,157438,1,301098
17273,0.001493,172.31.36.0-255,66,157504,1,301098
17274,0.001512,74.125.68.0-255,2902,160406,1,301098
17275,0.001514,172.31.36.0-255,66,160472,1,301098
17276,0.001518,74.125.68.0-255,1484,161956,1,301098
17277,0.001536,74.125.68.0-255,4320,166276,1,301098
17278,0.001539,172.31.36.0-255,66,166342,1,301098
17279,0.001559,74.125.68.0-255,3602,169944,1,301098
17280,0.001562,172.31.36.0-255,66,170010,1,301098
17281,0.003795,74.125.68.0-255,5738,175748,1,301098
17282,0.003811,172.31.36.0-255,66,175814,1,301098
17283,0.006059,74.125.68.0-255,5738,181552,1,301098
17284,0.00607,172.31.36.0-255,66,181618,1,301098
17285,0.008324,74.125.68.0-255,5738,187356,1,301098
17286,0.008329,172.31.36.0-255,66,187422,1,301098
17287,0.010612,74.125.68.0-255,5738,193160,1,301098
17288,0.010628,172.31.36.0-255,66,193226,1,301098
17289,0.01287,74.125.68.0-255,5738,198964,1,301098
17290,0.012885,172.31.36.0-255,66,199030,1,301098
17291,0.015145,74.125.68.0-255,5738,204768,1,301098
17292,0.015164,172.31.36.0-255,66,204834,1,301098
17293,0.01743,74.125.68.0-255,5738,210572,1,301098
17294,0.017448,172.31.36.0-255,66,210638,1,301098
17295,0.019761,74.125.68.0-255,5738,216376,1,301098
17296,0.01978,172.31.36.0-255,66,216442,1,301098
17297,0.022048,74.125.68.0-255,5738,222180,1,301098
17298,0.022062,172.31.36.0-255,66,222246,1,301098
17299,0.02432,74.125.68.0-255,5738,227984,1,301098
17300,0.024336,172.31.36.0-255,66,228050,1,301098
17301,0.026591,74.125.68.0-255,5738,233788,1,301098
17302,0.026604,172.31.36.0-255,66,233854,1,301098
17303,0.028871,74.125.68.0-255,5738,239592,1,301098
17304,0.028888,172.31.36.0-255,66,239658,1,301098
17305,0.03116,74.125.68.0-255,5738,245396,1,301098
17306,0.031172,172.31.36.0-255,66,245462,1,301098
17307,0.033431,74.125.68.0-255,5738,251200,1,301098
17308,0.033446,172.31.36.0-255,66,251266,1,301098
17309,0.035692,74.125.68.0-255,5738,257004,1,301098
17310,0.035708,172.31.36.0-255,66,257070,1,301098
17311,0.037965,74.125.68.0-255,5738,262808,1,301098
17312,0.037978,172.31.36.0-255,66,262874,1,301098
17313,0.040235,74.125.68.0-255,5738,268612,1,301098
17314,0.040256,172.31.36.0-255,66,268678,1,301098
17315,0.042086,172.31.36.0-255,172,268850,1,301098
17316,0.042141,172.31.36.0-255,1113,269963,1,301098
17317,0.042213,172.31.36.0-255,1514,271477,1,301098
17318,0.042216,172.31.36.0-255,1514,272991,1,301098
17319,0.042217,172.31.36.0-255,1514,274505,1,301098
17320,0.042222,172.31.36.0-255,1514,276019,1,301098
17321,0.042223,172.31.36.0-255,1491,277510,1,301098
17322,0.042501,74.125.68.0-255,5738,283248,1,301098
17323,0.04251,172.31.36.0-255,66,283314,1,301098
17324,0.043611,104.244.42.0-255,66,283380,1,301098
17325,0.043717,104.244.42.0-255,66,283446,1,301098
17326,0.043858,104.244.42.0-255,66,283512,1,301098
17327,0.04474,74.125.68.0-255,5738,289250,1,301098
17328,0.044749,172.31.36.0-255,66,289316,1,301098
17329,0.044896,104.244.42.0-255,108,289424,1,301098
17330,0.044902,172.31.36.0-255,66,289490,1,301098
17331,0.046993,74.125.68.0-255,5738,295228,1,301098
17332,0.047007,172.31.36.0-255,66,295294,1,301098
17333,0.04925,74.125.68.0-255,5738,301032,1,301098
17334,0.049259,172.31.36.0-255,66,301098,1,301098
17335,0.0,74.125.24.0-255,146,146,1,274746
17336,1.8e-05,172.31.36.0-255,66,212,1,274746
17337,2.7e-05,74.125.24.0-255,1484,1696,1,274746
17338,3.1e-05,172.31.36.0-255,66,1762,1,274746
17339,3.7e-05,74.125.24.0-255,2902,4664,1,274746
17340,5.3e-05,172.31.36.0-255,66,4730,1,274746
17341,6e-05,74.125.24.0-255,7156,11886,1,274746
17342,6.4e-05,172.31.36.0-255,66,11952,1,274746
17343,6.8e-05,74.125.24.0-255,2046,13998,1,274746
17344,7e-05,172.31.36.0-255,66,14064,1,274746
17345,0.000102,74.125.24.0-255,1484,15548,1,274746
17346,0.000104,172.31.36.0-255,66,15614,1,274746
17347,0.00011,74.125.24.0-255,2902,18516,1,274746
17348,0.000112,172.31.36.0-255,66,18582,1,274746
17349,0.000118,74.125.24.0-255,5738,24320,1,274746
17350,0.00012,172.31.36.0-255,66,24386,1,274746
17351,0.000164,74.125.24.0-255,6797,31183,1,274746
17352,0.000167,172.31.36.0-255,66,31249,1,274746
17353,0.000189,74.125.24.0-255,7156,38405,1,274746
17354,0.000192,172.31.36.0-255,66,38471,1,274746
17355,0.000199,74.125.24.0-255,7156,45627,1,274746
17356,0.000202,172.31.36.0-255,66,45693,1,274746
17357,0.000241,74.125.24.0-255,2543,48236,1,274746
17358,0.000244,172.31.36.0-255,66,48302,1,274746
17359,0.00033,74.125.24.0-255,1484,49786,1,274746
17360,0.000334,172.31.36.0-255,66,49852,1,274746
17361,0.00034,74.125.24.0-255,2902,52754,1,274746
17362,0.000342,172.31.36.0-255,66,52820,1,274746
17363,0.000362,74.125.24.0-255,5738,58558,1,274746
17364,0.000365,172.31.36.0-255,66,58624,1,274746
17365,0.000369,74.125.24.0-255,2902,61526,1,274746
17366,0.000385,172.31.36.0-255,66,61592,1,274746
17367,0.000421,74.125.24.0-255,4292,65884,1,274746
17368,0.000424,172.31.36.0-255,66,65950,1,274746
17369,0.000628,74.125.24.0-255,111,66061,1,274746
17370,0.000642,74.125.24.0-255,332,66393,1,274746
17371,0.000906,74.125.24.0-255,1484,67877,1,274746
17372,0.000911,172.31.36.0-255,66,67943,1,274746
17373,0.000916,74.125.24.0-255,2902,70845,1,274746
17374,0.000919,172.31.36.0-255,66,70911,1,274746
17375,0.000923,74.125.24.0-255,2902,73813,1,274746
17376,0.00093,172.31.36.0-255,66,73879,1,274746
17377,0.000942,74.125.24.0-255,2902,76781,1,274746
17378,0.000945,172.31.36.0-255,66,76847,1,274746
17379,0.000952,74.125.24.0-255,5738,82585,1,274746
17380,0.000954,172.31.36.0-255,66,82651,1,274746
17381,0.00098,74.125.24.0-255,7156,89807,1,274746
17382,0.000983,172.31.36.0-255,66,89873,1,274746
17383,0.000996,172.31.36.0-255,66,89939,1,274746
17384,0.001171,74.125.24.0-255,1484,91423,1,274746
17385,0.001188,74.125.24.0-255,2902,94325,1,274746
17386,0.001192,172.31.36.0-255,66,94391,1,274746
17387,0.0012,74.125.24.0-255,5738,100129,1,274746
17388,0.001202,172.31.36.0-255,66,100195,1,274746
17389,0.001229,74.125.24.0-255,5738,105933,1,274746
17390,0.001231,172.31.36.0-255,66,105999,1,274746
17391,0.00126,74.125.24.0-255,7156,113155,1,274746
17392,0.001263,172.31.36.0-255,66,113221,1,274746
17393,0.001267,74.125.24.0-255,1484,114705,1,274746
17394,0.001298,172.31.36.0-255,66,114771,1,274746
17395,0.001323,74.125.24.0-255,1484,116255,1,274746
17396,0.00134,74.125.24.0-255,2902,119157,1,274746
17397,0.001343,172.31.36.0-255,66,119223,1,274746
17398,0.001349,74.125.24.0-255,4320,123543,1,274746
17399,0.001352,172.31.36.0-255,66,123609,1,274746
17400,0.00137,74.125.24.0-255,1484,125093,1,274746
17401,0.001406,74.125.24.0-255,7156,132249,1,274746
17402,0.001412,172.31.36.0-255,66,132315,1,274746
17403,0.00143,74.125.24.0-255,5738,138053,1,274746
17404,0.001437,74.125.24.0-255,7156,145209,1,274746
17405,0.001453,172.31.36.0-255,66,145275,1,274746
17406,0.001459,74.125.24.0-255,3602,148877,1,274746
17407,0.001492,172.31.36.0-255,66,148943,1,274746
17408,0.003653,74.125.24.0-255,1484,150427,1,274746
17409,0.003717,74.125.24.0-255,4320,154747,1,274746
17410,0.003722,172.31.36.0-255,66,154813,1,274746
17411,0.005932,74.125.24.0-255,5738,160551,1,274746
17412,0.005936,172.31.36.0-255,66,160617,1,274746
17413,0.008162,74.125.24.0-255,5738,166355,1,274746
17414,0.00817,172.31.36.0-255,66,166421,1,274746
17415,0.010439,74.125.24.0-255,5738,172159,1,274746
17416,0.010447,172.31.36.0-255,66,172225,1,274746
17417,0.012659,74.125.24.0-255,5738,177963,1,274746
17418,0.012666,172.31.36.0-255,66,178029,1,274746
17419,0.014883,74.125.24.0-255,5738,183767,1,274746
17420,0.014889,172.31.36.0-255,66,183833,1,274746
17421,0.01712,74.125.24.0-255,5738,189571,1,274746
17422,0.017127,172.31.36.0-255,66,189637,1,274746
17423,0.019334,74.125.24.0-255,2902,192539,1,274746
17424,0.019341,172.31.36.0-255,66,192605,1,274746
17425,0.019376,74.125.24.0-255,2902,195507,1,274746
17426,0.01938,172.31.36.0-255,66,195573,1,274746
17427,0.02159,74.125.24.0-255,2902,198475,1,274746
17428,0.021598,172.31.36.0-255,66,198541,1,274746
17429,0.021632,74.125.24.0-255,2902,201443,1,274746
17430,0.021635,172.31.36.0-255,66,201509,1,274746
17431,0.023823,74.125.24.0-255,2902,204411,1,274746
17432,0.02383,172.31.36.0-255,66,204477,1,274746
17433,0.023863,74.125.24.0-255,2902,207379,1,274746
17434,0.023866,172.31.36.0-255,66,207445,1,274746
17435,0.026041,74.125.24.0-255,2902,210347,1,274746
17436,0.026047,172.31.36.0-255,66,210413,1,274746
17437,0.026078,74.125.24.0-255,2902,213315,1,274746
17438,0.026081,172.31.36.0-255,66,213381,1,274746
17439,0.028236,74.125.24.0-255,2902,216283,1,274746
17440,0.028243,172.31.36.0-255,66,216349,1,274746
17441,0.028285,74.125.24.0-255,2902,219251,1,274746
17442,0.028288,172.31.36.0-255,66,219317,1,274746
17443,0.028943,172.31.36.0-255,168,219485,1,274746
17444,0.028976,172.31.36.0-255,1121,220606,1,274746
17445,0.029032,172.31.36.0-255,1514,222120,1,274746
17446,0.029034,172.31.36.0-255,1280,223400,1,274746
17447,0.03044,74.125.24.0-255,2902,226302,1,274746
17448,0.030447,172.31.36.0-255,66,226368,1,274746
17449,0.030479,74.125.24.0-255,2902,229270,1,274746
17450,0.030483,172.31.36.0-255,66,229336,1,274746
17451,0.030597,104.244.42.0-255,66,229402,1,274746
17452,0.030603,104.244.42.0-255,66,229468,1,274746
17453,0.030606,104.244.42.0-255,66,229534,1,274746
17454,0.032787,74.125.24.0-255,2902,232436,1,274746
17455,0.032793,172.31.36.0-255,66,232502,1,274746
17456,0.032822,74.125.24.0-255,2902,235404,1,274746
17457,0.032825,172.31.36.0-255,66,235470,1,274746
17458,0.035021,74.125.24.0-255,4320,239790,1,274746
17459,0.035029,172.31.36.0-255,66,239856,1,274746
17460,0.035063,74.125.24.0-255,1484,241340,1,274746
17461,0.037237,74.125.24.0-255,4320,245660,1,274746
17462,0.037243,172.31.36.0-255,66,245726,1,274746
17463,0.039457,74.125.24.0-255,5738,251464,1,274746
17464,0.039462,172.31.36.0-255,66,251530,1,274746
17465,0.04168,74.125.24.0-255,5738,257268,1,274746
17466,0.041687,172.31.36.0-255,66,257334,1,274746
17467,0.043899,74.125.24.0-255,5738,263072,1,274746
17468,0.043904,172.31.36.0-255,66,263138,1,274746
17469,0.046096,74.125.24.0-255,5738,268876,1,274746
17470,0.046102,172.31.36.0-255,66,268942,1,274746
17471,0.048311,74.125.24.0-255,5738,274680,1,274746
17472,0.048318,172.31.36.0-255,66,274746,1,274746
17473,0.0,172.217.194.0-255,157,157,1,241498
17474,2e-05,172.31.36.0-255,66,223,1,241498
17475,2.7e-05,172.217.194.0-255,1484,1707,1,241498
17476,3e-05,172.31.36.0-255,66,1773,1,241498
17477,3.5e-05,172.217.194.0-255,2902,4675,1,241498
17478,3.8e-05,172.31.36.0-255,66,4741,1,241498
17479,5.3e-05,172.217.194.0-255,7156,11897,1,241498
17480,5.7e-05,172.31.36.0-255,66,11963,1,241498
17481,6.1e-05,172.217.194.0-255,1991,13954,1,241498
17482,6.4e-05,172.31.36.0-255,66,14020,1,241498
17483,0.000123,172.217.194.0-255,1484,15504,1,241498
17484,0.000125,172.31.36.0-255,66,15570,1,241498
17485,0.000152,172.217.194.0-255,2902,18472,1,241498
17486,0.000154,172.31.36.0-255,66,18538,1,241498
17487,0.000161,172.217.194.0-255,5738,24276,1,241498
17488,0.000163,172.31.36.0-255,66,24342,1,241498
17489,0.00019,172.217.194.0-255,4320,28662,1,241498
17490,0.000192,172.31.36.0-255,66,28728,1,241498
17491,0.000207,172.217.194.0-255,2543,31271,1,241498
17492,0.000209,172.31.36.0-255,66,31337,1,241498
17493,0.000231,172.217.194.0-255,4320,35657,1,241498
17494,0.000234,172.31.36.0-255,66,35723,1,241498
17495,0.000264,172.217.194.0-255,2902,38625,1,241498
17496,0.000266,172.31.36.0-255,66,38691,1,241498
17497,0.000273,172.217.194.0-255,7156,45847,1,241498
17498,0.000275,172.31.36.0-255,66,45913,1,241498
17499,0.000319,172.217.194.0-255,2543,48456,1,241498
17500,0.000322,172.31.36.0-255,66,48522,1,241498
17501,0.000353,172.217.194.0-255,1484,50006,1,241498
17502,0.000356,172.31.36.0-255,66,50072,1,241498
17503,0.000359,172.217.194.0-255,1484,51556,1,241498
17504,0.00036,172.31.36.0-255,66,51622,1,241498
17505,0.000386,172.217.194.0-255,1484,53106,1,241498
17506,0.000397,172.217.194.0-255,5738,58844,1,241498
17507,0.0004,172.31.36.0-255,66,58910,1,241498
17508,0.000409,172.31.36.0-255,66,58976,1,241498
17509,0.000566,172.217.194.0-255,1484,60460,1,241498
17510,0.000572,172.217.194.0-255,2902,63362,1,241498
17511,0.000574,172.31.36.0-255,66,63428,1,241498
17512,0.000598,172.217.194.0-255,5738,69166,1,241498
17513,0.0006,172.31.36.0-255,66,69232,1,241498
17514,0.000603,172.217.194.0-255,1484,70716,1,241498
17515,0.00063,172.217.194.0-255,5379,76095,1,241498
17516,0.000632,172.31.36.0-255,66,76161,1,241498
17517,0.000635,172.217.194.0-255,1484,77645,1,241498
17518,0.000668,172.31.36.0-255,66,77711,1,241498
17519,0.000693,172.217.194.0-255,2543,80254,1,241498
17520,0.000696,172.31.36.0-255,66,80320,1,241498
17521,0.001576,172.217.194.0-255,1484,81804,1,241498
17522,0.001585,172.217.194.0-255,2902,84706,1,241498
17523,0.001589,172.31.36.0-255,66,84772,1,241498
17524,0.001596,172.217.194.0-255,5738,90510,1,241498
17525,0.001598,172.31.36.0-255,66,90576,1,241498
17526,0.001631,172.31.36.0-255,66,90642,1,241498
17527,0.001638,172.217.194.0-255,7156,97798,1,241498
17528,0.00164,172.31.36.0-255,66,97864,1,241498
17529,0.001671,172.217.194.0-255,2902,100766,1,241498
17530,0.001674,172.31.36.0-255,66,100832,1,241498
17531,0.001677,172.217.194.0-255,766,101598,1,241498
17532,0.003697,172.217.194.0-255,4320,105918,1,241498
17533,0.003703,172.31.36.0-255,66,105984,1,241498
17534,0.005768,172.217.194.0-255,5738,111722,1,241498
17535,0.005777,172.31.36.0-255,66,111788,1,241498
17536,0.007852,172.217.194.0-255,5738,117526,1,241498
17537,0.007859,172.31.36.0-255,66,117592,1,241498
17538,0.009901,172.217.194.0-255,5738,123330,1,241498
17539,0.009908,172.31.36.0-255,66,123396,1,241498
17540,0.011933,172.217.194.0-255,5738,129134,1,241498
17541,0.011941,172.31.36.0-255,66,129200,1,241498
17542,0.014198,172.217.194.0-255,5738,134938,1,241498
17543,0.014261,172.31.36.0-255,66,135004,1,241498
17544,0.016305,172.217.194.0-255,5738,140742,1,241498
17545,0.016312,172.31.36.0-255,66,140808,1,241498
17546,0.01838,172.217.194.0-255,5738,146546,1,241498
17547,0.018388,172.31.36.0-255,66,146612,1,241498
17548,0.020433,172.217.194.0-255,5738,152350,1,241498
17549,0.020441,172.31.36.0-255,66,152416,1,241498
17550,0.022498,172.217.194.0-255,5738,158154,1,241498
17551,0.022505,172.31.36.0-255,66,158220,1,241498
17552,0.024556,172.217.194.0-255,5738,163958,1,241498
17553,0.024563,172.31.36.0-255,66,164024,1,241498
17554,0.02661,172.217.194.0-255,5738,169762,1,241498
17555,0.026617,172.31.36.0-255,66,169828,1,241498
17556,0.028662,172.217.194.0-255,5738,175566,1,241498
17557,0.02867,172.31.36.0-255,66,175632,1,241498
17558,0.030704,172.217.194.0-255,5738,181370,1,241498
17559,0.03071,172.31.36.0-255,66,181436,1,241498
17560,0.032742,172.217.194.0-255,5738,187174,1,241498
17561,0.032748,172.31.36.0-255,66,187240,1,241498
17562,0.034791,172.217.194.0-255,5738,192978,1,241498
17563,0.034798,172.31.36.0-255,66,193044,1,241498
17564,0.035428,172.31.36.0-255,188,193232,1,241498
17565,0.035459,172.31.36.0-255,958,194190,1,241498
17566,0.03551,172.31.36.0-255,1514,195704,1,241498
17567,0.035512,172.31.36.0-255,1514,197218,1,241498
17568,0.035513,172.31.36.0-255,1514,198732,1,241498
17569,0.035515,172.31.36.0-255,1514,200246,1,241498
17570,0.035515,172.31.36.0-255,1514,201760,1,241498
17571,0.035543,172.31.36.0-255,198,201958,1,241498
17572,0.036863,172.217.194.0-255,5738,207696,1,241498
17573,0.03687,172.31.36.0-255,66,207762,1,241498
17574,0.03697,104.244.42.0-255,66,207828,1,241498
17575,0.037035,104.244.42.0-255,66,207894,1,241498
17576,0.037048,104.244.42.0-255,66,207960,1,241498
17577,0.037094,104.244.42.0-255,66,208026,1,241498
17578,0.038912,172.217.194.0-255,5738,213764,1,241498
17579,0.038918,172.31.36.0-255,66,213830,1,241498
17580,0.040996,172.217.194.0-255,5738,219568,1,241498
17581,0.04101,172.31.36.0-255,66,219634,1,241498
17582,0.043042,172.217.194.0-255,5738,225372,1,241498
17583,0.043047,172.31.36.0-255,66,225438,1,241498
17584,0.045081,172.217.194.0-255,4320,229758,1,241498
17585,0.045087,172.31.36.0-255,66,229824,1,241498
17586,0.045118,172.217.194.0-255,1484,231308,1,241498
17587,0.047117,172.217.194.0-255,4320,235628,1,241498
17588,0.047122,172.31.36.0-255,66,235694,1,241498
17589,0.049162,172.217.194.0-255,5738,241432,1,241498
17590,0.049168,172.31.36.0-255,66,241498,1,241498
17591,0.0,172.217.194.0-255,153,153,1,286205
17592,3.6e-05,172.31.36.0-255,66,219,1,286205
17593,4.2e-05,172.217.194.0-255,1484,1703,1,286205
17594,4.7e-05,172.31.36.0-255,66,1769,1,286205
17595,5.1e-05,172.217.194.0-255,2902,4671,1,286205
17596,5.3e-05,172.31.36.0-255,66,4737,1,286205
17597,7.5e-05,172.217.194.0-255,5738,10475,1,286205
17598,7.8e-05,172.31.36.0-255,66,10541,1,286205
17599,9.9e-05,172.217.194.0-255,1484,12025,1,286205
17600,0.000101,172.31.36.0-255,66,12091,1,286205
17601,0.000105,172.217.194.0-255,2068,14159,1,286205
17602,0.000108,172.31.36.0-255,66,14225,1,286205
17603,0.000131,172.217.194.0-255,2902,17127,1,286205
17604,0.000134,172.31.36.0-255,66,17193,1,286205
17605,0.000139,172.217.194.0-255,4320,21513,1,286205
17606,0.000141,172.31.36.0-255,66,21579,1,286205
17607,0.000153,172.217.194.0-255,1484,23063,1,286205
17608,0.000157,172.31.36.0-255,66,23129,1,286205
17609,0.000201,172.31.36.0-255,66,23195,1,286205
17610,0.000248,172.31.36.0-255,66,23261,1,286205
17611,0.00025,172.217.194.0-255,1484,24745,1,286205
17612,0.000252,172.31.36.0-255,66,24811,1,286205
17613,0.000297,172.217.194.0-255,6797,31608,1,286205
17614,0.0003,172.31.36.0-255,66,31674,1,286205
17615,0.000317,172.217.194.0-255,7156,38830,1,286205
17616,0.00032,172.31.36.0-255,66,38896,1,286205
17617,0.000351,172.217.194.0-255,5738,44634,1,286205
17618,0.000357,172.31.36.0-255,66,44700,1,286205
17619,0.000376,172.217.194.0-255,4237,48937,1,286205
17620,0.000379,172.31.36.0-255,66,49003,1,286205
17621,0.000415,172.217.194.0-255,122,49125,1,286205
17622,0.000781,172.217.194.0-255,378,49503,1,286205
17623,0.000884,172.31.36.0-255,66,49569,1,286205
17624,0.000935,172.217.194.0-255,1484,51053,1,286205
17625,0.000941,172.217.194.0-255,2902,53955,1,286205
17626,0.000948,172.31.36.0-255,66,54021,1,286205
17627,0.00097,172.217.194.0-255,5738,59759,1,286205
17628,0.000973,172.217.194.0-255,1484,61243,1,286205
17629,0.000989,172.31.36.0-255,66,61309,1,286205
17630,0.000994,172.217.194.0-255,7156,68465,1,286205
17631,0.001004,172.31.36.0-255,66,68531,1,286205
17632,0.001013,172.217.194.0-255,4320,72851,1,286205
17633,0.00102,172.31.36.0-255,66,72917,1,286205
17634,0.001037,172.31.36.0-255,66,72983,1,286205
17635,0.001039,172.217.194.0-255,2184,75167,1,286205
17636,0.001052,172.31.36.0-255,66,75233,1,286205
17637,0.001141,172.217.194.0-255,1484,76717,1,286205
17638,0.001146,172.217.194.0-255,2902,79619,1,286205
17639,0.001153,172.31.36.0-255,66,79685,1,286205
17640,0.001172,172.217.194.0-255,5738,85423,1,286205
17641,0.001175,172.31.36.0-255,66,85489,1,286205
17642,0.001179,172.217.194.0-255,1484,86973,1,286205
17643,0.001214,172.31.36.0-255,66,87039,1,286205
17644,0.001222,172.217.194.0-255,2902,89941,1,286205
17645,0.001228,172.31.36.0-255,66,90007,1,286205
17646,0.001242,172.217.194.0-255,7156,97163,1,286205
17647,0.001254,172.31.36.0-255,66,97229,1,286205
17648,0.001261,172.217.194.0-255,766,97995,1,286205
17649,0.001287,172.217.194.0-255,1484,99479,1,286205
17650,0.001293,172.217.194.0-255,2902,102381,1,286205
17651,0.001299,172.31.36.0-255,66,102447,1,286205
17652,0.001317,172.217.194.0-255,5738,108185,1,286205
17653,0.001324,172.31.36.0-255,66,108251,1,286205
17654,0.001325,172.217.194.0-255,5738,113989,1,286205
17655,0.001329,172.31.36.0-255,66,114055,1,286205
17656,0.001387,172.31.36.0-255,66,114121,1,286205
17657,0.001389,172.217.194.0-255,5020,119141,1,286205
17658,0.001392,172.31.36.0-255,66,119207,1,286205
17659,0.001394,172.217.194.0-255,4320,123527,1,286205
17660,0.001403,172.31.36.0-255,66,123593,1,286205
17661,0.001408,172.217.194.0-255,1484,125077,1,286205
17662,0.001412,172.217.194.0-255,2902,127979,1,286205
17663,0.001419,172.31.36.0-255,66,128045,1,286205
17664,0.001443,172.217.194.0-255,7156,135201,1,286205
17665,0.001451,172.31.36.0-255,66,135267,1,286205
17666,0.001468,172.31.36.0-255,66,135333,1,286205
17667,0.001477,172.217.194.0-255,6438,141771,1,286205
17668,0.001482,172.31.36.0-255,66,141837,1,286205
17669,0.001522,172.217.194.0-255,1484,143321,1,286205
17670,0.001527,172.217.194.0-255,2902,146223,1,286205
17671,0.001541,172.31.36.0-255,66,146289,1,286205
17672,0.001554,172.217.194.0-255,5738,152027,1,286205
17673,0.001564,172.31.36.0-255,66,152093,1,286205
17674,0.00157,172.217.194.0-255,2902,154995,1,286205
17675,0.001579,172.31.36.0-255,66,155061,1,286205
17676,0.001608,172.31.36.0-255,66,155127,1,286205
17677,0.001624,172.217.194.0-255,5738,160865,1,286205
17678,0.001631,172.31.36.0-255,66,160931,1,286205
17679,0.001652,172.217.194.0-255,5020,165951,1,286205
17680,0.001655,172.31.36.0-255,66,166017,1,286205
17681,0.001675,172.217.194.0-255,5738,171755,1,286205
17682,0.001679,172.31.36.0-255,66,171821,1,286205
17683,0.001699,172.217.194.0-255,5738,177559,1,286205
17684,0.001704,172.31.36.0-255,66,177625,1,286205
17685,0.00176,172.31.36.0-255,66,177691,1,286205
17686,0.001819,172.217.194.0-255,1484,179175,1,286205
17687,0.001824,172.217.194.0-255,2902,182077,1,286205
17688,0.001834,172.31.36.0-255,66,182143,1,286205
17689,0.001836,172.217.194.0-255,2902,185045,1,286205
17690,0.001852,172.217.194.0-255,2902,187947,1,286205
17691,0.001854,172.31.36.0-255,66,188013,1,286205
17692,0.001859,172.31.36.0-255,66,188079,1,286205
17693,0.001896,172.31.36.0-255,66,188145,1,286205
17694,0.001914,172.217.194.0-255,2184,190329,1,286205
17695,0.001925,172.31.36.0-255,66,190395,1,286205
17696,0.001927,172.217.194.0-255,1484,191879,1,286205
17697,0.001946,172.217.194.0-255,2902,194781,1,286205
17698,0.001951,172.31.36.0-255,66,194847,1,286205
17699,0.001953,172.217.194.0-255,5738,200585,1,286205
17700,0.001957,172.31.36.0-255,66,200651,1,286205
17701,0.001959,172.217.194.0-255,4320,204971,1,286205
17702,0.00197,172.31.36.0-255,66,205037,1,286205
17703,0.001984,172.217.194.0-255,7156,212193,1,286205
17704,0.00199,172.217.194.0-255,4320,216513,1,286205
17705,0.001992,172.31.36.0-255,66,216579,1,286205
17706,0.001996,172.31.36.0-255,66,216645,1,286205
17707,0.002028,172.31.36.0-255,66,216711,1,286205
17708,0.002304,172.217.194.0-255,1484,218195,1,286205
17709,0.002323,172.217.194.0-255,2902,221097,1,286205
17710,0.002328,172.31.36.0-255,66,221163,1,286205
17711,0.002334,172.217.194.0-255,5738,226901,1,286205
17712,0.002342,172.31.36.0-255,66,226967,1,286205
17713,0.002345,172.217.194.0-255,1484,228451,1,286205
17714,0.002374,172.217.194.0-255,4320,232771,1,286205
17715,0.002374,172.31.36.0-255,66,232837,1,286205
17716,0.002379,172.31.36.0-255,66,232903,1,286205
17717,0.002399,172.217.194.0-255,5738,238641,1,286205
17718,0.002407,172.31.36.0-255,66,238707,1,286205
17719,0.002412,172.217.194.0-255,766,239473,1,286205
17720,0.002433,172.217.194.0-255,1484,240957,1,286205
17721,0.002436,172.217.194.0-255,1484,242441,1,286205
17722,0.002446,172.31.36.0-255,66,242507,1,286205
17723,0.002452,172.217.194.0-255,2902,245409,1,286205
17724,0.002455,172.31.36.0-255,66,245475,1,286205
17725,0.002459,172.217.194.0-255,2902,248377,1,286205
17726,0.002462,172.31.36.0-255,66,248443,1,286205
17727,0.002494,172.217.194.0-255,7156,255599,1,286205
17728,0.002501,172.31.36.0-255,66,255665,1,286205
17729,0.002505,172.31.36.0-255,66,255731,1,286205
17730,0.00253,172.217.194.0-255,7156,262887,1,286205
17731,0.002534,172.31.36.0-255,66,262953,1,286205
17732,0.002541,172.217.194.0-255,2184,265137,1,286205
17733,0.002545,172.31.36.0-255,66,265203,1,286205
17734,0.005042,172.217.194.0-255,2902,268105,1,286205
17735,0.005049,172.31.36.0-255,66,268171,1,286205
17736,0.005069,172.217.194.0-255,2902,271073,1,286205
17737,0.007585,172.217.194.0-255,2902,273975,1,286205
17738,0.008738,172.31.36.0-255,66,274041,1,286205
17739,0.011228,172.217.194.0-255,2832,276873,1,286205
17740,0.011238,172.31.36.0-255,66,276939,1,286205
17741,0.015405,172.31.36.0-255,105,277044,1,286205
17742,0.017876,172.217.194.0-255,66,277110,1,286205
17743,0.034439,172.31.36.0-255,172,277282,1,286205
17744,0.034467,172.31.36.0-255,1115,278397,1,286205
17745,0.034522,172.31.36.0-255,1514,279911,1,286205
17746,0.034523,172.31.36.0-255,1514,281425,1,286205
17747,0.034528,172.31.36.0-255,1514,282939,1,286205
17748,0.034529,172.31.36.0-255,1514,284453,1,286205
17749,0.034556,172.31.36.0-255,1488,285941,1,286205
17750,0.03598,104.244.42.0-255,66,286007,1,286205
17751,0.036052,104.244.42.0-255,66,286073,1,286205
17752,0.036101,104.244.42.0-255,66,286139,1,286205
17753,0.036104,104.244.42.0-255,66,286205,1,286205
17754,0.0,172.217.194.0-255,153,153,1,202350
17755,2.2e-05,172.31.36.0-255,66,219,1,202350
17756,2.9e-05,172.217.194.0-255,1484,1703,1,202350
17757,3.3e-05,172.31.36.0-255,66,1769,1,202350
17758,3.9e-05,172.217.194.0-255,2902,4671,1,202350
17759,4.2e-05,172.31.36.0-255,66,4737,1,202350
17760,4.9e-05,172.217.194.0-255,7156,11893,1,202350
17761,5.2e-05,172.31.36.0-255,66,11959,1,202350
17762,5.7e-05,172.217.194.0-255,3436,15395,1,202350
17763,6.1e-05,172.31.36.0-255,66,15461,1,202350
17764,6.7e-05,172.217.194.0-255,4320,19781,1,202350
17765,7e-05,172.31.36.0-255,66,19847,1,202350
17766,0.000113,172.31.36.0-255,66,19913,1,202350
17767,0.000117,172.217.194.0-255,2543,22456,1,202350
17768,0.000119,172.31.36.0-255,66,22522,1,202350
17769,0.000134,172.217.194.0-255,2902,25424,1,202350
17770,0.000136,172.31.36.0-255,66,25490,1,202350
17771,0.000159,172.217.194.0-255,4320,29810,1,202350
17772,0.000162,172.31.36.0-255,66,29876,1,202350
17773,0.000169,172.217.194.0-255,5738,35614,1,202350
17774,0.000171,172.31.36.0-255,66,35680,1,202350
17775,0.000185,172.217.194.0-255,2902,38582,1,202350
17776,0.000187,172.31.36.0-255,66,38648,1,202350
17777,0.000205,172.217.194.0-255,2902,41550,1,202350
17778,0.000208,172.31.36.0-255,66,41616,1,202350
17779,0.000242,172.31.36.0-255,66,41682,1,202350
17780,0.000264,172.217.194.0-255,5668,47350,1,202350
17781,0.000267,172.31.36.0-255,66,47416,1,202350
17782,0.00027,172.217.194.0-255,98,47514,1,202350
17783,0.000272,172.31.36.0-255,66,47580,1,202350
17784,0.000293,172.217.194.0-255,364,47944,1,202350
17785,0.000487,172.217.194.0-255,1484,49428,1,202350
17786,0.000493,172.31.36.0-255,66,49494,1,202350
17787,0.000499,172.217.194.0-255,2902,52396,1,202350
17788,0.000502,172.31.36.0-255,66,52462,1,202350
17789,0.000506,172.217.194.0-255,2902,55364,1,202350
17790,0.000508,172.31.36.0-255,66,55430,1,202350
17791,0.000536,172.217.194.0-255,2902,58332,1,202350
17792,0.000539,172.31.36.0-255,66,58398,1,202350
17793,0.000552,172.31.36.0-255,66,58464,1,202350
17794,0.000591,172.31.36.0-255,66,58530,1,202350
17795,0.000883,172.217.194.0-255,1484,60014,1,202350
17796,0.00089,172.217.194.0-255,2902,62916,1,202350
17797,0.000893,172.31.36.0-255,66,62982,1,202350
17798,0.000935,172.217.194.0-255,5738,68720,1,202350
17799,0.000941,172.217.194.0-255,7156,75876,1,202350
17800,0.000945,172.31.36.0-255,66,75942,1,202350
17801,0.000953,172.31.36.0-255,66,76008,1,202350
17802,0.000964,172.31.36.0-255,66,76074,1,202350
17803,0.000982,172.217.194.0-255,4320,80394,1,202350
17804,0.000984,172.31.36.0-255,66,80460,1,202350
17805,0.000988,172.217.194.0-255,2184,82644,1,202350
17806,0.00099,172.31.36.0-255,66,82710,1,202350
17807,0.001079,172.217.194.0-255,1484,84194,1,202350
17808,0.001108,172.217.194.0-255,2902,87096,1,202350
17809,0.001111,172.31.36.0-255,66,87162,1,202350
17810,0.001114,172.217.194.0-255,1484,88646,1,202350
17811,0.001134,172.217.194.0-255,4320,92966,1,202350
17812,0.001137,172.31.36.0-255,66,93032,1,202350
17813,0.001139,172.217.194.0-255,1484,94516,1,202350
17814,0.001142,172.217.194.0-255,1484,96000,1,202350
17815,0.001143,172.31.36.0-255,66,96066,1,202350
17816,0.001161,172.217.194.0-255,7156,103222,1,202350
17817,0.001163,172.217.194.0-255,1484,104706,1,202350
17818,0.001166,172.31.36.0-255,66,104772,1,202350
17819,0.001183,172.31.36.0-255,66,104838,1,202350
17820,0.001228,172.217.194.0-255,2184,107022,1,202350
17821,0.001231,172.31.36.0-255,66,107088,1,202350
17822,0.001261,172.217.194.0-255,2902,109990,1,202350
17823,0.001264,172.31.36.0-255,66,110056,1,202350
17824,0.001267,172.217.194.0-255,1484,111540,1,202350
17825,0.001285,172.217.194.0-255,2902,114442,1,202350
17826,0.001291,172.217.194.0-255,7156,121598,1,202350
17827,0.001295,172.31.36.0-255,66,121664,1,202350
17828,0.001298,172.31.36.0-255,66,121730,1,202350
17829,0.001311,172.217.194.0-255,1484,123214,1,202350
17830,0.001327,172.217.194.0-255,2902,126116,1,202350
17831,0.001331,172.31.36.0-255,66,126182,1,202350
17832,0.001362,172.31.36.0-255,66,126248,1,202350
17833,0.001365,172.217.194.0-255,1484,127732,1,202350
17834,0.00138,172.217.194.0-255,2184,129916,1,202350
17835,0.001383,172.31.36.0-255,66,129982,1,202350
17836,0.001419,172.217.194.0-255,4320,134302,1,202350
17837,0.001422,172.31.36.0-255,66,134368,1,202350
17838,0.00144,172.217.194.0-255,5738,140106,1,202350
17839,0.001443,172.31.36.0-255,66,140172,1,202350
17840,0.001462,172.217.194.0-255,1484,141656,1,202350
17841,0.001485,172.31.36.0-255,66,141722,1,202350
17842,0.001489,172.217.194.0-255,2902,144624,1,202350
17843,0.001491,172.31.36.0-255,66,144690,1,202350
17844,0.001508,172.217.194.0-255,2902,147592,1,202350
17845,0.00151,172.31.36.0-255,66,147658,1,202350
17846,0.001531,172.217.194.0-255,2902,150560,1,202350
17847,0.001533,172.31.36.0-255,66,150626,1,202350
17848,0.001546,172.217.194.0-255,3602,154228,1,202350
17849,0.001549,172.31.36.0-255,66,154294,1,202350
17850,0.001643,172.217.194.0-255,1484,155778,1,202350
17851,0.001647,172.217.194.0-255,1484,157262,1,202350
17852,0.00165,172.31.36.0-255,66,157328,1,202350
17853,0.001669,172.217.194.0-255,1484,158812,1,202350
17854,0.001675,172.217.194.0-255,5738,164550,1,202350
17855,0.001678,172.31.36.0-255,66,164616,1,202350
17856,0.001683,172.217.194.0-255,2902,167518,1,202350
17857,0.001684,172.31.36.0-255,66,167584,1,202350
17858,0.001718,172.31.36.0-255,66,167650,1,202350
17859,0.001734,172.217.194.0-255,7156,174806,1,202350
17860,0.001737,172.31.36.0-255,66,174872,1,202350
17861,0.001772,172.31.36.0-255,66,174938,1,202350
17862,0.001787,172.31.36.0-255,66,175004,1,202350
17863,0.001878,172.217.194.0-255,1484,176488,1,202350
17864,0.001887,172.31.36.0-255,66,176554,1,202350
17865,0.00191,172.31.36.0-255,66,176620,1,202350
17866,0.001996,172.217.194.0-255,6438,183058,1,202350
17867,0.002002,172.217.194.0-255,5738,188796,1,202350
17868,0.002005,172.31.36.0-255,66,188862,1,202350
17869,0.002011,172.31.36.0-255,66,188928,1,202350
17870,0.002021,172.217.194.0-255,3876,192804,1,202350
17871,0.002024,172.217.194.0-255,105,192909,1,202350
17872,0.00205,172.31.36.0-255,66,192975,1,202350
17873,0.004404,172.31.36.0-255,105,193080,1,202350
17874,0.006688,172.217.194.0-255,66,193146,1,202350
17875,0.037022,172.31.36.0-255,172,193318,1,202350
17876,0.037141,172.31.36.0-255,1115,194433,1,202350
17877,0.037224,172.31.36.0-255,1514,195947,1,202350
17878,0.037227,172.31.36.0-255,1514,197461,1,202350
17879,0.037228,172.31.36.0-255,1514,198975,1,202350
17880,0.037232,172.31.36.0-255,1514,200489,1,202350
17881,0.037233,172.31.36.0-255,1489,201978,1,202350
17882,0.038574,104.244.42.0-255,66,202044,1,202350
17883,0.038741,104.244.42.0-255,66,202110,1,202350
17884,0.038837,104.244.42.0-255,66,202176,1,202350
17885,0.040336,104.244.42.0-255,108,202284,1,202350
17886,0.040347,172.31.36.0-255,66,202350,1,202350
17887,0.0,74.125.200.0-255,160,160,1,305186
17888,1.6e-05,172.31.36.0-255,66,226,1,305186
17889,2.3e-05,74.125.200.0-255,1484,1710,1,305186
17890,2.8e-05,172.31.36.0-255,66,1776,1,305186
17891,3.4e-05,74.125.200.0-255,2902,4678,1,305186
17892,4.4e-05,172.31.36.0-255,66,4744,1,305186
17893,5.3e-05,74.125.200.0-255,7156,11900,1,305186
17894,5.7e-05,172.31.36.0-255,66,11966,1,305186
17895,6.1e-05,74.125.200.0-255,2086,14052,1,305186
17896,6.4e-05,172.31.36.0-255,66,14118,1,305186
17897,0.000182,74.125.200.0-255,1484,15602,1,305186
17898,0.000187,172.31.36.0-255,66,15668,1,305186
17899,0.000192,74.125.200.0-255,2902,18570,1,305186
17900,0.000195,172.31.36.0-255,66,18636,1,305186
17901,0.00022,74.125.200.0-255,5738,24374,1,305186
17902,0.000224,172.31.36.0-255,66,24440,1,305186
17903,0.000236,74.125.200.0-255,6797,31237,1,305186
17904,0.000239,172.31.36.0-255,66,31303,1,305186
17905,0.000264,74.125.200.0-255,2902,34205,1,305186
17906,0.000266,172.31.36.0-255,66,34271,1,305186
17907,0.000271,74.125.200.0-255,4320,38591,1,305186
17908,0.000274,172.31.36.0-255,66,38657,1,305186
17909,0.000311,172.31.36.0-255,66,38723,1,305186
17910,0.000313,74.125.200.0-255,1125,39848,1,305186
17911,0.000315,172.31.36.0-255,66,39914,1,305186
17912,0.000364,74.125.200.0-255,1484,41398,1,305186
17913,0.000367,172.31.36.0-255,66,41464,1,305186
17914,0.000394,74.125.200.0-255,2902,44366,1,305186
17915,0.000397,172.31.36.0-255,66,44432,1,305186
17916,0.000404,74.125.200.0-255,5738,50170,1,305186
17917,0.000407,172.31.36.0-255,66,50236,1,305186
17918,0.000417,74.125.200.0-255,5738,55974,1,305186
17919,0.000419,172.31.36.0-255,66,56040,1,305186
17920,0.000457,74.125.200.0-255,1394,57434,1,305186
17921,0.000512,74.125.200.0-255,1804,59238,1,305186
17922,0.000515,172.31.36.0-255,66,59304,1,305186
17923,0.000519,74.125.200.0-255,1484,60788,1,305186
17924,0.00054,74.125.200.0-255,1484,62272,1,305186
17925,0.000543,172.31.36.0-255,66,62338,1,305186
17926,0.000551,74.125.200.0-255,7156,69494,1,305186
17927,0.000553,172.31.36.0-255,66,69560,1,305186
17928,0.000563,74.125.200.0-255,4830,74390,1,305186
17929,0.000566,172.31.36.0-255,66,74456,1,305186
17930,0.001056,74.125.200.0-255,1484,75940,1,305186
17931,0.001075,74.125.200.0-255,2902,78842,1,305186
17932,0.00108,172.31.36.0-255,66,78908,1,305186
17933,0.001087,74.125.200.0-255,5738,84646,1,305186
17934,0.001089,172.31.36.0-255,66,84712,1,305186
17935,0.001126,172.31.36.0-255,66,84778,1,305186
17936,0.001132,74.125.200.0-255,4320,89098,1,305186
17937,0.001134,172.31.36.0-255,66,89164,1,305186
17938,0.001176,74.125.200.0-255,6438,95602,1,305186
17939,0.001181,172.31.36.0-255,66,95668,1,305186
17940,0.001553,74.125.200.0-255,1484,97152,1,305186
17941,0.001562,74.125.200.0-255,2902,100054,1,305186
17942,0.001567,172.31.36.0-255,66,100120,1,305186
17943,0.001601,74.125.200.0-255,5738,105858,1,305186
17944,0.001604,172.31.36.0-255,66,105924,1,305186
17945,0.001612,74.125.200.0-255,7156,113080,1,305186
17946,0.001614,172.31.36.0-255,66,113146,1,305186
17947,0.001673,172.31.36.0-255,66,113212,1,305186
17948,0.001678,74.125.200.0-255,2184,115396,1,305186
17949,0.00168,172.31.36.0-255,66,115462,1,305186
17950,0.001743,74.125.200.0-255,2902,118364,1,305186
17951,0.001746,172.31.36.0-255,66,118430,1,305186
17952,0.001754,74.125.200.0-255,7156,125586,1,305186
17953,0.001756,172.31.36.0-255,66,125652,1,305186
17954,0.001761,74.125.200.0-255,2902,128554,1,305186
17955,0.001768,172.31.36.0-255,66,128620,1,305186
17956,0.001774,74.125.200.0-255,4320,132940,1,305186
17957,0.001776,172.31.36.0-255,66,133006,1,305186
17958,0.001787,172.31.36.0-255,66,133072,1,305186
17959,0.001798,172.31.36.0-255,66,133138,1,305186
17960,0.00185,74.125.200.0-255,1484,134622,1,305186
17961,0.001864,74.125.200.0-255,2902,137524,1,305186
17962,0.001866,172.31.36.0-255,66,137590,1,305186
17963,0.001892,74.125.200.0-255,2902,140492,1,305186
17964,0.001895,172.31.36.0-255,66,140558,1,305186
17965,0.001901,74.125.200.0-255,4320,144878,1,305186
17966,0.001903,172.31.36.0-255,66,144944,1,305186
17967,0.001944,172.31.36.0-255,66,145010,1,305186
17968,0.001969,74.125.200.0-255,5738,150748,1,305186
17969,0.001973,172.31.36.0-255,66,150814,1,305186
17970,0.002,74.125.200.0-255,4320,155134,1,305186
17971,0.002003,172.31.36.0-255,66,155200,1,305186
17972,0.002008,74.125.200.0-255,3602,158802,1,305186
17973,0.00201,172.31.36.0-255,66,158868,1,305186
17974,0.002067,74.125.200.0-255,1484,160352,1,305186
17975,0.002082,74.125.200.0-255,2902,163254,1,305186
17976,0.002084,172.31.36.0-255,66,163320,1,305186
17977,0.002104,74.125.200.0-255,5738,169058,1,305186
17978,0.002133,74.125.200.0-255,7156,176214,1,305186
17979,0.002157,74.125.200.0-255,5738,181952,1,305186
17980,0.002163,74.125.200.0-255,4320,186272,1,305186
17981,0.002202,74.125.200.0-255,6438,192710,1,305186
17982,0.008943,172.31.36.0-255,66,192776,1,305186
17983,0.011177,74.125.200.0-255,5738,198514,1,305186
17984,0.011183,172.31.36.0-255,66,198580,1,305186
17985,0.013389,74.125.200.0-255,5738,204318,1,305186
17986,0.013396,172.31.36.0-255,66,204384,1,305186
17987,0.015622,74.125.200.0-255,5738,210122,1,305186
17988,0.015629,172.31.36.0-255,66,210188,1,305186
17989,0.017835,74.125.200.0-255,5738,215926,1,305186
17990,0.017842,172.31.36.0-255,66,215992,1,305186
17991,0.02004,74.125.200.0-255,5738,221730,1,305186
17992,0.020048,172.31.36.0-255,66,221796,1,305186
17993,0.022255,74.125.200.0-255,5738,227534,1,305186
17994,0.022265,172.31.36.0-255,66,227600,1,305186
17995,0.024471,74.125.200.0-255,5738,233338,1,305186
17996,0.024478,172.31.36.0-255,66,233404,1,305186
17997,0.026695,74.125.200.0-255,5738,239142,1,305186
17998,0.026703,172.31.36.0-255,66,239208,1,305186
17999,0.028905,74.125.200.0-255,5738,244946,1,305186
18000,0.028912,172.31.36.0-255,66,245012,1,305186
18001,0.031115,74.125.200.0-255,5738,250750,1,305186
18002,0.031123,172.31.36.0-255,66,250816,1,305186
18003,0.033324,74.125.200.0-255,5738,256554,1,305186
18004,0.033331,172.31.36.0-255,66,256620,1,305186
18005,0.035534,74.125.200.0-255,5738,262358,1,305186
18006,0.03554,172.31.36.0-255,66,262424,1,305186
18007,0.037762,74.125.200.0-255,5738,268162,1,305186
18008,0.03777,172.31.36.0-255,66,268228,1,305186
18009,0.039974,74.125.200.0-255,5738,273966,1,305186
18010,0.039979,172.31.36.0-255,66,274032,1,305186
18011,0.040941,172.31.36.0-255,190,274222,1,305186
18012,0.04097,172.31.36.0-255,1114,275336,1,305186
18013,0.041031,172.31.36.0-255,1514,276850,1,305186
18014,0.041033,172.31.36.0-255,1514,278364,1,305186
18015,0.04104,172.31.36.0-255,1514,279878,1,305186
18016,0.041041,172.31.36.0-255,1514,281392,1,305186
18017,0.041064,172.31.36.0-255,1492,282884,1,305186
18018,0.042178,74.125.200.0-255,4320,287204,1,305186
18019,0.042191,172.31.36.0-255,66,287270,1,305186
18020,0.042218,74.125.200.0-255,1484,288754,1,305186
18021,0.042418,104.244.42.0-255,66,288820,1,305186
18022,0.042443,104.244.42.0-255,66,288886,1,305186
18023,0.042551,104.244.42.0-255,66,288952,1,305186
18024,0.042595,104.244.42.0-255,66,289018,1,305186
18025,0.043239,104.244.42.0-255,108,289126,1,305186
18026,0.043248,172.31.36.0-255,66,289192,1,305186
18027,0.044379,74.125.200.0-255,4320,293512,1,305186
18028,0.044383,172.31.36.0-255,66,293578,1,305186
18029,0.04659,74.125.200.0-255,5738,299316,1,305186
18030,0.046597,172.31.36.0-255,66,299382,1,305186
18031,0.048805,74.125.200.0-255,5738,305120,1,305186
18032,0.048811,172.31.36.0-255,66,305186,1,305186
18033,0.0,74.125.24.0-255,153,153,1,188766
18034,1.9e-05,172.31.36.0-255,66,219,1,188766
18035,2.6e-05,74.125.24.0-255,1484,1703,1,188766
18036,3.2e-05,172.31.36.0-255,66,1769,1,188766
18037,4.7e-05,74.125.24.0-255,2902,4671,1,188766
18038,5e-05,172.31.36.0-255,66,4737,1,188766
18039,5.8e-05,74.125.24.0-255,7156,11893,1,188766
18040,6.1e-05,172.31.36.0-255,66,11959,1,188766
18041,6.7e-05,74.125.24.0-255,3485,15444,1,188766
18042,6.9e-05,172.31.36.0-255,66,15510,1,188766
18043,7.7e-05,74.125.24.0-255,7156,22666,1,188766
18044,8e-05,172.31.36.0-255,66,22732,1,188766
18045,0.000121,74.125.24.0-255,5738,28470,1,188766
18046,0.000124,172.31.36.0-255,66,28536,1,188766
18047,0.000129,74.125.24.0-255,2543,31079,1,188766
18048,0.000131,172.31.36.0-255,66,31145,1,188766
18049,0.000173,74.125.24.0-255,1484,32629,1,188766
18050,0.000175,172.31.36.0-255,66,32695,1,188766
18051,0.000179,74.125.24.0-255,2902,35597,1,188766
18052,0.000182,172.31.36.0-255,66,35663,1,188766
18053,0.000205,74.125.24.0-255,5738,41401,1,188766
18054,0.000208,172.31.36.0-255,66,41467,1,188766
18055,0.000251,172.31.36.0-255,66,41533,1,188766
18056,0.000258,74.125.24.0-255,5738,47271,1,188766
18057,0.00026,172.31.36.0-255,66,47337,1,188766
18058,0.000283,74.125.24.0-255,3961,51298,1,188766
18059,0.000286,172.31.36.0-255,66,51364,1,188766
18060,0.000289,74.125.24.0-255,396,51760,1,188766
18061,0.000291,172.31.36.0-255,66,51826,1,188766
18062,0.000313,74.125.24.0-255,113,51939,1,188766
18063,0.000316,172.31.36.0-255,66,52005,1,188766
18064,0.000432,74.125.24.0-255,1484,53489,1,188766
18065,0.000448,74.125.24.0-255,2902,56391,1,188766
18066,0.000452,172.31.36.0-255,66,56457,1,188766
18067,0.000455,74.125.24.0-255,1484,57941,1,188766
18068,0.00048,74.125.24.0-255,4320,62261,1,188766
18069,0.000482,172.31.36.0-255,66,62327,1,188766
18070,0.000494,74.125.24.0-255,2902,65229,1,188766
18071,0.000501,172.31.36.0-255,66,65295,1,188766
18072,0.000537,172.31.36.0-255,66,65361,1,188766
18073,0.000541,74.125.24.0-255,1484,66845,1,188766
18074,0.000571,172.31.36.0-255,66,66911,1,188766
18075,0.000716,74.125.24.0-255,1484,68395,1,188766
18076,0.000723,74.125.24.0-255,2902,71297,1,188766
18077,0.000727,172.31.36.0-255,66,71363,1,188766
18078,0.000733,74.125.24.0-255,4320,75683,1,188766
18079,0.000736,172.31.36.0-255,66,75749,1,188766
18080,0.00077,74.125.24.0-255,1484,77233,1,188766
18081,0.000778,74.125.24.0-255,5738,82971,1,188766
18082,0.000781,172.31.36.0-255,66,83037,1,188766
18083,0.000796,172.31.36.0-255,66,83103,1,188766
18084,0.000799,74.125.24.0-255,1484,84587,1,188766
18085,0.000823,74.125.24.0-255,3602,88189,1,188766
18086,0.000826,172.31.36.0-255,66,88255,1,188766
18087,0.000833,74.125.24.0-255,5738,93993,1,188766
18088,0.000835,172.31.36.0-255,66,94059,1,188766
18089,0.000858,74.125.24.0-255,5738,99797,1,188766
18090,0.000861,172.31.36.0-255,66,99863,1,188766
18091,0.000886,74.125.24.0-255,2902,102765,1,188766
18092,0.000889,172.31.36.0-255,66,102831,1,188766
18093,0.000903,172.31.36.0-255,66,102897,1,188766
18094,0.000933,74.125.24.0-255,2902,105799,1,188766
18095,0.000935,172.31.36.0-255,66,105865,1,188766
18096,0.000941,74.125.24.0-255,3602,109467,1,188766
18097,0.000942,172.31.36.0-255,66,109533,1,188766
18098,0.000982,74.125.24.0-255,1484,111017,1,188766
18099,0.001002,74.125.24.0-255,2902,113919,1,188766
18100,0.001006,172.31.36.0-255,66,113985,1,188766
18101,0.001012,74.125.24.0-255,5738,119723,1,188766
18102,0.001014,172.31.36.0-255,66,119789,1,188766
18103,0.001093,172.31.36.0-255,66,119855,1,188766
18104,0.001107,172.31.36.0-255,66,119921,1,188766
18105,0.001248,74.125.24.0-255,1484,121405,1,188766
18106,0.001268,74.125.24.0-255,2902,124307,1,188766
18107,0.001271,172.31.36.0-255,66,124373,1,188766
18108,0.001299,74.125.24.0-255,5738,130111,1,188766
18109,0.001302,172.31.36.0-255,66,130177,1,188766
18110,0.001309,74.125.24.0-255,4320,134497,1,188766
18111,0.001311,172.31.36.0-255,66,134563,1,188766
18112,0.001338,172.31.36.0-255,66,134629,1,188766
18113,0.001384,172.31.36.0-255,66,134695,1,188766
18114,0.001396,172.31.36.0-255,66,134761,1,188766
18115,0.001468,172.31.36.0-255,66,134827,1,188766
18116,0.001474,74.125.24.0-255,3602,138429,1,188766
18117,0.001476,172.31.36.0-255,66,138495,1,188766
18118,0.001608,74.125.24.0-255,1484,139979,1,188766
18119,0.001625,74.125.24.0-255,2902,142881,1,188766
18120,0.001628,172.31.36.0-255,66,142947,1,188766
18121,0.001635,74.125.24.0-255,5738,148685,1,188766
18122,0.001638,172.31.36.0-255,66,148751,1,188766
18123,0.001645,74.125.24.0-255,1484,150235,1,188766
18124,0.001686,172.31.36.0-255,66,150301,1,188766
18125,0.001697,172.31.36.0-255,66,150367,1,188766
18126,0.001725,74.125.24.0-255,2184,152551,1,188766
18127,0.001728,172.31.36.0-255,66,152617,1,188766
18128,0.001761,74.125.24.0-255,1484,154101,1,188766
18129,0.001776,74.125.24.0-255,2902,157003,1,188766
18130,0.001779,172.31.36.0-255,66,157069,1,188766
18131,0.001785,74.125.24.0-255,4320,161389,1,188766
18132,0.001787,172.31.36.0-255,66,161455,1,188766
18133,0.001814,74.125.24.0-255,1484,162939,1,188766
18134,0.001829,172.31.36.0-255,66,163005,1,188766
18135,0.001834,74.125.24.0-255,4320,167325,1,188766
18136,0.001836,172.31.36.0-255,66,167391,1,188766
18137,0.001857,74.125.24.0-255,5738,173129,1,188766
18138,0.001865,172.31.36.0-255,66,173195,1,188766
18139,0.001885,74.125.24.0-255,5738,178933,1,188766
18140,0.001887,172.31.36.0-255,66,178999,1,188766
18141,0.001931,172.31.36.0-255,66,179065,1,188766
18142,0.002022,172.31.36.0-255,66,179131,1,188766
18143,0.002038,172.31.36.0-255,66,179197,1,188766
18144,0.002053,172.31.36.0-255,66,179263,1,188766
18145,0.002055,74.125.24.0-255,105,179368,1,188766
18146,0.004725,172.31.36.0-255,66,179434,1,188766
18147,0.011375,172.31.36.0-255,105,179539,1,188766
18148,0.013652,74.125.24.0-255,66,179605,1,188766
18149,0.038857,172.31.36.0-255,172,179777,1,188766
18150,0.038889,172.31.36.0-255,1114,180891,1,188766
18151,0.038974,172.31.36.0-255,1514,182405,1,188766
18152,0.039014,172.31.36.0-255,1514,183919,1,188766
18153,0.039018,172.31.36.0-255,1514,185433,1,188766
18154,0.039034,172.31.36.0-255,1514,186947,1,188766
18155,0.039038,172.31.36.0-255,1489,188436,1,188766
18156,0.040394,104.244.42.0-255,66,188502,1,188766
18157,0.040429,104.244.42.0-255,66,188568,1,188766
18158,0.04054,104.244.42.0-255,66,188634,1,188766
18159,0.040581,104.244.42.0-255,66,188700,1,188766
18160,0.040635,104.244.42.0-255,66,188766,1,188766
18161,0.0,172.217.194.0-255,150,150,1,240991
18162,2.8e-05,172.31.36.0-255,66,216,1,240991
18163,3.4e-05,172.217.194.0-255,1484,1700,1,240991
18164,3.8e-05,172.31.36.0-255,66,1766,1,240991
18165,4.3e-05,172.217.194.0-255,2902,4668,1,240991
18166,5.4e-05,172.31.36.0-255,66,4734,1,240991
18167,6.1e-05,172.217.194.0-255,7156,11890,1,240991
18168,6.3e-05,172.31.36.0-255,66,11956,1,240991
18169,9.3e-05,172.217.194.0-255,2002,13958,1,240991
18170,9.7e-05,172.31.36.0-255,66,14024,1,240991
18171,0.000335,172.217.194.0-255,1484,15508,1,240991
18172,0.00034,172.31.36.0-255,66,15574,1,240991
18173,0.000346,172.217.194.0-255,2902,18476,1,240991
18174,0.000348,172.31.36.0-255,66,18542,1,240991
18175,0.00038,172.217.194.0-255,5738,24280,1,240991
18176,0.000384,172.31.36.0-255,66,24346,1,240991
18177,0.000387,172.217.194.0-255,1484,25830,1,240991
18178,0.000388,172.31.36.0-255,66,25896,1,240991
18179,0.000427,172.217.194.0-255,5379,31275,1,240991
18180,0.000431,172.31.36.0-255,66,31341,1,240991
18181,0.000438,172.217.194.0-255,7156,38497,1,240991
18182,0.00044,172.31.36.0-255,66,38563,1,240991
18183,0.000443,172.217.194.0-255,1484,40047,1,240991
18184,0.000452,172.31.36.0-255,66,40113,1,240991
18185,0.000494,172.31.36.0-255,66,40179,1,240991
18186,0.0006,172.217.194.0-255,1484,41663,1,240991
18187,0.000604,172.31.36.0-255,66,41729,1,240991
18188,0.000626,172.217.194.0-255,2902,44631,1,240991
18189,0.000629,172.31.36.0-255,66,44697,1,240991
18190,0.000635,172.217.194.0-255,5738,50435,1,240991
18191,0.000638,172.31.36.0-255,66,50501,1,240991
18192,0.000677,172.217.194.0-255,7087,57588,1,240991
18193,0.00068,172.31.36.0-255,66,57654,1,240991
18194,0.001149,172.217.194.0-255,1484,59138,1,240991
18195,0.00116,172.217.194.0-255,2902,62040,1,240991
18196,0.001164,172.31.36.0-255,66,62106,1,240991
18197,0.001172,172.217.194.0-255,5738,67844,1,240991
18198,0.001174,172.31.36.0-255,66,67910,1,240991
18199,0.001217,172.217.194.0-255,4320,72230,1,240991
18200,0.00122,172.31.36.0-255,66,72296,1,240991
18201,0.001257,172.217.194.0-255,7075,79371,1,240991
18202,0.00126,172.31.36.0-255,66,79437,1,240991
18203,0.001271,172.31.36.0-255,66,79503,1,240991
18204,0.001295,172.31.36.0-255,66,79569,1,240991
18205,0.001563,172.217.194.0-255,1484,81053,1,240991
18206,0.00157,172.217.194.0-255,2902,83955,1,240991
18207,0.001573,172.31.36.0-255,66,84021,1,240991
18208,0.001579,172.217.194.0-255,4320,88341,1,240991
18209,0.001581,172.31.36.0-255,66,88407,1,240991
18210,0.001609,172.217.194.0-255,1484,89891,1,240991
18211,0.001615,172.217.194.0-255,5738,95629,1,240991
18212,0.001618,172.31.36.0-255,66,95695,1,240991
18213,0.00163,172.217.194.0-255,7156,102851,1,240991
18214,0.001632,172.31.36.0-255,66,102917,1,240991
18215,0.001648,172.31.36.0-255,66,102983,1,240991
18216,0.001654,172.217.194.0-255,5738,108721,1,240991
18217,0.001657,172.31.36.0-255,66,108787,1,240991
18218,0.001684,172.217.194.0-255,5020,113807,1,240991
18219,0.00169,172.31.36.0-255,66,113873,1,240991
18220,0.001704,172.31.36.0-255,66,113939,1,240991
18221,0.001755,172.31.36.0-255,66,114005,1,240991
18222,0.001793,172.31.36.0-255,66,114071,1,240991
18223,0.001817,172.31.36.0-255,66,114137,1,240991
18224,0.001822,172.217.194.0-255,3602,117739,1,240991
18225,0.001824,172.31.36.0-255,66,117805,1,240991
18226,0.001845,172.217.194.0-255,1484,119289,1,240991
18227,0.001849,172.217.194.0-255,2902,122191,1,240991
18228,0.001856,172.31.36.0-255,66,122257,1,240991
18229,0.001859,172.217.194.0-255,1484,123741,1,240991
18230,0.001881,172.217.194.0-255,4320,128061,1,240991
18231,0.001884,172.31.36.0-255,66,128127,1,240991
18232,0.00189,172.217.194.0-255,5738,133865,1,240991
18233,0.001892,172.31.36.0-255,66,133931,1,240991
18234,0.001979,172.31.36.0-255,66,133997,1,240991
18235,0.001984,172.217.194.0-255,4320,138317,1,240991
18236,0.001986,172.31.36.0-255,66,138383,1,240991
18237,0.002003,172.217.194.0-255,4320,142703,1,240991
18238,0.002005,172.31.36.0-255,66,142769,1,240991
18239,0.002063,172.31.36.0-255,66,142835,1,240991
18240,0.002066,172.217.194.0-255,1484,144319,1,240991
18241,0.00207,172.217.194.0-255,2902,147221,1,240991
18242,0.002072,172.31.36.0-255,66,147287,1,240991
18243,0.002083,172.217.194.0-255,5738,153025,1,240991
18244,0.002085,172.31.36.0-255,66,153091,1,240991
18245,0.00209,172.217.194.0-255,4320,157411,1,240991
18246,0.002092,172.31.36.0-255,66,157477,1,240991
18247,0.002097,172.217.194.0-255,5738,163215,1,240991
18248,0.0021,172.31.36.0-255,66,163281,1,240991
18249,0.00215,172.31.36.0-255,66,163347,1,240991
18250,0.002154,172.217.194.0-255,2184,165531,1,240991
18251,0.002156,172.31.36.0-255,66,165597,1,240991
18252,0.002196,172.217.194.0-255,1484,167081,1,240991
18253,0.002201,172.217.194.0-255,2902,169983,1,240991
18254,0.002204,172.31.36.0-255,66,170049,1,240991
18255,0.002236,172.217.194.0-255,5738,175787,1,240991
18256,0.002239,172.31.36.0-255,66,175853,1,240991
18257,0.002242,172.217.194.0-255,1484,177337,1,240991
18258,0.002274,172.31.36.0-255,66,177403,1,240991
18259,0.0023,172.217.194.0-255,7156,184559,1,240991
18260,0.002303,172.31.36.0-255,66,184625,1,240991
18261,0.002347,172.31.36.0-255,66,184691,1,240991
18262,0.002358,172.31.36.0-255,66,184757,1,240991
18263,0.002377,172.31.36.0-255,66,184823,1,240991
18264,0.004659,172.217.194.0-255,5738,190561,1,240991
18265,0.004664,172.31.36.0-255,66,190627,1,240991
18266,0.006979,172.217.194.0-255,5738,196365,1,240991
18267,0.006986,172.31.36.0-255,66,196431,1,240991
18268,0.0093,172.217.194.0-255,5738,202169,1,240991
18269,0.009309,172.31.36.0-255,66,202235,1,240991
18270,0.011594,172.217.194.0-255,5738,207973,1,240991
18271,0.011601,172.31.36.0-255,66,208039,1,240991
18272,0.013887,172.217.194.0-255,5738,213777,1,240991
18273,0.013896,172.31.36.0-255,66,213843,1,240991
18274,0.016202,172.217.194.0-255,5738,219581,1,240991
18275,0.01621,172.31.36.0-255,66,219647,1,240991
18276,0.018509,172.217.194.0-255,5738,225385,1,240991
18277,0.018516,172.31.36.0-255,66,225451,1,240991
18278,0.020797,172.217.194.0-255,5738,231189,1,240991
18279,0.020805,172.31.36.0-255,66,231255,1,240991
18280,0.023097,172.217.194.0-255,449,231704,1,240991
18281,0.023258,172.31.36.0-255,66,231770,1,240991
18282,0.023289,172.31.36.0-255,105,231875,1,240991
18283,0.025526,172.217.194.0-255,66,231941,1,240991
18284,0.035211,172.31.36.0-255,193,232134,1,240991
18285,0.035242,172.31.36.0-255,1113,233247,1,240991
18286,0.035292,172.31.36.0-255,1514,234761,1,240991
18287,0.035295,172.31.36.0-255,1514,236275,1,240991
18288,0.035296,172.31.36.0-255,1514,237789,1,240991
18289,0.035297,172.31.36.0-255,1514,239303,1,240991
18290,0.035324,172.31.36.0-255,1490,240793,1,240991
18291,0.036781,104.244.42.0-255,66,240859,1,240991
18292,0.03681,104.244.42.0-255,66,240925,1,240991
18293,0.036903,104.244.42.0-255,66,240991,1,240991
18294,0.0,74.125.130.0-255,153,153,1,258289
18295,3.4e-05,172.31.36.0-255,66,219,1,258289
18296,4.1e-05,74.125.130.0-255,1484,1703,1,258289
18297,4.5e-05,172.31.36.0-255,66,1769,1,258289
18298,5e-05,74.125.130.0-255,2902,4671,1,258289
18299,6.1e-05,172.31.36.0-255,66,4737,1,258289
18300,6.8e-05,74.125.130.0-255,7156,11893,1,258289
18301,7.2e-05,172.31.36.0-255,66,11959,1,258289
18302,0.000115,74.125.130.0-255,2049,14008,1,258289
18303,0.000118,172.31.36.0-255,66,14074,1,258289
18304,0.000213,74.125.130.0-255,1484,15558,1,258289
18305,0.000218,172.31.36.0-255,66,15624,1,258289
18306,0.000222,74.125.130.0-255,1484,17108,1,258289
18307,0.000225,172.31.36.0-255,66,17174,1,258289
18308,0.000261,74.125.130.0-255,1484,18658,1,258289
18309,0.000264,172.31.36.0-255,66,18724,1,258289
18310,0.000271,74.125.130.0-255,5738,24462,1,258289
18311,0.000274,172.31.36.0-255,66,24528,1,258289
18312,0.000288,74.125.130.0-255,6797,31325,1,258289
18313,0.000291,172.31.36.0-255,66,31391,1,258289
18314,0.0005,74.125.130.0-255,1484,32875,1,258289
18315,0.000504,172.31.36.0-255,66,32941,1,258289
18316,0.000509,74.125.130.0-255,2902,35843,1,258289
18317,0.000511,172.31.36.0-255,66,35909,1,258289
18318,0.000514,74.125.130.0-255,1484,37393,1,258289
18319,0.000521,172.31.36.0-255,66,37459,1,258289
18320,0.000554,74.125.130.0-255,4320,41779,1,258289
18321,0.000558,172.31.36.0-255,66,41845,1,258289
18322,0.000569,172.31.36.0-255,66,41911,1,258289
18323,0.000603,74.125.130.0-255,5379,47290,1,258289
18324,0.000606,172.31.36.0-255,66,47356,1,258289
18325,0.000623,172.31.36.0-255,66,47422,1,258289
18326,0.000625,74.125.130.0-255,376,47798,1,258289
18327,0.000657,74.125.130.0-255,367,48165,1,258289
18328,0.000757,74.125.130.0-255,1484,49649,1,258289
18329,0.00076,172.31.36.0-255,66,49715,1,258289
18330,0.000766,74.125.130.0-255,2902,52617,1,258289
18331,0.000769,172.31.36.0-255,66,52683,1,258289
18332,0.000773,74.125.130.0-255,2902,55585,1,258289
18333,0.00078,172.31.36.0-255,66,55651,1,258289
18334,0.000786,74.125.130.0-255,4320,59971,1,258289
18335,0.000788,172.31.36.0-255,66,60037,1,258289
18336,0.000816,74.125.130.0-255,4320,64357,1,258289
18337,0.00082,172.31.36.0-255,66,64423,1,258289
18338,0.000852,74.125.130.0-255,5379,69802,1,258289
18339,0.000855,172.31.36.0-255,66,69868,1,258289
18340,0.00086,74.125.130.0-255,4320,74188,1,258289
18341,0.000862,172.31.36.0-255,66,74254,1,258289
18342,0.000897,172.31.36.0-255,66,74320,1,258289
18343,0.001163,74.125.130.0-255,1484,75804,1,258289
18344,0.001173,74.125.130.0-255,2902,78706,1,258289
18345,0.001177,172.31.36.0-255,66,78772,1,258289
18346,0.001182,74.125.130.0-255,1484,80256,1,258289
18347,0.001211,74.125.130.0-255,2902,83158,1,258289
18348,0.001215,172.31.36.0-255,66,83224,1,258289
18349,0.00122,74.125.130.0-255,2902,86126,1,258289
18350,0.001222,172.31.36.0-255,66,86192,1,258289
18351,0.001244,74.125.130.0-255,5738,91930,1,258289
18352,0.001252,172.31.36.0-255,66,91996,1,258289
18353,0.00127,172.31.36.0-255,66,92062,1,258289
18354,0.001315,74.125.130.0-255,1484,93546,1,258289
18355,0.001321,74.125.130.0-255,2902,96448,1,258289
18356,0.001324,172.31.36.0-255,66,96514,1,258289
18357,0.001346,74.125.130.0-255,4320,100834,1,258289
18358,0.001349,172.31.36.0-255,66,100900,1,258289
18359,0.001361,172.31.36.0-255,66,100966,1,258289
18360,0.001424,172.31.36.0-255,66,101032,1,258289
18361,0.001448,74.125.130.0-255,3602,104634,1,258289
18362,0.001451,172.31.36.0-255,66,104700,1,258289
18363,0.001589,74.125.130.0-255,1484,106184,1,258289
18364,0.001595,74.125.130.0-255,2902,109086,1,258289
18365,0.0016,172.31.36.0-255,66,109152,1,258289
18366,0.001605,74.125.130.0-255,2902,112054,1,258289
18367,0.001608,172.31.36.0-255,66,112120,1,258289
18368,0.001613,74.125.130.0-255,4320,116440,1,258289
18369,0.001623,172.31.36.0-255,66,116506,1,258289
18370,0.001634,172.31.36.0-255,66,116572,1,258289
18371,0.001651,172.31.36.0-255,66,116638,1,258289
18372,0.001757,74.125.130.0-255,1484,118122,1,258289
18373,0.001763,74.125.130.0-255,2902,121024,1,258289
18374,0.001767,172.31.36.0-255,66,121090,1,258289
18375,0.001796,74.125.130.0-255,5738,126828,1,258289
18376,0.001802,172.31.36.0-255,66,126894,1,258289
18377,0.001813,74.125.130.0-255,4320,131214,1,258289
18378,0.001818,172.31.36.0-255,66,131280,1,258289
18379,0.001822,74.125.130.0-255,2902,134182,1,258289
18380,0.001824,172.31.36.0-255,66,134248,1,258289
18381,0.001845,74.125.130.0-255,2902,137150,1,258289
18382,0.001848,172.31.36.0-255,66,137216,1,258289
18383,0.001857,74.125.130.0-255,4320,141536,1,258289
18384,0.00186,172.31.36.0-255,66,141602,1,258289
18385,0.001866,74.125.130.0-255,5738,147340,1,258289
18386,0.001871,172.31.36.0-255,66,147406,1,258289
18387,0.001897,74.125.130.0-255,3602,151008,1,258289
18388,0.001899,172.31.36.0-255,66,151074,1,258289
18389,0.002019,74.125.130.0-255,1484,152558,1,258289
18390,0.002025,74.125.130.0-255,2902,155460,1,258289
18391,0.002028,172.31.36.0-255,66,155526,1,258289
18392,0.002033,74.125.130.0-255,2902,158428,1,258289
18393,0.002035,172.31.36.0-255,66,158494,1,258289
18394,0.002067,74.125.130.0-255,2902,161396,1,258289
18395,0.00207,172.31.36.0-255,66,161462,1,258289
18396,0.002075,74.125.130.0-255,4320,165782,1,258289
18397,0.002077,172.31.36.0-255,66,165848,1,258289
18398,0.0021,172.31.36.0-255,66,165914,1,258289
18399,0.002124,74.125.130.0-255,2902,168816,1,258289
18400,0.00213,172.31.36.0-255,66,168882,1,258289
18401,0.002139,172.31.36.0-255,66,168948,1,258289
18402,0.002278,74.125.130.0-255,1484,170432,1,258289
18403,0.002296,74.125.130.0-255,2902,173334,1,258289
18404,0.002299,172.31.36.0-255,66,173400,1,258289
18405,0.002304,74.125.130.0-255,2902,176302,1,258289
18406,0.002305,172.31.36.0-255,66,176368,1,258289
18407,0.002309,74.125.130.0-255,2902,179270,1,258289
18408,0.002311,172.31.36.0-255,66,179336,1,258289
18409,0.002339,74.125.130.0-255,1484,180820,1,258289
18410,0.002347,74.125.130.0-255,7156,187976,1,258289
18411,0.002349,172.31.36.0-255,66,188042,1,258289
18412,0.00238,74.125.130.0-255,1484,189526,1,258289
18413,0.002387,74.125.130.0-255,5738,195264,1,258289
18414,0.00239,172.31.36.0-255,66,195330,1,258289
18415,0.002392,74.125.130.0-255,1484,196814,1,258289
18416,0.002396,74.125.130.0-255,2902,199716,1,258289
18417,0.002397,172.31.36.0-255,66,199782,1,258289
18418,0.002402,74.125.130.0-255,3602,203384,1,258289
18419,0.002409,172.31.36.0-255,66,203450,1,258289
18420,0.002453,74.125.130.0-255,1484,204934,1,258289
18421,0.002458,74.125.130.0-255,2902,207836,1,258289
18422,0.00246,172.31.36.0-255,66,207902,1,258289
18423,0.002463,74.125.130.0-255,1484,209386,1,258289
18424,0.00249,74.125.130.0-255,4320,213706,1,258289
18425,0.002493,172.31.36.0-255,66,213772,1,258289
18426,0.002498,74.125.130.0-255,4320,218092,1,258289
18427,0.0025,172.31.36.0-255,66,218158,1,258289
18428,0.002535,172.31.36.0-255,66,218224,1,258289
18429,0.002545,172.31.36.0-255,66,218290,1,258289
18430,0.002549,74.125.130.0-255,2184,220474,1,258289
18431,0.002555,172.31.36.0-255,66,220540,1,258289
18432,0.00256,74.125.130.0-255,4320,224860,1,258289
18433,0.002562,172.31.36.0-255,66,224926,1,258289
18434,0.002606,74.125.130.0-255,4320,229246,1,258289
18435,0.002609,172.31.36.0-255,66,229312,1,258289
18436,0.002614,74.125.130.0-255,2902,232214,1,258289
18437,0.002616,172.31.36.0-255,66,232280,1,258289
18438,0.002618,74.125.130.0-255,1484,233764,1,258289
18439,0.002621,172.31.36.0-255,78,233842,1,258289
18440,0.002632,74.125.130.0-255,7156,240998,1,258289
18441,0.002635,172.31.36.0-255,66,241064,1,258289
18442,0.002639,74.125.130.0-255,2902,243966,1,258289
18443,0.002662,74.125.130.0-255,4320,248286,1,258289
18444,0.002726,172.31.36.0-255,66,248352,1,258289
18445,0.002728,172.31.36.0-255,66,248418,1,258289
18446,0.002729,172.31.36.0-255,66,248484,1,258289
18447,0.002729,172.31.36.0-255,66,248550,1,258289
18448,0.00273,172.31.36.0-255,66,248616,1,258289
18449,0.002731,172.31.36.0-255,66,248682,1,258289
18450,0.002774,172.31.36.0-255,66,248748,1,258289
18451,0.002776,74.125.130.0-255,105,248853,1,258289
18452,0.003147,172.31.36.0-255,101,248954,1,258289
18453,0.005056,172.31.36.0-255,105,249059,1,258289
18454,0.005408,74.125.130.0-255,66,249125,1,258289
18455,0.00732,74.125.130.0-255,66,249191,1,258289
18456,0.039707,172.31.36.0-255,172,249363,1,258289
18457,0.039891,172.31.36.0-255,1114,250477,1,258289
18458,0.03997,172.31.36.0-255,1514,251991,1,258289
18459,0.039972,172.31.36.0-255,1514,253505,1,258289
18460,0.039977,172.31.36.0-255,1514,255019,1,258289
18461,0.039979,172.31.36.0-255,1514,256533,1,258289
18462,0.040007,172.31.36.0-255,1492,258025,1,258289
18463,0.041222,104.244.42.0-255,66,258091,1,258289
18464,0.041394,104.244.42.0-255,66,258157,1,258289
18465,0.04151,104.244.42.0-255,66,258223,1,258289
18466,0.041565,104.244.42.0-255,66,258289,1,258289
18467,0.0,74.125.68.0-255,153,153,1,294351
18468,2.3e-05,172.31.36.0-255,66,219,1,294351
18469,3.1e-05,74.125.68.0-255,1484,1703,1,294351
18470,3.5e-05,172.31.36.0-255,66,1769,1,294351
18471,4.1e-05,74.125.68.0-255,2902,4671,1,294351
18472,4.4e-05,172.31.36.0-255,66,4737,1,294351
18473,5.1e-05,74.125.68.0-255,5738,10475,1,294351
18474,5.3e-05,172.31.36.0-255,66,10541,1,294351
18475,5.9e-05,74.125.68.0-255,3385,13926,1,294351
18476,6.3e-05,172.31.36.0-255,66,13992,1,294351
18477,6.9e-05,74.125.68.0-255,4320,18312,1,294351
18478,7.2e-05,172.31.36.0-255,66,18378,1,294351
18479,9.4e-05,74.125.68.0-255,4320,22698,1,294351
18480,9.7e-05,172.31.36.0-255,66,22764,1,294351
18481,0.000119,74.125.68.0-255,5738,28502,1,294351
18482,0.000121,172.31.36.0-255,66,28568,1,294351
18483,0.000128,74.125.68.0-255,5738,34306,1,294351
18484,0.000131,172.31.36.0-255,66,34372,1,294351
18485,0.000204,74.125.68.0-255,5738,40110,1,294351
18486,0.000207,172.31.36.0-255,66,40176,1,294351
18487,0.000228,172.31.36.0-255,66,40242,1,294351
18488,0.00072,74.125.68.0-255,1484,41726,1,294351
18489,0.000726,172.31.36.0-255,66,41792,1,294351
18490,0.000733,74.125.68.0-255,2902,44694,1,294351
18491,0.000735,172.31.36.0-255,66,44760,1,294351
18492,0.000766,74.125.68.0-255,5738,50498,1,294351
18493,0.000769,172.31.36.0-255,66,50564,1,294351
18494,0.000773,74.125.68.0-255,2902,53466,1,294351
18495,0.000775,172.31.36.0-255,66,53532,1,294351
18496,0.000781,74.125.68.0-255,4271,57803,1,294351
18497,0.000783,172.31.36.0-255,66,57869,1,294351
18498,0.000786,74.125.68.0-255,347,58216,1,294351
18499,0.001052,172.31.36.0-255,66,58282,1,294351
18500,0.001454,74.125.68.0-255,1484,59766,1,294351
18501,0.001464,74.125.68.0-255,2902,62668,1,294351
18502,0.001468,172.31.36.0-255,66,62734,1,294351
18503,0.001473,74.125.68.0-255,1484,64218,1,294351
18504,0.001478,74.125.68.0-255,2902,67120,1,294351
18505,0.00148,172.31.36.0-255,66,67186,1,294351
18506,0.001533,74.125.68.0-255,4320,71506,1,294351
18507,0.001536,172.31.36.0-255,66,71572,1,294351
18508,0.00156,74.125.68.0-255,5738,77310,1,294351
18509,0.001562,172.31.36.0-255,66,77376,1,294351
18510,0.001565,74.125.68.0-255,1484,78860,1,294351
18511,0.001589,172.31.36.0-255,66,78926,1,294351
18512,0.001606,74.125.68.0-255,1484,80410,1,294351
18513,0.001631,74.125.68.0-255,3602,84012,1,294351
18514,0.001634,172.31.36.0-255,66,84078,1,294351
18515,0.001651,74.125.68.0-255,4320,88398,1,294351
18516,0.001653,172.31.36.0-255,66,88464,1,294351
18517,0.001671,74.125.68.0-255,2902,91366,1,294351
18518,0.001674,172.31.36.0-255,66,91432,1,294351
18519,0.001703,74.125.68.0-255,4320,95752,1,294351
18520,0.001705,172.31.36.0-255,66,95818,1,294351
18521,0.001717,172.31.36.0-255,66,95884,1,294351
18522,0.001737,74.125.68.0-255,7156,103040,1,294351
18523,0.00174,172.31.36.0-255,66,103106,1,294351
18524,0.001765,74.125.68.0-255,6438,109544,1,294351
18525,0.001768,172.31.36.0-255,66,109610,1,294351
18526,0.001771,74.125.68.0-255,1484,111094,1,294351
18527,0.001799,172.31.36.0-255,66,111160,1,294351
18528,0.001832,74.125.68.0-255,5738,116898,1,294351
18529,0.001835,172.31.36.0-255,66,116964,1,294351
18530,0.001861,172.31.36.0-255,66,117030,1,294351
18531,0.001866,74.125.68.0-255,2902,119932,1,294351
18532,0.001868,172.31.36.0-255,66,119998,1,294351
18533,0.001889,74.125.68.0-255,3602,123600,1,294351
18534,0.001892,172.31.36.0-255,66,123666,1,294351
18535,0.001898,74.125.68.0-255,4320,127986,1,294351
18536,0.0019,172.31.36.0-255,66,128052,1,294351
18537,0.001925,74.125.68.0-255,4320,132372,1,294351
18538,0.001928,172.31.36.0-255,66,132438,1,294351
18539,0.00195,74.125.68.0-255,5738,138176,1,294351
18540,0.001954,172.31.36.0-255,66,138242,1,294351
18541,0.001959,74.125.68.0-255,4320,142562,1,294351
18542,0.001962,172.31.36.0-255,66,142628,1,294351
18543,0.002004,74.125.68.0-255,7156,149784,1,294351
18544,0.002008,172.31.36.0-255,66,149850,1,294351
18545,0.002028,74.125.68.0-255,5020,154870,1,294351
18546,0.002032,172.31.36.0-255,66,154936,1,294351
18547,0.002046,172.31.36.0-255,66,155002,1,294351
18548,0.002051,74.125.68.0-255,4320,159322,1,294351
18549,0.002054,172.31.36.0-255,66,159388,1,294351
18550,0.002085,74.125.68.0-255,4320,163708,1,294351
18551,0.002088,172.31.36.0-255,66,163774,1,294351
18552,0.002099,172.31.36.0-255,66,163840,1,294351
18553,0.002105,74.125.68.0-255,3602,167442,1,294351
18554,0.002107,172.31.36.0-255,66,167508,1,294351
18555,0.002113,74.125.68.0-255,4320,171828,1,294351
18556,0.002115,172.31.36.0-255,66,171894,1,294351
18557,0.002177,172.31.36.0-255,66,171960,1,294351
18558,0.002187,74.125.68.0-255,4320,176280,1,294351
18559,0.00219,172.31.36.0-255,66,176346,1,294351
18560,0.002229,172.31.36.0-255,66,176412,1,294351
18561,0.002275,74.125.68.0-255,5738,182150,1,294351
18562,0.002295,74.125.68.0-255,2902,185052,1,294351
18563,0.002324,74.125.68.0-255,3602,188654,1,294351
18564,0.002351,74.125.68.0-255,1484,190138,1,294351
18565,0.002376,74.125.68.0-255,2902,193040,1,294351
18566,0.002397,74.125.68.0-255,5738,198778,1,294351
18567,0.0024,74.125.68.0-255,1484,200262,1,294351
18568,0.002417,74.125.68.0-255,1484,201746,1,294351
18569,0.002422,74.125.68.0-255,4320,206066,1,294351
18570,0.002442,74.125.68.0-255,2902,208968,1,294351
18571,0.002458,74.125.68.0-255,5738,214706,1,294351
18572,0.002466,74.125.68.0-255,5738,220444,1,294351
18573,0.002499,74.125.68.0-255,6438,226882,1,294351
18574,0.002502,74.125.68.0-255,1484,228366,1,294351
18575,0.002514,74.125.68.0-255,2902,231268,1,294351
18576,0.002535,74.125.68.0-255,5738,237006,1,294351
18577,0.002566,74.125.68.0-255,5738,242744,1,294351
18578,0.00258,74.125.68.0-255,2902,245646,1,294351
18579,0.002595,74.125.68.0-255,1484,247130,1,294351
18580,0.006386,172.31.36.0-255,66,247196,1,294351
18581,0.008988,74.125.68.0-255,5738,252934,1,294351
18582,0.008998,172.31.36.0-255,66,253000,1,294351
18583,0.011583,74.125.68.0-255,5738,258738,1,294351
18584,0.011592,172.31.36.0-255,66,258804,1,294351
18585,0.014201,74.125.68.0-255,5738,264542,1,294351
18586,0.014211,172.31.36.0-255,66,264608,1,294351
18587,0.016808,74.125.68.0-255,5738,270346,1,294351
18588,0.016819,172.31.36.0-255,66,270412,1,294351
18589,0.019406,74.125.68.0-255,5738,276150,1,294351
18590,0.019417,172.31.36.0-255,66,276216,1,294351
18591,0.022019,74.125.68.0-255,5738,281954,1,294351
18592,0.022028,172.31.36.0-255,66,282020,1,294351
18593,0.024615,74.125.68.0-255,5738,287758,1,294351
18594,0.024627,172.31.36.0-255,66,287824,1,294351
18595,0.027212,74.125.68.0-255,2902,290726,1,294351
18596,0.027219,172.31.36.0-255,66,290792,1,294351
18597,0.02724,74.125.68.0-255,2902,293694,1,294351
18598,0.027243,172.31.36.0-255,66,293760,1,294351
18599,0.029767,74.125.68.0-255,354,294114,1,294351
18600,0.030158,172.31.36.0-255,66,294180,1,294351
18601,0.030201,172.31.36.0-255,105,294285,1,294351
18602,0.032745,74.125.68.0-255,66,294351,1,294351
18603,0.0,172.217.194.0-255,161,161,1,210604
18604,2e-05,172.31.36.0-255,66,227,1,210604
18605,2.7e-05,172.217.194.0-255,1484,1711,1,210604
18606,3.1e-05,172.31.36.0-255,66,1777,1,210604
18607,4.6e-05,172.217.194.0-255,2902,4679,1,210604
18608,5.1e-05,172.31.36.0-255,66,4745,1,210604
18609,5.8e-05,172.217.194.0-255,5738,10483,1,210604
18610,6.2e-05,172.31.36.0-255,66,10549,1,210604
18611,0.000109,172.31.36.0-255,66,10615,1,210604
18612,0.000114,172.217.194.0-255,2902,13517,1,210604
18613,0.000117,172.31.36.0-255,66,13583,1,210604
18614,0.000144,172.217.194.0-255,3961,17544,1,210604
18615,0.000147,172.31.36.0-255,66,17610,1,210604
18616,0.000188,172.217.194.0-255,4320,21930,1,210604
18617,0.00019,172.31.36.0-255,66,21996,1,210604
18618,0.000195,172.217.194.0-255,2902,24898,1,210604
18619,0.000197,172.31.36.0-255,66,24964,1,210604
18620,0.000223,172.217.194.0-255,2902,27866,1,210604
18621,0.000226,172.31.36.0-255,66,27932,1,210604
18622,0.000244,172.31.36.0-255,66,27998,1,210604
18623,0.000256,172.31.36.0-255,66,28064,1,210604
18624,0.00028,172.217.194.0-255,1484,29548,1,210604
18625,0.000282,172.31.36.0-255,66,29614,1,210604
18626,0.000285,172.217.194.0-255,1416,31030,1,210604
18627,0.000287,172.31.36.0-255,66,31096,1,210604
18628,0.000331,172.217.194.0-255,364,31460,1,210604
18629,0.000333,172.31.36.0-255,66,31526,1,210604
18630,0.000409,172.217.194.0-255,1484,33010,1,210604
18631,0.000413,172.31.36.0-255,66,33076,1,210604
18632,0.000418,172.217.194.0-255,2902,35978,1,210604
18633,0.000421,172.31.36.0-255,66,36044,1,210604
18634,0.000425,172.217.194.0-255,1484,37528,1,210604
18635,0.000459,172.217.194.0-255,4320,41848,1,210604
18636,0.000462,172.31.36.0-255,66,41914,1,210604
18637,0.00049,172.217.194.0-255,6248,48162,1,210604
18638,0.000493,172.31.36.0-255,66,48228,1,210604
18639,0.000821,172.217.194.0-255,1484,49712,1,210604
18640,0.000829,172.217.194.0-255,2902,52614,1,210604
18641,0.000832,172.31.36.0-255,66,52680,1,210604
18642,0.000867,172.217.194.0-255,5738,58418,1,210604
18643,0.000873,172.31.36.0-255,66,58484,1,210604
18644,0.000885,172.217.194.0-255,4320,62804,1,210604
18645,0.000887,172.31.36.0-255,66,62870,1,210604
18646,0.00092,172.31.36.0-255,66,62936,1,210604
18647,0.000927,172.217.194.0-255,5738,68674,1,210604
18648,0.000929,172.31.36.0-255,66,68740,1,210604
18649,0.000962,172.217.194.0-255,5020,73760,1,210604
18650,0.00097,172.31.36.0-255,66,73826,1,210604
18651,0.002183,172.217.194.0-255,1484,75310,1,210604
18652,0.002193,172.217.194.0-255,2902,78212,1,210604
18653,0.002199,172.31.36.0-255,66,78278,1,210604
18654,0.002207,172.217.194.0-255,5738,84016,1,210604
18655,0.00221,172.31.36.0-255,66,84082,1,210604
18656,0.002227,172.31.36.0-255,66,84148,1,210604
18657,0.002276,172.31.36.0-255,66,84214,1,210604
18658,0.002295,172.217.194.0-255,2184,86398,1,210604
18659,0.002298,172.31.36.0-255,66,86464,1,210604
18660,0.004483,172.217.194.0-255,2902,89366,1,210604
18661,0.004491,172.31.36.0-255,66,89432,1,210604
18662,0.004527,172.217.194.0-255,2902,92334,1,210604
18663,0.00453,172.31.36.0-255,66,92400,1,210604
18664,0.006752,172.217.194.0-255,5738,98138,1,210604
18665,0.006762,172.31.36.0-255,66,98204,1,210604
18666,0.009038,172.217.194.0-255,5738,103942,1,210604
18667,0.009049,172.31.36.0-255,66,104008,1,210604
18668,0.011334,172.217.194.0-255,5738,109746,1,210604
18669,0.011342,172.31.36.0-255,66,109812,1,210604
18670,0.013574,172.217.194.0-255,5738,115550,1,210604
18671,0.013582,172.31.36.0-255,66,115616,1,210604
18672,0.015875,172.217.194.0-255,5738,121354,1,210604
18673,0.015883,172.31.36.0-255,66,121420,1,210604
18674,0.018146,172.217.194.0-255,5738,127158,1,210604
18675,0.018162,172.31.36.0-255,66,127224,1,210604
18676,0.020386,172.217.194.0-255,5738,132962,1,210604
18677,0.020395,172.31.36.0-255,66,133028,1,210604
18678,0.022626,172.217.194.0-255,5738,138766,1,210604
18679,0.022635,172.31.36.0-255,66,138832,1,210604
18680,0.024864,172.217.194.0-255,5738,144570,1,210604
18681,0.024873,172.31.36.0-255,66,144636,1,210604
18682,0.027157,172.217.194.0-255,5738,150374,1,210604
18683,0.027166,172.31.36.0-255,66,150440,1,210604
18684,0.029388,172.217.194.0-255,5738,156178,1,210604
18685,0.029396,172.31.36.0-255,66,156244,1,210604
18686,0.031623,172.217.194.0-255,5738,161982,1,210604
18687,0.031631,172.31.36.0-255,66,162048,1,210604
18688,0.033894,172.217.194.0-255,5738,167786,1,210604
18689,0.033903,172.31.36.0-255,66,167852,1,210604
18690,0.034804,172.31.36.0-255,247,168099,1,210604
18691,0.034836,172.31.36.0-255,1115,169214,1,210604
18692,0.034892,172.31.36.0-255,564,169778,1,210604
18693,0.036141,172.217.194.0-255,5738,175516,1,210604
18694,0.036148,172.31.36.0-255,66,175582,1,210604
18695,0.036376,104.244.42.0-255,66,175648,1,210604
18696,0.036383,104.244.42.0-255,66,175714,1,210604
18697,0.036459,104.244.42.0-255,66,175780,1,210604
18698,0.038408,172.217.194.0-255,5738,181518,1,210604
18699,0.038415,172.31.36.0-255,66,181584,1,210604
18700,0.040639,172.217.194.0-255,5738,187322,1,210604
18701,0.040647,172.31.36.0-255,66,187388,1,210604
18702,0.042878,172.217.194.0-255,5738,193126,1,210604
18703,0.042887,172.31.36.0-255,66,193192,1,210604
18704,0.045106,172.217.194.0-255,5738,198930,1,210604
18705,0.045113,172.31.36.0-255,66,198996,1,210604
18706,0.047352,172.217.194.0-255,5738,204734,1,210604
18707,0.047361,172.31.36.0-255,66,204800,1,210604
18708,0.049587,172.217.194.0-255,5738,210538,1,210604
18709,0.049593,172.31.36.0-255,66,210604,1,210604
18710,0.0,74.125.68.0-255,308,308,1,262663
18711,2.2e-05,172.31.36.0-255,66,374,1,262663
18712,2.7e-05,74.125.68.0-255,1484,1858,1,262663
18713,3.1e-05,172.31.36.0-255,66,1924,1,262663
18714,3.5e-05,74.125.68.0-255,4320,6244,1,262663
18715,3.8e-05,172.31.36.0-255,66,6310,1,262663
18716,4.8e-05,74.125.68.0-255,2902,9212,1,262663
18717,5e-05,172.31.36.0-255,66,9278,1,262663
18718,5.5e-05,74.125.68.0-255,2902,12180,1,262663
18719,5.7e-05,172.31.36.0-255,66,12246,1,262663
18720,8.8e-05,74.125.68.0-255,1484,13730,1,262663
18721,9e-05,172.31.36.0-255,66,13796,1,262663
18722,0.000117,74.125.68.0-255,2902,16698,1,262663
18723,0.00012,172.31.36.0-255,66,16764,1,262663
18724,0.000139,74.125.68.0-255,4320,21084,1,262663
18725,0.000142,172.31.36.0-255,66,21150,1,262663
18726,0.000165,74.125.68.0-255,1775,22925,1,262663
18727,0.000167,172.31.36.0-255,66,22991,1,262663
18728,0.0002,74.125.68.0-255,2902,25893,1,262663
18729,0.000203,172.31.36.0-255,66,25959,1,262663
18730,0.000232,74.125.68.0-255,5379,31338,1,262663
18731,0.000234,172.31.36.0-255,66,31404,1,262663
18732,0.000553,74.125.68.0-255,1484,32888,1,262663
18733,0.000557,172.31.36.0-255,66,32954,1,262663
18734,0.000564,74.125.68.0-255,1484,34438,1,262663
18735,0.000566,172.31.36.0-255,66,34504,1,262663
18736,0.000575,74.125.68.0-255,2902,37406,1,262663
18737,0.000577,172.31.36.0-255,66,37472,1,262663
18738,0.000581,74.125.68.0-255,2902,40374,1,262663
18739,0.000583,172.31.36.0-255,66,40440,1,262663
18740,0.000608,74.125.68.0-255,2902,43342,1,262663
18741,0.000615,172.31.36.0-255,66,43408,1,262663
18742,0.00062,74.125.68.0-255,2902,46310,1,262663
18743,0.000622,172.31.36.0-255,66,46376,1,262663
18744,0.000656,74.125.68.0-255,7156,53532,1,262663
18745,0.00066,172.31.36.0-255,66,53598,1,262663
18746,0.000697,74.125.68.0-255,4320,57918,1,262663
18747,0.0007,172.31.36.0-255,66,57984,1,262663
18748,0.000728,74.125.68.0-255,7156,65140,1,262663
18749,0.000731,172.31.36.0-255,66,65206,1,262663
18750,0.000773,74.125.68.0-255,766,65972,1,262663
18751,0.000787,74.125.68.0-255,677,66649,1,262663
18752,0.000804,74.125.68.0-255,1484,68133,1,262663
18753,0.000808,172.31.36.0-255,66,68199,1,262663
18754,0.000826,74.125.68.0-255,1484,69683,1,262663
18755,0.000844,74.125.68.0-255,7156,76839,1,262663
18756,0.000848,172.31.36.0-255,66,76905,1,262663
18757,0.000895,74.125.68.0-255,4320,81225,1,262663
18758,0.000899,172.31.36.0-255,66,81291,1,262663
18759,0.000935,74.125.68.0-255,7156,88447,1,262663
18760,0.000939,172.31.36.0-255,66,88513,1,262663
18761,0.000997,74.125.68.0-255,7156,95669,1,262663
18762,0.001003,172.31.36.0-255,66,95735,1,262663
18763,0.001033,74.125.68.0-255,5020,100755,1,262663
18764,0.001036,172.31.36.0-255,66,100821,1,262663
18765,0.001469,74.125.68.0-255,1484,102305,1,262663
18766,0.001475,74.125.68.0-255,1484,103789,1,262663
18767,0.001481,172.31.36.0-255,66,103855,1,262663
18768,0.001506,74.125.68.0-255,1484,105339,1,262663
18769,0.001513,74.125.68.0-255,5738,111077,1,262663
18770,0.001515,172.31.36.0-255,66,111143,1,262663
18771,0.001533,74.125.68.0-255,2902,114045,1,262663
18772,0.001537,172.31.36.0-255,66,114111,1,262663
18773,0.001566,74.125.68.0-255,4320,118431,1,262663
18774,0.001569,172.31.36.0-255,66,118497,1,262663
18775,0.001601,74.125.68.0-255,4320,122817,1,262663
18776,0.001603,172.31.36.0-255,66,122883,1,262663
18777,0.001632,74.125.68.0-255,4320,127203,1,262663
18778,0.001634,172.31.36.0-255,66,127269,1,262663
18779,0.001665,74.125.68.0-255,1484,128753,1,262663
18780,0.001682,74.125.68.0-255,2902,131655,1,262663
18781,0.001684,172.31.36.0-255,66,131721,1,262663
18782,0.001712,74.125.68.0-255,3602,135323,1,262663
18783,0.001715,172.31.36.0-255,66,135389,1,262663
18784,0.003876,74.125.68.0-255,1484,136873,1,262663
18785,0.003914,74.125.68.0-255,4320,141193,1,262663
18786,0.003919,172.31.36.0-255,66,141259,1,262663
18787,0.006122,74.125.68.0-255,5738,146997,1,262663
18788,0.006128,172.31.36.0-255,66,147063,1,262663
18789,0.008327,74.125.68.0-255,4320,151383,1,262663
18790,0.008333,172.31.36.0-255,66,151449,1,262663
18791,0.008362,74.125.68.0-255,1484,152933,1,262663
18792,0.01053,74.125.68.0-255,1484,154417,1,262663
18793,0.010535,172.31.36.0-255,66,154483,1,262663
18794,0.010567,74.125.68.0-255,2902,157385,1,262663
18795,0.010571,172.31.36.0-255,66,157451,1,262663
18796,0.012877,74.125.68.0-255,5738,163189,1,262663
18797,0.012885,172.31.36.0-255,66,163255,1,262663
18798,0.01509,74.125.68.0-255,5738,168993,1,262663
18799,0.015098,172.31.36.0-255,66,169059,1,262663
18800,0.017325,74.125.68.0-255,5738,174797,1,262663
18801,0.017338,172.31.36.0-255,66,174863,1,262663
18802,0.019564,74.125.68.0-255,5738,180601,1,262663
18803,0.019575,172.31.36.0-255,66,180667,1,262663
18804,0.0218,74.125.68.0-255,5738,186405,1,262663
18805,0.021816,172.31.36.0-255,66,186471,1,262663
18806,0.024025,74.125.68.0-255,5738,192209,1,262663
18807,0.024036,172.31.36.0-255,66,192275,1,262663
18808,0.026255,74.125.68.0-255,5738,198013,1,262663
18809,0.026265,172.31.36.0-255,66,198079,1,262663
18810,0.028469,74.125.68.0-255,1484,199563,1,262663
18811,0.028497,74.125.68.0-255,4320,203883,1,262663
18812,0.028505,172.31.36.0-255,66,203949,1,262663
18813,0.030717,74.125.68.0-255,5738,209687,1,262663
18814,0.030725,172.31.36.0-255,66,209753,1,262663
18815,0.032774,172.31.36.0-255,192,209945,1,262663
18816,0.03283,172.31.36.0-255,958,210903,1,262663
18817,0.032914,172.31.36.0-255,1514,212417,1,262663
18818,0.032916,172.31.36.0-255,1514,213931,1,262663
18819,0.032922,172.31.36.0-255,1514,215445,1,262663
18820,0.032923,172.31.36.0-255,1514,216959,1,262663
18821,0.03296,74.125.68.0-255,4320,221279,1,262663
18822,0.032965,172.31.36.0-255,66,221345,1,262663
18823,0.03297,172.31.36.0-255,1514,222859,1,262663
18824,0.032971,172.31.36.0-255,198,223057,1,262663
18825,0.032983,74.125.68.0-255,1484,224541,1,262663
18826,0.034334,104.244.42.0-255,66,224607,1,262663
18827,0.034378,104.244.42.0-255,66,224673,1,262663
18828,0.034526,104.244.42.0-255,66,224739,1,262663
18829,0.034532,104.244.42.0-255,66,224805,1,262663
18830,0.035176,74.125.68.0-255,4320,229125,1,262663
18831,0.035183,172.31.36.0-255,66,229191,1,262663
18832,0.037386,74.125.68.0-255,4320,233511,1,262663
18833,0.037393,172.31.36.0-255,66,233577,1,262663
18834,0.037418,74.125.68.0-255,1484,235061,1,262663
18835,0.039598,74.125.68.0-255,4320,239381,1,262663
18836,0.039606,172.31.36.0-255,66,239447,1,262663
18837,0.041818,74.125.68.0-255,5738,245185,1,262663
18838,0.041824,172.31.36.0-255,66,245251,1,262663
18839,0.044044,74.125.68.0-255,5738,250989,1,262663
18840,0.04405,172.31.36.0-255,66,251055,1,262663
18841,0.04626,74.125.68.0-255,5738,256793,1,262663
18842,0.046266,172.31.36.0-255,66,256859,1,262663
18843,0.048472,74.125.68.0-255,5738,262597,1,262663
18844,0.048479,172.31.36.0-255,66,262663,1,262663
18845,0.0,74.125.24.0-255,146,146,1,231198
18846,3.2e-05,172.31.36.0-255,66,212,1,231198
18847,4e-05,74.125.24.0-255,1484,1696,1,231198
18848,4.4e-05,172.31.36.0-255,66,1762,1,231198
18849,4.9e-05,74.125.24.0-255,2902,4664,1,231198
18850,5.1e-05,172.31.36.0-255,66,4730,1,231198
18851,5.7e-05,74.125.24.0-255,5738,10468,1,231198
18852,6.1e-05,172.31.36.0-255,66,10534,1,231198
18853,8e-05,74.125.24.0-255,1484,12018,1,231198
18854,8.2e-05,172.31.36.0-255,66,12084,1,231198
18855,8.7e-05,74.125.24.0-255,2058,14142,1,231198
18856,9e-05,172.31.36.0-255,66,14208,1,231198
18857,0.000118,74.125.24.0-255,2902,17110,1,231198
18858,0.00012,172.31.36.0-255,66,17176,1,231198
18859,0.000147,74.125.24.0-255,7156,24332,1,231198
18860,0.00015,172.31.36.0-255,66,24398,1,231198
18861,0.000155,74.125.24.0-255,4320,28718,1,231198
18862,0.000157,172.31.36.0-255,66,28784,1,231198
18863,0.000197,74.125.24.0-255,2543,31327,1,231198
18864,0.000199,172.31.36.0-255,66,31393,1,231198
18865,0.000273,74.125.24.0-255,1484,32877,1,231198
18866,0.000276,172.31.36.0-255,66,32943,1,231198
18867,0.000294,74.125.24.0-255,2902,35845,1,231198
18868,0.000297,172.31.36.0-255,66,35911,1,231198
18869,0.000303,74.125.24.0-255,4320,40231,1,231198
18870,0.000305,172.31.36.0-255,66,40297,1,231198
18871,0.00032,74.125.24.0-255,1484,41781,1,231198
18872,0.000323,172.31.36.0-255,66,41847,1,231198
18873,0.000331,74.125.24.0-255,6797,48644,1,231198
18874,0.000333,172.31.36.0-255,66,48710,1,231198
18875,0.000367,74.125.24.0-255,4320,53030,1,231198
18876,0.000371,172.31.36.0-255,66,53096,1,231198
18877,0.000378,74.125.24.0-255,5738,58834,1,231198
18878,0.000381,172.31.36.0-255,66,58900,1,231198
18879,0.000412,74.125.24.0-255,6797,65697,1,231198
18880,0.000415,172.31.36.0-255,66,65763,1,231198
18881,0.000418,74.125.24.0-255,394,66157,1,231198
18882,0.000493,74.125.24.0-255,1484,67641,1,231198
18883,0.000496,74.125.24.0-255,1484,69125,1,231198
18884,0.0005,172.31.36.0-255,66,69191,1,231198
18885,0.000511,74.125.24.0-255,1484,70675,1,231198
18886,0.000514,172.31.36.0-255,66,70741,1,231198
18887,0.000521,74.125.24.0-255,5738,76479,1,231198
18888,0.000524,172.31.36.0-255,66,76545,1,231198
18889,0.000556,172.31.36.0-255,66,76611,1,231198
18890,0.000563,74.125.24.0-255,5738,82349,1,231198
18891,0.000565,172.31.36.0-255,66,82415,1,231198
18892,0.000602,74.125.24.0-255,5020,87435,1,231198
18893,0.000607,172.31.36.0-255,66,87501,1,231198
18894,0.000713,74.125.24.0-255,1484,88985,1,231198
18895,0.000731,74.125.24.0-255,2902,91887,1,231198
18896,0.000734,172.31.36.0-255,66,91953,1,231198
18897,0.000757,74.125.24.0-255,5738,97691,1,231198
18898,0.00076,172.31.36.0-255,66,97757,1,231198
18899,0.000764,74.125.24.0-255,2902,100659,1,231198
18900,0.000766,172.31.36.0-255,66,100725,1,231198
18901,0.000798,172.31.36.0-255,66,100791,1,231198
18902,0.000804,74.125.24.0-255,4320,105111,1,231198
18903,0.000808,172.31.36.0-255,66,105177,1,231198
18904,0.000834,74.125.24.0-255,6438,111615,1,231198
18905,0.000838,172.31.36.0-255,66,111681,1,231198
18906,0.000941,74.125.24.0-255,1484,113165,1,231198
18907,0.000946,74.125.24.0-255,2902,116067,1,231198
18908,0.000949,172.31.36.0-255,66,116133,1,231198
18909,0.000955,74.125.24.0-255,5738,121871,1,231198
18910,0.000957,172.31.36.0-255,66,121937,1,231198
18911,0.000963,74.125.24.0-255,4320,126257,1,231198
18912,0.000964,172.31.36.0-255,66,126323,1,231198
18913,0.000994,172.31.36.0-255,66,126389,1,231198
18914,0.001004,172.31.36.0-255,66,126455,1,231198
18915,0.001024,74.125.24.0-255,2184,128639,1,231198
18916,0.001027,172.31.36.0-255,66,128705,1,231198
18917,0.001039,74.125.24.0-255,2902,131607,1,231198
18918,0.001042,172.31.36.0-255,66,131673,1,231198
18919,0.001073,74.125.24.0-255,7156,138829,1,231198
18920,0.001076,172.31.36.0-255,66,138895,1,231198
18921,0.001086,172.31.36.0-255,66,138961,1,231198
18922,0.001108,74.125.24.0-255,2902,141863,1,231198
18923,0.00111,172.31.36.0-255,66,141929,1,231198
18924,0.001139,74.125.24.0-255,2902,144831,1,231198
18925,0.001142,172.31.36.0-255,66,144897,1,231198
18926,0.00117,172.31.36.0-255,66,144963,1,231198
18927,0.001216,74.125.24.0-255,5738,150701,1,231198
18928,0.001219,172.31.36.0-255,66,150767,1,231198
18929,0.001241,74.125.24.0-255,7156,157923,1,231198
18930,0.001244,172.31.36.0-255,66,157989,1,231198
18931,0.001249,74.125.24.0-255,3664,161653,1,231198
18932,0.001251,172.31.36.0-255,66,161719,1,231198
18933,0.001267,74.125.24.0-255,5738,167457,1,231198
18934,0.00127,172.31.36.0-255,66,167523,1,231198
18935,0.001288,74.125.24.0-255,5738,173261,1,231198
18936,0.00129,172.31.36.0-255,66,173327,1,231198
18937,0.001305,172.31.36.0-255,66,173393,1,231198
18938,0.00134,74.125.24.0-255,5738,179131,1,231198
18939,0.001343,172.31.36.0-255,66,179197,1,231198
18940,0.001364,74.125.24.0-255,3602,182799,1,231198
18941,0.001367,172.31.36.0-255,66,182865,1,231198
18942,0.001752,74.125.24.0-255,1484,184349,1,231198
18943,0.001758,74.125.24.0-255,2902,187251,1,231198
18944,0.001761,172.31.36.0-255,66,187317,1,231198
18945,0.001767,74.125.24.0-255,2902,190219,1,231198
18946,0.001769,172.31.36.0-255,66,190285,1,231198
18947,0.001782,74.125.24.0-255,2902,193187,1,231198
18948,0.001785,172.31.36.0-255,66,193253,1,231198
18949,0.00179,74.125.24.0-255,2902,196155,1,231198
18950,0.001791,172.31.36.0-255,66,196221,1,231198
18951,0.001823,172.31.36.0-255,66,196287,1,231198
18952,0.001847,74.125.24.0-255,5738,202025,1,231198
18953,0.001851,172.31.36.0-255,66,202091,1,231198
18954,0.001883,172.31.36.0-255,66,202157,1,231198
18955,0.001889,74.125.24.0-255,7156,209313,1,231198
18956,0.001892,172.31.36.0-255,66,209379,1,231198
18957,0.001921,172.31.36.0-255,66,209445,1,231198
18958,0.001952,172.31.36.0-255,66,209511,1,231198
18959,0.00197,172.31.36.0-255,66,209577,1,231198
18960,0.001982,172.31.36.0-255,66,209643,1,231198
18961,0.002003,74.125.24.0-255,1484,211127,1,231198
18962,0.002024,172.31.36.0-255,66,211193,1,231198
18963,0.002042,74.125.24.0-255,2184,213377,1,231198
18964,0.002044,172.31.36.0-255,66,213443,1,231198
18965,0.002056,172.31.36.0-255,66,213509,1,231198
18966,0.002075,74.125.24.0-255,2902,216411,1,231198
18967,0.002078,172.31.36.0-255,66,216477,1,231198
18968,0.002089,172.31.36.0-255,66,216543,1,231198
18969,0.002117,74.125.24.0-255,5020,221563,1,231198
18970,0.002126,172.31.36.0-255,66,221629,1,231198
18971,0.002131,172.31.36.0-255,66,221695,1,231198
18972,0.002143,172.31.36.0-255,66,221761,1,231198
18973,0.002198,74.125.24.0-255,105,221866,1,231198
18974,0.007648,172.31.36.0-255,66,221932,1,231198
18975,0.007675,172.31.36.0-255,105,222037,1,231198
18976,0.009893,74.125.24.0-255,66,222103,1,231198
18977,0.038516,172.31.36.0-255,172,222275,1,231198
18978,0.038664,172.31.36.0-255,1113,223388,1,231198
18979,0.038731,172.31.36.0-255,1514,224902,1,231198
18980,0.038732,172.31.36.0-255,1514,226416,1,231198
18981,0.038734,172.31.36.0-255,1514,227930,1,231198
18982,0.038735,172.31.36.0-255,1514,229444,1,231198
18983,0.038762,172.31.36.0-255,1490,230934,1,231198
18984,0.040044,104.244.42.0-255,66,231000,1,231198
18985,0.040234,104.244.42.0-255,66,231066,1,231198
18986,0.040325,104.244.42.0-255,66,231132,1,231198
18987,0.040376,104.244.42.0-255,66,231198,1,231198
18988,0.0,74.125.24.0-255,153,153,1,250998
18989,3.2e-05,172.31.36.0-255,66,219,1,250998
18990,3.9e-05,74.125.24.0-255,1484,1703,1,250998
18991,4.3e-05,172.31.36.0-255,66,1769,1,250998
18992,4.9e-05,74.125.24.0-255,2902,4671,1,250998
18993,5.9e-05,172.31.36.0-255,66,4737,1,250998
18994,6.5e-05,74.125.24.0-255,5738,10475,1,250998
18995,6.8e-05,172.31.36.0-255,66,10541,1,250998
18996,0.000126,172.31.36.0-255,66,10607,1,250998
18997,0.000207,74.125.24.0-255,6797,17404,1,250998
18998,0.000214,172.31.36.0-255,66,17470,1,250998
18999,0.000253,74.125.24.0-255,7156,24626,1,250998
19000,0.000256,172.31.36.0-255,66,24692,1,250998
19001,0.00033,172.31.36.0-255,66,24758,1,250998
19002,0.000356,74.125.24.0-255,2543,27301,1,250998
19003,0.000359,172.31.36.0-255,66,27367,1,250998
19004,0.000412,74.125.24.0-255,5738,33105,1,250998
19005,0.000417,172.31.36.0-255,66,33171,1,250998
19006,0.000473,172.31.36.0-255,66,33237,1,250998
19007,0.000516,74.125.24.0-255,648,33885,1,250998
19008,0.00052,172.31.36.0-255,66,33951,1,250998
19009,0.00068,74.125.24.0-255,1484,35435,1,250998
19010,0.000685,172.31.36.0-255,66,35501,1,250998
19011,0.000691,74.125.24.0-255,2902,38403,1,250998
19012,0.000694,172.31.36.0-255,66,38469,1,250998
19013,0.000706,74.125.24.0-255,5738,44207,1,250998
19014,0.00071,172.31.36.0-255,66,44273,1,250998
19015,0.000751,172.31.36.0-255,66,44339,1,250998
19016,0.00078,74.125.24.0-255,4320,48659,1,250998
19017,0.000784,172.31.36.0-255,66,48725,1,250998
19018,0.000866,172.31.36.0-255,66,48791,1,250998
19019,0.000953,172.31.36.0-255,66,48857,1,250998
19020,0.000988,74.125.24.0-255,2902,51759,1,250998
19021,0.000992,172.31.36.0-255,66,51825,1,250998
19022,0.001042,172.31.36.0-255,66,51891,1,250998
19023,0.001081,172.31.36.0-255,66,51957,1,250998
19024,0.001219,74.125.24.0-255,7156,59113,1,250998
19025,0.001225,172.31.36.0-255,66,59179,1,250998
19026,0.001292,172.31.36.0-255,66,59245,1,250998
19027,0.001345,74.125.24.0-255,2902,62147,1,250998
19028,0.00135,172.31.36.0-255,66,62213,1,250998
19029,0.001397,172.31.36.0-255,66,62279,1,250998
19030,0.001466,74.125.24.0-255,766,63045,1,250998
19031,0.001699,74.125.24.0-255,1484,64529,1,250998
19032,0.001705,172.31.36.0-255,66,64595,1,250998
19033,0.001711,74.125.24.0-255,2902,67497,1,250998
19034,0.001714,172.31.36.0-255,66,67563,1,250998
19035,0.001742,74.125.24.0-255,5738,73301,1,250998
19036,0.001751,172.31.36.0-255,66,73367,1,250998
19037,0.001785,74.125.24.0-255,7156,80523,1,250998
19038,0.001789,172.31.36.0-255,66,80589,1,250998
19039,0.001824,74.125.24.0-255,5738,86327,1,250998
19040,0.001827,172.31.36.0-255,66,86393,1,250998
19041,0.001865,172.31.36.0-255,66,86459,1,250998
19042,0.001937,74.125.24.0-255,2184,88643,1,250998
19043,0.001941,172.31.36.0-255,66,88709,1,250998
19044,0.002009,74.125.24.0-255,1484,90193,1,250998
19045,0.002015,74.125.24.0-255,2902,93095,1,250998
19046,0.002018,172.31.36.0-255,66,93161,1,250998
19047,0.002022,74.125.24.0-255,1484,94645,1,250998
19048,0.002049,74.125.24.0-255,4320,98965,1,250998
19049,0.002053,172.31.36.0-255,66,99031,1,250998
19050,0.00208,74.125.24.0-255,4320,103351,1,250998
19051,0.002084,172.31.36.0-255,66,103417,1,250998
19052,0.002113,74.125.24.0-255,1484,104901,1,250998
19053,0.002119,74.125.24.0-255,4320,109221,1,250998
19054,0.002122,172.31.36.0-255,66,109287,1,250998
19055,0.00216,172.31.36.0-255,66,109353,1,250998
19056,0.002235,74.125.24.0-255,5020,114373,1,250998
19057,0.002241,172.31.36.0-255,66,114439,1,250998
19058,0.004275,74.125.24.0-255,5738,120177,1,250998
19059,0.00428,172.31.36.0-255,66,120243,1,250998
19060,0.006346,74.125.24.0-255,5738,125981,1,250998
19061,0.006352,172.31.36.0-255,66,126047,1,250998
19062,0.008398,74.125.24.0-255,5738,131785,1,250998
19063,0.008403,172.31.36.0-255,66,131851,1,250998
19064,0.010469,74.125.24.0-255,5738,137589,1,250998
19065,0.010474,172.31.36.0-255,66,137655,1,250998
19066,0.012555,74.125.24.0-255,5738,143393,1,250998
19067,0.012563,172.31.36.0-255,66,143459,1,250998
19068,0.014622,74.125.24.0-255,5738,149197,1,250998
19069,0.014638,172.31.36.0-255,66,149263,1,250998
19070,0.016708,74.125.24.0-255,5738,155001,1,250998
19071,0.016724,172.31.36.0-255,66,155067,1,250998
19072,0.018805,74.125.24.0-255,5738,160805,1,250998
19073,0.018818,172.31.36.0-255,66,160871,1,250998
19074,0.020865,74.125.24.0-255,5738,166609,1,250998
19075,0.020877,172.31.36.0-255,66,166675,1,250998
19076,0.022941,74.125.24.0-255,5738,172413,1,250998
19077,0.022949,172.31.36.0-255,66,172479,1,250998
19078,0.025001,74.125.24.0-255,5738,178217,1,250998
19079,0.025009,172.31.36.0-255,66,178283,1,250998
19080,0.027094,74.125.24.0-255,5738,184021,1,250998
19081,0.027108,172.31.36.0-255,66,184087,1,250998
19082,0.02914,74.125.24.0-255,5738,189825,1,250998
19083,0.029147,172.31.36.0-255,66,189891,1,250998
19084,0.031211,74.125.24.0-255,5738,195629,1,250998
19085,0.031218,172.31.36.0-255,66,195695,1,250998
19086,0.033281,74.125.24.0-255,5738,201433,1,250998
19087,0.033288,172.31.36.0-255,66,201499,1,250998
19088,0.035325,74.125.24.0-255,5738,207237,1,250998
19089,0.035331,172.31.36.0-255,66,207303,1,250998
19090,0.037095,172.31.36.0-255,172,207475,1,250998
19091,0.037124,172.31.36.0-255,1114,208589,1,250998
19092,0.037175,172.31.36.0-255,1514,210103,1,250998
19093,0.037178,172.31.36.0-255,1289,211392,1,250998
19094,0.037403,74.125.24.0-255,5738,217130,1,250998
19095,0.037409,172.31.36.0-255,66,217196,1,250998
19096,0.038635,104.244.42.0-255,66,217262,1,250998
19097,0.038674,104.244.42.0-255,66,217328,1,250998
19098,0.03872,104.244.42.0-255,66,217394,1,250998
19099,0.039445,74.125.24.0-255,2902,220296,1,250998
19100,0.039449,172.31.36.0-255,66,220362,1,250998
19101,0.039475,74.125.24.0-255,2902,223264,1,250998
19102,0.039477,172.31.36.0-255,66,223330,1,250998
19103,0.041507,74.125.24.0-255,5738,229068,1,250998
19104,0.041523,172.31.36.0-255,66,229134,1,250998
19105,0.043623,74.125.24.0-255,4320,233454,1,250998
19106,0.043628,172.31.36.0-255,66,233520,1,250998
19107,0.043657,74.125.24.0-255,1484,235004,1,250998
19108,0.045667,74.125.24.0-255,4320,239324,1,250998
19109,0.045673,172.31.36.0-255,66,239390,1,250998
19110,0.047737,74.125.24.0-255,5738,245128,1,250998
19111,0.047743,172.31.36.0-255,66,245194,1,250998
19112,0.049813,74.125.24.0-255,5738,250932,1,250998
19113,0.049819,172.31.36.0-255,66,250998,1,250998
19114,0.0,172.217.194.0-255,151,151,1,225433
19115,3.4e-05,172.31.36.0-255,66,217,1,225433
19116,4.2e-05,172.217.194.0-255,1484,1701,1,225433
19117,4.6e-05,172.31.36.0-255,66,1767,1,225433
19118,5.1e-05,172.217.194.0-255,2902,4669,1,225433
19119,5.3e-05,172.31.36.0-255,66,4735,1,225433
19120,6e-05,172.217.194.0-255,7156,11891,1,225433
19121,6.3e-05,172.31.36.0-255,66,11957,1,225433
19122,6.6e-05,172.217.194.0-255,1484,13441,1,225433
19123,6.8e-05,172.31.36.0-255,66,13507,1,225433
19124,0.000107,172.31.36.0-255,66,13573,1,225433
19125,0.00011,172.217.194.0-255,1484,15057,1,225433
19126,0.000111,172.31.36.0-255,66,15123,1,225433
19127,0.000134,172.217.194.0-255,6797,21920,1,225433
19128,0.000137,172.31.36.0-255,66,21986,1,225433
19129,0.000367,172.217.194.0-255,1484,23470,1,225433
19130,0.000372,172.31.36.0-255,66,23536,1,225433
19131,0.000376,172.217.194.0-255,1484,25020,1,225433
19132,0.000378,172.31.36.0-255,66,25086,1,225433
19133,0.000393,172.217.194.0-255,1484,26570,1,225433
19134,0.000396,172.31.36.0-255,66,26636,1,225433
19135,0.000402,172.217.194.0-255,5738,32374,1,225433
19136,0.000405,172.31.36.0-255,66,32440,1,225433
19137,0.000427,172.217.194.0-255,5738,38178,1,225433
19138,0.00043,172.31.36.0-255,66,38244,1,225433
19139,0.000448,172.217.194.0-255,2543,40787,1,225433
19140,0.000451,172.31.36.0-255,66,40853,1,225433
19141,0.000455,172.217.194.0-255,2902,43755,1,225433
19142,0.00046,172.31.36.0-255,66,43821,1,225433
19143,0.000478,172.217.194.0-255,7156,50977,1,225433
19144,0.000481,172.31.36.0-255,66,51043,1,225433
19145,0.000493,172.217.194.0-255,5379,56422,1,225433
19146,0.000496,172.31.36.0-255,66,56488,1,225433
19147,0.000499,172.217.194.0-255,379,56867,1,225433
19148,0.000813,172.31.36.0-255,66,56933,1,225433
19149,0.000879,172.217.194.0-255,365,57298,1,225433
19150,0.00091,172.31.36.0-255,66,57364,1,225433
19151,0.001095,172.217.194.0-255,1484,58848,1,225433
19152,0.001103,172.217.194.0-255,2902,61750,1,225433
19153,0.001107,172.31.36.0-255,66,61816,1,225433
19154,0.001111,172.217.194.0-255,1484,63300,1,225433
19155,0.00113,172.217.194.0-255,4320,67620,1,225433
19156,0.001133,172.31.36.0-255,66,67686,1,225433
19157,0.001143,172.31.36.0-255,66,67752,1,225433
19158,0.001184,172.217.194.0-255,4320,72072,1,225433
19159,0.001187,172.31.36.0-255,66,72138,1,225433
19160,0.001219,172.31.36.0-255,66,72204,1,225433
19161,0.001796,172.217.194.0-255,1484,73688,1,225433
19162,0.001803,172.217.194.0-255,1484,75172,1,225433
19163,0.001806,172.31.36.0-255,66,75238,1,225433
19164,0.001818,172.217.194.0-255,1484,76722,1,225433
19165,0.001824,172.217.194.0-255,5738,82460,1,225433
19166,0.001825,172.31.36.0-255,66,82526,1,225433
19167,0.001857,172.31.36.0-255,66,82592,1,225433
19168,0.001889,172.217.194.0-255,4320,86912,1,225433
19169,0.001892,172.31.36.0-255,66,86978,1,225433
19170,0.001922,172.31.36.0-255,66,87044,1,225433
19171,0.001939,172.217.194.0-255,4320,91364,1,225433
19172,0.001941,172.31.36.0-255,66,91430,1,225433
19173,0.001972,172.31.36.0-255,66,91496,1,225433
19174,0.001975,172.217.194.0-255,1484,92980,1,225433
19175,0.00201,172.217.194.0-255,2902,95882,1,225433
19176,0.002012,172.31.36.0-255,66,95948,1,225433
19177,0.002051,172.31.36.0-255,66,96014,1,225433
19178,0.002063,172.31.36.0-255,66,96080,1,225433
19179,0.002072,172.31.36.0-255,66,96146,1,225433
19180,0.002101,172.31.36.0-255,66,96212,1,225433
19181,0.002104,172.217.194.0-255,1484,97696,1,225433
19182,0.002108,172.217.194.0-255,2902,100598,1,225433
19183,0.00211,172.31.36.0-255,66,100664,1,225433
19184,0.002134,172.217.194.0-255,5738,106402,1,225433
19185,0.002136,172.31.36.0-255,66,106468,1,225433
19186,0.002139,172.217.194.0-255,1484,107952,1,225433
19187,0.002174,172.31.36.0-255,66,108018,1,225433
19188,0.002185,172.31.36.0-255,66,108084,1,225433
19189,0.002203,172.217.194.0-255,2184,110268,1,225433
19190,0.002205,172.31.36.0-255,66,110334,1,225433
19191,0.004766,172.217.194.0-255,5738,116072,1,225433
19192,0.004771,172.31.36.0-255,66,116138,1,225433
19193,0.007347,172.217.194.0-255,5738,121876,1,225433
19194,0.007354,172.31.36.0-255,66,121942,1,225433
19195,0.009929,172.217.194.0-255,5738,127680,1,225433
19196,0.009953,172.31.36.0-255,66,127746,1,225433
19197,0.012539,172.217.194.0-255,5738,133484,1,225433
19198,0.01255,172.31.36.0-255,66,133550,1,225433
19199,0.015114,172.217.194.0-255,5738,139288,1,225433
19200,0.015122,172.31.36.0-255,66,139354,1,225433
19201,0.017691,172.217.194.0-255,5738,145092,1,225433
19202,0.0177,172.31.36.0-255,66,145158,1,225433
19203,0.020295,172.217.194.0-255,2902,148060,1,225433
19204,0.020303,172.31.36.0-255,66,148126,1,225433
19205,0.020324,172.217.194.0-255,2902,151028,1,225433
19206,0.020327,172.31.36.0-255,66,151094,1,225433
19207,0.022863,172.217.194.0-255,2902,153996,1,225433
19208,0.022871,172.31.36.0-255,66,154062,1,225433
19209,0.022928,172.217.194.0-255,2902,156964,1,225433
19210,0.022932,172.31.36.0-255,66,157030,1,225433
19211,0.025445,172.217.194.0-255,2902,159932,1,225433
19212,0.025452,172.31.36.0-255,66,159998,1,225433
19213,0.025492,172.217.194.0-255,2902,162900,1,225433
19214,0.02551,172.31.36.0-255,66,162966,1,225433
19215,0.02802,172.217.194.0-255,2902,165868,1,225433
19216,0.028027,172.31.36.0-255,66,165934,1,225433
19217,0.028095,172.217.194.0-255,2902,168836,1,225433
19218,0.028099,172.31.36.0-255,66,168902,1,225433
19219,0.030633,172.217.194.0-255,2902,171804,1,225433
19220,0.03064,172.31.36.0-255,66,171870,1,225433
19221,0.03067,172.217.194.0-255,2902,174772,1,225433
19222,0.030672,172.31.36.0-255,66,174838,1,225433
19223,0.032038,172.31.36.0-255,172,175010,1,225433
19224,0.032068,172.31.36.0-255,1112,176122,1,225433
19225,0.032136,172.31.36.0-255,1514,177636,1,225433
19226,0.032138,172.31.36.0-255,1514,179150,1,225433
19227,0.032144,172.31.36.0-255,1514,180664,1,225433
19228,0.032145,172.31.36.0-255,1514,182178,1,225433
19229,0.032164,172.31.36.0-255,1505,183683,1,225433
19230,0.033211,172.217.194.0-255,2902,186585,1,225433
19231,0.033216,172.31.36.0-255,66,186651,1,225433
19232,0.033251,172.217.194.0-255,2902,189553,1,225433
19233,0.033254,172.31.36.0-255,66,189619,1,225433
19234,0.033579,104.244.42.0-255,66,189685,1,225433
19235,0.03363,104.244.42.0-255,66,189751,1,225433
19236,0.033771,104.244.42.0-255,66,189817,1,225433
19237,0.035789,172.217.194.0-255,2902,192719,1,225433
19238,0.035795,172.31.36.0-255,66,192785,1,225433
19239,0.035825,172.217.194.0-255,2902,195687,1,225433
19240,0.035828,172.31.36.0-255,66,195753,1,225433
19241,0.038367,172.217.194.0-255,2902,198655,1,225433
19242,0.038372,172.31.36.0-255,66,198721,1,225433
19243,0.03842,172.217.194.0-255,2902,201623,1,225433
19244,0.038424,172.31.36.0-255,66,201689,1,225433
19245,0.04095,172.217.194.0-255,2902,204591,1,225433
19246,0.040956,172.31.36.0-255,66,204657,1,225433
19247,0.040989,172.217.194.0-255,2902,207559,1,225433
19248,0.040991,172.31.36.0-255,66,207625,1,225433
19249,0.043607,172.217.194.0-255,2902,210527,1,225433
19250,0.043626,172.31.36.0-255,66,210593,1,225433
19251,0.043645,172.217.194.0-255,2902,213495,1,225433
19252,0.043651,172.31.36.0-255,66,213561,1,225433
19253,0.046176,172.217.194.0-255,2902,216463,1,225433
19254,0.046182,172.31.36.0-255,66,216529,1,225433
19255,0.046213,172.217.194.0-255,2902,219431,1,225433
19256,0.046216,172.31.36.0-255,66,219497,1,225433
19257,0.048742,172.217.194.0-255,2902,222399,1,225433
19258,0.048749,172.31.36.0-255,66,222465,1,225433
19259,0.048862,172.217.194.0-255,2902,225367,1,225433
19260,0.048867,172.31.36.0-255,66,225433,1,225433
19261,0.0,172.253.118.0-255,153,153,1,278769
19262,2.2e-05,172.31.36.0-255,66,219,1,278769
19263,2.9e-05,172.253.118.0-255,1484,1703,1,278769
19264,3.4e-05,172.31.36.0-255,66,1769,1,278769
19265,3.9e-05,172.253.118.0-255,2902,4671,1,278769
19266,4.2e-05,172.31.36.0-255,66,4737,1,278769
19267,4.8e-05,172.253.118.0-255,4320,9057,1,278769
19268,5.1e-05,172.31.36.0-255,66,9123,1,278769
19269,7.4e-05,172.253.118.0-255,2902,12025,1,278769
19270,7.7e-05,172.31.36.0-255,66,12091,1,278769
19271,8.2e-05,172.253.118.0-255,1993,14084,1,278769
19272,8.5e-05,172.31.36.0-255,66,14150,1,278769
19273,9e-05,172.253.118.0-255,2902,17052,1,278769
19274,9.2e-05,172.31.36.0-255,66,17118,1,278769
19275,0.00013,172.31.36.0-255,66,17184,1,278769
19276,0.000136,172.253.118.0-255,5379,22563,1,278769
19277,0.000139,172.31.36.0-255,66,22629,1,278769
19278,0.000353,172.253.118.0-255,1484,24113,1,278769
19279,0.000358,172.31.36.0-255,66,24179,1,278769
19280,0.000364,172.253.118.0-255,2902,27081,1,278769
19281,0.000366,172.31.36.0-255,66,27147,1,278769
19282,0.000396,172.253.118.0-255,5738,32885,1,278769
19283,0.000398,172.31.36.0-255,66,32951,1,278769
19284,0.00042,172.253.118.0-255,7156,40107,1,278769
19285,0.000423,172.31.36.0-255,66,40173,1,278769
19286,0.000427,172.253.118.0-255,2902,43075,1,278769
19287,0.00043,172.31.36.0-255,66,43141,1,278769
19288,0.000447,172.253.118.0-255,5738,48879,1,278769
19289,0.000449,172.31.36.0-255,66,48945,1,278769
19290,0.000452,172.253.118.0-255,1484,50429,1,278769
19291,0.000454,172.31.36.0-255,66,50495,1,278769
19292,0.000472,172.253.118.0-255,6438,56933,1,278769
19293,0.000474,172.31.36.0-255,66,56999,1,278769
19294,0.000492,172.253.118.0-255,401,57400,1,278769
19295,0.000526,172.253.118.0-255,110,57510,1,278769
19296,0.000548,172.253.118.0-255,329,57839,1,278769
19297,0.001013,172.253.118.0-255,1484,59323,1,278769
19298,0.001018,172.31.36.0-255,66,59389,1,278769
19299,0.001024,172.253.118.0-255,2902,62291,1,278769
19300,0.001026,172.31.36.0-255,66,62357,1,278769
19301,0.001057,172.253.118.0-255,5738,68095,1,278769
19302,0.00106,172.31.36.0-255,66,68161,1,278769
19303,0.001067,172.253.118.0-255,5738,73899,1,278769
19304,0.001069,172.31.36.0-255,66,73965,1,278769
19305,0.001105,172.31.36.0-255,66,74031,1,278769
19306,0.001128,172.253.118.0-255,4320,78351,1,278769
19307,0.00113,172.31.36.0-255,66,78417,1,278769
19308,0.001136,172.253.118.0-255,5020,83437,1,278769
19309,0.001138,172.31.36.0-255,66,83503,1,278769
19310,0.002352,172.253.118.0-255,1484,84987,1,278769
19311,0.00237,172.253.118.0-255,2902,87889,1,278769
19312,0.002373,172.31.36.0-255,66,87955,1,278769
19313,0.002386,172.253.118.0-255,1484,89439,1,278769
19314,0.002402,172.253.118.0-255,4320,93759,1,278769
19315,0.002404,172.31.36.0-255,66,93825,1,278769
19316,0.002429,172.253.118.0-255,1484,95309,1,278769
19317,0.002443,172.253.118.0-255,4320,99629,1,278769
19318,0.002446,172.31.36.0-255,66,99695,1,278769
19319,0.002473,172.253.118.0-255,7156,106851,1,278769
19320,0.002476,172.31.36.0-255,66,106917,1,278769
19321,0.002483,172.253.118.0-255,7156,114073,1,278769
19322,0.002485,172.31.36.0-255,66,114139,1,278769
19323,0.00249,172.253.118.0-255,2902,117041,1,278769
19324,0.002492,172.31.36.0-255,66,117107,1,278769
19325,0.002495,172.253.118.0-255,766,117873,1,278769
19326,0.002641,172.253.118.0-255,1484,119357,1,278769
19327,0.002644,172.31.36.0-255,66,119423,1,278769
19328,0.002649,172.253.118.0-255,2902,122325,1,278769
19329,0.002652,172.31.36.0-255,66,122391,1,278769
19330,0.00267,172.253.118.0-255,5738,128129,1,278769
19331,0.002674,172.31.36.0-255,66,128195,1,278769
19332,0.002698,172.253.118.0-255,7156,135351,1,278769
19333,0.0027,172.31.36.0-255,66,135417,1,278769
19334,0.002703,172.253.118.0-255,1484,136901,1,278769
19335,0.00271,172.253.118.0-255,5738,142639,1,278769
19336,0.002712,172.31.36.0-255,66,142705,1,278769
19337,0.002729,172.253.118.0-255,2902,145607,1,278769
19338,0.002731,172.31.36.0-255,66,145673,1,278769
19339,0.002736,172.253.118.0-255,4320,149993,1,278769
19340,0.002738,172.31.36.0-255,66,150059,1,278769
19341,0.002742,172.253.118.0-255,2184,152243,1,278769
19342,0.002745,172.31.36.0-255,66,152309,1,278769
19343,0.004618,172.253.118.0-255,1484,153793,1,278769
19344,0.004629,172.253.118.0-255,2902,156695,1,278769
19345,0.004634,172.31.36.0-255,66,156761,1,278769
19346,0.004643,172.253.118.0-255,5738,162499,1,278769
19347,0.004645,172.31.36.0-255,66,162565,1,278769
19348,0.00465,172.253.118.0-255,2902,165467,1,278769
19349,0.004652,172.31.36.0-255,66,165533,1,278769
19350,0.00468,172.253.118.0-255,2902,168435,1,278769
19351,0.004682,172.31.36.0-255,66,168501,1,278769
19352,0.004691,172.253.118.0-255,7156,175657,1,278769
19353,0.004693,172.31.36.0-255,66,175723,1,278769
19354,0.004716,172.253.118.0-255,7156,182879,1,278769
19355,0.004719,172.31.36.0-255,66,182945,1,278769
19356,0.00474,172.253.118.0-255,3602,186547,1,278769
19357,0.004742,172.31.36.0-255,66,186613,1,278769
19358,0.004981,172.253.118.0-255,1484,188097,1,278769
19359,0.004994,172.253.118.0-255,2902,190999,1,278769
19360,0.004997,172.31.36.0-255,66,191065,1,278769
19361,0.005002,172.253.118.0-255,2902,193967,1,278769
19362,0.005004,172.31.36.0-255,66,194033,1,278769
19363,0.00502,172.253.118.0-255,4320,198353,1,278769
19364,0.005022,172.31.36.0-255,66,198419,1,278769
19365,0.005038,172.253.118.0-255,2902,201321,1,278769
19366,0.00504,172.31.36.0-255,66,201387,1,278769
19367,0.005044,172.253.118.0-255,1484,202871,1,278769
19368,0.005075,172.31.36.0-255,66,202937,1,278769
19369,0.005079,172.253.118.0-255,1484,204421,1,278769
19370,0.005082,172.253.118.0-255,1484,205905,1,278769
19371,0.005084,172.31.36.0-255,66,205971,1,278769
19372,0.005091,172.253.118.0-255,5738,211709,1,278769
19373,0.005093,172.31.36.0-255,66,211775,1,278769
19374,0.00512,172.253.118.0-255,2184,213959,1,278769
19375,0.005124,172.31.36.0-255,66,214025,1,278769
19376,0.00513,172.253.118.0-255,5738,219763,1,278769
19377,0.005133,172.31.36.0-255,66,219829,1,278769
19378,0.005137,172.253.118.0-255,2902,222731,1,278769
19379,0.005139,172.31.36.0-255,66,222797,1,278769
19380,0.005155,172.31.36.0-255,66,222863,1,278769
19381,0.005158,172.253.118.0-255,1484,224347,1,278769
19382,0.005187,172.31.36.0-255,66,224413,1,278769
19383,0.005241,172.253.118.0-255,1484,225897,1,278769
19384,0.00526,172.253.118.0-255,2902,228799,1,278769
19385,0.005262,172.31.36.0-255,66,228865,1,278769
19386,0.005269,172.253.118.0-255,5738,234603,1,278769
19387,0.005272,172.31.36.0-255,66,234669,1,278769
19388,0.005292,172.31.36.0-255,66,234735,1,278769
19389,0.005306,172.253.118.0-255,4320,239055,1,278769
19390,0.005308,172.31.36.0-255,66,239121,1,278769
19391,0.005321,172.31.36.0-255,66,239187,1,278769
19392,0.005339,172.253.118.0-255,766,239953,1,278769
19393,0.005356,172.253.118.0-255,2902,242855,1,278769
19394,0.005382,172.253.118.0-255,2902,245757,1,278769
19395,0.005417,172.253.118.0-255,1484,247241,1,278769
19396,0.005432,172.253.118.0-255,2902,250143,1,278769
19397,0.005516,172.253.118.0-255,1484,251627,1,278769
19398,0.00556,172.253.118.0-255,1484,253111,1,278769
19399,0.005583,172.253.118.0-255,1484,254595,1,278769
19400,0.00559,172.253.118.0-255,4320,258915,1,278769
19401,0.005604,172.253.118.0-255,2184,261099,1,278769
19402,0.00564,172.253.118.0-255,4320,265419,1,278769
19403,0.005657,172.253.118.0-255,3979,269398,1,278769
19404,0.005686,172.253.118.0-255,105,269503,1,278769
19405,0.009431,172.31.36.0-255,66,269569,1,278769
19406,0.011325,172.31.36.0-255,105,269674,1,278769
19407,0.013638,172.253.118.0-255,66,269740,1,278769
19408,0.040411,172.31.36.0-255,172,269912,1,278769
19409,0.040473,172.31.36.0-255,1113,271025,1,278769
19410,0.040544,172.31.36.0-255,1514,272539,1,278769
19411,0.040546,172.31.36.0-255,1514,274053,1,278769
19412,0.040547,172.31.36.0-255,1514,275567,1,278769
19413,0.040548,172.31.36.0-255,1514,277081,1,278769
19414,0.040575,172.31.36.0-255,1490,278571,1,278769
19415,0.041951,104.244.42.0-255,66,278637,1,278769
19416,0.042024,104.244.42.0-255,66,278703,1,278769
19417,0.042161,104.244.42.0-255,66,278769,1,278769
19418,0.0,74.125.68.0-255,153,153,1,234994
19419,2.4e-05,172.31.36.0-255,66,219,1,234994
19420,3.2e-05,74.125.68.0-255,1484,1703,1,234994
19421,3.6e-05,172.31.36.0-255,66,1769,1,234994
19422,4.2e-05,74.125.68.0-255,2902,4671,1,234994
19423,4.6e-05,172.31.36.0-255,66,4737,1,234994
19424,5.4e-05,74.125.68.0-255,7156,11893,1,234994
19425,5.8e-05,172.31.36.0-255,66,11959,1,234994
19426,6.1e-05,74.125.68.0-255,2004,13963,1,234994
19427,6.4e-05,172.31.36.0-255,66,14029,1,234994
19428,0.000316,74.125.68.0-255,1484,15513,1,234994
19429,0.000322,172.31.36.0-255,66,15579,1,234994
19430,0.000328,74.125.68.0-255,2902,18481,1,234994
19431,0.000331,172.31.36.0-255,66,18547,1,234994
19432,0.000362,74.125.68.0-255,5738,24285,1,234994
19433,0.000365,172.31.36.0-255,66,24351,1,234994
19434,0.000394,74.125.68.0-255,6797,31148,1,234994
19435,0.000398,172.31.36.0-255,66,31214,1,234994
19436,0.000446,74.125.68.0-255,1484,32698,1,234994
19437,0.00045,172.31.36.0-255,66,32764,1,234994
19438,0.000454,74.125.68.0-255,1484,34248,1,234994
19439,0.000456,172.31.36.0-255,66,34314,1,234994
19440,0.000469,74.125.68.0-255,1484,35798,1,234994
19441,0.000471,172.31.36.0-255,66,35864,1,234994
19442,0.000478,74.125.68.0-255,4320,40184,1,234994
19443,0.000481,172.31.36.0-255,66,40250,1,234994
19444,0.000516,74.125.68.0-255,1484,41734,1,234994
19445,0.000519,172.31.36.0-255,66,41800,1,234994
19446,0.000545,74.125.68.0-255,6797,48597,1,234994
19447,0.000548,172.31.36.0-255,66,48663,1,234994
19448,0.000952,74.125.68.0-255,1484,50147,1,234994
19449,0.000957,172.31.36.0-255,66,50213,1,234994
19450,0.000966,74.125.68.0-255,2902,53115,1,234994
19451,0.000968,172.31.36.0-255,66,53181,1,234994
19452,0.000973,74.125.68.0-255,2902,56083,1,234994
19453,0.000975,172.31.36.0-255,66,56149,1,234994
19454,0.000995,74.125.68.0-255,1484,57633,1,234994
19455,0.001019,74.125.68.0-255,1484,59117,1,234994
19456,0.001022,172.31.36.0-255,66,59183,1,234994
19457,0.00104,74.125.68.0-255,4320,63503,1,234994
19458,0.001042,172.31.36.0-255,66,63569,1,234994
19459,0.001063,74.125.68.0-255,2543,66112,1,234994
19460,0.001065,172.31.36.0-255,66,66178,1,234994
19461,0.001072,74.125.68.0-255,5738,71916,1,234994
19462,0.001074,172.31.36.0-255,66,71982,1,234994
19463,0.001093,74.125.68.0-255,2902,74884,1,234994
19464,0.001095,172.31.36.0-255,66,74950,1,234994
19465,0.00113,74.125.68.0-255,2902,77852,1,234994
19466,0.001132,172.31.36.0-255,66,77918,1,234994
19467,0.001155,74.125.68.0-255,5379,83297,1,234994
19468,0.001157,172.31.36.0-255,66,83363,1,234994
19469,0.001733,74.125.68.0-255,1484,84847,1,234994
19470,0.00174,74.125.68.0-255,1484,86331,1,234994
19471,0.001744,172.31.36.0-255,66,86397,1,234994
19472,0.001749,74.125.68.0-255,1484,87881,1,234994
19473,0.001765,74.125.68.0-255,1484,89365,1,234994
19474,0.001767,172.31.36.0-255,66,89431,1,234994
19475,0.001774,74.125.68.0-255,5738,95169,1,234994
19476,0.001776,172.31.36.0-255,66,95235,1,234994
19477,0.001802,172.31.36.0-255,66,95301,1,234994
19478,0.001818,74.125.68.0-255,1484,96785,1,234994
19479,0.001822,74.125.68.0-255,2902,99687,1,234994
19480,0.001824,172.31.36.0-255,66,99753,1,234994
19481,0.001849,172.31.36.0-255,66,99819,1,234994
19482,0.001852,74.125.68.0-255,766,100585,1,234994
19483,0.002296,74.125.68.0-255,1484,102069,1,234994
19484,0.002299,172.31.36.0-255,66,102135,1,234994
19485,0.002314,74.125.68.0-255,2902,105037,1,234994
19486,0.002317,172.31.36.0-255,66,105103,1,234994
19487,0.002338,74.125.68.0-255,4320,109423,1,234994
19488,0.002341,172.31.36.0-255,66,109489,1,234994
19489,0.004595,74.125.68.0-255,1484,110973,1,234994
19490,0.004617,74.125.68.0-255,4320,115293,1,234994
19491,0.00462,172.31.36.0-255,66,115359,1,234994
19492,0.006905,74.125.68.0-255,5738,121097,1,234994
19493,0.006912,172.31.36.0-255,66,121163,1,234994
19494,0.009232,74.125.68.0-255,5738,126901,1,234994
19495,0.00924,172.31.36.0-255,66,126967,1,234994
19496,0.01153,74.125.68.0-255,5738,132705,1,234994
19497,0.011538,172.31.36.0-255,66,132771,1,234994
19498,0.013843,74.125.68.0-255,5738,138509,1,234994
19499,0.01385,172.31.36.0-255,66,138575,1,234994
19500,0.016162,74.125.68.0-255,5738,144313,1,234994
19501,0.016172,172.31.36.0-255,66,144379,1,234994
19502,0.018453,74.125.68.0-255,2902,147281,1,234994
19503,0.018459,172.31.36.0-255,66,147347,1,234994
19504,0.018484,74.125.68.0-255,2902,150249,1,234994
19505,0.018487,172.31.36.0-255,66,150315,1,234994
19506,0.020758,74.125.68.0-255,2902,153217,1,234994
19507,0.020767,172.31.36.0-255,66,153283,1,234994
19508,0.020792,74.125.68.0-255,2902,156185,1,234994
19509,0.020794,172.31.36.0-255,66,156251,1,234994
19510,0.023057,74.125.68.0-255,5738,161989,1,234994
19511,0.023066,172.31.36.0-255,66,162055,1,234994
19512,0.025358,74.125.68.0-255,5738,167793,1,234994
19513,0.025367,172.31.36.0-255,66,167859,1,234994
19514,0.027678,74.125.68.0-255,5738,173597,1,234994
19515,0.027686,172.31.36.0-255,66,173663,1,234994
19516,0.029981,74.125.68.0-255,5738,179401,1,234994
19517,0.029988,172.31.36.0-255,66,179467,1,234994
19518,0.032287,74.125.68.0-255,5738,185205,1,234994
19519,0.032296,172.31.36.0-255,66,185271,1,234994
19520,0.033958,172.31.36.0-255,172,185443,1,234994
19521,0.033994,172.31.36.0-255,1114,186557,1,234994
19522,0.03406,172.31.36.0-255,1514,188071,1,234994
19523,0.034062,172.31.36.0-255,1514,189585,1,234994
19524,0.034063,172.31.36.0-255,1514,191099,1,234994
19525,0.034065,172.31.36.0-255,1514,192613,1,234994
19526,0.034114,172.31.36.0-255,1489,194102,1,234994
19527,0.034593,74.125.68.0-255,5738,199840,1,234994
19528,0.034599,172.31.36.0-255,66,199906,1,234994
19529,0.035469,104.244.42.0-255,66,199972,1,234994
19530,0.035525,104.244.42.0-255,66,200038,1,234994
19531,0.035644,104.244.42.0-255,66,200104,1,234994
19532,0.035675,104.244.42.0-255,66,200170,1,234994
19533,0.036893,74.125.68.0-255,5738,205908,1,234994
19534,0.0369,172.31.36.0-255,66,205974,1,234994
19535,0.039197,74.125.68.0-255,5738,211712,1,234994
19536,0.039203,172.31.36.0-255,66,211778,1,234994
19537,0.041501,74.125.68.0-255,5738,217516,1,234994
19538,0.041512,172.31.36.0-255,66,217582,1,234994
19539,0.043828,74.125.68.0-255,5738,223320,1,234994
19540,0.043834,172.31.36.0-255,66,223386,1,234994
19541,0.046131,74.125.68.0-255,5738,229124,1,234994
19542,0.046138,172.31.36.0-255,66,229190,1,234994
19543,0.048423,74.125.68.0-255,5738,234928,1,234994
19544,0.048429,172.31.36.0-255,66,234994,1,234994
19545,0.0,74.125.200.0-255,146,146,1,326645
19546,7.6e-05,172.31.36.0-255,66,212,1,326645
19547,8.3e-05,74.125.200.0-255,1484,1696,1,326645
19548,8.9e-05,172.31.36.0-255,66,1762,1,326645
19549,9.4e-05,74.125.200.0-255,2902,4664,1,326645
19550,9.8e-05,172.31.36.0-255,66,4730,1,326645
19551,0.000103,74.125.200.0-255,4320,9050,1,326645
19552,0.000106,172.31.36.0-255,66,9116,1,326645
19553,0.000113,74.125.200.0-255,4814,13930,1,326645
19554,0.000116,172.31.36.0-255,66,13996,1,326645
19555,0.000122,74.125.200.0-255,5738,19734,1,326645
19556,0.000125,172.31.36.0-255,66,19800,1,326645
19557,0.00013,74.125.200.0-255,2902,22702,1,326645
19558,0.000133,172.31.36.0-255,66,22768,1,326645
19559,0.000171,172.31.36.0-255,66,22834,1,326645
19560,0.000206,74.125.200.0-255,1484,24318,1,326645
19561,0.000209,172.31.36.0-255,66,24384,1,326645
19562,0.000224,74.125.200.0-255,1484,25868,1,326645
19563,0.000226,172.31.36.0-255,66,25934,1,326645
19564,0.00023,74.125.200.0-255,2902,28836,1,326645
19565,0.000232,172.31.36.0-255,66,28902,1,326645
19566,0.000258,74.125.200.0-255,5738,34640,1,326645
19567,0.000261,172.31.36.0-255,66,34706,1,326645
19568,0.000286,74.125.200.0-255,5379,40085,1,326645
19569,0.00029,172.31.36.0-255,66,40151,1,326645
19570,0.000331,74.125.200.0-255,5738,45889,1,326645
19571,0.000334,172.31.36.0-255,66,45955,1,326645
19572,0.000362,172.31.36.0-255,66,46021,1,326645
19573,0.00038,74.125.200.0-255,2818,48839,1,326645
19574,0.000383,172.31.36.0-255,66,48905,1,326645
19575,0.00044,74.125.200.0-255,1548,50453,1,326645
19576,0.000443,172.31.36.0-255,66,50519,1,326645
19577,0.000449,74.125.200.0-255,2902,53421,1,326645
19578,0.000452,172.31.36.0-255,66,53487,1,326645
19579,0.000458,74.125.200.0-255,5738,59225,1,326645
19580,0.000461,172.31.36.0-255,66,59291,1,326645
19581,0.000496,74.125.200.0-255,6498,65789,1,326645
19582,0.0005,172.31.36.0-255,66,65855,1,326645
19583,0.000537,74.125.200.0-255,5738,71593,1,326645
19584,0.00054,172.31.36.0-255,66,71659,1,326645
19585,0.000554,74.125.200.0-255,1484,73143,1,326645
19586,0.000557,172.31.36.0-255,66,73209,1,326645
19587,0.000562,74.125.200.0-255,2902,76111,1,326645
19588,0.000564,172.31.36.0-255,66,76177,1,326645
19589,0.000596,74.125.200.0-255,1484,77661,1,326645
19590,0.000599,172.31.36.0-255,66,77727,1,326645
19591,0.000622,74.125.200.0-255,5379,83106,1,326645
19592,0.000625,172.31.36.0-255,66,83172,1,326645
19593,0.000747,74.125.200.0-255,1484,84656,1,326645
19594,0.000754,172.31.36.0-255,66,84722,1,326645
19595,0.000766,74.125.200.0-255,2902,87624,1,326645
19596,0.000768,172.31.36.0-255,66,87690,1,326645
19597,0.000773,74.125.200.0-255,2902,90592,1,326645
19598,0.000775,172.31.36.0-255,66,90658,1,326645
19599,0.000799,74.125.200.0-255,2902,93560,1,326645
19600,0.000802,172.31.36.0-255,66,93626,1,326645
19601,0.000809,74.125.200.0-255,7156,100782,1,326645
19602,0.000811,172.31.36.0-255,66,100848,1,326645
19603,0.000843,172.31.36.0-255,66,100914,1,326645
19604,0.000844,74.125.200.0-255,4320,105234,1,326645
19605,0.000846,172.31.36.0-255,66,105300,1,326645
19606,0.000862,74.125.200.0-255,3602,108902,1,326645
19607,0.000866,172.31.36.0-255,66,108968,1,326645
19608,0.001101,74.125.200.0-255,1484,110452,1,326645
19609,0.001106,172.31.36.0-255,66,110518,1,326645
19610,0.001122,74.125.200.0-255,2902,113420,1,326645
19611,0.001125,172.31.36.0-255,66,113486,1,326645
19612,0.001148,74.125.200.0-255,5738,119224,1,326645
19613,0.001151,172.31.36.0-255,66,119290,1,326645
19614,0.001155,74.125.200.0-255,1484,120774,1,326645
19615,0.001156,172.31.36.0-255,66,120840,1,326645
19616,0.001178,74.125.200.0-255,5738,126578,1,326645
19617,0.001181,172.31.36.0-255,66,126644,1,326645
19618,0.0012,74.125.200.0-255,5738,132382,1,326645
19619,0.001204,172.31.36.0-255,66,132448,1,326645
19620,0.00122,74.125.200.0-255,7156,139604,1,326645
19621,0.001223,172.31.36.0-255,66,139670,1,326645
19622,0.001236,74.125.200.0-255,1484,141154,1,326645
19623,0.001238,172.31.36.0-255,66,141220,1,326645
19624,0.001251,74.125.200.0-255,2184,143404,1,326645
19625,0.001254,172.31.36.0-255,66,143470,1,326645
19626,0.001478,74.125.200.0-255,1484,144954,1,326645
19627,0.001482,172.31.36.0-255,66,145020,1,326645
19628,0.001501,74.125.200.0-255,2902,147922,1,326645
19629,0.001505,172.31.36.0-255,66,147988,1,326645
19630,0.00152,74.125.200.0-255,4320,152308,1,326645
19631,0.001524,172.31.36.0-255,66,152374,1,326645
19632,0.001531,74.125.200.0-255,1484,153858,1,326645
19633,0.001534,172.31.36.0-255,66,153924,1,326645
19634,0.00155,74.125.200.0-255,4320,158244,1,326645
19635,0.001555,172.31.36.0-255,66,158310,1,326645
19636,0.001571,74.125.200.0-255,2902,161212,1,326645
19637,0.001574,172.31.36.0-255,66,161278,1,326645
19638,0.001665,74.125.200.0-255,4320,165598,1,326645
19639,0.001669,172.31.36.0-255,66,165664,1,326645
19640,0.001676,74.125.200.0-255,5738,171402,1,326645
19641,0.001678,172.31.36.0-255,66,171468,1,326645
19642,0.001685,74.125.200.0-255,6438,177906,1,326645
19643,0.001688,172.31.36.0-255,66,177972,1,326645
19644,0.001855,74.125.200.0-255,1484,179456,1,326645
19645,0.001858,172.31.36.0-255,66,179522,1,326645
19646,0.001862,74.125.200.0-255,1484,181006,1,326645
19647,0.001864,172.31.36.0-255,66,181072,1,326645
19648,0.001879,74.125.200.0-255,1484,182556,1,326645
19649,0.001881,172.31.36.0-255,66,182622,1,326645
19650,0.001888,74.125.200.0-255,5738,188360,1,326645
19651,0.00189,172.31.36.0-255,66,188426,1,326645
19652,0.001895,74.125.200.0-255,2902,191328,1,326645
19653,0.001897,172.31.36.0-255,66,191394,1,326645
19654,0.00192,74.125.200.0-255,1484,192878,1,326645
19655,0.001923,172.31.36.0-255,66,192944,1,326645
19656,0.00193,74.125.200.0-255,5738,198682,1,326645
19657,0.001932,172.31.36.0-255,66,198748,1,326645
19658,0.00196,172.31.36.0-255,66,198814,1,326645
19659,0.001965,74.125.200.0-255,2184,200998,1,326645
19660,0.001967,172.31.36.0-255,66,201064,1,326645
19661,0.004231,74.125.200.0-255,2902,203966,1,326645
19662,0.004243,172.31.36.0-255,66,204032,1,326645
19663,0.004262,74.125.200.0-255,2902,206934,1,326645
19664,0.004264,172.31.36.0-255,66,207000,1,326645
19665,0.006517,74.125.200.0-255,4320,211320,1,326645
19666,0.006521,172.31.36.0-255,66,211386,1,326645
19667,0.006534,74.125.200.0-255,1484,212870,1,326645
19668,0.006536,172.31.36.0-255,66,212936,1,326645
19669,0.008832,74.125.200.0-255,5738,218674,1,326645
19670,0.008849,172.31.36.0-255,66,218740,1,326645
19671,0.011146,74.125.200.0-255,5738,224478,1,326645
19672,0.011164,172.31.36.0-255,66,224544,1,326645
19673,0.013464,74.125.200.0-255,5738,230282,1,326645
19674,0.013479,172.31.36.0-255,66,230348,1,326645
19675,0.015781,74.125.200.0-255,5738,236086,1,326645
19676,0.015801,172.31.36.0-255,66,236152,1,326645
19677,0.018091,74.125.200.0-255,5738,241890,1,326645
19678,0.018105,172.31.36.0-255,66,241956,1,326645
19679,0.020403,74.125.200.0-255,5738,247694,1,326645
19680,0.020416,172.31.36.0-255,66,247760,1,326645
19681,0.02273,74.125.200.0-255,5738,253498,1,326645
19682,0.022746,172.31.36.0-255,66,253564,1,326645
19683,0.025048,74.125.200.0-255,5738,259302,1,326645
19684,0.02506,172.31.36.0-255,66,259368,1,326645
19685,0.027338,74.125.200.0-255,5738,265106,1,326645
19686,0.027347,172.31.36.0-255,66,265172,1,326645
19687,0.029643,74.125.200.0-255,5738,270910,1,326645
19688,0.029654,172.31.36.0-255,66,270976,1,326645
19689,0.031944,74.125.200.0-255,5738,276714,1,326645
19690,0.031959,172.31.36.0-255,66,276780,1,326645
19691,0.034251,74.125.200.0-255,5738,282518,1,326645
19692,0.034264,172.31.36.0-255,66,282584,1,326645
19693,0.036581,74.125.200.0-255,5738,288322,1,326645
19694,0.036597,172.31.36.0-255,66,288388,1,326645
19695,0.038905,74.125.200.0-255,5738,294126,1,326645
19696,0.038924,172.31.36.0-255,66,294192,1,326645
19697,0.041225,74.125.200.0-255,5738,299930,1,326645
19698,0.041237,172.31.36.0-255,66,299996,1,326645
19699,0.043526,74.125.200.0-255,5738,305734,1,326645
19700,0.043534,172.31.36.0-255,66,305800,1,326645
19701,0.043953,172.31.36.0-255,182,305982,1,326645
19702,0.043996,172.31.36.0-255,1114,307096,1,326645
19703,0.044092,172.31.36.0-255,1514,308610,1,326645
19704,0.044095,172.31.36.0-255,1514,310124,1,326645
19705,0.044096,172.31.36.0-255,1514,311638,1,326645
19706,0.044097,172.31.36.0-255,1514,313152,1,326645
19707,0.044129,172.31.36.0-255,1489,314641,1,326645
19708,0.045484,104.244.42.0-255,66,314707,1,326645
19709,0.045533,104.244.42.0-255,66,314773,1,326645
19710,0.045646,104.244.42.0-255,66,314839,1,326645
19711,0.04569,104.244.42.0-255,66,314905,1,326645
19712,0.045809,74.125.200.0-255,5738,320643,1,326645
19713,0.045815,172.31.36.0-255,66,320709,1,326645
19714,0.04809,74.125.200.0-255,2902,323611,1,326645
19715,0.048096,172.31.36.0-255,66,323677,1,326645
19716,0.048124,74.125.200.0-255,2902,326579,1,326645
19717,0.048127,172.31.36.0-255,66,326645,1,326645
19718,0.0,74.125.24.0-255,152,152,1,251264
19719,1.4e-05,172.31.36.0-255,66,218,1,251264
19720,2e-05,74.125.24.0-255,1484,1702,1,251264
19721,2.4e-05,172.31.36.0-255,66,1768,1,251264
19722,3e-05,74.125.24.0-255,2902,4670,1,251264
19723,3.3e-05,172.31.36.0-255,66,4736,1,251264
19724,5e-05,74.125.24.0-255,1484,6220,1,251264
19725,5.4e-05,172.31.36.0-255,66,6286,1,251264
19726,7.7e-05,74.125.24.0-255,5738,12024,1,251264
19727,8.2e-05,172.31.36.0-255,66,12090,1,251264
19728,0.00014,74.125.24.0-255,2008,14098,1,251264
19729,0.000144,172.31.36.0-255,66,14164,1,251264
19730,0.000508,74.125.24.0-255,1484,15648,1,251264
19731,0.000515,172.31.36.0-255,66,15714,1,251264
19732,0.000521,74.125.24.0-255,2902,18616,1,251264
19733,0.000523,172.31.36.0-255,66,18682,1,251264
19734,0.00054,74.125.24.0-255,4320,23002,1,251264
19735,0.000543,172.31.36.0-255,66,23068,1,251264
19736,0.000568,74.125.24.0-255,1484,24552,1,251264
19737,0.000571,172.31.36.0-255,66,24618,1,251264
19738,0.000578,74.125.24.0-255,6797,31415,1,251264
19739,0.000581,172.31.36.0-255,66,31481,1,251264
19740,0.000619,74.125.24.0-255,1484,32965,1,251264
19741,0.000623,172.31.36.0-255,66,33031,1,251264
19742,0.000629,74.125.24.0-255,2902,35933,1,251264
19743,0.000631,172.31.36.0-255,66,35999,1,251264
19744,0.000638,74.125.24.0-255,5738,41737,1,251264
19745,0.00064,172.31.36.0-255,66,41803,1,251264
19746,0.000689,74.125.24.0-255,6797,48600,1,251264
19747,0.000694,172.31.36.0-255,66,48666,1,251264
19748,0.001499,74.125.24.0-255,1484,50150,1,251264
19749,0.001505,172.31.36.0-255,66,50216,1,251264
19750,0.001514,74.125.24.0-255,2902,53118,1,251264
19751,0.001516,172.31.36.0-255,66,53184,1,251264
19752,0.001521,74.125.24.0-255,4320,57504,1,251264
19753,0.001523,172.31.36.0-255,66,57570,1,251264
19754,0.001546,74.125.24.0-255,1484,59054,1,251264
19755,0.001553,74.125.24.0-255,6797,65851,1,251264
19756,0.001555,172.31.36.0-255,66,65917,1,251264
19757,0.00156,74.125.24.0-255,4320,70237,1,251264
19758,0.001562,172.31.36.0-255,66,70303,1,251264
19759,0.001596,172.31.36.0-255,66,70369,1,251264
19760,0.0016,74.125.24.0-255,2543,72912,1,251264
19761,0.001602,172.31.36.0-255,66,72978,1,251264
19762,0.001627,74.125.24.0-255,1484,74462,1,251264
19763,0.001632,74.125.24.0-255,2902,77364,1,251264
19764,0.001634,74.125.24.0-255,1484,78848,1,251264
19765,0.001638,172.31.36.0-255,66,78914,1,251264
19766,0.001658,74.125.24.0-255,4320,83234,1,251264
19767,0.00166,172.31.36.0-255,66,83300,1,251264
19768,0.001674,74.125.24.0-255,1484,84784,1,251264
19769,0.00169,74.125.24.0-255,5959,90743,1,251264
19770,0.001693,172.31.36.0-255,66,90809,1,251264
19771,0.002233,74.125.24.0-255,1484,92293,1,251264
19772,0.00224,74.125.24.0-255,2902,95195,1,251264
19773,0.002244,172.31.36.0-255,66,95261,1,251264
19774,0.002251,74.125.24.0-255,5738,100999,1,251264
19775,0.002253,172.31.36.0-255,66,101065,1,251264
19776,0.002283,172.31.36.0-255,66,101131,1,251264
19777,0.002304,74.125.24.0-255,4320,105451,1,251264
19778,0.002306,172.31.36.0-255,66,105517,1,251264
19779,0.002311,74.125.24.0-255,4320,109837,1,251264
19780,0.002313,172.31.36.0-255,66,109903,1,251264
19781,0.002333,74.125.24.0-255,2902,112805,1,251264
19782,0.002335,172.31.36.0-255,66,112871,1,251264
19783,0.002353,74.125.24.0-255,3602,116473,1,251264
19784,0.002355,172.31.36.0-255,66,116539,1,251264
19785,0.002368,74.125.24.0-255,1484,118023,1,251264
19786,0.002393,74.125.24.0-255,5738,123761,1,251264
19787,0.002395,172.31.36.0-255,66,123827,1,251264
19788,0.002403,74.125.24.0-255,7156,130983,1,251264
19789,0.002404,172.31.36.0-255,66,131049,1,251264
19790,0.002448,172.31.36.0-255,66,131115,1,251264
19791,0.002452,74.125.24.0-255,3602,134717,1,251264
19792,0.002455,172.31.36.0-255,66,134783,1,251264
19793,0.002768,74.125.24.0-255,1484,136267,1,251264
19794,0.002774,74.125.24.0-255,2902,139169,1,251264
19795,0.002777,172.31.36.0-255,66,139235,1,251264
19796,0.00278,74.125.24.0-255,1484,140719,1,251264
19797,0.002798,74.125.24.0-255,2902,143621,1,251264
19798,0.0028,172.31.36.0-255,66,143687,1,251264
19799,0.002827,172.31.36.0-255,66,143753,1,251264
19800,0.002847,74.125.24.0-255,4320,148073,1,251264
19801,0.002849,172.31.36.0-255,66,148139,1,251264
19802,0.002878,172.31.36.0-255,66,148205,1,251264
19803,0.003158,74.125.24.0-255,1484,149689,1,251264
19804,0.003176,74.125.24.0-255,2902,152591,1,251264
19805,0.003178,172.31.36.0-255,66,152657,1,251264
19806,0.003185,74.125.24.0-255,5738,158395,1,251264
19807,0.003186,172.31.36.0-255,66,158461,1,251264
19808,0.003214,74.125.24.0-255,1484,159945,1,251264
19809,0.003237,74.125.24.0-255,5738,165683,1,251264
19810,0.003239,74.125.24.0-255,1484,167167,1,251264
19811,0.003251,172.31.36.0-255,66,167233,1,251264
19812,0.003254,172.31.36.0-255,66,167299,1,251264
19813,0.003269,74.125.24.0-255,5020,172319,1,251264
19814,0.003272,172.31.36.0-255,66,172385,1,251264
19815,0.003274,74.125.24.0-255,1484,173869,1,251264
19816,0.003312,74.125.24.0-255,1484,175353,1,251264
19817,0.003314,172.31.36.0-255,66,175419,1,251264
19818,0.003359,172.31.36.0-255,66,175485,1,251264
19819,0.003372,172.31.36.0-255,66,175551,1,251264
19820,0.003378,74.125.24.0-255,5020,180571,1,251264
19821,0.00338,172.31.36.0-255,66,180637,1,251264
19822,0.003515,74.125.24.0-255,1484,182121,1,251264
19823,0.003522,74.125.24.0-255,2902,185023,1,251264
19824,0.003525,172.31.36.0-255,66,185089,1,251264
19825,0.003532,74.125.24.0-255,5738,190827,1,251264
19826,0.003534,172.31.36.0-255,66,190893,1,251264
19827,0.00357,172.31.36.0-255,66,190959,1,251264
19828,0.003576,74.125.24.0-255,5738,196697,1,251264
19829,0.003579,172.31.36.0-255,66,196763,1,251264
19830,0.003615,74.125.24.0-255,2902,199665,1,251264
19831,0.003619,172.31.36.0-255,66,199731,1,251264
19832,0.003641,74.125.24.0-255,2184,201915,1,251264
19833,0.003644,172.31.36.0-255,66,201981,1,251264
19834,0.003677,74.125.24.0-255,1484,203465,1,251264
19835,0.003684,74.125.24.0-255,2902,206367,1,251264
19836,0.003688,172.31.36.0-255,66,206433,1,251264
19837,0.003692,74.125.24.0-255,2902,209335,1,251264
19838,0.003694,172.31.36.0-255,66,209401,1,251264
19839,0.00371,74.125.24.0-255,2902,212303,1,251264
19840,0.003712,172.31.36.0-255,66,212369,1,251264
19841,0.003725,172.31.36.0-255,66,212435,1,251264
19842,0.003728,74.125.24.0-255,1484,213919,1,251264
19843,0.003758,74.125.24.0-255,5738,219657,1,251264
19844,0.003762,172.31.36.0-255,66,219723,1,251264
19845,0.003793,172.31.36.0-255,66,219789,1,251264
19846,0.003798,74.125.24.0-255,4320,224109,1,251264
19847,0.003801,172.31.36.0-255,66,224175,1,251264
19848,0.003817,74.125.24.0-255,5738,229913,1,251264
19849,0.003819,172.31.36.0-255,66,229979,1,251264
19850,0.003853,74.125.24.0-255,4320,234299,1,251264
19851,0.003855,172.31.36.0-255,66,234365,1,251264
19852,0.00388,172.31.36.0-255,66,234431,1,251264
19853,0.003921,74.125.24.0-255,7156,241587,1,251264
19854,0.003924,172.31.36.0-255,66,241653,1,251264
19855,0.003958,172.31.36.0-255,66,241719,1,251264
19856,0.003961,74.125.24.0-255,105,241824,1,251264
19857,0.005298,172.31.36.0-255,66,241890,1,251264
19858,0.005334,172.31.36.0-255,105,241995,1,251264
19859,0.007912,74.125.24.0-255,66,242061,1,251264
19860,0.032024,172.31.36.0-255,172,242233,1,251264
19861,0.032083,172.31.36.0-255,1116,243349,1,251264
19862,0.032164,172.31.36.0-255,1514,244863,1,251264
19863,0.032167,172.31.36.0-255,1514,246377,1,251264
19864,0.032168,172.31.36.0-255,1514,247891,1,251264
19865,0.032169,172.31.36.0-255,1514,249405,1,251264
19866,0.032201,172.31.36.0-255,1487,250892,1,251264
19867,0.033582,104.244.42.0-255,66,250958,1,251264
19868,0.033697,104.244.42.0-255,66,251024,1,251264
19869,0.033756,104.244.42.0-255,66,251090,1,251264
19870,0.034565,104.244.42.0-255,108,251198,1,251264
19871,0.034572,172.31.36.0-255,66,251264,1,251264
19872,0.0,172.217.194.0-255,152,152,1,217021
19873,2.2e-05,172.31.36.0-255,66,218,1,217021
19874,4.4e-05,172.217.194.0-255,1484,1702,1,217021
19875,4.7e-05,172.31.36.0-255,66,1768,1,217021
19876,5.6e-05,172.217.194.0-255,1484,3252,1,217021
19877,5.9e-05,172.31.36.0-255,66,3318,1,217021
19878,7.3e-05,172.217.194.0-255,1484,4802,1,217021
19879,7.5e-05,172.31.36.0-255,66,4868,1,217021
19880,0.000103,172.217.194.0-255,4320,9188,1,217021
19881,0.000106,172.31.36.0-255,66,9254,1,217021
19882,0.000112,172.217.194.0-255,4945,14199,1,217021
19883,0.000114,172.31.36.0-255,66,14265,1,217021
19884,0.000131,172.217.194.0-255,5738,20003,1,217021
19885,0.000134,172.31.36.0-255,66,20069,1,217021
19886,0.000152,172.217.194.0-255,5738,25807,1,217021
19887,0.000156,172.31.36.0-255,66,25873,1,217021
19888,0.000163,172.217.194.0-255,5379,31252,1,217021
19889,0.000166,172.31.36.0-255,66,31318,1,217021
19890,0.000196,172.217.194.0-255,1484,32802,1,217021
19891,0.000199,172.31.36.0-255,66,32868,1,217021
19892,0.000202,172.217.194.0-255,1484,34352,1,217021
19893,0.000205,172.31.36.0-255,66,34418,1,217021
19894,0.000216,172.217.194.0-255,1484,35902,1,217021
19895,0.000219,172.31.36.0-255,66,35968,1,217021
19896,0.000224,172.217.194.0-255,2902,38870,1,217021
19897,0.000226,172.31.36.0-255,66,38936,1,217021
19898,0.000247,172.217.194.0-255,2902,41838,1,217021
19899,0.000251,172.31.36.0-255,66,41904,1,217021
19900,0.000262,172.31.36.0-255,66,41970,1,217021
19901,0.000268,172.217.194.0-255,5738,47708,1,217021
19902,0.00027,172.31.36.0-255,66,47774,1,217021
19903,0.000303,172.31.36.0-255,66,47840,1,217021
19904,0.000306,172.217.194.0-255,101,47941,1,217021
19905,0.000308,172.31.36.0-255,66,48007,1,217021
19906,0.000324,172.217.194.0-255,362,48369,1,217021
19907,0.000327,172.31.36.0-255,66,48435,1,217021
19908,0.000466,172.217.194.0-255,1484,49919,1,217021
19909,0.000471,172.217.194.0-255,2902,52821,1,217021
19910,0.000471,172.31.36.0-255,66,52887,1,217021
19911,0.000475,172.31.36.0-255,66,52953,1,217021
19912,0.000488,172.217.194.0-255,5738,58691,1,217021
19913,0.000492,172.31.36.0-255,66,58757,1,217021
19914,0.000517,172.31.36.0-255,66,58823,1,217021
19915,0.000562,172.217.194.0-255,7156,65979,1,217021
19916,0.000566,172.31.36.0-255,66,66045,1,217021
19917,0.000585,172.31.36.0-255,66,66111,1,217021
19918,0.000607,172.217.194.0-255,1484,67595,1,217021
19919,0.00061,172.31.36.0-255,66,67661,1,217021
19920,0.000615,172.217.194.0-255,2902,70563,1,217021
19921,0.000617,172.31.36.0-255,66,70629,1,217021
19922,0.000622,172.217.194.0-255,2902,73531,1,217021
19923,0.000624,172.31.36.0-255,66,73597,1,217021
19924,0.000643,172.217.194.0-255,2902,76499,1,217021
19925,0.000646,172.31.36.0-255,66,76565,1,217021
19926,0.000661,172.31.36.0-255,66,76631,1,217021
19927,0.000662,172.217.194.0-255,7156,83787,1,217021
19928,0.000664,172.31.36.0-255,66,83853,1,217021
19929,0.000685,172.217.194.0-255,3602,87455,1,217021
19930,0.000689,172.31.36.0-255,66,87521,1,217021
19931,0.000807,172.217.194.0-255,1484,89005,1,217021
19932,0.000813,172.217.194.0-255,2902,91907,1,217021
19933,0.000816,172.31.36.0-255,66,91973,1,217021
19934,0.000822,172.217.194.0-255,4320,96293,1,217021
19935,0.000825,172.31.36.0-255,66,96359,1,217021
19936,0.00084,172.217.194.0-255,1484,97843,1,217021
19937,0.000852,172.31.36.0-255,66,97909,1,217021
19938,0.000875,172.217.194.0-255,4320,102229,1,217021
19939,0.000878,172.31.36.0-255,66,102295,1,217021
19940,0.000891,172.31.36.0-255,66,102361,1,217021
19941,0.00093,172.217.194.0-255,1484,103845,1,217021
19942,0.000936,172.217.194.0-255,2902,106747,1,217021
19943,0.00094,172.31.36.0-255,66,106813,1,217021
19944,0.000961,172.217.194.0-255,5738,112551,1,217021
19945,0.000966,172.31.36.0-255,66,112617,1,217021
19946,0.001015,172.31.36.0-255,66,112683,1,217021
19947,0.00103,172.217.194.0-255,1484,114167,1,217021
19948,0.001043,172.31.36.0-255,66,114233,1,217021
19949,0.001047,172.217.194.0-255,2184,116417,1,217021
19950,0.001049,172.31.36.0-255,66,116483,1,217021
19951,0.001099,172.217.194.0-255,1484,117967,1,217021
19952,0.001103,172.217.194.0-255,1484,119451,1,217021
19953,0.001105,172.31.36.0-255,66,119517,1,217021
19954,0.001122,172.217.194.0-255,1484,121001,1,217021
19955,0.001128,172.217.194.0-255,4320,125321,1,217021
19956,0.001131,172.31.36.0-255,66,125387,1,217021
19957,0.001137,172.217.194.0-255,5738,131125,1,217021
19958,0.001141,172.31.36.0-255,66,131191,1,217021
19959,0.001145,172.217.194.0-255,2902,134093,1,217021
19960,0.001147,172.31.36.0-255,66,134159,1,217021
19961,0.001172,172.31.36.0-255,66,134225,1,217021
19962,0.001178,172.217.194.0-255,4320,138545,1,217021
19963,0.00118,172.31.36.0-255,66,138611,1,217021
19964,0.001195,172.217.194.0-255,3602,142213,1,217021
19965,0.001198,172.31.36.0-255,66,142279,1,217021
19966,0.001409,172.217.194.0-255,1484,143763,1,217021
19967,0.001416,172.217.194.0-255,2902,146665,1,217021
19968,0.001419,172.31.36.0-255,66,146731,1,217021
19969,0.001441,172.217.194.0-255,5738,152469,1,217021
19970,0.001444,172.31.36.0-255,66,152535,1,217021
19971,0.001468,172.217.194.0-255,5738,158273,1,217021
19972,0.001471,172.31.36.0-255,66,158339,1,217021
19973,0.001486,172.217.194.0-255,7156,165495,1,217021
19974,0.001489,172.31.36.0-255,66,165561,1,217021
19975,0.001501,172.31.36.0-255,66,165627,1,217021
19976,0.001643,172.217.194.0-255,1484,167111,1,217021
19977,0.001659,172.217.194.0-255,2902,170013,1,217021
19978,0.001662,172.31.36.0-255,66,170079,1,217021
19979,0.001669,172.217.194.0-255,5738,175817,1,217021
19980,0.001671,172.31.36.0-255,66,175883,1,217021
19981,0.001694,172.31.36.0-255,66,175949,1,217021
19982,0.001739,172.217.194.0-255,7156,183105,1,217021
19983,0.001743,172.31.36.0-255,66,183171,1,217021
19984,0.001766,172.217.194.0-255,6438,189609,1,217021
19985,0.001769,172.31.36.0-255,66,189675,1,217021
19986,0.001795,172.217.194.0-255,1484,191159,1,217021
19987,0.0018,172.217.194.0-255,2902,194061,1,217021
19988,0.001802,172.31.36.0-255,66,194127,1,217021
19989,0.001809,172.217.194.0-255,5738,199865,1,217021
19990,0.001812,172.31.36.0-255,66,199931,1,217021
19991,0.001838,172.217.194.0-255,4320,204251,1,217021
19992,0.001842,172.31.36.0-255,66,204317,1,217021
19993,0.00187,172.31.36.0-255,66,204383,1,217021
19994,0.001875,172.217.194.0-255,4320,208703,1,217021
19995,0.001877,172.31.36.0-255,66,208769,1,217021
19996,0.001882,172.217.194.0-255,4320,213089,1,217021
19997,0.001884,172.31.36.0-255,66,213155,1,217021
19998,0.001926,172.31.36.0-255,66,213221,1,217021
19999,0.00194,172.31.36.0-255,66,213287,1,217021
20000,0.00202,172.31.36.0-255,66,213353,1,217021
20001,0.00205,172.31.36.0-255,66,213419,1,217021
20002,0.002067,172.217.194.0-255,105,213524,1,217021
20003,0.002068,172.31.36.0-255,66,213590,1,217021
20004,0.004074,172.31.36.0-255,66,213656,1,217021
20005,0.004099,172.31.36.0-255,105,213761,1,217021
20006,0.006373,172.217.194.0-255,66,213827,1,217021
20007,0.026981,172.31.36.0-255,172,213999,1,217021
20008,0.027009,172.31.36.0-255,1114,215113,1,217021
20009,0.027044,172.31.36.0-255,1514,216627,1,217021
20010,0.027045,172.31.36.0-255,328,216955,1,217021
20011,0.028685,104.244.42.0-255,66,217021,1,217021
20012,0.0,74.125.24.0-255,143,143,1,241565
20013,3.3e-05,172.31.36.0-255,66,209,1,241565
20014,4e-05,74.125.24.0-255,1484,1693,1,241565
20015,4.5e-05,172.31.36.0-255,66,1759,1,241565
20016,4.9e-05,74.125.24.0-255,2902,4661,1,241565
20017,5.2e-05,172.31.36.0-255,66,4727,1,241565
20018,8.2e-05,74.125.24.0-255,5738,10465,1,241565
20019,8.5e-05,172.31.36.0-255,66,10531,1,241565
20020,9.1e-05,74.125.24.0-255,3504,14035,1,241565
20021,9.4e-05,172.31.36.0-255,66,14101,1,241565
20022,0.000186,74.125.24.0-255,1484,15585,1,241565
20023,0.000191,172.31.36.0-255,66,15651,1,241565
20024,0.000235,74.125.24.0-255,1484,17135,1,241565
20025,0.000238,172.31.36.0-255,66,17201,1,241565
20026,0.000243,74.125.24.0-255,2902,20103,1,241565
20027,0.000245,172.31.36.0-255,66,20169,1,241565
20028,0.000273,74.125.24.0-255,5738,25907,1,241565
20029,0.000278,172.31.36.0-255,66,25973,1,241565
20030,0.000298,74.125.24.0-255,5379,31352,1,241565
20031,0.000302,172.31.36.0-255,66,31418,1,241565
20032,0.000394,74.125.24.0-255,1484,32902,1,241565
20033,0.000398,172.31.36.0-255,66,32968,1,241565
20034,0.000403,74.125.24.0-255,2902,35870,1,241565
20035,0.000405,172.31.36.0-255,66,35936,1,241565
20036,0.000436,74.125.24.0-255,5738,41674,1,241565
20037,0.00044,172.31.36.0-255,66,41740,1,241565
20038,0.000445,74.125.24.0-255,4320,46060,1,241565
20039,0.000447,172.31.36.0-255,66,46126,1,241565
20040,0.000478,74.125.24.0-255,6797,52923,1,241565
20041,0.000482,172.31.36.0-255,66,52989,1,241565
20042,0.000496,172.31.36.0-255,66,53055,1,241565
20043,0.000498,74.125.24.0-255,1125,54180,1,241565
20044,0.000524,74.125.24.0-255,396,54576,1,241565
20045,0.000574,74.125.24.0-255,348,54924,1,241565
20046,0.000581,172.31.36.0-255,66,54990,1,241565
20047,0.000838,74.125.24.0-255,1484,56474,1,241565
20048,0.000845,74.125.24.0-255,2902,59376,1,241565
20049,0.000848,172.31.36.0-255,66,59442,1,241565
20050,0.000877,74.125.24.0-255,5738,65180,1,241565
20051,0.00088,74.125.24.0-255,1484,66664,1,241565
20052,0.000896,172.31.36.0-255,66,66730,1,241565
20053,0.00091,74.125.24.0-255,7156,73886,1,241565
20054,0.000912,172.31.36.0-255,66,73952,1,241565
20055,0.000916,172.31.36.0-255,66,74018,1,241565
20056,0.000959,74.125.24.0-255,3602,77620,1,241565
20057,0.000963,172.31.36.0-255,66,77686,1,241565
20058,0.001352,74.125.24.0-255,1484,79170,1,241565
20059,0.001363,74.125.24.0-255,2902,82072,1,241565
20060,0.001367,172.31.36.0-255,66,82138,1,241565
20061,0.001373,74.125.24.0-255,4320,86458,1,241565
20062,0.00138,74.125.24.0-255,7156,93614,1,241565
20063,0.001402,74.125.24.0-255,1484,95098,1,241565
20064,0.001443,74.125.24.0-255,2184,97282,1,241565
20065,0.001464,172.31.36.0-255,66,97348,1,241565
20066,0.002051,74.125.24.0-255,1484,98832,1,241565
20067,0.002061,74.125.24.0-255,2902,101734,1,241565
20068,0.002067,172.31.36.0-255,66,101800,1,241565
20069,0.002074,74.125.24.0-255,5738,107538,1,241565
20070,0.002101,74.125.24.0-255,5738,113276,1,241565
20071,0.002119,74.125.24.0-255,7156,120432,1,241565
20072,0.002136,172.31.36.0-255,66,120498,1,241565
20073,0.002145,74.125.24.0-255,2902,123400,1,241565
20074,0.002189,172.31.36.0-255,66,123466,1,241565
20075,0.004561,74.125.24.0-255,2902,126368,1,241565
20076,0.004567,172.31.36.0-255,66,126434,1,241565
20077,0.004591,74.125.24.0-255,2902,129336,1,241565
20078,0.004606,172.31.36.0-255,66,129402,1,241565
20079,0.00695,74.125.24.0-255,5738,135140,1,241565
20080,0.006989,172.31.36.0-255,66,135206,1,241565
20081,0.009402,74.125.24.0-255,5738,140944,1,241565
20082,0.009411,172.31.36.0-255,66,141010,1,241565
20083,0.011757,74.125.24.0-255,5738,146748,1,241565
20084,0.011764,172.31.36.0-255,66,146814,1,241565
20085,0.014125,74.125.24.0-255,5738,152552,1,241565
20086,0.014133,172.31.36.0-255,66,152618,1,241565
20087,0.016526,74.125.24.0-255,5738,158356,1,241565
20088,0.016535,172.31.36.0-255,66,158422,1,241565
20089,0.018927,74.125.24.0-255,5738,164160,1,241565
20090,0.018939,172.31.36.0-255,66,164226,1,241565
20091,0.021334,74.125.24.0-255,5738,169964,1,241565
20092,0.021359,172.31.36.0-255,66,170030,1,241565
20093,0.023727,74.125.24.0-255,5738,175768,1,241565
20094,0.023733,172.31.36.0-255,66,175834,1,241565
20095,0.026124,74.125.24.0-255,5738,181572,1,241565
20096,0.026132,172.31.36.0-255,66,181638,1,241565
20097,0.028537,74.125.24.0-255,5738,187376,1,241565
20098,0.028545,172.31.36.0-255,66,187442,1,241565
20099,0.030905,172.31.36.0-255,172,187614,1,241565
20100,0.030934,74.125.24.0-255,5738,193352,1,241565
20101,0.030939,172.31.36.0-255,66,193418,1,241565
20102,0.031004,172.31.36.0-255,1112,194530,1,241565
20103,0.031164,172.31.36.0-255,1514,196044,1,241565
20104,0.031167,172.31.36.0-255,1514,197558,1,241565
20105,0.031172,172.31.36.0-255,1514,199072,1,241565
20106,0.031173,172.31.36.0-255,1514,200586,1,241565
20107,0.0312,172.31.36.0-255,1505,202091,1,241565
20108,0.032455,104.244.42.0-255,66,202157,1,241565
20109,0.032546,104.244.42.0-255,66,202223,1,241565
20110,0.032758,104.244.42.0-255,66,202289,1,241565
20111,0.033324,74.125.24.0-255,5738,208027,1,241565
20112,0.033349,172.31.36.0-255,66,208093,1,241565
20113,0.035725,74.125.24.0-255,5738,213831,1,241565
20114,0.035734,172.31.36.0-255,66,213897,1,241565
20115,0.038089,74.125.24.0-255,5738,219635,1,241565
20116,0.038095,172.31.36.0-255,66,219701,1,241565
20117,0.040515,74.125.24.0-255,4320,224021,1,241565
20118,0.04052,172.31.36.0-255,66,224087,1,241565
20119,0.040555,74.125.24.0-255,1484,225571,1,241565
20120,0.042881,74.125.24.0-255,4320,229891,1,241565
20121,0.042887,172.31.36.0-255,66,229957,1,241565
20122,0.045271,74.125.24.0-255,5738,235695,1,241565
20123,0.045328,172.31.36.0-255,66,235761,1,241565
20124,0.047764,74.125.24.0-255,5738,241499,1,241565
20125,0.047769,172.31.36.0-255,66,241565,1,241565
20126,0.0,172.253.118.0-255,153,153,1,269786
20127,2.8e-05,172.31.36.0-255,66,219,1,269786
20128,3.5e-05,172.253.118.0-255,1484,1703,1,269786
20129,3.9e-05,172.31.36.0-255,66,1769,1,269786
20130,5.2e-05,172.253.118.0-255,2902,4671,1,269786
20131,5.5e-05,172.31.36.0-255,66,4737,1,269786
20132,7.9e-05,172.253.118.0-255,1484,6221,1,269786
20133,8.3e-05,172.31.36.0-255,66,6287,1,269786
20134,0.000117,172.253.118.0-255,5738,12025,1,269786
20135,0.00012,172.31.36.0-255,66,12091,1,269786
20136,0.000124,172.253.118.0-255,2038,14129,1,269786
20137,0.000126,172.31.36.0-255,66,14195,1,269786
20138,0.000364,172.253.118.0-255,1484,15679,1,269786
20139,0.00037,172.31.36.0-255,66,15745,1,269786
20140,0.000375,172.253.118.0-255,2902,18647,1,269786
20141,0.000378,172.31.36.0-255,66,18713,1,269786
20142,0.00039,172.253.118.0-255,5738,24451,1,269786
20143,0.000393,172.31.36.0-255,66,24517,1,269786
20144,0.000448,172.253.118.0-255,5738,30255,1,269786
20145,0.000452,172.31.36.0-255,66,30321,1,269786
20146,0.000491,172.31.36.0-255,66,30387,1,269786
20147,0.000503,172.31.36.0-255,66,30453,1,269786
20148,0.000525,172.253.118.0-255,1484,31937,1,269786
20149,0.000529,172.31.36.0-255,66,32003,1,269786
20150,0.000562,172.253.118.0-255,2902,34905,1,269786
20151,0.000565,172.31.36.0-255,66,34971,1,269786
20152,0.000573,172.253.118.0-255,5738,40709,1,269786
20153,0.000575,172.31.36.0-255,66,40775,1,269786
20154,0.000581,172.253.118.0-255,4320,45095,1,269786
20155,0.000586,172.31.36.0-255,66,45161,1,269786
20156,0.000601,172.253.118.0-255,1484,46645,1,269786
20157,0.000625,172.253.118.0-255,1437,48082,1,269786
20158,0.000628,172.31.36.0-255,66,48148,1,269786
20159,0.000653,172.253.118.0-255,109,48257,1,269786
20160,0.000744,172.253.118.0-255,1484,49741,1,269786
20161,0.000747,172.31.36.0-255,66,49807,1,269786
20162,0.000752,172.253.118.0-255,2902,52709,1,269786
20163,0.000754,172.31.36.0-255,66,52775,1,269786
20164,0.000758,172.253.118.0-255,2902,55677,1,269786
20165,0.000761,172.31.36.0-255,66,55743,1,269786
20166,0.00078,172.253.118.0-255,2902,58645,1,269786
20167,0.000783,172.31.36.0-255,66,58711,1,269786
20168,0.000791,172.253.118.0-255,6797,65508,1,269786
20169,0.000794,172.31.36.0-255,66,65574,1,269786
20170,0.0008,172.253.118.0-255,7156,72730,1,269786
20171,0.000803,172.31.36.0-255,66,72796,1,269786
20172,0.000838,172.31.36.0-255,66,72862,1,269786
20173,0.000862,172.253.118.0-255,333,73195,1,269786
20174,0.001145,172.31.36.0-255,66,73261,1,269786
20175,0.001192,172.253.118.0-255,1484,74745,1,269786
20176,0.001206,172.253.118.0-255,2902,77647,1,269786
20177,0.001209,172.31.36.0-255,66,77713,1,269786
20178,0.001214,172.253.118.0-255,2902,80615,1,269786
20179,0.001217,172.31.36.0-255,66,80681,1,269786
20180,0.001246,172.253.118.0-255,2902,83583,1,269786
20181,0.001249,172.31.36.0-255,66,83649,1,269786
20182,0.001259,172.31.36.0-255,66,83715,1,269786
20183,0.001299,172.31.36.0-255,66,83781,1,269786
20184,0.001729,172.253.118.0-255,1484,85265,1,269786
20185,0.001739,172.253.118.0-255,2902,88167,1,269786
20186,0.001744,172.31.36.0-255,66,88233,1,269786
20187,0.001753,172.253.118.0-255,5738,93971,1,269786
20188,0.001756,172.31.36.0-255,66,94037,1,269786
20189,0.001767,172.253.118.0-255,2902,96939,1,269786
20190,0.00177,172.31.36.0-255,66,97005,1,269786
20191,0.001812,172.31.36.0-255,66,97071,1,269786
20192,0.001835,172.253.118.0-255,5738,102809,1,269786
20193,0.001837,172.31.36.0-255,66,102875,1,269786
20194,0.001865,172.253.118.0-255,5020,107895,1,269786
20195,0.001867,172.31.36.0-255,66,107961,1,269786
20196,0.001874,172.253.118.0-255,5738,113699,1,269786
20197,0.001876,172.31.36.0-255,66,113765,1,269786
20198,0.00188,172.253.118.0-255,1484,115249,1,269786
20199,0.001909,172.253.118.0-255,5738,120987,1,269786
20200,0.001912,172.31.36.0-255,66,121053,1,269786
20201,0.001925,172.31.36.0-255,66,121119,1,269786
20202,0.001958,172.253.118.0-255,4320,125439,1,269786
20203,0.001961,172.31.36.0-255,66,125505,1,269786
20204,0.00197,172.253.118.0-255,6438,131943,1,269786
20205,0.001972,172.31.36.0-255,66,132009,1,269786
20206,0.00399,172.253.118.0-255,5738,137747,1,269786
20207,0.003994,172.31.36.0-255,66,137813,1,269786
20208,0.006063,172.253.118.0-255,5738,143551,1,269786
20209,0.006067,172.31.36.0-255,66,143617,1,269786
20210,0.008099,172.253.118.0-255,5738,149355,1,269786
20211,0.008105,172.31.36.0-255,66,149421,1,269786
20212,0.010147,172.253.118.0-255,5738,155159,1,269786
20213,0.010155,172.31.36.0-255,66,155225,1,269786
20214,0.01219,172.253.118.0-255,5738,160963,1,269786
20215,0.012195,172.31.36.0-255,66,161029,1,269786
20216,0.014233,172.253.118.0-255,5738,166767,1,269786
20217,0.014238,172.31.36.0-255,66,166833,1,269786
20218,0.016282,172.253.118.0-255,5738,172571,1,269786
20219,0.01629,172.31.36.0-255,66,172637,1,269786
20220,0.018344,172.253.118.0-255,5738,178375,1,269786
20221,0.01835,172.31.36.0-255,66,178441,1,269786
20222,0.020397,172.253.118.0-255,5738,184179,1,269786
20223,0.020404,172.31.36.0-255,66,184245,1,269786
20224,0.022465,172.253.118.0-255,5738,189983,1,269786
20225,0.022483,172.31.36.0-255,66,190049,1,269786
20226,0.024573,172.253.118.0-255,5738,195787,1,269786
20227,0.024591,172.31.36.0-255,66,195853,1,269786
20228,0.026645,172.253.118.0-255,5738,201591,1,269786
20229,0.026659,172.31.36.0-255,66,201657,1,269786
20230,0.028697,172.253.118.0-255,5738,207395,1,269786
20231,0.028705,172.31.36.0-255,66,207461,1,269786
20232,0.030775,172.253.118.0-255,5738,213199,1,269786
20233,0.030782,172.31.36.0-255,66,213265,1,269786
20234,0.032829,172.253.118.0-255,5738,219003,1,269786
20235,0.032837,172.31.36.0-255,66,219069,1,269786
20236,0.034878,172.253.118.0-255,5738,224807,1,269786
20237,0.034891,172.31.36.0-255,66,224873,1,269786
20238,0.036917,172.253.118.0-255,5738,230611,1,269786
20239,0.036925,172.31.36.0-255,66,230677,1,269786
20240,0.037639,172.31.36.0-255,172,230849,1,269786
20241,0.037681,172.31.36.0-255,1114,231963,1,269786
20242,0.037755,172.31.36.0-255,1514,233477,1,269786
20243,0.037757,172.31.36.0-255,1287,234764,1,269786
20244,0.038975,172.253.118.0-255,5738,240502,1,269786
20245,0.03899,172.31.36.0-255,66,240568,1,269786
20246,0.039209,104.244.42.0-255,66,240634,1,269786
20247,0.03926,104.244.42.0-255,66,240700,1,269786
20248,0.039341,104.244.42.0-255,66,240766,1,269786
20249,0.04103,172.253.118.0-255,5738,246504,1,269786
20250,0.041051,172.31.36.0-255,66,246570,1,269786
20251,0.043085,172.253.118.0-255,5738,252308,1,269786
20252,0.04309,172.31.36.0-255,66,252374,1,269786
20253,0.045127,172.253.118.0-255,5738,258112,1,269786
20254,0.045133,172.31.36.0-255,66,258178,1,269786
20255,0.047182,172.253.118.0-255,5738,263916,1,269786
20256,0.047189,172.31.36.0-255,66,263982,1,269786
20257,0.049231,172.253.118.0-255,5738,269720,1,269786
20258,0.049237,172.31.36.0-255,66,269786,1,269786
20259,0.0,74.125.130.0-255,153,153,1,307117
20260,1.6e-05,172.31.36.0-255,66,219,1,307117
20261,2.3e-05,74.125.130.0-255,1484,1703,1,307117
20262,2.7e-05,172.31.36.0-255,66,1769,1,307117
20263,3.3e-05,74.125.130.0-255,2902,4671,1,307117
20264,3.6e-05,172.31.36.0-255,66,4737,1,307117
20265,4.2e-05,74.125.130.0-255,4320,9057,1,307117
20266,4.5e-05,172.31.36.0-255,66,9123,1,307117
20267,7.3e-05,74.125.130.0-255,2902,12025,1,307117
20268,7.6e-05,172.31.36.0-255,66,12091,1,307117
20269,9.7e-05,74.125.130.0-255,2035,14126,1,307117
20270,0.0001,172.31.36.0-255,66,14192,1,307117
20271,0.000162,74.125.130.0-255,1484,15676,1,307117
20272,0.000165,172.31.36.0-255,66,15742,1,307117
20273,0.000168,74.125.130.0-255,1484,17226,1,307117
20274,0.00017,172.31.36.0-255,66,17292,1,307117
20275,0.000175,74.125.130.0-255,2902,20194,1,307117
20276,0.000178,172.31.36.0-255,66,20260,1,307117
20277,0.0002,74.125.130.0-255,5738,25998,1,307117
20278,0.000202,172.31.36.0-255,66,26064,1,307117
20279,0.000233,74.125.130.0-255,5379,31443,1,307117
20280,0.000235,172.31.36.0-255,66,31509,1,307117
20281,0.00026,74.125.130.0-255,5738,37247,1,307117
20282,0.000263,172.31.36.0-255,66,37313,1,307117
20283,0.000287,74.125.130.0-255,5738,43051,1,307117
20284,0.000289,172.31.36.0-255,66,43117,1,307117
20285,0.000331,74.125.130.0-255,5379,48496,1,307117
20286,0.000334,172.31.36.0-255,66,48562,1,307117
20287,0.000374,74.125.130.0-255,1484,50046,1,307117
20288,0.000376,172.31.36.0-255,66,50112,1,307117
20289,0.000396,74.125.130.0-255,2902,53014,1,307117
20290,0.000398,172.31.36.0-255,66,53080,1,307117
20291,0.000419,74.125.130.0-255,5738,58818,1,307117
20292,0.000422,172.31.36.0-255,66,58884,1,307117
20293,0.000426,74.125.130.0-255,1484,60368,1,307117
20294,0.000483,74.125.130.0-255,2902,63270,1,307117
20295,0.000486,172.31.36.0-255,66,63336,1,307117
20296,0.000501,74.125.130.0-255,2543,65879,1,307117
20297,0.000503,172.31.36.0-255,66,65945,1,307117
20298,0.000506,74.125.130.0-255,363,66308,1,307117
20299,0.000523,74.125.130.0-255,380,66688,1,307117
20300,0.001128,74.125.130.0-255,1484,68172,1,307117
20301,0.001134,172.31.36.0-255,66,68238,1,307117
20302,0.001141,74.125.130.0-255,2902,71140,1,307117
20303,0.001144,172.31.36.0-255,66,71206,1,307117
20304,0.001179,74.125.130.0-255,2902,74108,1,307117
20305,0.001182,172.31.36.0-255,66,74174,1,307117
20306,0.001202,74.125.130.0-255,2902,77076,1,307117
20307,0.001205,74.125.130.0-255,1484,78560,1,307117
20308,0.001214,172.31.36.0-255,66,78626,1,307117
20309,0.00122,74.125.130.0-255,2902,81528,1,307117
20310,0.001222,172.31.36.0-255,66,81594,1,307117
20311,0.001229,74.125.130.0-255,5738,87332,1,307117
20312,0.001231,172.31.36.0-255,66,87398,1,307117
20313,0.00125,74.125.130.0-255,2902,90300,1,307117
20314,0.001252,172.31.36.0-255,66,90366,1,307117
20315,0.001272,74.125.130.0-255,4320,94686,1,307117
20316,0.001274,172.31.36.0-255,66,94752,1,307117
20317,0.001289,74.125.130.0-255,4320,99072,1,307117
20318,0.001292,172.31.36.0-255,66,99138,1,307117
20319,0.001344,74.125.130.0-255,2184,101322,1,307117
20320,0.001347,172.31.36.0-255,66,101388,1,307117
20321,0.001488,74.125.130.0-255,1484,102872,1,307117
20322,0.001514,74.125.130.0-255,2902,105774,1,307117
20323,0.001517,172.31.36.0-255,66,105840,1,307117
20324,0.001546,74.125.130.0-255,4320,110160,1,307117
20325,0.00155,172.31.36.0-255,66,110226,1,307117
20326,0.001566,74.125.130.0-255,1484,111710,1,307117
20327,0.001589,74.125.130.0-255,4320,116030,1,307117
20328,0.001591,172.31.36.0-255,66,116096,1,307117
20329,0.001603,74.125.130.0-255,1484,117580,1,307117
20330,0.001619,74.125.130.0-255,2902,120482,1,307117
20331,0.001621,172.31.36.0-255,66,120548,1,307117
20332,0.001625,74.125.130.0-255,1484,122032,1,307117
20333,0.001645,74.125.130.0-255,4320,126352,1,307117
20334,0.001648,172.31.36.0-255,66,126418,1,307117
20335,0.001654,74.125.130.0-255,5738,132156,1,307117
20336,0.001656,172.31.36.0-255,66,132222,1,307117
20337,0.001713,74.125.130.0-255,3602,135824,1,307117
20338,0.001719,172.31.36.0-255,66,135890,1,307117
20339,0.00179,74.125.130.0-255,1484,137374,1,307117
20340,0.001808,74.125.130.0-255,2902,140276,1,307117
20341,0.001811,172.31.36.0-255,66,140342,1,307117
20342,0.001836,74.125.130.0-255,2902,143244,1,307117
20343,0.001838,172.31.36.0-255,66,143310,1,307117
20344,0.001859,74.125.130.0-255,2902,146212,1,307117
20345,0.001862,172.31.36.0-255,66,146278,1,307117
20346,0.001865,74.125.130.0-255,1484,147762,1,307117
20347,0.00187,74.125.130.0-255,2902,150664,1,307117
20348,0.001872,172.31.36.0-255,66,150730,1,307117
20349,0.001919,74.125.130.0-255,5738,156468,1,307117
20350,0.001922,172.31.36.0-255,66,156534,1,307117
20351,0.001925,74.125.130.0-255,1484,158018,1,307117
20352,0.001945,74.125.130.0-255,7156,165174,1,307117
20353,0.001948,172.31.36.0-255,66,165240,1,307117
20354,0.001967,74.125.130.0-255,1484,166724,1,307117
20355,0.00197,74.125.130.0-255,1484,168208,1,307117
20356,0.001972,172.31.36.0-255,66,168274,1,307117
20357,0.001976,74.125.130.0-255,2184,170458,1,307117
20358,0.001979,172.31.36.0-255,66,170524,1,307117
20359,0.002087,74.125.130.0-255,1484,172008,1,307117
20360,0.002093,74.125.130.0-255,2902,174910,1,307117
20361,0.002096,172.31.36.0-255,66,174976,1,307117
20362,0.0021,74.125.130.0-255,1484,176460,1,307117
20363,0.002103,74.125.130.0-255,1484,177944,1,307117
20364,0.002104,172.31.36.0-255,66,178010,1,307117
20365,0.002129,74.125.130.0-255,1484,179494,1,307117
20366,0.002136,74.125.130.0-255,5738,185232,1,307117
20367,0.002139,172.31.36.0-255,66,185298,1,307117
20368,0.002142,74.125.130.0-255,1484,186782,1,307117
20369,0.002162,74.125.130.0-255,7156,193938,1,307117
20370,0.002165,172.31.36.0-255,66,194004,1,307117
20371,0.002191,172.31.36.0-255,66,194070,1,307117
20372,0.002194,74.125.130.0-255,766,194836,1,307117
20373,0.002956,172.31.36.0-255,66,194902,1,307117
20374,0.004764,74.125.130.0-255,4320,199222,1,307117
20375,0.004772,172.31.36.0-255,66,199288,1,307117
20376,0.005513,74.125.130.0-255,1484,200772,1,307117
20377,0.007324,74.125.130.0-255,4320,205092,1,307117
20378,0.007327,172.31.36.0-255,66,205158,1,307117
20379,0.009889,74.125.130.0-255,5738,210896,1,307117
20380,0.009899,172.31.36.0-255,66,210962,1,307117
20381,0.012477,74.125.130.0-255,5738,216700,1,307117
20382,0.012488,172.31.36.0-255,66,216766,1,307117
20383,0.015095,74.125.130.0-255,5738,222504,1,307117
20384,0.015113,172.31.36.0-255,66,222570,1,307117
20385,0.017713,74.125.130.0-255,5738,228308,1,307117
20386,0.017733,172.31.36.0-255,66,228374,1,307117
20387,0.020304,74.125.130.0-255,5738,234112,1,307117
20388,0.020316,172.31.36.0-255,66,234178,1,307117
20389,0.022898,74.125.130.0-255,5738,239916,1,307117
20390,0.022913,172.31.36.0-255,66,239982,1,307117
20391,0.025518,74.125.130.0-255,5738,245720,1,307117
20392,0.025534,172.31.36.0-255,66,245786,1,307117
20393,0.028107,74.125.130.0-255,5738,251524,1,307117
20394,0.028118,172.31.36.0-255,66,251590,1,307117
20395,0.030698,74.125.130.0-255,5738,257328,1,307117
20396,0.030708,172.31.36.0-255,66,257394,1,307117
20397,0.033269,74.125.130.0-255,5738,263132,1,307117
20398,0.033277,172.31.36.0-255,66,263198,1,307117
20399,0.03586,74.125.130.0-255,5738,268936,1,307117
20400,0.035868,172.31.36.0-255,66,269002,1,307117
20401,0.038431,74.125.130.0-255,5738,274740,1,307117
20402,0.03844,172.31.36.0-255,66,274806,1,307117
20403,0.040539,172.31.36.0-255,172,274978,1,307117
20404,0.040607,172.31.36.0-255,1113,276091,1,307117
20405,0.040682,172.31.36.0-255,1514,277605,1,307117
20406,0.040684,172.31.36.0-255,1514,279119,1,307117
20407,0.040685,172.31.36.0-255,1514,280633,1,307117
20408,0.040686,172.31.36.0-255,1514,282147,1,307117
20409,0.040717,172.31.36.0-255,1490,283637,1,307117
20410,0.041013,74.125.130.0-255,5738,289375,1,307117
20411,0.04102,172.31.36.0-255,66,289441,1,307117
20412,0.042106,104.244.42.0-255,66,289507,1,307117
20413,0.042137,104.244.42.0-255,66,289573,1,307117
20414,0.042276,104.244.42.0-255,66,289639,1,307117
20415,0.042282,104.244.42.0-255,66,289705,1,307117
20416,0.043587,74.125.130.0-255,5738,295443,1,307117
20417,0.043595,172.31.36.0-255,66,295509,1,307117
20418,0.046214,74.125.130.0-255,5738,301247,1,307117
20419,0.046226,172.31.36.0-255,66,301313,1,307117
20420,0.048803,74.125.130.0-255,5738,307051,1,307117
20421,0.048813,172.31.36.0-255,66,307117,1,307117
20422,0.0,172.217.194.0-255,148,148,1,207686
20423,2.7e-05,172.31.36.0-255,66,214,1,207686
20424,3.5e-05,172.217.194.0-255,1484,1698,1,207686
20425,3.9e-05,172.31.36.0-255,66,1764,1,207686
20426,5.1e-05,172.217.194.0-255,2902,4666,1,207686
20427,5.5e-05,172.31.36.0-255,66,4732,1,207686
20428,5.8e-05,172.217.194.0-255,1484,6216,1,207686
20429,6e-05,172.31.36.0-255,66,6282,1,207686
20430,6.7e-05,172.217.194.0-255,5738,12020,1,207686
20431,7e-05,172.31.36.0-255,66,12086,1,207686
20432,7.5e-05,172.217.194.0-255,2902,14988,1,207686
20433,7.7e-05,172.31.36.0-255,66,15054,1,207686
20434,0.000127,172.31.36.0-255,66,15120,1,207686
20435,0.000136,172.217.194.0-255,5379,20499,1,207686
20436,0.000138,172.31.36.0-255,66,20565,1,207686
20437,0.000149,172.217.194.0-255,1484,22049,1,207686
20438,0.000152,172.31.36.0-255,66,22115,1,207686
20439,0.000188,172.217.194.0-255,2902,25017,1,207686
20440,0.000191,172.31.36.0-255,66,25083,1,207686
20441,0.000197,172.217.194.0-255,5738,30821,1,207686
20442,0.0002,172.31.36.0-255,66,30887,1,207686
20443,0.000211,172.217.194.0-255,4320,35207,1,207686
20444,0.000213,172.31.36.0-255,66,35273,1,207686
20445,0.000218,172.217.194.0-255,2902,38175,1,207686
20446,0.000221,172.31.36.0-255,66,38241,1,207686
20447,0.000264,172.31.36.0-255,66,38307,1,207686
20448,0.000269,172.217.194.0-255,4320,42627,1,207686
20449,0.000271,172.31.36.0-255,66,42693,1,207686
20450,0.000303,172.217.194.0-255,3602,46295,1,207686
20451,0.000307,172.31.36.0-255,66,46361,1,207686
20452,0.000396,172.217.194.0-255,378,46739,1,207686
20453,0.000415,172.217.194.0-255,100,46839,1,207686
20454,0.000624,172.217.194.0-255,1484,48323,1,207686
20455,0.000629,172.31.36.0-255,66,48389,1,207686
20456,0.000634,172.217.194.0-255,2902,51291,1,207686
20457,0.000645,172.31.36.0-255,66,51357,1,207686
20458,0.000657,172.217.194.0-255,5738,57095,1,207686
20459,0.000665,172.217.194.0-255,1484,58579,1,207686
20460,0.000666,172.31.36.0-255,66,58645,1,207686
20461,0.000697,172.217.194.0-255,5738,64383,1,207686
20462,0.000711,172.31.36.0-255,66,64449,1,207686
20463,0.000727,172.31.36.0-255,66,64515,1,207686
20464,0.000741,172.217.194.0-255,2902,67417,1,207686
20465,0.000754,172.31.36.0-255,66,67483,1,207686
20466,0.000763,172.217.194.0-255,3602,71085,1,207686
20467,0.000768,172.31.36.0-255,66,71151,1,207686
20468,0.000949,172.217.194.0-255,1484,72635,1,207686
20469,0.000954,172.217.194.0-255,2902,75537,1,207686
20470,0.000957,172.31.36.0-255,66,75603,1,207686
20471,0.000977,172.217.194.0-255,5738,81341,1,207686
20472,0.00098,172.31.36.0-255,66,81407,1,207686
20473,0.001,172.217.194.0-255,4320,85727,1,207686
20474,0.00101,172.31.36.0-255,66,85793,1,207686
20475,0.001036,172.217.194.0-255,5738,91531,1,207686
20476,0.001036,172.31.36.0-255,66,91597,1,207686
20477,0.001041,172.31.36.0-255,66,91663,1,207686
20478,0.001087,172.31.36.0-255,66,91729,1,207686
20479,0.001112,172.31.36.0-255,66,91795,1,207686
20480,0.001126,172.217.194.0-255,7156,98951,1,207686
20481,0.001131,172.31.36.0-255,66,99017,1,207686
20482,0.001179,172.31.36.0-255,66,99083,1,207686
20483,0.001183,172.217.194.0-255,2184,101267,1,207686
20484,0.001193,172.31.36.0-255,66,101333,1,207686
20485,0.001389,172.217.194.0-255,1484,102817,1,207686
20486,0.001394,172.217.194.0-255,2902,105719,1,207686
20487,0.001397,172.31.36.0-255,66,105785,1,207686
20488,0.001421,172.217.194.0-255,5738,111523,1,207686
20489,0.001424,172.217.194.0-255,1484,113007,1,207686
20490,0.001427,172.31.36.0-255,66,113073,1,207686
20491,0.001468,172.217.194.0-255,1484,114557,1,207686
20492,0.001475,172.31.36.0-255,66,114623,1,207686
20493,0.001521,172.217.194.0-255,7156,121779,1,207686
20494,0.001525,172.31.36.0-255,66,121845,1,207686
20495,0.001565,172.217.194.0-255,1484,123329,1,207686
20496,0.001577,172.217.194.0-255,2902,126231,1,207686
20497,0.001612,172.217.194.0-255,4320,130551,1,207686
20498,0.001625,172.217.194.0-255,1484,132035,1,207686
20499,0.001628,172.217.194.0-255,1484,133519,1,207686
20500,0.001671,172.217.194.0-255,2902,136421,1,207686
20501,0.001716,172.217.194.0-255,2902,139323,1,207686
20502,0.001747,172.217.194.0-255,1484,140807,1,207686
20503,0.00178,172.217.194.0-255,7156,147963,1,207686
20504,0.0018,172.217.194.0-255,3602,151565,1,207686
20505,0.001814,172.217.194.0-255,1484,153049,1,207686
20506,0.001817,172.217.194.0-255,1484,154533,1,207686
20507,0.001832,172.217.194.0-255,1484,156017,1,207686
20508,0.001843,172.217.194.0-255,4320,160337,1,207686
20509,0.001852,172.217.194.0-255,1484,161821,1,207686
20510,0.001872,172.217.194.0-255,4320,166141,1,207686
20511,0.001939,172.217.194.0-255,5738,171879,1,207686
20512,0.001958,172.217.194.0-255,2184,174063,1,207686
20513,0.001985,172.217.194.0-255,2902,176965,1,207686
20514,0.002021,172.217.194.0-255,4320,181285,1,207686
20515,0.002024,172.217.194.0-255,2902,184187,1,207686
20516,0.002054,172.217.194.0-255,2902,187089,1,207686
20517,0.002072,172.217.194.0-255,7156,194245,1,207686
20518,0.002188,172.217.194.0-255,3995,198240,1,207686
20519,0.002216,172.217.194.0-255,105,198345,1,207686
20520,0.006587,172.31.36.0-255,66,198411,1,207686
20521,0.008733,172.31.36.0-255,105,198516,1,207686
20522,0.010918,172.217.194.0-255,66,198582,1,207686
20523,0.033262,172.31.36.0-255,247,198829,1,207686
20524,0.033309,172.31.36.0-255,1113,199942,1,207686
20525,0.033341,172.31.36.0-255,1514,201456,1,207686
20526,0.033343,172.31.36.0-255,1514,202970,1,207686
20527,0.033344,172.31.36.0-255,1514,204484,1,207686
20528,0.033345,172.31.36.0-255,1514,205998,1,207686
20529,0.033369,172.31.36.0-255,1490,207488,1,207686
20530,0.034842,104.244.42.0-255,66,207554,1,207686
20531,0.034875,104.244.42.0-255,66,207620,1,207686
20532,0.034978,104.244.42.0-255,66,207686,1,207686
20533,0.0,74.125.68.0-255,150,150,1,252087
20534,2.3e-05,172.31.36.0-255,66,216,1,252087
20535,2.9e-05,74.125.68.0-255,1484,1700,1,252087
20536,3.3e-05,172.31.36.0-255,66,1766,1,252087
20537,3.8e-05,74.125.68.0-255,2902,4668,1,252087
20538,4.8e-05,172.31.36.0-255,66,4734,1,252087
20539,7.9e-05,74.125.68.0-255,5738,10472,1,252087
20540,8.2e-05,172.31.36.0-255,66,10538,1,252087
20541,0.000131,74.125.68.0-255,3431,13969,1,252087
20542,0.000135,172.31.36.0-255,66,14035,1,252087
20543,0.000239,74.125.68.0-255,1484,15519,1,252087
20544,0.000244,172.31.36.0-255,66,15585,1,252087
20545,0.000251,74.125.68.0-255,2902,18487,1,252087
20546,0.000254,172.31.36.0-255,66,18553,1,252087
20547,0.000291,74.125.68.0-255,5738,24291,1,252087
20548,0.000294,172.31.36.0-255,66,24357,1,252087
20549,0.000338,74.125.68.0-255,4320,28677,1,252087
20550,0.000343,172.31.36.0-255,66,28743,1,252087
20551,0.000352,74.125.68.0-255,2543,31286,1,252087
20552,0.00036,172.31.36.0-255,66,31352,1,252087
20553,0.000422,74.125.68.0-255,2902,34254,1,252087
20554,0.000427,172.31.36.0-255,66,34320,1,252087
20555,0.000456,74.125.68.0-255,2902,37222,1,252087
20556,0.00046,172.31.36.0-255,66,37288,1,252087
20557,0.000494,74.125.68.0-255,7156,44444,1,252087
20558,0.000497,172.31.36.0-255,66,44510,1,252087
20559,0.00058,74.125.68.0-255,7156,51666,1,252087
20560,0.000584,172.31.36.0-255,66,51732,1,252087
20561,0.000612,172.31.36.0-255,66,51798,1,252087
20562,0.000763,74.125.68.0-255,5020,56818,1,252087
20563,0.000768,172.31.36.0-255,66,56884,1,252087
20564,0.000817,74.125.68.0-255,5738,62622,1,252087
20565,0.000821,172.31.36.0-255,66,62688,1,252087
20566,0.000869,172.31.36.0-255,66,62754,1,252087
20567,0.001027,74.125.68.0-255,1484,64238,1,252087
20568,0.001434,74.125.68.0-255,1484,65722,1,252087
20569,0.001442,74.125.68.0-255,2902,68624,1,252087
20570,0.001493,74.125.68.0-255,4320,72944,1,252087
20571,0.001523,74.125.68.0-255,2902,75846,1,252087
20572,0.001538,74.125.68.0-255,2902,78748,1,252087
20573,0.001571,74.125.68.0-255,2902,81650,1,252087
20574,0.001592,74.125.68.0-255,4320,85970,1,252087
20575,0.00167,74.125.68.0-255,1484,87454,1,252087
20576,0.001779,74.125.68.0-255,766,88220,1,252087
20577,0.002045,74.125.68.0-255,1484,89704,1,252087
20578,0.00206,74.125.68.0-255,1484,91188,1,252087
20579,0.00207,74.125.68.0-255,1484,92672,1,252087
20580,0.002088,74.125.68.0-255,2902,95574,1,252087
20581,0.0021,74.125.68.0-255,2902,98476,1,252087
20582,0.002145,74.125.68.0-255,2902,101378,1,252087
20583,0.002163,74.125.68.0-255,2902,104280,1,252087
20584,0.002219,74.125.68.0-255,4320,108600,1,252087
20585,0.002375,74.125.68.0-255,5020,113620,1,252087
20586,0.002428,74.125.68.0-255,2902,116522,1,252087
20587,0.002626,172.31.36.0-255,66,116588,1,252087
20588,0.002645,74.125.68.0-255,4320,120908,1,252087
20589,0.002651,172.31.36.0-255,66,120974,1,252087
20590,0.002692,172.31.36.0-255,66,121040,1,252087
20591,0.002837,74.125.68.0-255,7156,128196,1,252087
20592,0.002847,172.31.36.0-255,66,128262,1,252087
20593,0.005112,74.125.68.0-255,5738,134000,1,252087
20594,0.005118,172.31.36.0-255,66,134066,1,252087
20595,0.007378,74.125.68.0-255,5738,139804,1,252087
20596,0.007384,172.31.36.0-255,66,139870,1,252087
20597,0.009649,74.125.68.0-255,5738,145608,1,252087
20598,0.009658,172.31.36.0-255,66,145674,1,252087
20599,0.011928,74.125.68.0-255,5738,151412,1,252087
20600,0.011937,172.31.36.0-255,66,151478,1,252087
20601,0.014196,74.125.68.0-255,5738,157216,1,252087
20602,0.014204,172.31.36.0-255,66,157282,1,252087
20603,0.01647,74.125.68.0-255,5738,163020,1,252087
20604,0.016477,172.31.36.0-255,66,163086,1,252087
20605,0.01876,74.125.68.0-255,5738,168824,1,252087
20606,0.018769,172.31.36.0-255,66,168890,1,252087
20607,0.021036,74.125.68.0-255,5738,174628,1,252087
20608,0.021063,172.31.36.0-255,66,174694,1,252087
20609,0.023333,74.125.68.0-255,5738,180432,1,252087
20610,0.023339,172.31.36.0-255,66,180498,1,252087
20611,0.025612,74.125.68.0-255,5738,186236,1,252087
20612,0.025618,172.31.36.0-255,66,186302,1,252087
20613,0.027891,74.125.68.0-255,5738,192040,1,252087
20614,0.027898,172.31.36.0-255,66,192106,1,252087
20615,0.030158,74.125.68.0-255,5738,197844,1,252087
20616,0.030165,172.31.36.0-255,66,197910,1,252087
20617,0.0315,172.31.36.0-255,172,198082,1,252087
20618,0.031529,172.31.36.0-255,1116,199198,1,252087
20619,0.031578,172.31.36.0-255,1514,200712,1,252087
20620,0.03158,172.31.36.0-255,1514,202226,1,252087
20621,0.031586,172.31.36.0-255,1514,203740,1,252087
20622,0.031587,172.31.36.0-255,1514,205254,1,252087
20623,0.031609,172.31.36.0-255,1489,206743,1,252087
20624,0.032438,74.125.68.0-255,5738,212481,1,252087
20625,0.032446,172.31.36.0-255,66,212547,1,252087
20626,0.033054,104.244.42.0-255,66,212613,1,252087
20627,0.03309,104.244.42.0-255,66,212679,1,252087
20628,0.033151,104.244.42.0-255,66,212745,1,252087
20629,0.033174,104.244.42.0-255,66,212811,1,252087
20630,0.03471,74.125.68.0-255,5738,218549,1,252087
20631,0.034715,172.31.36.0-255,66,218615,1,252087
20632,0.036991,74.125.68.0-255,5738,224353,1,252087
20633,0.036997,172.31.36.0-255,66,224419,1,252087
20634,0.039262,74.125.68.0-255,5738,230157,1,252087
20635,0.039268,172.31.36.0-255,66,230223,1,252087
20636,0.041562,74.125.68.0-255,4320,234543,1,252087
20637,0.041567,172.31.36.0-255,66,234609,1,252087
20638,0.041604,74.125.68.0-255,1484,236093,1,252087
20639,0.043829,74.125.68.0-255,4320,240413,1,252087
20640,0.043834,172.31.36.0-255,66,240479,1,252087
20641,0.046125,74.125.68.0-255,5738,246217,1,252087
20642,0.046183,172.31.36.0-255,66,246283,1,252087
20643,0.048452,74.125.68.0-255,5738,252021,1,252087
20644,0.048457,172.31.36.0-255,66,252087,1,252087
20645,0.0,172.217.194.0-255,66,66,1,66
20646,0.0,74.125.24.0-255,150,150,1,274696
20647,2.2e-05,172.31.36.0-255,66,216,1,274696
20648,4.6e-05,74.125.24.0-255,1484,1700,1,274696
20649,5e-05,172.31.36.0-255,66,1766,1,274696
20650,7.2e-05,74.125.24.0-255,2902,4668,1,274696
20651,7.4e-05,172.31.36.0-255,66,4734,1,274696
20652,8.2e-05,74.125.24.0-255,5738,10472,1,274696
20653,8.4e-05,172.31.36.0-255,66,10538,1,274696
20654,0.00014,74.125.24.0-255,3505,14043,1,274696
20655,0.000142,172.31.36.0-255,66,14109,1,274696
20656,0.000251,74.125.24.0-255,1484,15593,1,274696
20657,0.000256,172.31.36.0-255,66,15659,1,274696
20658,0.000278,74.125.24.0-255,2902,18561,1,274696
20659,0.000281,172.31.36.0-255,66,18627,1,274696
20660,0.000319,74.125.24.0-255,4320,22947,1,274696
20661,0.000321,172.31.36.0-255,66,23013,1,274696
20662,0.000327,74.125.24.0-255,5738,28751,1,274696
20663,0.00033,172.31.36.0-255,66,28817,1,274696
20664,0.000335,74.125.24.0-255,2543,31360,1,274696
20665,0.000337,172.31.36.0-255,66,31426,1,274696
20666,0.000409,74.125.24.0-255,4320,35746,1,274696
20667,0.000413,172.31.36.0-255,66,35812,1,274696
20668,0.000429,74.125.24.0-255,5738,41550,1,274696
20669,0.000431,172.31.36.0-255,66,41616,1,274696
20670,0.000448,74.125.24.0-255,2902,44518,1,274696
20671,0.00045,172.31.36.0-255,66,44584,1,274696
20672,0.000466,74.125.24.0-255,3961,48545,1,274696
20673,0.000468,172.31.36.0-255,66,48611,1,274696
20674,0.000765,74.125.24.0-255,1484,50095,1,274696
20675,0.000769,172.31.36.0-255,66,50161,1,274696
20676,0.000775,74.125.24.0-255,2902,53063,1,274696
20677,0.000777,172.31.36.0-255,66,53129,1,274696
20678,0.000803,74.125.24.0-255,4320,57449,1,274696
20679,0.000806,172.31.36.0-255,66,57515,1,274696
20680,0.000826,74.125.24.0-255,5738,63253,1,274696
20681,0.000828,172.31.36.0-255,66,63319,1,274696
20682,0.000846,74.125.24.0-255,3961,67280,1,274696
20683,0.000862,172.31.36.0-255,66,67346,1,274696
20684,0.000875,74.125.24.0-255,5738,73084,1,274696
20685,0.00089,172.31.36.0-255,66,73150,1,274696
20686,0.000926,172.31.36.0-255,66,73216,1,274696
20687,0.000952,74.125.24.0-255,5738,78954,1,274696
20688,0.000963,172.31.36.0-255,66,79020,1,274696
20689,0.001025,74.125.24.0-255,4320,83340,1,274696
20690,0.001032,74.125.24.0-255,4357,87697,1,274696
20691,0.001036,172.31.36.0-255,66,87763,1,274696
20692,0.001401,74.125.24.0-255,1484,89247,1,274696
20693,0.001417,74.125.24.0-255,2902,92149,1,274696
20694,0.001421,172.31.36.0-255,66,92215,1,274696
20695,0.001428,74.125.24.0-255,4320,96535,1,274696
20696,0.00143,172.31.36.0-255,66,96601,1,274696
20697,0.001453,74.125.24.0-255,1484,98085,1,274696
20698,0.001471,74.125.24.0-255,5738,103823,1,274696
20699,0.00148,172.31.36.0-255,66,103889,1,274696
20700,0.001537,172.31.36.0-255,66,103955,1,274696
20701,0.00157,74.125.24.0-255,2184,106139,1,274696
20702,0.001584,172.31.36.0-255,66,106205,1,274696
20703,0.002057,74.125.24.0-255,1484,107689,1,274696
20704,0.00208,74.125.24.0-255,2902,110591,1,274696
20705,0.002084,172.31.36.0-255,66,110657,1,274696
20706,0.002089,74.125.24.0-255,2902,113559,1,274696
20707,0.002091,172.31.36.0-255,66,113625,1,274696
20708,0.002105,74.125.24.0-255,2902,116527,1,274696
20709,0.002109,172.31.36.0-255,66,116593,1,274696
20710,0.002127,74.125.24.0-255,5738,122331,1,274696
20711,0.00213,172.31.36.0-255,66,122397,1,274696
20712,0.002158,74.125.24.0-255,4320,126717,1,274696
20713,0.002162,172.31.36.0-255,66,126783,1,274696
20714,0.002176,74.125.24.0-255,2184,128967,1,274696
20715,0.002189,172.31.36.0-255,66,129033,1,274696
20716,0.00226,74.125.24.0-255,1484,130517,1,274696
20717,0.002266,74.125.24.0-255,2902,133419,1,274696
20718,0.002297,172.31.36.0-255,66,133485,1,274696
20719,0.002307,74.125.24.0-255,5738,139223,1,274696
20720,0.002313,172.31.36.0-255,66,139289,1,274696
20721,0.002328,74.125.24.0-255,5738,145027,1,274696
20722,0.002345,74.125.24.0-255,4320,149347,1,274696
20723,0.002351,172.31.36.0-255,66,149413,1,274696
20724,0.004627,74.125.24.0-255,5738,155151,1,274696
20725,0.004634,172.31.36.0-255,66,155217,1,274696
20726,0.006912,74.125.24.0-255,5738,160955,1,274696
20727,0.006916,172.31.36.0-255,66,161021,1,274696
20728,0.009174,74.125.24.0-255,5738,166759,1,274696
20729,0.009181,172.31.36.0-255,66,166825,1,274696
20730,0.011473,74.125.24.0-255,5738,172563,1,274696
20731,0.011482,172.31.36.0-255,66,172629,1,274696
20732,0.013765,74.125.24.0-255,5738,178367,1,274696
20733,0.013774,172.31.36.0-255,66,178433,1,274696
20734,0.016074,74.125.24.0-255,5738,184171,1,274696
20735,0.016101,172.31.36.0-255,66,184237,1,274696
20736,0.018378,74.125.24.0-255,5738,189975,1,274696
20737,0.018389,172.31.36.0-255,66,190041,1,274696
20738,0.02064,74.125.24.0-255,5738,195779,1,274696
20739,0.02065,172.31.36.0-255,66,195845,1,274696
20740,0.022931,74.125.24.0-255,5738,201583,1,274696
20741,0.022939,172.31.36.0-255,66,201649,1,274696
20742,0.025211,74.125.24.0-255,5738,207387,1,274696
20743,0.025218,172.31.36.0-255,66,207453,1,274696
20744,0.027489,74.125.24.0-255,5738,213191,1,274696
20745,0.027497,172.31.36.0-255,66,213257,1,274696
20746,0.02981,74.125.24.0-255,5738,218995,1,274696
20747,0.029817,172.31.36.0-255,66,219061,1,274696
20748,0.032092,74.125.24.0-255,5738,224799,1,274696
20749,0.0321,172.31.36.0-255,66,224865,1,274696
20750,0.034351,74.125.24.0-255,5738,230603,1,274696
20751,0.034361,172.31.36.0-255,66,230669,1,274696
20752,0.036621,74.125.24.0-255,5738,236407,1,274696
20753,0.036629,172.31.36.0-255,66,236473,1,274696
20754,0.03798,172.31.36.0-255,172,236645,1,274696
20755,0.038013,172.31.36.0-255,1114,237759,1,274696
20756,0.03808,172.31.36.0-255,1514,239273,1,274696
20757,0.038082,172.31.36.0-255,1514,240787,1,274696
20758,0.038083,172.31.36.0-255,1514,242301,1,274696
20759,0.038084,172.31.36.0-255,1514,243815,1,274696
20760,0.03811,172.31.36.0-255,1489,245304,1,274696
20761,0.038897,74.125.24.0-255,5738,251042,1,274696
20762,0.038905,172.31.36.0-255,66,251108,1,274696
20763,0.039551,104.244.42.0-255,66,251174,1,274696
20764,0.039561,104.244.42.0-255,66,251240,1,274696
20765,0.039696,104.244.42.0-255,66,251306,1,274696
20766,0.040362,104.244.42.0-255,108,251414,1,274696
20767,0.040372,172.31.36.0-255,66,251480,1,274696
20768,0.041182,74.125.24.0-255,5738,257218,1,274696
20769,0.041189,172.31.36.0-255,66,257284,1,274696
20770,0.043456,74.125.24.0-255,5738,263022,1,274696
20771,0.043463,172.31.36.0-255,66,263088,1,274696
20772,0.045716,74.125.24.0-255,5738,268826,1,274696
20773,0.045723,172.31.36.0-255,66,268892,1,274696
20774,0.047986,74.125.24.0-255,5738,274630,1,274696
20775,0.047993,172.31.36.0-255,66,274696,1,274696
20776,0.0,172.217.194.0-255,146,146,1,190029
20777,2.3e-05,172.31.36.0-255,66,212,1,190029
20778,3.1e-05,172.217.194.0-255,1484,1696,1,190029
20779,3.5e-05,172.31.36.0-255,66,1762,1,190029
20780,4e-05,172.217.194.0-255,2902,4664,1,190029
20781,4.3e-05,172.31.36.0-255,66,4730,1,190029
20782,7.5e-05,172.217.194.0-255,7156,11886,1,190029
20783,7.8e-05,172.31.36.0-255,66,11952,1,190029
20784,0.000168,172.217.194.0-255,2093,14045,1,190029
20785,0.000172,172.31.36.0-255,66,14111,1,190029
20786,0.000206,172.217.194.0-255,2902,17013,1,190029
20787,0.000209,172.31.36.0-255,66,17079,1,190029
20788,0.000269,172.217.194.0-255,7156,24235,1,190029
20789,0.000272,172.31.36.0-255,66,24301,1,190029
20790,0.000388,172.31.36.0-255,66,24367,1,190029
20791,0.000531,172.31.36.0-255,66,24433,1,190029
20792,0.000545,172.217.194.0-255,3961,28394,1,190029
20793,0.000548,172.31.36.0-255,66,28460,1,190029
20794,0.000781,172.217.194.0-255,7156,35616,1,190029
20795,0.000785,172.31.36.0-255,66,35682,1,190029
20796,0.000813,172.31.36.0-255,66,35748,1,190029
20797,0.001041,172.217.194.0-255,381,36129,1,190029
20798,0.001045,172.31.36.0-255,66,36195,1,190029
20799,0.001064,172.217.194.0-255,1484,37679,1,190029
20800,0.001066,172.31.36.0-255,66,37745,1,190029
20801,0.001106,172.217.194.0-255,4320,42065,1,190029
20802,0.001108,172.31.36.0-255,66,42131,1,190029
20803,0.001173,172.217.194.0-255,5738,47869,1,190029
20804,0.001176,172.31.36.0-255,66,47935,1,190029
20805,0.001198,172.217.194.0-255,4320,52255,1,190029
20806,0.0012,172.31.36.0-255,66,52321,1,190029
20807,0.001349,172.217.194.0-255,7156,59477,1,190029
20808,0.001354,172.31.36.0-255,66,59543,1,190029
20809,0.001379,172.31.36.0-255,66,59609,1,190029
20810,0.001665,172.31.36.0-255,66,59675,1,190029
20811,0.001687,172.217.194.0-255,5738,65413,1,190029
20812,0.001689,172.31.36.0-255,66,65479,1,190029
20813,0.00196,172.31.36.0-255,66,65545,1,190029
20814,0.002005,172.31.36.0-255,66,65611,1,190029
20815,0.002555,172.31.36.0-255,66,65677,1,190029
20816,0.002596,172.31.36.0-255,66,65743,1,190029
20817,0.002623,172.31.36.0-255,66,65809,1,190029
20818,0.00346,172.217.194.0-255,2902,68711,1,190029
20819,0.003464,172.31.36.0-255,66,68777,1,190029
20820,0.00349,172.31.36.0-255,66,68843,1,190029
20821,0.003571,172.31.36.0-255,66,68909,1,190029
20822,0.003602,172.31.36.0-255,66,68975,1,190029
20823,0.005884,172.217.194.0-255,5738,74713,1,190029
20824,0.005891,172.31.36.0-255,66,74779,1,190029
20825,0.008127,172.217.194.0-255,5738,80517,1,190029
20826,0.008131,172.31.36.0-255,66,80583,1,190029
20827,0.010419,172.217.194.0-255,5738,86321,1,190029
20828,0.010427,172.31.36.0-255,66,86387,1,190029
20829,0.012731,172.217.194.0-255,5738,92125,1,190029
20830,0.01274,172.31.36.0-255,66,92191,1,190029
20831,0.015068,172.217.194.0-255,4320,96511,1,190029
20832,0.015075,172.31.36.0-255,66,96577,1,190029
20833,0.015091,172.217.194.0-255,1484,98061,1,190029
20834,0.017339,172.217.194.0-255,4320,102381,1,190029
20835,0.017347,172.31.36.0-255,66,102447,1,190029
20836,0.019611,172.217.194.0-255,5738,108185,1,190029
20837,0.019622,172.31.36.0-255,66,108251,1,190029
20838,0.02194,172.217.194.0-255,5738,113989,1,190029
20839,0.021948,172.31.36.0-255,66,114055,1,190029
20840,0.024224,172.217.194.0-255,5738,119793,1,190029
20841,0.024231,172.31.36.0-255,66,119859,1,190029
20842,0.026473,172.217.194.0-255,5738,125597,1,190029
20843,0.02648,172.31.36.0-255,66,125663,1,190029
20844,0.028781,172.217.194.0-255,5738,131401,1,190029
20845,0.028787,172.31.36.0-255,66,131467,1,190029
20846,0.031069,172.217.194.0-255,4320,135787,1,190029
20847,0.031078,172.31.36.0-255,66,135853,1,190029
20848,0.031098,172.217.194.0-255,1484,137337,1,190029
20849,0.033338,172.217.194.0-255,4320,141657,1,190029
20850,0.033348,172.31.36.0-255,66,141723,1,190029
20851,0.035622,172.217.194.0-255,5738,147461,1,190029
20852,0.035632,172.31.36.0-255,66,147527,1,190029
20853,0.037926,172.217.194.0-255,5738,153265,1,190029
20854,0.037934,172.31.36.0-255,66,153331,1,190029
20855,0.039754,172.31.36.0-255,172,153503,1,190029
20856,0.039784,172.31.36.0-255,1115,154618,1,190029
20857,0.03987,172.31.36.0-255,1514,156132,1,190029
20858,0.039872,172.31.36.0-255,1514,157646,1,190029
20859,0.039873,172.31.36.0-255,1514,159160,1,190029
20860,0.039877,172.31.36.0-255,1514,160674,1,190029
20861,0.039879,172.31.36.0-255,1489,162163,1,190029
20862,0.040235,172.217.194.0-255,4320,166483,1,190029
20863,0.040242,172.31.36.0-255,66,166549,1,190029
20864,0.040261,172.217.194.0-255,1484,168033,1,190029
20865,0.041303,104.244.42.0-255,66,168099,1,190029
20866,0.041344,104.244.42.0-255,66,168165,1,190029
20867,0.041495,104.244.42.0-255,66,168231,1,190029
20868,0.042558,172.217.194.0-255,4320,172551,1,190029
20869,0.042564,172.31.36.0-255,66,172617,1,190029
20870,0.044821,172.217.194.0-255,5738,178355,1,190029
20871,0.044826,172.31.36.0-255,66,178421,1,190029
20872,0.047122,172.217.194.0-255,5738,184159,1,190029
20873,0.047126,172.31.36.0-255,66,184225,1,190029
20874,0.049434,172.217.194.0-255,5738,189963,1,190029
20875,0.049441,172.31.36.0-255,66,190029,1,190029
20876,0.0,74.125.200.0-255,156,156,1,196594
20877,2.3e-05,172.31.36.0-255,66,222,1,196594
20878,3.1e-05,74.125.200.0-255,1484,1706,1,196594
20879,3.5e-05,172.31.36.0-255,66,1772,1,196594
20880,5e-05,74.125.200.0-255,2902,4674,1,196594
20881,5.4e-05,172.31.36.0-255,66,4740,1,196594
20882,6e-05,74.125.200.0-255,4320,9060,1,196594
20883,6.3e-05,172.31.36.0-255,66,9126,1,196594
20884,6.9e-05,74.125.200.0-255,4854,13980,1,196594
20885,7.2e-05,172.31.36.0-255,66,14046,1,196594
20886,0.000182,74.125.200.0-255,1484,15530,1,196594
20887,0.000186,172.31.36.0-255,66,15596,1,196594
20888,0.000192,74.125.200.0-255,2902,18498,1,196594
20889,0.000194,172.31.36.0-255,66,18564,1,196594
20890,0.000215,74.125.200.0-255,5738,24302,1,196594
20891,0.000222,172.31.36.0-255,66,24368,1,196594
20892,0.000249,74.125.200.0-255,6797,31165,1,196594
20893,0.000252,172.31.36.0-255,66,31231,1,196594
20894,0.00037,74.125.200.0-255,1484,32715,1,196594
20895,0.000374,172.31.36.0-255,66,32781,1,196594
20896,0.00038,74.125.200.0-255,2902,35683,1,196594
20897,0.000382,172.31.36.0-255,66,35749,1,196594
20898,0.000408,74.125.200.0-255,4320,40069,1,196594
20899,0.000411,172.31.36.0-255,66,40135,1,196594
20900,0.000452,172.31.36.0-255,66,40201,1,196594
20901,0.000458,74.125.200.0-255,4320,44521,1,196594
20902,0.00046,172.31.36.0-255,66,44587,1,196594
20903,0.000502,74.125.200.0-255,7156,51743,1,196594
20904,0.000505,172.31.36.0-255,66,51809,1,196594
20905,0.000532,74.125.200.0-255,3961,55770,1,196594
20906,0.000535,172.31.36.0-255,66,55836,1,196594
20907,0.000731,74.125.200.0-255,411,56247,1,196594
20908,0.000773,74.125.200.0-255,332,56579,1,196594
20909,0.00117,172.31.36.0-255,66,56645,1,196594
20910,0.001655,74.125.200.0-255,1484,58129,1,196594
20911,0.001668,74.125.200.0-255,2902,61031,1,196594
20912,0.001672,172.31.36.0-255,66,61097,1,196594
20913,0.001681,74.125.200.0-255,5738,66835,1,196594
20914,0.001683,172.31.36.0-255,66,66901,1,196594
20915,0.001754,172.31.36.0-255,66,66967,1,196594
20916,0.001773,172.31.36.0-255,66,67033,1,196594
20917,0.004029,74.125.200.0-255,4320,71353,1,196594
20918,0.004035,172.31.36.0-255,66,71419,1,196594
20919,0.004064,74.125.200.0-255,1484,72903,1,196594
20920,0.006283,74.125.200.0-255,4320,77223,1,196594
20921,0.006289,172.31.36.0-255,66,77289,1,196594
20922,0.008546,74.125.200.0-255,5738,83027,1,196594
20923,0.008554,172.31.36.0-255,66,83093,1,196594
20924,0.010824,74.125.200.0-255,5738,88831,1,196594
20925,0.010833,172.31.36.0-255,66,88897,1,196594
20926,0.013098,74.125.200.0-255,5738,94635,1,196594
20927,0.013107,172.31.36.0-255,66,94701,1,196594
20928,0.015376,74.125.200.0-255,5738,100439,1,196594
20929,0.015384,172.31.36.0-255,66,100505,1,196594
20930,0.017662,74.125.200.0-255,5738,106243,1,196594
20931,0.01767,172.31.36.0-255,66,106309,1,196594
20932,0.01994,74.125.200.0-255,5738,112047,1,196594
20933,0.019951,172.31.36.0-255,66,112113,1,196594
20934,0.022214,74.125.200.0-255,5738,117851,1,196594
20935,0.022223,172.31.36.0-255,66,117917,1,196594
20936,0.024481,74.125.200.0-255,5738,123655,1,196594
20937,0.024489,172.31.36.0-255,66,123721,1,196594
20938,0.02675,74.125.200.0-255,5738,129459,1,196594
20939,0.026758,172.31.36.0-255,66,129525,1,196594
20940,0.029007,74.125.200.0-255,5738,135263,1,196594
20941,0.029015,172.31.36.0-255,66,135329,1,196594
20942,0.031273,74.125.200.0-255,5738,141067,1,196594
20943,0.03128,172.31.36.0-255,66,141133,1,196594
20944,0.033535,74.125.200.0-255,5738,146871,1,196594
20945,0.033542,172.31.36.0-255,66,146937,1,196594
20946,0.035803,74.125.200.0-255,5738,152675,1,196594
20947,0.035811,172.31.36.0-255,66,152741,1,196594
20948,0.03758,172.31.36.0-255,172,152913,1,196594
20949,0.037612,172.31.36.0-255,1115,154028,1,196594
20950,0.037679,172.31.36.0-255,1514,155542,1,196594
20951,0.037681,172.31.36.0-255,1514,157056,1,196594
20952,0.037686,172.31.36.0-255,1514,158570,1,196594
20953,0.037688,172.31.36.0-255,1514,160084,1,196594
20954,0.037706,172.31.36.0-255,1488,161572,1,196594
20955,0.038077,74.125.200.0-255,5738,167310,1,196594
20956,0.038083,172.31.36.0-255,66,167376,1,196594
20957,0.039112,104.244.42.0-255,66,167442,1,196594
20958,0.03912,104.244.42.0-255,66,167508,1,196594
20959,0.039336,104.244.42.0-255,66,167574,1,196594
20960,0.040352,74.125.200.0-255,5738,173312,1,196594
20961,0.040359,172.31.36.0-255,66,173378,1,196594
20962,0.042628,74.125.200.0-255,5738,179116,1,196594
20963,0.042642,172.31.36.0-255,66,179182,1,196594
20964,0.044922,74.125.200.0-255,5738,184920,1,196594
20965,0.044934,172.31.36.0-255,66,184986,1,196594
20966,0.0472,74.125.200.0-255,5738,190724,1,196594
20967,0.047207,172.31.36.0-255,66,190790,1,196594
20968,0.04947,74.125.200.0-255,5738,196528,1,196594
20969,0.049476,172.31.36.0-255,66,196594,1,196594
20970,0.0,74.125.24.0-255,152,152,1,279332
20971,1.4e-05,172.31.36.0-255,66,218,1,279332
20972,2e-05,74.125.24.0-255,1484,1702,1,279332
20973,2.5e-05,172.31.36.0-255,66,1768,1,279332
20974,3.5e-05,74.125.24.0-255,2902,4670,1,279332
20975,3.8e-05,172.31.36.0-255,66,4736,1,279332
20976,4.3e-05,74.125.24.0-255,2902,7638,1,279332
20977,4.5e-05,172.31.36.0-255,66,7704,1,279332
20978,8.1e-05,74.125.24.0-255,4320,12024,1,279332
20979,8.4e-05,172.31.36.0-255,66,12090,1,279332
20980,8.8e-05,74.125.24.0-255,2106,14196,1,279332
20981,9e-05,172.31.36.0-255,66,14262,1,279332
20982,9.5e-05,74.125.24.0-255,2902,17164,1,279332
20983,9.6e-05,172.31.36.0-255,66,17230,1,279332
20984,0.000126,74.125.24.0-255,7156,24386,1,279332
20985,0.000129,172.31.36.0-255,66,24452,1,279332
20986,0.000135,74.125.24.0-255,4320,28772,1,279332
20987,0.000137,172.31.36.0-255,66,28838,1,279332
20988,0.000176,74.125.24.0-255,2543,31381,1,279332
20989,0.000178,172.31.36.0-255,66,31447,1,279332
20990,0.000242,74.125.24.0-255,1484,32931,1,279332
20991,0.000245,172.31.36.0-255,66,32997,1,279332
20992,0.00025,74.125.24.0-255,2902,35899,1,279332
20993,0.000252,172.31.36.0-255,66,35965,1,279332
20994,0.000262,74.125.24.0-255,4320,40285,1,279332
20995,0.000265,172.31.36.0-255,66,40351,1,279332
20996,0.000293,74.125.24.0-255,1484,41835,1,279332
20997,0.000295,172.31.36.0-255,66,41901,1,279332
20998,0.000303,74.125.24.0-255,6797,48698,1,279332
20999,0.000305,172.31.36.0-255,66,48764,1,279332
21000,0.000312,74.125.24.0-255,7156,55920,1,279332
21001,0.000315,172.31.36.0-255,66,55986,1,279332
21002,0.00035,74.125.24.0-255,7156,63142,1,279332
21003,0.000355,74.125.24.0-255,2543,65685,1,279332
21004,0.000367,74.125.24.0-255,677,66362,1,279332
21005,0.000511,172.31.36.0-255,66,66428,1,279332
21006,0.000557,74.125.24.0-255,1484,67912,1,279332
21007,0.000564,74.125.24.0-255,2902,70814,1,279332
21008,0.000575,172.31.36.0-255,66,70880,1,279332
21009,0.000604,74.125.24.0-255,5738,76618,1,279332
21010,0.000636,74.125.24.0-255,5738,82356,1,279332
21011,0.000646,172.31.36.0-255,66,82422,1,279332
21012,0.000655,74.125.24.0-255,4320,86742,1,279332
21013,0.000668,74.125.24.0-255,766,87508,1,279332
21014,0.000674,172.31.36.0-255,66,87574,1,279332
21015,0.000738,74.125.24.0-255,1484,89058,1,279332
21016,0.000744,74.125.24.0-255,2902,91960,1,279332
21017,0.000765,74.125.24.0-255,5738,97698,1,279332
21018,0.000791,74.125.24.0-255,1484,99182,1,279332
21019,0.000797,172.31.36.0-255,66,99248,1,279332
21020,0.000822,74.125.24.0-255,4320,103568,1,279332
21021,0.000828,172.31.36.0-255,66,103634,1,279332
21022,0.000849,74.125.24.0-255,6438,110072,1,279332
21023,0.000869,172.31.36.0-255,66,110138,1,279332
21024,0.000879,74.125.24.0-255,2902,113040,1,279332
21025,0.000888,172.31.36.0-255,66,113106,1,279332
21026,0.00091,74.125.24.0-255,7156,120262,1,279332
21027,0.000925,74.125.24.0-255,2902,123164,1,279332
21028,0.000944,74.125.24.0-255,5738,128902,1,279332
21029,0.000955,172.31.36.0-255,66,128968,1,279332
21030,0.000988,74.125.24.0-255,3602,132570,1,279332
21031,0.001008,172.31.36.0-255,66,132636,1,279332
21032,0.00104,74.125.24.0-255,4320,136956,1,279332
21033,0.001045,74.125.24.0-255,2902,139858,1,279332
21034,0.001056,172.31.36.0-255,66,139924,1,279332
21035,0.001084,74.125.24.0-255,2902,142826,1,279332
21036,0.001118,172.31.36.0-255,66,142892,1,279332
21037,0.001195,74.125.24.0-255,1484,144376,1,279332
21038,0.001201,74.125.24.0-255,2902,147278,1,279332
21039,0.00121,74.125.24.0-255,1484,148762,1,279332
21040,0.001225,74.125.24.0-255,4320,153082,1,279332
21041,0.001227,74.125.24.0-255,1484,154566,1,279332
21042,0.00124,74.125.24.0-255,1484,156050,1,279332
21043,0.001248,172.31.36.0-255,66,156116,1,279332
21044,0.001254,74.125.24.0-255,4320,160436,1,279332
21045,0.001276,172.31.36.0-255,66,160502,1,279332
21046,0.001283,74.125.24.0-255,5738,166240,1,279332
21047,0.001312,74.125.24.0-255,2184,168424,1,279332
21048,0.001324,172.31.36.0-255,66,168490,1,279332
21049,0.001415,74.125.24.0-255,1484,169974,1,279332
21050,0.001421,74.125.24.0-255,2902,172876,1,279332
21051,0.00144,172.31.36.0-255,66,172942,1,279332
21052,0.001445,74.125.24.0-255,2902,175844,1,279332
21053,0.001449,74.125.24.0-255,2902,178746,1,279332
21054,0.001465,74.125.24.0-255,1484,180230,1,279332
21055,0.001469,74.125.24.0-255,2902,183132,1,279332
21056,0.001472,172.31.36.0-255,66,183198,1,279332
21057,0.001507,74.125.24.0-255,5738,188936,1,279332
21058,0.001515,74.125.24.0-255,7156,196092,1,279332
21059,0.00152,74.125.24.0-255,2902,198994,1,279332
21060,0.001531,172.31.36.0-255,66,199060,1,279332
21061,0.001547,74.125.24.0-255,5020,204080,1,279332
21062,0.001553,74.125.24.0-255,5738,209818,1,279332
21063,0.00156,172.31.36.0-255,66,209884,1,279332
21064,0.001571,74.125.24.0-255,5738,215622,1,279332
21065,0.00166,74.125.24.0-255,1484,217106,1,279332
21066,0.001664,74.125.24.0-255,2902,220008,1,279332
21067,0.00167,74.125.24.0-255,5738,225746,1,279332
21068,0.001721,74.125.24.0-255,2902,228648,1,279332
21069,0.001733,74.125.24.0-255,766,229414,1,279332
21070,0.001783,74.125.24.0-255,1484,230898,1,279332
21071,0.001801,74.125.24.0-255,1484,232382,1,279332
21072,0.00182,74.125.24.0-255,2902,235284,1,279332
21073,0.001826,74.125.24.0-255,5738,241022,1,279332
21074,0.001849,74.125.24.0-255,5738,246760,1,279332
21075,0.001866,74.125.24.0-255,7156,253916,1,279332
21076,0.001916,74.125.24.0-255,7156,261072,1,279332
21077,0.001951,74.125.24.0-255,7156,268228,1,279332
21078,0.001974,74.125.24.0-255,1484,269712,1,279332
21079,0.00201,74.125.24.0-255,97,269809,1,279332
21080,0.004261,172.31.36.0-255,66,269875,1,279332
21081,0.006247,74.125.24.0-255,105,269980,1,279332
21082,0.011273,172.31.36.0-255,66,270046,1,279332
21083,0.011314,172.31.36.0-255,105,270151,1,279332
21084,0.013282,74.125.24.0-255,66,270217,1,279332
21085,0.040555,172.31.36.0-255,190,270407,1,279332
21086,0.040592,172.31.36.0-255,1114,271521,1,279332
21087,0.040669,172.31.36.0-255,1514,273035,1,279332
21088,0.040671,172.31.36.0-255,1514,274549,1,279332
21089,0.040672,172.31.36.0-255,1514,276063,1,279332
21090,0.040673,172.31.36.0-255,1514,277577,1,279332
21091,0.040701,172.31.36.0-255,1491,279068,1,279332
21092,0.042086,104.244.42.0-255,66,279134,1,279332
21093,0.042107,104.244.42.0-255,66,279200,1,279332
21094,0.042244,104.244.42.0-255,66,279266,1,279332
21095,0.04225,104.244.42.0-255,66,279332,1,279332
21096,0.0,74.125.130.0-255,293,293,1,339844
21097,0.000104,172.31.36.0-255,66,359,1,339844
21098,0.00011,74.125.130.0-255,1484,1843,1,339844
21099,0.000115,172.31.36.0-255,66,1909,1,339844
21100,0.000121,74.125.130.0-255,2902,4811,1,339844
21101,0.000132,172.31.36.0-255,66,4877,1,339844
21102,0.000138,74.125.130.0-255,5738,10615,1,339844
21103,0.000141,172.31.36.0-255,66,10681,1,339844
21104,0.000145,74.125.130.0-255,2902,13583,1,339844
21105,0.000148,172.31.36.0-255,66,13649,1,339844
21106,0.000153,74.125.130.0-255,3269,16918,1,339844
21107,0.000155,172.31.36.0-255,66,16984,1,339844
21108,0.000164,172.31.36.0-255,66,17050,1,339844
21109,0.000168,74.125.130.0-255,2902,19952,1,339844
21110,0.000173,172.31.36.0-255,66,20018,1,339844
21111,0.000178,74.125.130.0-255,2543,22561,1,339844
21112,0.00018,172.31.36.0-255,66,22627,1,339844
21113,0.000279,74.125.130.0-255,1484,24111,1,339844
21114,0.000283,172.31.36.0-255,66,24177,1,339844
21115,0.000289,74.125.130.0-255,2902,27079,1,339844
21116,0.000292,172.31.36.0-255,66,27145,1,339844
21117,0.000319,74.125.130.0-255,5738,32883,1,339844
21118,0.000322,172.31.36.0-255,66,32949,1,339844
21119,0.000326,74.125.130.0-255,2902,35851,1,339844
21120,0.000328,172.31.36.0-255,66,35917,1,339844
21121,0.000339,74.125.130.0-255,3961,39878,1,339844
21122,0.000341,172.31.36.0-255,66,39944,1,339844
21123,0.000353,74.125.130.0-255,2902,42846,1,339844
21124,0.000355,172.31.36.0-255,66,42912,1,339844
21125,0.000387,74.125.130.0-255,5738,48650,1,339844
21126,0.000391,172.31.36.0-255,66,48716,1,339844
21127,0.000395,74.125.130.0-255,2902,51618,1,339844
21128,0.000397,172.31.36.0-255,66,51684,1,339844
21129,0.000432,74.125.130.0-255,5631,57315,1,339844
21130,0.000436,172.31.36.0-255,66,57381,1,339844
21131,0.000439,74.125.130.0-255,120,57501,1,339844
21132,0.00048,74.125.130.0-255,1484,58985,1,339844
21133,0.000483,172.31.36.0-255,66,59051,1,339844
21134,0.000489,74.125.130.0-255,2902,61953,1,339844
21135,0.000491,172.31.36.0-255,66,62019,1,339844
21136,0.000521,74.125.130.0-255,7156,69175,1,339844
21137,0.000525,172.31.36.0-255,66,69241,1,339844
21138,0.00053,74.125.130.0-255,2902,72143,1,339844
21139,0.000534,172.31.36.0-255,66,72209,1,339844
21140,0.00057,74.125.130.0-255,2277,74486,1,339844
21141,0.000574,172.31.36.0-255,66,74552,1,339844
21142,0.000682,74.125.130.0-255,1484,76036,1,339844
21143,0.000688,74.125.130.0-255,2902,78938,1,339844
21144,0.00069,172.31.36.0-255,66,79004,1,339844
21145,0.000716,74.125.130.0-255,5738,84742,1,339844
21146,0.000719,172.31.36.0-255,66,84808,1,339844
21147,0.000723,74.125.130.0-255,1484,86292,1,339844
21148,0.000746,74.125.130.0-255,2902,89194,1,339844
21149,0.000749,172.31.36.0-255,66,89260,1,339844
21150,0.000774,74.125.130.0-255,2543,91803,1,339844
21151,0.000778,172.31.36.0-255,66,91869,1,339844
21152,0.001088,74.125.130.0-255,1484,93353,1,339844
21153,0.001105,74.125.130.0-255,2902,96255,1,339844
21154,0.001108,172.31.36.0-255,66,96321,1,339844
21155,0.00113,74.125.130.0-255,5738,102059,1,339844
21156,0.001133,172.31.36.0-255,66,102125,1,339844
21157,0.001136,74.125.130.0-255,1484,103609,1,339844
21158,0.001178,74.125.130.0-255,5738,109347,1,339844
21159,0.001182,172.31.36.0-255,66,109413,1,339844
21160,0.001189,74.125.130.0-255,5738,115151,1,339844
21161,0.001191,172.31.36.0-255,66,115217,1,339844
21162,0.001197,74.125.130.0-255,4320,119537,1,339844
21163,0.001222,172.31.36.0-255,66,119603,1,339844
21164,0.001227,74.125.130.0-255,2902,122505,1,339844
21165,0.00123,172.31.36.0-255,66,122571,1,339844
21166,0.001236,74.125.130.0-255,3602,126173,1,339844
21167,0.00124,172.31.36.0-255,66,126239,1,339844
21168,0.001528,74.125.130.0-255,1484,127723,1,339844
21169,0.001546,74.125.130.0-255,2902,130625,1,339844
21170,0.00155,172.31.36.0-255,66,130691,1,339844
21171,0.001571,74.125.130.0-255,5738,136429,1,339844
21172,0.001574,172.31.36.0-255,66,136495,1,339844
21173,0.001602,74.125.130.0-255,5738,142233,1,339844
21174,0.001606,172.31.36.0-255,66,142299,1,339844
21175,0.001636,74.125.130.0-255,7156,149455,1,339844
21176,0.001639,172.31.36.0-255,66,149521,1,339844
21177,0.001643,74.125.130.0-255,2902,152423,1,339844
21178,0.001645,172.31.36.0-255,66,152489,1,339844
21179,0.001719,172.31.36.0-255,66,152555,1,339844
21180,0.001784,74.125.130.0-255,1484,154039,1,339844
21181,0.001801,74.125.130.0-255,2902,156941,1,339844
21182,0.001804,172.31.36.0-255,66,157007,1,339844
21183,0.001812,74.125.130.0-255,5738,162745,1,339844
21184,0.001815,172.31.36.0-255,66,162811,1,339844
21185,0.001865,74.125.130.0-255,7156,169967,1,339844
21186,0.001869,172.31.36.0-255,66,170033,1,339844
21187,0.001879,172.31.36.0-255,66,170099,1,339844
21188,0.001885,74.125.130.0-255,4320,174419,1,339844
21189,0.001888,172.31.36.0-255,66,174485,1,339844
21190,0.00192,74.125.130.0-255,3602,178087,1,339844
21191,0.001923,172.31.36.0-255,66,178153,1,339844
21192,0.002103,74.125.130.0-255,1484,179637,1,339844
21193,0.00212,74.125.130.0-255,2902,182539,1,339844
21194,0.002123,172.31.36.0-255,66,182605,1,339844
21195,0.002128,74.125.130.0-255,2902,185507,1,339844
21196,0.00213,172.31.36.0-255,66,185573,1,339844
21197,0.002164,74.125.130.0-255,1484,187057,1,339844
21198,0.002171,74.125.130.0-255,5738,192795,1,339844
21199,0.002174,172.31.36.0-255,66,192861,1,339844
21200,0.002185,172.31.36.0-255,66,192927,1,339844
21201,0.00219,74.125.130.0-255,2902,195829,1,339844
21202,0.002192,172.31.36.0-255,66,195895,1,339844
21203,0.002242,74.125.130.0-255,5020,200915,1,339844
21204,0.002246,172.31.36.0-255,66,200981,1,339844
21205,0.002379,74.125.130.0-255,1484,202465,1,339844
21206,0.002393,74.125.130.0-255,1484,203949,1,339844
21207,0.002396,172.31.36.0-255,66,204015,1,339844
21208,0.002401,74.125.130.0-255,2902,206917,1,339844
21209,0.002403,172.31.36.0-255,66,206983,1,339844
21210,0.002426,74.125.130.0-255,4320,211303,1,339844
21211,0.00243,172.31.36.0-255,66,211369,1,339844
21212,0.00245,74.125.130.0-255,1484,212853,1,339844
21213,0.002453,74.125.130.0-255,1484,214337,1,339844
21214,0.002455,172.31.36.0-255,66,214403,1,339844
21215,0.002465,74.125.130.0-255,2902,217305,1,339844
21216,0.002468,172.31.36.0-255,66,217371,1,339844
21217,0.002496,74.125.130.0-255,2902,220273,1,339844
21218,0.002499,172.31.36.0-255,66,220339,1,339844
21219,0.004837,74.125.130.0-255,2902,223241,1,339844
21220,0.004842,172.31.36.0-255,66,223307,1,339844
21221,0.004865,74.125.130.0-255,2902,226209,1,339844
21222,0.004867,172.31.36.0-255,66,226275,1,339844
21223,0.007244,74.125.130.0-255,5738,232013,1,339844
21224,0.007262,172.31.36.0-255,66,232079,1,339844
21225,0.009667,74.125.130.0-255,5738,237817,1,339844
21226,0.009683,172.31.36.0-255,66,237883,1,339844
21227,0.01206,74.125.130.0-255,5738,243621,1,339844
21228,0.012066,172.31.36.0-255,66,243687,1,339844
21229,0.014463,74.125.130.0-255,5738,249425,1,339844
21230,0.014471,172.31.36.0-255,66,249491,1,339844
21231,0.016881,74.125.130.0-255,5738,255229,1,339844
21232,0.016898,172.31.36.0-255,66,255295,1,339844
21233,0.019285,74.125.130.0-255,5738,261033,1,339844
21234,0.019292,172.31.36.0-255,66,261099,1,339844
21235,0.021677,74.125.130.0-255,5738,266837,1,339844
21236,0.021684,172.31.36.0-255,66,266903,1,339844
21237,0.024069,74.125.130.0-255,5738,272641,1,339844
21238,0.024075,172.31.36.0-255,66,272707,1,339844
21239,0.026457,74.125.130.0-255,5738,278445,1,339844
21240,0.026467,172.31.36.0-255,66,278511,1,339844
21241,0.028846,74.125.130.0-255,5738,284249,1,339844
21242,0.028853,172.31.36.0-255,66,284315,1,339844
21243,0.031251,74.125.130.0-255,5738,290053,1,339844
21244,0.031261,172.31.36.0-255,66,290119,1,339844
21245,0.033645,74.125.130.0-255,5738,295857,1,339844
21246,0.033652,172.31.36.0-255,66,295923,1,339844
21247,0.036037,74.125.130.0-255,5738,301661,1,339844
21248,0.036043,172.31.36.0-255,66,301727,1,339844
21249,0.038441,74.125.130.0-255,5738,307465,1,339844
21250,0.038448,172.31.36.0-255,66,307531,1,339844
21251,0.040864,74.125.130.0-255,5738,313269,1,339844
21252,0.040872,172.31.36.0-255,66,313335,1,339844
21253,0.043252,74.125.130.0-255,5738,319073,1,339844
21254,0.043261,172.31.36.0-255,66,319139,1,339844
21255,0.043471,172.31.36.0-255,172,319311,1,339844
21256,0.043514,172.31.36.0-255,1114,320425,1,339844
21257,0.043682,172.31.36.0-255,1514,321939,1,339844
21258,0.043685,172.31.36.0-255,1514,323453,1,339844
21259,0.043687,172.31.36.0-255,1514,324967,1,339844
21260,0.043693,172.31.36.0-255,1514,326481,1,339844
21261,0.043695,172.31.36.0-255,1491,327972,1,339844
21262,0.045015,104.244.42.0-255,66,328038,1,339844
21263,0.045022,104.244.42.0-255,66,328104,1,339844
21264,0.045231,104.244.42.0-255,66,328170,1,339844
21265,0.045624,74.125.130.0-255,1484,329654,1,339844
21266,0.045654,74.125.130.0-255,4320,333974,1,339844
21267,0.045658,172.31.36.0-255,66,334040,1,339844
21268,0.048037,74.125.130.0-255,5738,339778,1,339844
21269,0.048042,172.31.36.0-255,66,339844,1,339844
21270,0.0,74.125.68.0-255,146,146,1,299234
21271,2.3e-05,172.31.36.0-255,66,212,1,299234
21272,3.1e-05,74.125.68.0-255,1484,1696,1,299234
21273,3.5e-05,172.31.36.0-255,66,1762,1,299234
21274,3.9e-05,74.125.68.0-255,1484,3246,1,299234
21275,4.2e-05,172.31.36.0-255,66,3312,1,299234
21276,4.8e-05,74.125.68.0-255,2902,6214,1,299234
21277,5.2e-05,172.31.36.0-255,66,6280,1,299234
21278,8.3e-05,74.125.68.0-255,5738,12018,1,299234
21279,8.7e-05,172.31.36.0-255,66,12084,1,299234
21280,9.1e-05,74.125.68.0-255,2085,14169,1,299234
21281,9.3e-05,172.31.36.0-255,66,14235,1,299234
21282,0.000173,74.125.68.0-255,1484,15719,1,299234
21283,0.000176,172.31.36.0-255,66,15785,1,299234
21284,0.000182,74.125.68.0-255,2902,18687,1,299234
21285,0.000184,172.31.36.0-255,66,18753,1,299234
21286,0.000215,74.125.68.0-255,5738,24491,1,299234
21287,0.000218,172.31.36.0-255,66,24557,1,299234
21288,0.000248,74.125.68.0-255,2902,27459,1,299234
21289,0.00025,172.31.36.0-255,66,27525,1,299234
21290,0.000256,74.125.68.0-255,3961,31486,1,299234
21291,0.000259,172.31.36.0-255,66,31552,1,299234
21292,0.000297,74.125.68.0-255,1484,33036,1,299234
21293,0.0003,172.31.36.0-255,66,33102,1,299234
21294,0.000305,74.125.68.0-255,2902,36004,1,299234
21295,0.000307,172.31.36.0-255,66,36070,1,299234
21296,0.000312,74.125.68.0-255,2902,38972,1,299234
21297,0.000315,172.31.36.0-255,66,39038,1,299234
21298,0.000335,74.125.68.0-255,2902,41940,1,299234
21299,0.000339,172.31.36.0-255,66,42006,1,299234
21300,0.000345,74.125.68.0-255,5738,47744,1,299234
21301,0.000347,172.31.36.0-255,66,47810,1,299234
21302,0.000379,74.125.68.0-255,1125,48935,1,299234
21303,0.000381,172.31.36.0-255,66,49001,1,299234
21304,0.000679,74.125.68.0-255,1484,50485,1,299234
21305,0.000685,172.31.36.0-255,66,50551,1,299234
21306,0.000707,74.125.68.0-255,2902,53453,1,299234
21307,0.000711,172.31.36.0-255,66,53519,1,299234
21308,0.000716,74.125.68.0-255,2902,56421,1,299234
21309,0.000719,172.31.36.0-255,66,56487,1,299234
21310,0.000736,74.125.68.0-255,2902,59389,1,299234
21311,0.000739,172.31.36.0-255,66,59455,1,299234
21312,0.000746,74.125.68.0-255,5738,65193,1,299234
21313,0.000748,172.31.36.0-255,66,65259,1,299234
21314,0.000764,74.125.68.0-255,1125,66384,1,299234
21315,0.000766,172.31.36.0-255,66,66450,1,299234
21316,0.000773,74.125.68.0-255,4320,70770,1,299234
21317,0.000776,172.31.36.0-255,66,70836,1,299234
21318,0.000798,74.125.68.0-255,2902,73738,1,299234
21319,0.000801,172.31.36.0-255,66,73804,1,299234
21320,0.000806,74.125.68.0-255,4320,78124,1,299234
21321,0.000808,172.31.36.0-255,66,78190,1,299234
21322,0.000815,74.125.68.0-255,5738,83928,1,299234
21323,0.000817,172.31.36.0-255,66,83994,1,299234
21324,0.000851,172.31.36.0-255,66,84060,1,299234
21325,0.000864,74.125.68.0-255,2902,86962,1,299234
21326,0.000869,74.125.68.0-255,4320,91282,1,299234
21327,0.000888,172.31.36.0-255,66,91348,1,299234
21328,0.000919,74.125.68.0-255,1346,92694,1,299234
21329,0.001102,74.125.68.0-255,1484,94178,1,299234
21330,0.001131,74.125.68.0-255,2902,97080,1,299234
21331,0.00116,74.125.68.0-255,1484,98564,1,299234
21332,0.001179,74.125.68.0-255,2902,101466,1,299234
21333,0.001204,74.125.68.0-255,5738,107204,1,299234
21334,0.001208,74.125.68.0-255,2902,110106,1,299234
21335,0.001257,74.125.68.0-255,4320,114426,1,299234
21336,0.001277,74.125.68.0-255,1484,115910,1,299234
21337,0.001296,74.125.68.0-255,4320,120230,1,299234
21338,0.001312,74.125.68.0-255,6438,126668,1,299234
21339,0.001629,74.125.68.0-255,1484,128152,1,299234
21340,0.001637,74.125.68.0-255,2902,131054,1,299234
21341,0.001655,74.125.68.0-255,4320,135374,1,299234
21342,0.001679,74.125.68.0-255,1484,136858,1,299234
21343,0.001685,74.125.68.0-255,4320,141178,1,299234
21344,0.001729,74.125.68.0-255,2902,144080,1,299234
21345,0.001764,74.125.68.0-255,1484,145564,1,299234
21346,0.001803,74.125.68.0-255,2902,148466,1,299234
21347,0.001844,74.125.68.0-255,1484,149950,1,299234
21348,0.001866,74.125.68.0-255,2902,152852,1,299234
21349,0.001869,74.125.68.0-255,1484,154336,1,299234
21350,0.001872,74.125.68.0-255,1484,155820,1,299234
21351,0.001883,74.125.68.0-255,1484,157304,1,299234
21352,0.001928,74.125.68.0-255,3602,160906,1,299234
21353,0.002201,74.125.68.0-255,1484,162390,1,299234
21354,0.002221,74.125.68.0-255,2902,165292,1,299234
21355,0.002224,74.125.68.0-255,1484,166776,1,299234
21356,0.002229,74.125.68.0-255,2902,169678,1,299234
21357,0.002267,74.125.68.0-255,5738,175416,1,299234
21358,0.002271,74.125.68.0-255,2902,178318,1,299234
21359,0.002289,74.125.68.0-255,1484,179802,1,299234
21360,0.005965,172.31.36.0-255,66,179868,1,299234
21361,0.008254,74.125.68.0-255,5738,185606,1,299234
21362,0.008264,172.31.36.0-255,66,185672,1,299234
21363,0.010556,74.125.68.0-255,5738,191410,1,299234
21364,0.010569,172.31.36.0-255,66,191476,1,299234
21365,0.01285,74.125.68.0-255,5738,197214,1,299234
21366,0.012868,172.31.36.0-255,66,197280,1,299234
21367,0.015186,74.125.68.0-255,5738,203018,1,299234
21368,0.015202,172.31.36.0-255,66,203084,1,299234
21369,0.017487,74.125.68.0-255,5738,208822,1,299234
21370,0.017506,172.31.36.0-255,66,208888,1,299234
21371,0.019793,74.125.68.0-255,5738,214626,1,299234
21372,0.019807,172.31.36.0-255,66,214692,1,299234
21373,0.022077,74.125.68.0-255,5738,220430,1,299234
21374,0.022091,172.31.36.0-255,66,220496,1,299234
21375,0.024371,74.125.68.0-255,5738,226234,1,299234
21376,0.024386,172.31.36.0-255,66,226300,1,299234
21377,0.026692,74.125.68.0-255,5738,232038,1,299234
21378,0.026709,172.31.36.0-255,66,232104,1,299234
21379,0.028994,74.125.68.0-255,5738,237842,1,299234
21380,0.029009,172.31.36.0-255,66,237908,1,299234
21381,0.031309,74.125.68.0-255,5738,243646,1,299234
21382,0.031324,172.31.36.0-255,66,243712,1,299234
21383,0.033626,74.125.68.0-255,5738,249450,1,299234
21384,0.033639,172.31.36.0-255,66,249516,1,299234
21385,0.035931,74.125.68.0-255,5738,255254,1,299234
21386,0.035946,172.31.36.0-255,66,255320,1,299234
21387,0.036841,172.31.36.0-255,167,255487,1,299234
21388,0.036873,172.31.36.0-255,1114,256601,1,299234
21389,0.036951,172.31.36.0-255,1514,258115,1,299234
21390,0.036953,172.31.36.0-255,1514,259629,1,299234
21391,0.036954,172.31.36.0-255,1514,261143,1,299234
21392,0.036955,172.31.36.0-255,1514,262657,1,299234
21393,0.036985,172.31.36.0-255,1489,264146,1,299234
21394,0.038241,74.125.68.0-255,5738,269884,1,299234
21395,0.038256,172.31.36.0-255,66,269950,1,299234
21396,0.038356,104.244.42.0-255,66,270016,1,299234
21397,0.038384,104.244.42.0-255,66,270082,1,299234
21398,0.038486,104.244.42.0-255,66,270148,1,299234
21399,0.038575,104.244.42.0-255,66,270214,1,299234
21400,0.040541,74.125.68.0-255,5738,275952,1,299234
21401,0.040552,172.31.36.0-255,66,276018,1,299234
21402,0.042831,74.125.68.0-255,5738,281756,1,299234
21403,0.042841,172.31.36.0-255,66,281822,1,299234
21404,0.045125,74.125.68.0-255,5738,287560,1,299234
21405,0.045136,172.31.36.0-255,66,287626,1,299234
21406,0.047412,74.125.68.0-255,5738,293364,1,299234
21407,0.047421,172.31.36.0-255,66,293430,1,299234
21408,0.049709,74.125.68.0-255,5738,299168,1,299234
21409,0.049719,172.31.36.0-255,66,299234,1,299234
21410,0.0,172.217.194.0-255,153,153,1,212670
21411,2.5e-05,172.31.36.0-255,66,219,1,212670
21412,3.2e-05,172.217.194.0-255,1484,1703,1,212670
21413,3.7e-05,172.31.36.0-255,66,1769,1,212670
21414,4.3e-05,172.217.194.0-255,2902,4671,1,212670
21415,4.5e-05,172.31.36.0-255,66,4737,1,212670
21416,5.4e-05,172.217.194.0-255,7156,11893,1,212670
21417,5.7e-05,172.31.36.0-255,66,11959,1,212670
21418,6.1e-05,172.217.194.0-255,2057,14016,1,212670
21419,6.4e-05,172.31.36.0-255,66,14082,1,212670
21420,9.3e-05,172.217.194.0-255,2902,16984,1,212670
21421,9.6e-05,172.31.36.0-255,66,17050,1,212670
21422,0.000102,172.217.194.0-255,4320,21370,1,212670
21423,0.000104,172.31.36.0-255,66,21436,1,212670
21424,0.00011,172.217.194.0-255,4320,25756,1,212670
21425,0.000112,172.31.36.0-255,66,25822,1,212670
21426,0.000134,172.217.194.0-255,4320,30142,1,212670
21427,0.000136,172.31.36.0-255,66,30208,1,212670
21428,0.000139,172.217.194.0-255,1125,31333,1,212670
21429,0.000141,172.31.36.0-255,66,31399,1,212670
21430,0.000247,172.217.194.0-255,1484,32883,1,212670
21431,0.000251,172.31.36.0-255,66,32949,1,212670
21432,0.000257,172.217.194.0-255,2902,35851,1,212670
21433,0.000259,172.31.36.0-255,66,35917,1,212670
21434,0.000265,172.217.194.0-255,5738,41655,1,212670
21435,0.000268,172.31.36.0-255,66,41721,1,212670
21436,0.000296,172.217.194.0-255,6797,48518,1,212670
21437,0.000299,172.31.36.0-255,66,48584,1,212670
21438,0.000317,172.217.194.0-255,4320,52904,1,212670
21439,0.000319,172.31.36.0-255,66,52970,1,212670
21440,0.000342,172.217.194.0-255,2902,55872,1,212670
21441,0.000345,172.31.36.0-255,66,55938,1,212670
21442,0.000353,172.217.194.0-255,7156,63094,1,212670
21443,0.000355,172.31.36.0-255,66,63160,1,212670
21444,0.000372,172.217.194.0-255,2818,65978,1,212670
21445,0.000374,172.31.36.0-255,66,66044,1,212670
21446,0.000377,172.217.194.0-255,117,66161,1,212670
21447,0.000921,172.217.194.0-255,383,66544,1,212670
21448,0.001085,172.31.36.0-255,66,66610,1,212670
21449,0.001123,172.217.194.0-255,1484,68094,1,212670
21450,0.001127,172.217.194.0-255,1484,69578,1,212670
21451,0.00113,172.31.36.0-255,66,69644,1,212670
21452,0.001153,172.217.194.0-255,1484,71128,1,212670
21453,0.00116,172.217.194.0-255,5738,76866,1,212670
21454,0.001162,172.31.36.0-255,66,76932,1,212670
21455,0.001167,172.217.194.0-255,4320,81252,1,212670
21456,0.001169,172.31.36.0-255,66,81318,1,212670
21457,0.001193,172.31.36.0-255,66,81384,1,212670
21458,0.001207,172.31.36.0-255,66,81450,1,212670
21459,0.003424,172.217.194.0-255,5738,87188,1,212670
21460,0.00343,172.31.36.0-255,66,87254,1,212670
21461,0.005627,172.217.194.0-255,2902,90156,1,212670
21462,0.005631,172.31.36.0-255,66,90222,1,212670
21463,0.005649,172.217.194.0-255,2902,93124,1,212670
21464,0.005651,172.31.36.0-255,66,93190,1,212670
21465,0.007867,172.217.194.0-255,5738,98928,1,212670
21466,0.007875,172.31.36.0-255,66,98994,1,212670
21467,0.010121,172.217.194.0-255,5738,104732,1,212670
21468,0.010129,172.31.36.0-255,66,104798,1,212670
21469,0.012345,172.217.194.0-255,5738,110536,1,212670
21470,0.012353,172.31.36.0-255,66,110602,1,212670
21471,0.014585,172.217.194.0-255,5738,116340,1,212670
21472,0.014592,172.31.36.0-255,66,116406,1,212670
21473,0.016828,172.217.194.0-255,5738,122144,1,212670
21474,0.016837,172.31.36.0-255,66,122210,1,212670
21475,0.019065,172.217.194.0-255,5738,127948,1,212670
21476,0.019074,172.31.36.0-255,66,128014,1,212670
21477,0.021302,172.217.194.0-255,5738,133752,1,212670
21478,0.02131,172.31.36.0-255,66,133818,1,212670
21479,0.023517,172.217.194.0-255,5738,139556,1,212670
21480,0.023525,172.31.36.0-255,66,139622,1,212670
21481,0.025752,172.217.194.0-255,5738,145360,1,212670
21482,0.02576,172.31.36.0-255,66,145426,1,212670
21483,0.027996,172.217.194.0-255,5738,151164,1,212670
21484,0.028004,172.31.36.0-255,66,151230,1,212670
21485,0.03025,172.217.194.0-255,5738,156968,1,212670
21486,0.030256,172.31.36.0-255,66,157034,1,212670
21487,0.032468,172.217.194.0-255,5738,162772,1,212670
21488,0.032474,172.31.36.0-255,66,162838,1,212670
21489,0.034717,172.217.194.0-255,5738,168576,1,212670
21490,0.034725,172.31.36.0-255,66,168642,1,212670
21491,0.035612,172.31.36.0-255,172,168814,1,212670
21492,0.035643,172.31.36.0-255,1115,169929,1,212670
21493,0.035719,172.31.36.0-255,1514,171443,1,212670
21494,0.035721,172.31.36.0-255,1514,172957,1,212670
21495,0.035722,172.31.36.0-255,1514,174471,1,212670
21496,0.035723,172.31.36.0-255,1514,175985,1,212670
21497,0.035749,172.31.36.0-255,1489,177474,1,212670
21498,0.036937,172.217.194.0-255,5738,183212,1,212670
21499,0.036944,172.31.36.0-255,66,183278,1,212670
21500,0.037127,104.244.42.0-255,66,183344,1,212670
21501,0.037167,104.244.42.0-255,66,183410,1,212670
21502,0.037291,104.244.42.0-255,66,183476,1,212670
21503,0.037985,104.244.42.0-255,108,183584,1,212670
21504,0.03799,172.31.36.0-255,66,183650,1,212670
21505,0.039167,172.217.194.0-255,5738,189388,1,212670
21506,0.039175,172.31.36.0-255,66,189454,1,212670
21507,0.041403,172.217.194.0-255,5738,195192,1,212670
21508,0.041409,172.31.36.0-255,66,195258,1,212670
21509,0.043645,172.217.194.0-255,5738,200996,1,212670
21510,0.043652,172.31.36.0-255,66,201062,1,212670
21511,0.045872,172.217.194.0-255,5738,206800,1,212670
21512,0.045879,172.31.36.0-255,66,206866,1,212670
21513,0.048109,172.217.194.0-255,5738,212604,1,212670
21514,0.048116,172.31.36.0-255,66,212670,1,212670
21515,0.0,74.125.24.0-255,152,152,1,294388
21516,2.3e-05,172.31.36.0-255,66,218,1,294388
21517,3e-05,74.125.24.0-255,1484,1702,1,294388
21518,3.6e-05,172.31.36.0-255,66,1768,1,294388
21519,4.4e-05,74.125.24.0-255,2902,4670,1,294388
21520,4.8e-05,172.31.36.0-255,66,4736,1,294388
21521,5.1e-05,74.125.24.0-255,1484,6220,1,294388
21522,5.3e-05,172.31.36.0-255,66,6286,1,294388
21523,8.7e-05,172.31.36.0-255,66,6352,1,294388
21524,0.000105,74.125.24.0-255,1484,7836,1,294388
21525,0.000107,172.31.36.0-255,66,7902,1,294388
21526,0.000122,74.125.24.0-255,2902,10804,1,294388
21527,0.000125,172.31.36.0-255,66,10870,1,294388
21528,0.000131,74.125.24.0-255,5738,16608,1,294388
21529,0.000134,172.31.36.0-255,66,16674,1,294388
21530,0.000173,74.125.24.0-255,6797,23471,1,294388
21531,0.000176,172.31.36.0-255,66,23537,1,294388
21532,0.000295,74.125.24.0-255,1484,25021,1,294388
21533,0.0003,172.31.36.0-255,66,25087,1,294388
21534,0.000306,74.125.24.0-255,2902,27989,1,294388
21535,0.000308,172.31.36.0-255,66,28055,1,294388
21536,0.000338,74.125.24.0-255,4320,32375,1,294388
21537,0.000342,172.31.36.0-255,66,32441,1,294388
21538,0.000349,74.125.24.0-255,5738,38179,1,294388
21539,0.000351,172.31.36.0-255,66,38245,1,294388
21540,0.000354,74.125.24.0-255,1484,39729,1,294388
21541,0.000356,172.31.36.0-255,66,39795,1,294388
21542,0.000404,172.31.36.0-255,66,39861,1,294388
21543,0.000408,74.125.24.0-255,2902,42763,1,294388
21544,0.00041,172.31.36.0-255,66,42829,1,294388
21545,0.000416,74.125.24.0-255,3961,46790,1,294388
21546,0.000419,172.31.36.0-255,66,46856,1,294388
21547,0.000499,74.125.24.0-255,646,47502,1,294388
21548,0.000683,74.125.24.0-255,1484,48986,1,294388
21549,0.000688,172.31.36.0-255,66,49052,1,294388
21550,0.000694,74.125.24.0-255,2902,51954,1,294388
21551,0.000697,172.31.36.0-255,66,52020,1,294388
21552,0.000703,74.125.24.0-255,4320,56340,1,294388
21553,0.000706,172.31.36.0-255,66,56406,1,294388
21554,0.000727,74.125.24.0-255,1484,57890,1,294388
21555,0.000742,172.31.36.0-255,66,57956,1,294388
21556,0.000754,172.31.36.0-255,66,58022,1,294388
21557,0.00129,74.125.24.0-255,1484,59506,1,294388
21558,0.001295,74.125.24.0-255,2902,62408,1,294388
21559,0.001301,172.31.36.0-255,66,62474,1,294388
21560,0.001312,74.125.24.0-255,2902,65376,1,294388
21561,0.001315,172.31.36.0-255,66,65442,1,294388
21562,0.001328,74.125.24.0-255,2902,68344,1,294388
21563,0.001331,172.31.36.0-255,66,68410,1,294388
21564,0.001337,74.125.24.0-255,4320,72730,1,294388
21565,0.00134,172.31.36.0-255,66,72796,1,294388
21566,0.001376,172.31.36.0-255,66,72862,1,294388
21567,0.001387,172.31.36.0-255,66,72928,1,294388
21568,0.00139,74.125.24.0-255,766,73694,1,294388
21569,0.001493,74.125.24.0-255,1484,75178,1,294388
21570,0.001498,172.31.36.0-255,66,75244,1,294388
21571,0.001503,74.125.24.0-255,2902,78146,1,294388
21572,0.001505,172.31.36.0-255,66,78212,1,294388
21573,0.001509,74.125.24.0-255,1484,79696,1,294388
21574,0.001526,74.125.24.0-255,4320,84016,1,294388
21575,0.001528,172.31.36.0-255,66,84082,1,294388
21576,0.001533,74.125.24.0-255,2902,86984,1,294388
21577,0.001535,172.31.36.0-255,66,87050,1,294388
21578,0.001567,172.31.36.0-255,66,87116,1,294388
21579,0.001578,172.31.36.0-255,66,87182,1,294388
21580,0.001594,74.125.24.0-255,766,87948,1,294388
21581,0.001673,74.125.24.0-255,1484,89432,1,294388
21582,0.001677,172.31.36.0-255,66,89498,1,294388
21583,0.001682,74.125.24.0-255,2902,92400,1,294388
21584,0.001684,172.31.36.0-255,66,92466,1,294388
21585,0.001713,74.125.24.0-255,5738,98204,1,294388
21586,0.001716,172.31.36.0-255,66,98270,1,294388
21587,0.001721,74.125.24.0-255,2902,101172,1,294388
21588,0.001723,172.31.36.0-255,66,101238,1,294388
21589,0.001734,172.31.36.0-255,66,101304,1,294388
21590,0.001764,74.125.24.0-255,4320,105624,1,294388
21591,0.001767,172.31.36.0-255,66,105690,1,294388
21592,0.001791,74.125.24.0-255,6438,112128,1,294388
21593,0.001794,172.31.36.0-255,66,112194,1,294388
21594,0.001828,74.125.24.0-255,1484,113678,1,294388
21595,0.001835,74.125.24.0-255,2902,116580,1,294388
21596,0.001837,172.31.36.0-255,66,116646,1,294388
21597,0.001844,74.125.24.0-255,5738,122384,1,294388
21598,0.001846,172.31.36.0-255,66,122450,1,294388
21599,0.001876,74.125.24.0-255,5738,128188,1,294388
21600,0.00188,172.31.36.0-255,66,128254,1,294388
21601,0.001888,74.125.24.0-255,7156,135410,1,294388
21602,0.00189,172.31.36.0-255,66,135476,1,294388
21603,0.001906,74.125.24.0-255,2902,138378,1,294388
21604,0.001908,172.31.36.0-255,66,138444,1,294388
21605,0.001933,172.31.36.0-255,66,138510,1,294388
21606,0.001953,172.31.36.0-255,66,138576,1,294388
21607,0.001988,74.125.24.0-255,2902,141478,1,294388
21608,0.001991,172.31.36.0-255,66,141544,1,294388
21609,0.002013,172.31.36.0-255,66,141610,1,294388
21610,0.002018,74.125.24.0-255,5738,147348,1,294388
21611,0.002021,172.31.36.0-255,66,147414,1,294388
21612,0.004047,74.125.24.0-255,5738,153152,1,294388
21613,0.004055,172.31.36.0-255,66,153218,1,294388
21614,0.005995,74.125.24.0-255,5738,158956,1,294388
21615,0.005999,172.31.36.0-255,66,159022,1,294388
21616,0.007949,74.125.24.0-255,5738,164760,1,294388
21617,0.007954,172.31.36.0-255,66,164826,1,294388
21618,0.009887,74.125.24.0-255,5738,170564,1,294388
21619,0.009894,172.31.36.0-255,66,170630,1,294388
21620,0.011874,74.125.24.0-255,5738,176368,1,294388
21621,0.011882,172.31.36.0-255,66,176434,1,294388
21622,0.013819,74.125.24.0-255,5738,182172,1,294388
21623,0.013827,172.31.36.0-255,66,182238,1,294388
21624,0.015783,74.125.24.0-255,5738,187976,1,294388
21625,0.015791,172.31.36.0-255,66,188042,1,294388
21626,0.017768,74.125.24.0-255,5738,193780,1,294388
21627,0.017777,172.31.36.0-255,66,193846,1,294388
21628,0.019729,74.125.24.0-255,5738,199584,1,294388
21629,0.019738,172.31.36.0-255,66,199650,1,294388
21630,0.021694,74.125.24.0-255,5738,205388,1,294388
21631,0.021704,172.31.36.0-255,66,205454,1,294388
21632,0.023674,74.125.24.0-255,5738,211192,1,294388
21633,0.023682,172.31.36.0-255,66,211258,1,294388
21634,0.025642,74.125.24.0-255,5738,216996,1,294388
21635,0.02565,172.31.36.0-255,66,217062,1,294388
21636,0.027593,74.125.24.0-255,5738,222800,1,294388
21637,0.0276,172.31.36.0-255,66,222866,1,294388
21638,0.029568,74.125.24.0-255,5738,228604,1,294388
21639,0.029576,172.31.36.0-255,66,228670,1,294388
21640,0.031552,74.125.24.0-255,5738,234408,1,294388
21641,0.03156,172.31.36.0-255,66,234474,1,294388
21642,0.033519,74.125.24.0-255,5738,240212,1,294388
21643,0.033527,172.31.36.0-255,66,240278,1,294388
21644,0.035478,74.125.24.0-255,5738,246016,1,294388
21645,0.035486,172.31.36.0-255,66,246082,1,294388
21646,0.037478,74.125.24.0-255,5738,251820,1,294388
21647,0.037485,172.31.36.0-255,66,251886,1,294388
21648,0.039444,74.125.24.0-255,4320,256206,1,294388
21649,0.039449,172.31.36.0-255,66,256272,1,294388
21650,0.039467,74.125.24.0-255,1484,257756,1,294388
21651,0.041428,74.125.24.0-255,4320,262076,1,294388
21652,0.041435,172.31.36.0-255,66,262142,1,294388
21653,0.042069,172.31.36.0-255,172,262314,1,294388
21654,0.042102,172.31.36.0-255,1113,263427,1,294388
21655,0.04217,172.31.36.0-255,1514,264941,1,294388
21656,0.042172,172.31.36.0-255,1514,266455,1,294388
21657,0.042173,172.31.36.0-255,1514,267969,1,294388
21658,0.042178,172.31.36.0-255,1514,269483,1,294388
21659,0.042179,172.31.36.0-255,1491,270974,1,294388
21660,0.043376,74.125.24.0-255,5738,276712,1,294388
21661,0.043384,172.31.36.0-255,66,276778,1,294388
21662,0.043593,104.244.42.0-255,66,276844,1,294388
21663,0.043618,104.244.42.0-255,66,276910,1,294388
21664,0.043769,104.244.42.0-255,66,276976,1,294388
21665,0.045352,74.125.24.0-255,5738,282714,1,294388
21666,0.04536,172.31.36.0-255,66,282780,1,294388
21667,0.047347,74.125.24.0-255,5738,288518,1,294388
21668,0.047353,172.31.36.0-255,66,288584,1,294388
21669,0.049292,74.125.24.0-255,5738,294322,1,294388
21670,0.049299,172.31.36.0-255,66,294388,1,294388
21671,0.0,74.125.24.0-255,152,152,1,213638
21672,1.7e-05,172.31.36.0-255,66,218,1,213638
21673,2.4e-05,74.125.24.0-255,1484,1702,1,213638
21674,2.9e-05,172.31.36.0-255,66,1768,1,213638
21675,3.6e-05,74.125.24.0-255,2902,4670,1,213638
21676,4.8e-05,172.31.36.0-255,66,4736,1,213638
21677,5.6e-05,74.125.24.0-255,7156,11892,1,213638
21678,5.9e-05,172.31.36.0-255,66,11958,1,213638
21679,6.3e-05,74.125.24.0-255,2012,13970,1,213638
21680,6.7e-05,172.31.36.0-255,66,14036,1,213638
21681,0.000101,74.125.24.0-255,2902,16938,1,213638
21682,0.000104,172.31.36.0-255,66,17004,1,213638
21683,0.000111,74.125.24.0-255,7156,24160,1,213638
21684,0.000114,172.31.36.0-255,66,24226,1,213638
21685,0.000127,74.125.24.0-255,6797,31023,1,213638
21686,0.00013,172.31.36.0-255,66,31089,1,213638
21687,0.000429,74.125.24.0-255,1484,32573,1,213638
21688,0.000435,172.31.36.0-255,66,32639,1,213638
21689,0.000444,74.125.24.0-255,2902,35541,1,213638
21690,0.000446,172.31.36.0-255,66,35607,1,213638
21691,0.000458,74.125.24.0-255,5738,41345,1,213638
21692,0.000461,172.31.36.0-255,66,41411,1,213638
21693,0.000465,74.125.24.0-255,1484,42895,1,213638
21694,0.000468,172.31.36.0-255,66,42961,1,213638
21695,0.000518,172.31.36.0-255,66,43027,1,213638
21696,0.000536,172.31.36.0-255,66,43093,1,213638
21697,0.001235,74.125.24.0-255,647,43740,1,213638
21698,0.001242,172.31.36.0-255,66,43806,1,213638
21699,0.001376,74.125.24.0-255,1484,45290,1,213638
21700,0.00138,172.31.36.0-255,66,45356,1,213638
21701,0.001386,74.125.24.0-255,2902,48258,1,213638
21702,0.001389,172.31.36.0-255,66,48324,1,213638
21703,0.001398,74.125.24.0-255,1484,49808,1,213638
21704,0.001429,74.125.24.0-255,4320,54128,1,213638
21705,0.001432,172.31.36.0-255,66,54194,1,213638
21706,0.001446,172.31.36.0-255,66,54260,1,213638
21707,0.001458,74.125.24.0-255,7156,61416,1,213638
21708,0.001461,172.31.36.0-255,66,61482,1,213638
21709,0.001494,74.125.24.0-255,3602,65084,1,213638
21710,0.001497,172.31.36.0-255,66,65150,1,213638
21711,0.002081,74.125.24.0-255,1484,66634,1,213638
21712,0.0021,74.125.24.0-255,2902,69536,1,213638
21713,0.002106,172.31.36.0-255,66,69602,1,213638
21714,0.002111,74.125.24.0-255,1484,71086,1,213638
21715,0.002134,74.125.24.0-255,1484,72570,1,213638
21716,0.002136,172.31.36.0-255,66,72636,1,213638
21717,0.002145,74.125.24.0-255,7156,79792,1,213638
21718,0.002151,172.31.36.0-255,66,79858,1,213638
21719,0.002195,172.31.36.0-255,66,79924,1,213638
21720,0.002226,74.125.24.0-255,6438,86362,1,213638
21721,0.002229,172.31.36.0-255,66,86428,1,213638
21722,0.004531,74.125.24.0-255,5738,92166,1,213638
21723,0.004536,172.31.36.0-255,66,92232,1,213638
21724,0.006834,74.125.24.0-255,5738,97970,1,213638
21725,0.006837,172.31.36.0-255,66,98036,1,213638
21726,0.009175,74.125.24.0-255,5738,103774,1,213638
21727,0.009183,172.31.36.0-255,66,103840,1,213638
21728,0.011491,74.125.24.0-255,5738,109578,1,213638
21729,0.011498,172.31.36.0-255,66,109644,1,213638
21730,0.013827,74.125.24.0-255,5738,115382,1,213638
21731,0.013834,172.31.36.0-255,66,115448,1,213638
21732,0.01616,74.125.24.0-255,5738,121186,1,213638
21733,0.016168,172.31.36.0-255,66,121252,1,213638
21734,0.018464,74.125.24.0-255,5738,126990,1,213638
21735,0.018472,172.31.36.0-255,66,127056,1,213638
21736,0.020779,74.125.24.0-255,5738,132794,1,213638
21737,0.020788,172.31.36.0-255,66,132860,1,213638
21738,0.023117,74.125.24.0-255,5738,138598,1,213638
21739,0.023125,172.31.36.0-255,66,138664,1,213638
21740,0.025444,74.125.24.0-255,5738,144402,1,213638
21741,0.025452,172.31.36.0-255,66,144468,1,213638
21742,0.027748,74.125.24.0-255,5738,150206,1,213638
21743,0.027773,172.31.36.0-255,66,150272,1,213638
21744,0.028034,172.31.36.0-255,187,150459,1,213638
21745,0.028064,172.31.36.0-255,982,151441,1,213638
21746,0.028132,172.31.36.0-255,1514,152955,1,213638
21747,0.028134,172.31.36.0-255,1514,154469,1,213638
21748,0.028135,172.31.36.0-255,1514,155983,1,213638
21749,0.028136,172.31.36.0-255,1514,157497,1,213638
21750,0.028171,172.31.36.0-255,1514,159011,1,213638
21751,0.028173,172.31.36.0-255,1514,160525,1,213638
21752,0.028173,172.31.36.0-255,265,160790,1,213638
21753,0.029588,104.244.42.0-255,66,160856,1,213638
21754,0.029596,104.244.42.0-255,66,160922,1,213638
21755,0.029693,104.244.42.0-255,66,160988,1,213638
21756,0.029736,104.244.42.0-255,66,161054,1,213638
21757,0.02974,104.244.42.0-255,66,161120,1,213638
21758,0.030084,74.125.24.0-255,5738,166858,1,213638
21759,0.03009,172.31.36.0-255,66,166924,1,213638
21760,0.030413,104.244.42.0-255,108,167032,1,213638
21761,0.030422,172.31.36.0-255,66,167098,1,213638
21762,0.032413,74.125.24.0-255,5738,172836,1,213638
21763,0.032421,172.31.36.0-255,66,172902,1,213638
21764,0.034743,74.125.24.0-255,5738,178640,1,213638
21765,0.034751,172.31.36.0-255,66,178706,1,213638
21766,0.037053,74.125.24.0-255,5738,184444,1,213638
21767,0.037061,172.31.36.0-255,66,184510,1,213638
21768,0.039385,74.125.24.0-255,5738,190248,1,213638
21769,0.039392,172.31.36.0-255,66,190314,1,213638
21770,0.041687,74.125.24.0-255,5738,196052,1,213638
21771,0.041697,172.31.36.0-255,66,196118,1,213638
21772,0.044027,74.125.24.0-255,5738,201856,1,213638
21773,0.044041,172.31.36.0-255,66,201922,1,213638
21774,0.0464,74.125.24.0-255,5738,207660,1,213638
21775,0.046408,172.31.36.0-255,66,207726,1,213638
21776,0.048704,74.125.24.0-255,5738,213464,1,213638
21777,0.048711,172.31.36.0-255,66,213530,1,213638
21778,0.049515,172.31.36.0-255,108,213638,1,213638
21779,0.0,172.217.194.0-255,143,143,1,262109
21780,2.7e-05,172.31.36.0-255,66,209,1,262109
21781,3.5e-05,172.217.194.0-255,1484,1693,1,262109
21782,3.8e-05,172.31.36.0-255,66,1759,1,262109
21783,5.1e-05,172.217.194.0-255,2902,4661,1,262109
21784,5.4e-05,172.31.36.0-255,66,4727,1,262109
21785,6.1e-05,172.217.194.0-255,7156,11883,1,262109
21786,6.4e-05,172.31.36.0-255,66,11949,1,262109
21787,6.7e-05,172.217.194.0-255,1484,13433,1,262109
21788,6.9e-05,172.31.36.0-255,66,13499,1,262109
21789,0.000101,172.217.194.0-255,2902,16401,1,262109
21790,0.000104,172.31.36.0-255,66,16467,1,262109
21791,0.000142,172.217.194.0-255,4809,21276,1,262109
21792,0.000146,172.31.36.0-255,66,21342,1,262109
21793,0.000157,172.31.36.0-255,66,21408,1,262109
21794,0.000166,172.217.194.0-255,1125,22533,1,262109
21795,0.000169,172.31.36.0-255,66,22599,1,262109
21796,0.000254,172.217.194.0-255,1484,24083,1,262109
21797,0.000257,172.31.36.0-255,66,24149,1,262109
21798,0.000262,172.217.194.0-255,2902,27051,1,262109
21799,0.000265,172.31.36.0-255,66,27117,1,262109
21800,0.00027,172.217.194.0-255,4320,31437,1,262109
21801,0.000272,172.31.36.0-255,66,31503,1,262109
21802,0.0003,172.217.194.0-255,1484,32987,1,262109
21803,0.000303,172.31.36.0-255,66,33053,1,262109
21804,0.000354,172.31.36.0-255,66,33119,1,262109
21805,0.000381,172.217.194.0-255,1125,34244,1,262109
21806,0.000384,172.31.36.0-255,66,34310,1,262109
21807,0.000397,172.31.36.0-255,66,34376,1,262109
21808,0.0004,172.217.194.0-255,411,34787,1,262109
21809,0.000785,172.217.194.0-255,363,35150,1,262109
21810,0.000803,172.31.36.0-255,66,35216,1,262109
21811,0.000969,172.217.194.0-255,1484,36700,1,262109
21812,0.000978,172.217.194.0-255,2902,39602,1,262109
21813,0.000982,172.31.36.0-255,66,39668,1,262109
21814,0.00099,172.217.194.0-255,5738,45406,1,262109
21815,0.000992,172.31.36.0-255,66,45472,1,262109
21816,0.001048,172.31.36.0-255,66,45538,1,262109
21817,0.001061,172.31.36.0-255,66,45604,1,262109
21818,0.00162,172.217.194.0-255,1484,47088,1,262109
21819,0.001629,172.217.194.0-255,2902,49990,1,262109
21820,0.001633,172.31.36.0-255,66,50056,1,262109
21821,0.001639,172.217.194.0-255,5738,55794,1,262109
21822,0.001641,172.31.36.0-255,66,55860,1,262109
21823,0.001644,172.217.194.0-255,1484,57344,1,262109
21824,0.001686,172.31.36.0-255,66,57410,1,262109
21825,0.001691,172.217.194.0-255,4320,61730,1,262109
21826,0.001694,172.31.36.0-255,66,61796,1,262109
21827,0.00172,172.217.194.0-255,6438,68234,1,262109
21828,0.001722,172.31.36.0-255,66,68300,1,262109
21829,0.001827,172.217.194.0-255,1484,69784,1,262109
21830,0.001832,172.217.194.0-255,2902,72686,1,262109
21831,0.001834,172.31.36.0-255,66,72752,1,262109
21832,0.001862,172.217.194.0-255,5738,78490,1,262109
21833,0.001864,172.31.36.0-255,66,78556,1,262109
21834,0.001899,172.31.36.0-255,66,78622,1,262109
21835,0.001903,172.217.194.0-255,2902,81524,1,262109
21836,0.001905,172.31.36.0-255,66,81590,1,262109
21837,0.001933,172.31.36.0-255,66,81656,1,262109
21838,0.001936,172.217.194.0-255,1484,83140,1,262109
21839,0.001939,172.217.194.0-255,2902,86042,1,262109
21840,0.001944,172.31.36.0-255,66,86108,1,262109
21841,0.001967,172.217.194.0-255,5738,91846,1,262109
21842,0.00197,172.31.36.0-255,66,91912,1,262109
21843,0.002011,172.31.36.0-255,66,91978,1,262109
21844,0.002016,172.217.194.0-255,5738,97716,1,262109
21845,0.00202,172.31.36.0-255,66,97782,1,262109
21846,0.002047,172.217.194.0-255,2902,100684,1,262109
21847,0.002049,172.31.36.0-255,66,100750,1,262109
21848,0.002063,172.217.194.0-255,2184,102934,1,262109
21849,0.002069,172.31.36.0-255,66,103000,1,262109
21850,0.002075,172.217.194.0-255,5738,108738,1,262109
21851,0.002077,172.31.36.0-255,66,108804,1,262109
21852,0.0021,172.217.194.0-255,7156,115960,1,262109
21853,0.002103,172.31.36.0-255,66,116026,1,262109
21854,0.002134,172.217.194.0-255,5738,121764,1,262109
21855,0.002136,172.31.36.0-255,66,121830,1,262109
21856,0.002139,172.217.194.0-255,1484,123314,1,262109
21857,0.002142,172.217.194.0-255,1484,124798,1,262109
21858,0.002144,172.31.36.0-255,66,124864,1,262109
21859,0.00422,172.217.194.0-255,2902,127766,1,262109
21860,0.004223,172.31.36.0-255,66,127832,1,262109
21861,0.004241,172.217.194.0-255,2902,130734,1,262109
21862,0.004243,172.31.36.0-255,66,130800,1,262109
21863,0.006359,172.217.194.0-255,5738,136538,1,262109
21864,0.006365,172.31.36.0-255,66,136604,1,262109
21865,0.008465,172.217.194.0-255,5738,142342,1,262109
21866,0.008472,172.31.36.0-255,66,142408,1,262109
21867,0.010703,172.217.194.0-255,5738,148146,1,262109
21868,0.01071,172.31.36.0-255,66,148212,1,262109
21869,0.012855,172.217.194.0-255,5738,153950,1,262109
21870,0.012862,172.31.36.0-255,66,154016,1,262109
21871,0.014978,172.217.194.0-255,5738,159754,1,262109
21872,0.01499,172.31.36.0-255,66,159820,1,262109
21873,0.017102,172.217.194.0-255,5738,165558,1,262109
21874,0.017111,172.31.36.0-255,66,165624,1,262109
21875,0.019199,172.217.194.0-255,5738,171362,1,262109
21876,0.019205,172.31.36.0-255,66,171428,1,262109
21877,0.021289,172.217.194.0-255,5738,177166,1,262109
21878,0.021296,172.31.36.0-255,66,177232,1,262109
21879,0.023388,172.217.194.0-255,5738,182970,1,262109
21880,0.023395,172.31.36.0-255,66,183036,1,262109
21881,0.0255,172.217.194.0-255,5738,188774,1,262109
21882,0.025507,172.31.36.0-255,66,188840,1,262109
21883,0.027621,172.217.194.0-255,5738,194578,1,262109
21884,0.027628,172.31.36.0-255,66,194644,1,262109
21885,0.029746,172.217.194.0-255,5738,200382,1,262109
21886,0.029755,172.31.36.0-255,66,200448,1,262109
21887,0.031841,172.217.194.0-255,5738,206186,1,262109
21888,0.031848,172.31.36.0-255,66,206252,1,262109
21889,0.033941,172.217.194.0-255,5738,211990,1,262109
21890,0.033948,172.31.36.0-255,66,212056,1,262109
21891,0.036042,172.217.194.0-255,5738,217794,1,262109
21892,0.03605,172.31.36.0-255,66,217860,1,262109
21893,0.037415,172.31.36.0-255,172,218032,1,262109
21894,0.037448,172.31.36.0-255,1116,219148,1,262109
21895,0.037493,172.31.36.0-255,1514,220662,1,262109
21896,0.037495,172.31.36.0-255,1514,222176,1,262109
21897,0.037496,172.31.36.0-255,1514,223690,1,262109
21898,0.0375,172.31.36.0-255,1514,225204,1,262109
21899,0.037502,172.31.36.0-255,1487,226691,1,262109
21900,0.038133,172.217.194.0-255,5738,232429,1,262109
21901,0.03814,172.31.36.0-255,66,232495,1,262109
21902,0.038984,104.244.42.0-255,66,232561,1,262109
21903,0.03911,104.244.42.0-255,66,232627,1,262109
21904,0.039158,104.244.42.0-255,66,232693,1,262109
21905,0.040246,172.217.194.0-255,5738,238431,1,262109
21906,0.040251,172.31.36.0-255,66,238497,1,262109
21907,0.042345,172.217.194.0-255,2902,241399,1,262109
21908,0.042367,172.31.36.0-255,66,241465,1,262109
21909,0.042386,172.217.194.0-255,2902,244367,1,262109
21910,0.04239,172.31.36.0-255,66,244433,1,262109
21911,0.044462,172.217.194.0-255,5738,250171,1,262109
21912,0.044468,172.31.36.0-255,66,250237,1,262109
21913,0.046565,172.217.194.0-255,2902,253139,1,262109
21914,0.04657,172.31.36.0-255,66,253205,1,262109
21915,0.046613,172.217.194.0-255,2902,256107,1,262109
21916,0.046617,172.31.36.0-255,66,256173,1,262109
21917,0.048667,172.217.194.0-255,2902,259075,1,262109
21918,0.048672,172.31.36.0-255,66,259141,1,262109
21919,0.048707,172.217.194.0-255,2902,262043,1,262109
21920,0.04871,172.31.36.0-255,66,262109,1,262109
21921,0.0,172.217.194.0-255,156,156,1,286524
21922,2.1e-05,172.31.36.0-255,66,222,1,286524
21923,2.8e-05,172.217.194.0-255,1484,1706,1,286524
21924,3.2e-05,172.31.36.0-255,66,1772,1,286524
21925,3.8e-05,172.217.194.0-255,2902,4674,1,286524
21926,4.1e-05,172.31.36.0-255,66,4740,1,286524
21927,4.8e-05,172.217.194.0-255,7156,11896,1,286524
21928,5.1e-05,172.31.36.0-255,66,11962,1,286524
21929,9.8e-05,172.217.194.0-255,6331,18293,1,286524
21930,0.000101,172.31.36.0-255,66,18359,1,286524
21931,0.000108,172.217.194.0-255,5738,24097,1,286524
21932,0.00011,172.31.36.0-255,66,24163,1,286524
21933,0.000127,172.217.194.0-255,1484,25647,1,286524
21934,0.00013,172.31.36.0-255,66,25713,1,286524
21935,0.000147,172.217.194.0-255,5379,31092,1,286524
21936,0.00015,172.31.36.0-255,66,31158,1,286524
21937,0.000257,172.217.194.0-255,1484,32642,1,286524
21938,0.000262,172.31.36.0-255,66,32708,1,286524
21939,0.000267,172.217.194.0-255,2902,35610,1,286524
21940,0.00027,172.31.36.0-255,66,35676,1,286524
21941,0.000274,172.217.194.0-255,2902,38578,1,286524
21942,0.000276,172.31.36.0-255,66,38644,1,286524
21943,0.000298,172.217.194.0-255,2902,41546,1,286524
21944,0.0003,172.31.36.0-255,66,41612,1,286524
21945,0.000307,172.217.194.0-255,5738,47350,1,286524
21946,0.000309,172.31.36.0-255,66,47416,1,286524
21947,0.000325,172.217.194.0-255,2543,49959,1,286524
21948,0.000327,172.31.36.0-255,66,50025,1,286524
21949,0.000333,172.217.194.0-255,4320,54345,1,286524
21950,0.000335,172.31.36.0-255,66,54411,1,286524
21951,0.000369,172.31.36.0-255,66,54477,1,286524
21952,0.000372,172.217.194.0-255,340,54817,1,286524
21953,0.000375,172.217.194.0-255,119,54936,1,286524
21954,0.000418,172.217.194.0-255,380,55316,1,286524
21955,0.000722,172.217.194.0-255,1484,56800,1,286524
21956,0.000729,172.31.36.0-255,66,56866,1,286524
21957,0.000735,172.217.194.0-255,2902,59768,1,286524
21958,0.000738,172.31.36.0-255,66,59834,1,286524
21959,0.000744,172.217.194.0-255,5738,65572,1,286524
21960,0.000747,172.31.36.0-255,66,65638,1,286524
21961,0.00075,172.217.194.0-255,1484,67122,1,286524
21962,0.000771,172.217.194.0-255,5738,72860,1,286524
21963,0.000774,172.31.36.0-255,66,72926,1,286524
21964,0.000785,172.31.36.0-255,66,72992,1,286524
21965,0.000823,172.31.36.0-255,66,73058,1,286524
21966,0.000935,172.217.194.0-255,1484,74542,1,286524
21967,0.000943,172.217.194.0-255,2902,77444,1,286524
21968,0.000947,172.31.36.0-255,66,77510,1,286524
21969,0.000967,172.217.194.0-255,4320,81830,1,286524
21970,0.00097,172.31.36.0-255,66,81896,1,286524
21971,0.000997,172.217.194.0-255,1484,83380,1,286524
21972,0.001013,172.31.36.0-255,66,83446,1,286524
21973,0.001021,172.217.194.0-255,7156,90602,1,286524
21974,0.001024,172.31.36.0-255,66,90668,1,286524
21975,0.001048,172.217.194.0-255,3602,94270,1,286524
21976,0.001051,172.31.36.0-255,66,94336,1,286524
21977,0.00153,172.217.194.0-255,1484,95820,1,286524
21978,0.001538,172.217.194.0-255,2902,98722,1,286524
21979,0.001543,172.31.36.0-255,66,98788,1,286524
21980,0.001548,172.217.194.0-255,2902,101690,1,286524
21981,0.001551,172.31.36.0-255,66,101756,1,286524
21982,0.001566,172.217.194.0-255,2902,104658,1,286524
21983,0.001569,172.31.36.0-255,66,104724,1,286524
21984,0.001597,172.31.36.0-255,66,104790,1,286524
21985,0.001604,172.217.194.0-255,7156,111946,1,286524
21986,0.001607,172.31.36.0-255,66,112012,1,286524
21987,0.001652,172.217.194.0-255,5738,117750,1,286524
21988,0.001656,172.31.36.0-255,66,117816,1,286524
21989,0.001671,172.217.194.0-255,6438,124254,1,286524
21990,0.001673,172.31.36.0-255,66,124320,1,286524
21991,0.001687,172.31.36.0-255,66,124386,1,286524
21992,0.001725,172.217.194.0-255,5738,130124,1,286524
21993,0.001728,172.31.36.0-255,66,130190,1,286524
21994,0.00175,172.217.194.0-255,6438,136628,1,286524
21995,0.001753,172.31.36.0-255,66,136694,1,286524
21996,0.001935,172.217.194.0-255,1484,138178,1,286524
21997,0.001951,172.217.194.0-255,2902,141080,1,286524
21998,0.001957,172.31.36.0-255,66,141146,1,286524
21999,0.001964,172.217.194.0-255,5738,146884,1,286524
22000,0.001967,172.31.36.0-255,66,146950,1,286524
22001,0.002049,172.31.36.0-255,66,147016,1,286524
22002,0.002063,172.31.36.0-255,66,147082,1,286524
22003,0.002066,172.217.194.0-255,766,147848,1,286524
22004,0.004068,172.217.194.0-255,4320,152168,1,286524
22005,0.004074,172.31.36.0-255,66,152234,1,286524
22006,0.006092,172.217.194.0-255,5738,157972,1,286524
22007,0.0061,172.31.36.0-255,66,158038,1,286524
22008,0.008082,172.217.194.0-255,4320,162358,1,286524
22009,0.008091,172.31.36.0-255,66,162424,1,286524
22010,0.00811,172.217.194.0-255,1484,163908,1,286524
22011,0.010094,172.217.194.0-255,4320,168228,1,286524
22012,0.010103,172.31.36.0-255,66,168294,1,286524
22013,0.012098,172.217.194.0-255,5738,174032,1,286524
22014,0.012105,172.31.36.0-255,66,174098,1,286524
22015,0.014122,172.217.194.0-255,5738,179836,1,286524
22016,0.014131,172.31.36.0-255,66,179902,1,286524
22017,0.016146,172.217.194.0-255,5738,185640,1,286524
22018,0.016157,172.31.36.0-255,66,185706,1,286524
22019,0.018166,172.217.194.0-255,5738,191444,1,286524
22020,0.018174,172.31.36.0-255,66,191510,1,286524
22021,0.02018,172.217.194.0-255,5738,197248,1,286524
22022,0.020187,172.31.36.0-255,66,197314,1,286524
22023,0.022251,172.217.194.0-255,5738,203052,1,286524
22024,0.022258,172.31.36.0-255,66,203118,1,286524
22025,0.024273,172.217.194.0-255,5738,208856,1,286524
22026,0.024283,172.31.36.0-255,66,208922,1,286524
22027,0.026311,172.217.194.0-255,5738,214660,1,286524
22028,0.026322,172.31.36.0-255,66,214726,1,286524
22029,0.028336,172.217.194.0-255,5738,220464,1,286524
22030,0.028345,172.31.36.0-255,66,220530,1,286524
22031,0.030367,172.217.194.0-255,5738,226268,1,286524
22032,0.030376,172.31.36.0-255,66,226334,1,286524
22033,0.032367,172.217.194.0-255,5738,232072,1,286524
22034,0.032374,172.31.36.0-255,66,232138,1,286524
22035,0.034373,172.217.194.0-255,5738,237876,1,286524
22036,0.034381,172.31.36.0-255,66,237942,1,286524
22037,0.036378,172.217.194.0-255,5738,243680,1,286524
22038,0.036383,172.31.36.0-255,66,243746,1,286524
22039,0.036746,172.31.36.0-255,171,243917,1,286524
22040,0.036777,172.31.36.0-255,1138,245055,1,286524
22041,0.036843,172.31.36.0-255,1514,246569,1,286524
22042,0.036846,172.31.36.0-255,1514,248083,1,286524
22043,0.036847,172.31.36.0-255,1514,249597,1,286524
22044,0.036878,172.31.36.0-255,1514,251111,1,286524
22045,0.03688,172.31.36.0-255,325,251436,1,286524
22046,0.038342,104.244.42.0-255,66,251502,1,286524
22047,0.038376,104.244.42.0-255,66,251568,1,286524
22048,0.038401,172.217.194.0-255,5738,257306,1,286524
22049,0.038411,172.31.36.0-255,66,257372,1,286524
22050,0.038428,104.244.42.0-255,66,257438,1,286524
22051,0.038432,104.244.42.0-255,66,257504,1,286524
22052,0.040404,172.217.194.0-255,5738,263242,1,286524
22053,0.040411,172.31.36.0-255,66,263308,1,286524
22054,0.042405,172.217.194.0-255,5738,269046,1,286524
22055,0.042413,172.31.36.0-255,66,269112,1,286524
22056,0.044402,172.217.194.0-255,5738,274850,1,286524
22057,0.044408,172.31.36.0-255,66,274916,1,286524
22058,0.046417,172.217.194.0-255,5738,280654,1,286524
22059,0.046423,172.31.36.0-255,66,280720,1,286524
22060,0.048438,172.217.194.0-255,5738,286458,1,286524
22061,0.048446,172.31.36.0-255,66,286524,1,286524
22062,0.0,172.217.194.0-255,146,146,1,264181
22063,1.5e-05,172.31.36.0-255,66,212,1,264181
22064,2.3e-05,172.217.194.0-255,1484,1696,1,264181
22065,2.8e-05,172.31.36.0-255,66,1762,1,264181
22066,3.3e-05,172.217.194.0-255,2902,4664,1,264181
22067,3.6e-05,172.31.36.0-255,66,4730,1,264181
22068,4.2e-05,172.217.194.0-255,4320,9050,1,264181
22069,4.4e-05,172.31.36.0-255,66,9116,1,264181
22070,6.3e-05,172.217.194.0-255,2902,12018,1,264181
22071,6.6e-05,172.31.36.0-255,66,12084,1,264181
22072,9.4e-05,172.217.194.0-255,6310,18394,1,264181
22073,9.7e-05,172.31.36.0-255,66,18460,1,264181
22074,0.000112,172.31.36.0-255,66,18526,1,264181
22075,0.000524,172.217.194.0-255,1484,20010,1,264181
22076,0.000529,172.31.36.0-255,66,20076,1,264181
22077,0.000535,172.217.194.0-255,2902,22978,1,264181
22078,0.000537,172.31.36.0-255,66,23044,1,264181
22079,0.000544,172.217.194.0-255,5738,28782,1,264181
22080,0.000546,172.31.36.0-255,66,28848,1,264181
22081,0.000578,172.31.36.0-255,66,28914,1,264181
22082,0.000592,172.217.194.0-255,1484,30398,1,264181
22083,0.000595,172.31.36.0-255,66,30464,1,264181
22084,0.0006,172.217.194.0-255,2902,33366,1,264181
22085,0.000603,172.31.36.0-255,66,33432,1,264181
22086,0.000628,172.217.194.0-255,5738,39170,1,264181
22087,0.000631,172.31.36.0-255,66,39236,1,264181
22088,0.000635,172.217.194.0-255,2184,41420,1,264181
22089,0.000637,172.31.36.0-255,66,41486,1,264181
22090,0.000688,172.217.194.0-255,358,41844,1,264181
22091,0.000691,172.31.36.0-255,66,41910,1,264181
22092,0.000722,172.217.194.0-255,1484,43394,1,264181
22093,0.000729,172.217.194.0-255,4320,47714,1,264181
22094,0.000746,172.217.194.0-255,1484,49198,1,264181
22095,0.000751,172.31.36.0-255,66,49264,1,264181
22096,0.000762,172.217.194.0-255,5738,55002,1,264181
22097,0.000768,172.31.36.0-255,66,55068,1,264181
22098,0.000782,172.217.194.0-255,1484,56552,1,264181
22099,0.000811,172.31.36.0-255,66,56618,1,264181
22100,0.000822,172.217.194.0-255,4320,60938,1,264181
22101,0.000838,172.217.194.0-255,5020,65958,1,264181
22102,0.000856,172.31.36.0-255,66,66024,1,264181
22103,0.004396,172.217.194.0-255,1484,67508,1,264181
22104,0.004407,172.217.194.0-255,2902,70410,1,264181
22105,0.004412,172.31.36.0-255,66,70476,1,264181
22106,0.004419,172.217.194.0-255,2902,73378,1,264181
22107,0.004437,172.217.194.0-255,7156,80534,1,264181
22108,0.004474,172.217.194.0-255,4320,84854,1,264181
22109,0.004529,172.217.194.0-255,5738,90592,1,264181
22110,0.004544,172.217.194.0-255,766,91358,1,264181
22111,0.006166,172.31.36.0-255,66,91424,1,264181
22112,0.00656,172.217.194.0-255,1484,92908,1,264181
22113,0.006569,172.217.194.0-255,2902,95810,1,264181
22114,0.006573,172.31.36.0-255,66,95876,1,264181
22115,0.006594,172.217.194.0-255,5738,101614,1,264181
22116,0.00661,172.31.36.0-255,66,101680,1,264181
22117,0.006633,172.217.194.0-255,2902,104582,1,264181
22118,0.00666,172.217.194.0-255,7156,111738,1,264181
22119,0.006664,172.31.36.0-255,66,111804,1,264181
22120,0.006669,172.31.36.0-255,66,111870,1,264181
22121,0.006684,172.217.194.0-255,5020,116890,1,264181
22122,0.006701,172.31.36.0-255,66,116956,1,264181
22123,0.006721,172.217.194.0-255,2902,119858,1,264181
22124,0.006758,172.217.194.0-255,7156,127014,1,264181
22125,0.006762,172.31.36.0-255,66,127080,1,264181
22126,0.006792,172.217.194.0-255,766,127846,1,264181
22127,0.006796,172.31.36.0-255,66,127912,1,264181
22128,0.007229,172.217.194.0-255,1484,129396,1,264181
22129,0.007246,172.217.194.0-255,2902,132298,1,264181
22130,0.00725,172.31.36.0-255,66,132364,1,264181
22131,0.007273,172.217.194.0-255,5738,138102,1,264181
22132,0.007285,172.217.194.0-255,1484,139586,1,264181
22133,0.007291,172.31.36.0-255,66,139652,1,264181
22134,0.007303,172.217.194.0-255,7156,146808,1,264181
22135,0.007312,172.31.36.0-255,66,146874,1,264181
22136,0.007347,172.217.194.0-255,7156,154030,1,264181
22137,0.007352,172.31.36.0-255,66,154096,1,264181
22138,0.007381,172.31.36.0-255,66,154162,1,264181
22139,0.007555,172.217.194.0-255,1484,155646,1,264181
22140,0.007572,172.217.194.0-255,2902,158548,1,264181
22141,0.007575,172.31.36.0-255,66,158614,1,264181
22142,0.007595,172.217.194.0-255,2902,161516,1,264181
22143,0.007611,172.217.194.0-255,2902,164418,1,264181
22144,0.007614,172.217.194.0-255,1484,165902,1,264181
22145,0.007647,172.31.36.0-255,66,165968,1,264181
22146,0.007688,172.217.194.0-255,7156,173124,1,264181
22147,0.007723,172.217.194.0-255,1484,174608,1,264181
22148,0.007822,172.217.194.0-255,1484,176092,1,264181
22149,0.007838,172.217.194.0-255,2902,178994,1,264181
22150,0.007867,172.217.194.0-255,5738,184732,1,264181
22151,0.007892,172.217.194.0-255,2902,187634,1,264181
22152,0.007913,172.217.194.0-255,7156,194790,1,264181
22153,0.007921,172.217.194.0-255,7156,201946,1,264181
22154,0.00794,172.217.194.0-255,6438,208384,1,264181
22155,0.007975,172.217.194.0-255,1484,209868,1,264181
22156,0.007992,172.217.194.0-255,2902,212770,1,264181
22157,0.008026,172.217.194.0-255,5738,218508,1,264181
22158,0.008041,172.217.194.0-255,4320,222828,1,264181
22159,0.00807,172.217.194.0-255,5738,228566,1,264181
22160,0.008124,172.217.194.0-255,2902,231468,1,264181
22161,0.008154,172.217.194.0-255,1484,232952,1,264181
22162,0.008186,172.217.194.0-255,2902,235854,1,264181
22163,0.008193,172.217.194.0-255,7156,243010,1,264181
22164,0.008238,172.217.194.0-255,3602,246612,1,264181
22165,0.008263,172.217.194.0-255,4320,250932,1,264181
22166,0.00829,172.217.194.0-255,3878,254810,1,264181
22167,0.00834,172.217.194.0-255,105,254915,1,264181
22168,0.008398,172.31.36.0-255,66,254981,1,264181
22169,0.010005,172.31.36.0-255,105,255086,1,264181
22170,0.012592,172.217.194.0-255,66,255152,1,264181
22171,0.037599,172.31.36.0-255,172,255324,1,264181
22172,0.037642,172.31.36.0-255,1113,256437,1,264181
22173,0.037714,172.31.36.0-255,1514,257951,1,264181
22174,0.037716,172.31.36.0-255,1514,259465,1,264181
22175,0.037717,172.31.36.0-255,1514,260979,1,264181
22176,0.037718,172.31.36.0-255,1514,262493,1,264181
22177,0.037719,172.31.36.0-255,1490,263983,1,264181
22178,0.039147,104.244.42.0-255,66,264049,1,264181
22179,0.039271,104.244.42.0-255,66,264115,1,264181
22180,0.039318,104.244.42.0-255,66,264181,1,264181
22181,0.0,74.125.68.0-255,152,152,1,285333
22182,2.3e-05,172.31.36.0-255,66,218,1,285333
22183,6.2e-05,74.125.68.0-255,1484,1702,1,285333
22184,6.8e-05,172.31.36.0-255,66,1768,1,285333
22185,7.2e-05,74.125.68.0-255,1484,3252,1,285333
22186,7.5e-05,172.31.36.0-255,66,3318,1,285333
22187,8.3e-05,74.125.68.0-255,4320,7638,1,285333
22188,8.6e-05,172.31.36.0-255,66,7704,1,285333
22189,9.1e-05,74.125.68.0-255,2902,10606,1,285333
22190,9.4e-05,172.31.36.0-255,66,10672,1,285333
22191,0.000128,74.125.68.0-255,3457,14129,1,285333
22192,0.000132,172.31.36.0-255,66,14195,1,285333
22193,0.000162,74.125.68.0-255,7156,21351,1,285333
22194,0.000165,172.31.36.0-255,66,21417,1,285333
22195,0.000168,74.125.68.0-255,1484,22901,1,285333
22196,0.000169,172.31.36.0-255,66,22967,1,285333
22197,0.000205,74.125.68.0-255,7156,30123,1,285333
22198,0.000208,172.31.36.0-255,66,30189,1,285333
22199,0.00022,172.31.36.0-255,66,30255,1,285333
22200,0.000263,172.31.36.0-255,66,30321,1,285333
22201,0.000887,74.125.68.0-255,1484,31805,1,285333
22202,0.000893,172.31.36.0-255,66,31871,1,285333
22203,0.000923,74.125.68.0-255,2902,34773,1,285333
22204,0.000927,172.31.36.0-255,66,34839,1,285333
22205,0.000934,74.125.68.0-255,5738,40577,1,285333
22206,0.000937,172.31.36.0-255,66,40643,1,285333
22207,0.00094,74.125.68.0-255,1484,42127,1,285333
22208,0.000943,172.31.36.0-255,66,42193,1,285333
22209,0.000987,74.125.68.0-255,5686,47879,1,285333
22210,0.000991,172.31.36.0-255,66,47945,1,285333
22211,0.001228,74.125.68.0-255,1484,49429,1,285333
22212,0.001245,74.125.68.0-255,2902,52331,1,285333
22213,0.001249,172.31.36.0-255,66,52397,1,285333
22214,0.001278,74.125.68.0-255,5738,58135,1,285333
22215,0.001281,172.31.36.0-255,66,58201,1,285333
22216,0.00133,74.125.68.0-255,5738,63939,1,285333
22217,0.001333,172.31.36.0-255,66,64005,1,285333
22218,0.001358,74.125.68.0-255,1484,65489,1,285333
22219,0.001369,172.31.36.0-255,66,65555,1,285333
22220,0.001374,74.125.68.0-255,2902,68457,1,285333
22221,0.001377,172.31.36.0-255,66,68523,1,285333
22222,0.001392,74.125.68.0-255,5020,73543,1,285333
22223,0.001395,172.31.36.0-255,66,73609,1,285333
22224,0.001569,74.125.68.0-255,1484,75093,1,285333
22225,0.001586,74.125.68.0-255,2902,77995,1,285333
22226,0.001589,172.31.36.0-255,66,78061,1,285333
22227,0.00161,74.125.68.0-255,5738,83799,1,285333
22228,0.001613,172.31.36.0-255,66,83865,1,285333
22229,0.001641,74.125.68.0-255,5738,89603,1,285333
22230,0.001644,172.31.36.0-255,66,89669,1,285333
22231,0.001651,74.125.68.0-255,7156,96825,1,285333
22232,0.001654,172.31.36.0-255,66,96891,1,285333
22233,0.001713,172.31.36.0-255,66,96957,1,285333
22234,0.001753,172.31.36.0-255,66,97023,1,285333
22235,0.00176,74.125.68.0-255,5738,102761,1,285333
22236,0.001763,172.31.36.0-255,66,102827,1,285333
22237,0.001785,74.125.68.0-255,7156,109983,1,285333
22238,0.001787,172.31.36.0-255,66,110049,1,285333
22239,0.001823,74.125.68.0-255,7156,117205,1,285333
22240,0.001826,172.31.36.0-255,66,117271,1,285333
22241,0.00183,74.125.68.0-255,2184,119455,1,285333
22242,0.001832,172.31.36.0-255,66,119521,1,285333
22243,0.001864,74.125.68.0-255,2902,122423,1,285333
22244,0.001867,172.31.36.0-255,66,122489,1,285333
22245,0.001872,74.125.68.0-255,2902,125391,1,285333
22246,0.001877,172.31.36.0-255,66,125457,1,285333
22247,0.0019,74.125.68.0-255,4320,129777,1,285333
22248,0.001903,172.31.36.0-255,66,129843,1,285333
22249,0.001908,74.125.68.0-255,4320,134163,1,285333
22250,0.00191,172.31.36.0-255,66,134229,1,285333
22251,0.001916,74.125.68.0-255,5738,139967,1,285333
22252,0.001918,172.31.36.0-255,66,140033,1,285333
22253,0.001925,74.125.68.0-255,4320,144353,1,285333
22254,0.001928,172.31.36.0-255,66,144419,1,285333
22255,0.001949,74.125.68.0-255,7156,151575,1,285333
22256,0.001953,172.31.36.0-255,66,151641,1,285333
22257,0.001957,74.125.68.0-255,2184,153825,1,285333
22258,0.00196,172.31.36.0-255,66,153891,1,285333
22259,0.002236,74.125.68.0-255,1484,155375,1,285333
22260,0.002257,74.125.68.0-255,1484,156859,1,285333
22261,0.00226,172.31.36.0-255,66,156925,1,285333
22262,0.002287,74.125.68.0-255,4320,161245,1,285333
22263,0.00229,172.31.36.0-255,66,161311,1,285333
22264,0.00449,74.125.68.0-255,1484,162795,1,285333
22265,0.004513,74.125.68.0-255,2902,165697,1,285333
22266,0.004518,172.31.36.0-255,66,165763,1,285333
22267,0.004536,74.125.68.0-255,1484,167247,1,285333
22268,0.006743,74.125.68.0-255,1484,168731,1,285333
22269,0.006746,172.31.36.0-255,66,168797,1,285333
22270,0.006772,74.125.68.0-255,2902,171699,1,285333
22271,0.006775,172.31.36.0-255,66,171765,1,285333
22272,0.009021,74.125.68.0-255,5738,177503,1,285333
22273,0.009048,172.31.36.0-255,66,177569,1,285333
22274,0.011314,74.125.68.0-255,5738,183307,1,285333
22275,0.011337,172.31.36.0-255,66,183373,1,285333
22276,0.013591,74.125.68.0-255,5738,189111,1,285333
22277,0.013606,172.31.36.0-255,66,189177,1,285333
22278,0.015848,74.125.68.0-255,5738,194915,1,285333
22279,0.015857,172.31.36.0-255,66,194981,1,285333
22280,0.018102,74.125.68.0-255,5738,200719,1,285333
22281,0.018115,172.31.36.0-255,66,200785,1,285333
22282,0.020407,74.125.68.0-255,5738,206523,1,285333
22283,0.020425,172.31.36.0-255,66,206589,1,285333
22284,0.022677,74.125.68.0-255,5738,212327,1,285333
22285,0.022689,172.31.36.0-255,66,212393,1,285333
22286,0.024967,74.125.68.0-255,5738,218131,1,285333
22287,0.024978,172.31.36.0-255,66,218197,1,285333
22288,0.027224,74.125.68.0-255,5738,223935,1,285333
22289,0.027235,172.31.36.0-255,66,224001,1,285333
22290,0.029494,74.125.68.0-255,5738,229739,1,285333
22291,0.029508,172.31.36.0-255,66,229805,1,285333
22292,0.031785,74.125.68.0-255,5738,235543,1,285333
22293,0.031799,172.31.36.0-255,66,235609,1,285333
22294,0.034043,74.125.68.0-255,5738,241347,1,285333
22295,0.034054,172.31.36.0-255,66,241413,1,285333
22296,0.036347,74.125.68.0-255,5738,247151,1,285333
22297,0.036385,172.31.36.0-255,66,247217,1,285333
22298,0.038643,74.125.68.0-255,5738,252955,1,285333
22299,0.038666,172.31.36.0-255,66,253021,1,285333
22300,0.040919,74.125.68.0-255,5738,258759,1,285333
22301,0.040933,172.31.36.0-255,66,258825,1,285333
22302,0.043196,74.125.68.0-255,5738,264563,1,285333
22303,0.043205,172.31.36.0-255,66,264629,1,285333
22304,0.04324,172.31.36.0-255,172,264801,1,285333
22305,0.043264,172.31.36.0-255,1113,265914,1,285333
22306,0.043324,172.31.36.0-255,1514,267428,1,285333
22307,0.043326,172.31.36.0-255,1514,268942,1,285333
22308,0.043331,172.31.36.0-255,1514,270456,1,285333
22309,0.043332,172.31.36.0-255,1514,271970,1,285333
22310,0.043351,172.31.36.0-255,1491,273461,1,285333
22311,0.044791,104.244.42.0-255,66,273527,1,285333
22312,0.044837,104.244.42.0-255,66,273593,1,285333
22313,0.04489,104.244.42.0-255,66,273659,1,285333
22314,0.044971,104.244.42.0-255,66,273725,1,285333
22315,0.045458,74.125.68.0-255,5738,279463,1,285333
22316,0.045476,172.31.36.0-255,66,279529,1,285333
22317,0.04788,74.125.68.0-255,5738,285267,1,285333
22318,0.047888,172.31.36.0-255,66,285333,1,285333
22319,0.0,172.31.36.0-255,130,130,1,1700
22320,0.000526,172.31.36.0-255,236,366,1,1700
22321,0.000555,172.31.36.0-255,378,744,1,1700
22322,0.002916,74.125.24.0-255,630,1374,1,1700
22323,0.003113,172.31.36.0-255,97,1471,1,1700
22324,0.003136,74.125.24.0-255,97,1568,1,1700
22325,0.010176,74.125.24.0-255,66,1634,1,1700
22326,0.041821,172.31.36.0-255,66,1700,1,1700
22327,0.0,172.217.194.0-255,149,149,1,311182
22328,2e-05,172.31.36.0-255,66,215,1,311182
22329,2.7e-05,172.217.194.0-255,1484,1699,1,311182
22330,3.2e-05,172.31.36.0-255,66,1765,1,311182
22331,3.7e-05,172.217.194.0-255,2902,4667,1,311182
22332,3.9e-05,172.31.36.0-255,66,4733,1,311182
22333,4.5e-05,172.217.194.0-255,7156,11889,1,311182
22334,4.7e-05,172.31.36.0-255,66,11955,1,311182
22335,5.1e-05,172.217.194.0-255,2077,14032,1,311182
22336,5.4e-05,172.31.36.0-255,66,14098,1,311182
22337,0.000107,172.217.194.0-255,2902,17000,1,311182
22338,0.00011,172.31.36.0-255,66,17066,1,311182
22339,0.000132,172.217.194.0-255,5738,22804,1,311182
22340,0.000134,172.31.36.0-255,66,22870,1,311182
22341,0.00016,172.217.194.0-255,2902,25772,1,311182
22342,0.000162,172.31.36.0-255,66,25838,1,311182
22343,0.000184,172.217.194.0-255,5379,31217,1,311182
22344,0.000186,172.31.36.0-255,66,31283,1,311182
22345,0.000199,172.217.194.0-255,1484,32767,1,311182
22346,0.0002,172.31.36.0-255,66,32833,1,311182
22347,0.000222,172.217.194.0-255,2902,35735,1,311182
22348,0.000224,172.31.36.0-255,66,35801,1,311182
22349,0.00023,172.217.194.0-255,5738,41539,1,311182
22350,0.000232,172.31.36.0-255,66,41605,1,311182
22351,0.000268,172.31.36.0-255,66,41671,1,311182
22352,0.000274,172.217.194.0-255,5738,47409,1,311182
22353,0.000276,172.31.36.0-255,66,47475,1,311182
22354,0.00029,172.217.194.0-255,2902,50377,1,311182
22355,0.000292,172.31.36.0-255,66,50443,1,311182
22356,0.000295,172.217.194.0-255,1125,51568,1,311182
22357,0.000297,172.31.36.0-255,66,51634,1,311182
22358,0.000585,172.217.194.0-255,646,52280,1,311182
22359,0.0008,172.217.194.0-255,1484,53764,1,311182
22360,0.000804,172.31.36.0-255,66,53830,1,311182
22361,0.00081,172.217.194.0-255,2902,56732,1,311182
22362,0.000812,172.31.36.0-255,66,56798,1,311182
22363,0.000831,172.217.194.0-255,5738,62536,1,311182
22364,0.000833,172.31.36.0-255,66,62602,1,311182
22365,0.000867,172.217.194.0-255,2902,65504,1,311182
22366,0.00087,172.31.36.0-255,66,65570,1,311182
22367,0.000889,172.217.194.0-255,3412,68982,1,311182
22368,0.000891,172.31.36.0-255,66,69048,1,311182
22369,0.001066,172.217.194.0-255,1484,70532,1,311182
22370,0.001079,172.217.194.0-255,2902,73434,1,311182
22371,0.001084,172.31.36.0-255,66,73500,1,311182
22372,0.001103,172.217.194.0-255,5738,79238,1,311182
22373,0.001105,172.31.36.0-255,66,79304,1,311182
22374,0.001131,172.217.194.0-255,7156,86460,1,311182
22375,0.001133,172.31.36.0-255,66,86526,1,311182
22376,0.00115,172.217.194.0-255,4320,90846,1,311182
22377,0.001152,172.31.36.0-255,66,90912,1,311182
22378,0.001185,172.31.36.0-255,66,90978,1,311182
22379,0.0012,172.217.194.0-255,2184,93162,1,311182
22380,0.001203,172.31.36.0-255,66,93228,1,311182
22381,0.001399,172.217.194.0-255,1484,94712,1,311182
22382,0.001405,172.217.194.0-255,2902,97614,1,311182
22383,0.001408,172.31.36.0-255,66,97680,1,311182
22384,0.001413,172.217.194.0-255,2902,100582,1,311182
22385,0.001415,172.31.36.0-255,66,100648,1,311182
22386,0.001432,172.217.194.0-255,2902,103550,1,311182
22387,0.001435,172.31.36.0-255,66,103616,1,311182
22388,0.001439,172.217.194.0-255,2902,106518,1,311182
22389,0.001441,172.31.36.0-255,66,106584,1,311182
22390,0.001462,172.217.194.0-255,1484,108068,1,311182
22391,0.001475,172.31.36.0-255,66,108134,1,311182
22392,0.0015,172.217.194.0-255,5738,113872,1,311182
22393,0.001503,172.31.36.0-255,66,113938,1,311182
22394,0.00152,172.217.194.0-255,2184,116122,1,311182
22395,0.001523,172.31.36.0-255,66,116188,1,311182
22396,0.001526,172.217.194.0-255,1484,117672,1,311182
22397,0.001529,172.217.194.0-255,2902,120574,1,311182
22398,0.001531,172.31.36.0-255,66,120640,1,311182
22399,0.001556,172.217.194.0-255,5738,126378,1,311182
22400,0.001559,172.31.36.0-255,66,126444,1,311182
22401,0.00159,172.31.36.0-255,66,126510,1,311182
22402,0.001612,172.217.194.0-255,2902,129412,1,311182
22403,0.001615,172.31.36.0-255,66,129478,1,311182
22404,0.001627,172.31.36.0-255,66,129544,1,311182
22405,0.00163,172.217.194.0-255,1484,131028,1,311182
22406,0.001685,172.31.36.0-255,66,131094,1,311182
22407,0.001762,172.217.194.0-255,1484,132578,1,311182
22408,0.001768,172.217.194.0-255,2902,135480,1,311182
22409,0.001773,172.31.36.0-255,66,135546,1,311182
22410,0.00178,172.217.194.0-255,5738,141284,1,311182
22411,0.001783,172.31.36.0-255,66,141350,1,311182
22412,0.001802,172.217.194.0-255,5738,147088,1,311182
22413,0.001807,172.31.36.0-255,66,147154,1,311182
22414,0.001834,172.217.194.0-255,4320,151474,1,311182
22415,0.001838,172.31.36.0-255,66,151540,1,311182
22416,0.001873,172.31.36.0-255,66,151606,1,311182
22417,0.00188,172.217.194.0-255,5020,156626,1,311182
22418,0.001883,172.31.36.0-255,66,156692,1,311182
22419,0.002007,172.217.194.0-255,1484,158176,1,311182
22420,0.002014,172.217.194.0-255,2902,161078,1,311182
22421,0.002018,172.31.36.0-255,66,161144,1,311182
22422,0.002025,172.217.194.0-255,5738,166882,1,311182
22423,0.002027,172.31.36.0-255,66,166948,1,311182
22424,0.002076,172.31.36.0-255,66,167014,1,311182
22425,0.002095,172.217.194.0-255,4320,171334,1,311182
22426,0.002098,172.31.36.0-255,66,171400,1,311182
22427,0.002126,172.217.194.0-255,6438,177838,1,311182
22428,0.00213,172.31.36.0-255,66,177904,1,311182
22429,0.002148,172.217.194.0-255,5738,183642,1,311182
22430,0.002151,172.31.36.0-255,66,183708,1,311182
22431,0.002175,172.217.194.0-255,1484,185192,1,311182
22432,0.002187,172.31.36.0-255,66,185258,1,311182
22433,0.002211,172.217.194.0-255,7156,192414,1,311182
22434,0.002215,172.31.36.0-255,66,192480,1,311182
22435,0.002242,172.217.194.0-255,5738,198218,1,311182
22436,0.002246,172.31.36.0-255,66,198284,1,311182
22437,0.002252,172.217.194.0-255,5020,203304,1,311182
22438,0.002255,172.31.36.0-255,66,203370,1,311182
22439,0.002532,172.217.194.0-255,1484,204854,1,311182
22440,0.002539,172.217.194.0-255,2902,207756,1,311182
22441,0.002543,172.31.36.0-255,66,207822,1,311182
22442,0.002549,172.217.194.0-255,2902,210724,1,311182
22443,0.002551,172.31.36.0-255,66,210790,1,311182
22444,0.002566,172.217.194.0-255,2902,213692,1,311182
22445,0.002569,172.31.36.0-255,66,213758,1,311182
22446,0.002574,172.217.194.0-255,2902,216660,1,311182
22447,0.002576,172.31.36.0-255,66,216726,1,311182
22448,0.002598,172.31.36.0-255,66,216792,1,311182
22449,0.002602,172.217.194.0-255,2902,219694,1,311182
22450,0.002605,172.31.36.0-255,66,219760,1,311182
22451,0.002608,172.217.194.0-255,1484,221244,1,311182
22452,0.00264,172.217.194.0-255,5738,226982,1,311182
22453,0.002644,172.31.36.0-255,66,227048,1,311182
22454,0.002647,172.217.194.0-255,766,227814,1,311182
22455,0.002702,172.217.194.0-255,1484,229298,1,311182
22456,0.002706,172.31.36.0-255,66,229364,1,311182
22457,0.002712,172.217.194.0-255,2902,232266,1,311182
22458,0.002714,172.31.36.0-255,66,232332,1,311182
22459,0.002717,172.217.194.0-255,1484,233816,1,311182
22460,0.002738,172.217.194.0-255,1484,235300,1,311182
22461,0.002742,172.31.36.0-255,66,235366,1,311182
22462,0.002764,172.217.194.0-255,7156,242522,1,311182
22463,0.002767,172.31.36.0-255,66,242588,1,311182
22464,0.002774,172.217.194.0-255,7156,249744,1,311182
22465,0.002777,172.31.36.0-255,66,249810,1,311182
22466,0.002783,172.217.194.0-255,5738,255548,1,311182
22467,0.002786,172.31.36.0-255,66,255614,1,311182
22468,0.002811,172.217.194.0-255,6438,262052,1,311182
22469,0.002815,172.31.36.0-255,66,262118,1,311182
22470,0.002821,172.217.194.0-255,5738,267856,1,311182
22471,0.002823,172.31.36.0-255,66,267922,1,311182
22472,0.002826,172.217.194.0-255,1484,269406,1,311182
22473,0.002849,172.217.194.0-255,2902,272308,1,311182
22474,0.002852,172.31.36.0-255,66,272374,1,311182
22475,0.002869,172.217.194.0-255,4320,276694,1,311182
22476,0.002871,172.31.36.0-255,66,276760,1,311182
22477,0.002893,172.217.194.0-255,2902,279662,1,311182
22478,0.002896,172.31.36.0-255,66,279728,1,311182
22479,0.002902,172.217.194.0-255,5738,285466,1,311182
22480,0.002905,172.31.36.0-255,66,285532,1,311182
22481,0.002921,172.217.194.0-255,5738,291270,1,311182
22482,0.002924,172.31.36.0-255,66,291336,1,311182
22483,0.002949,172.217.194.0-255,5738,297074,1,311182
22484,0.002952,172.31.36.0-255,66,297140,1,311182
22485,0.002978,172.217.194.0-255,6438,303578,1,311182
22486,0.002981,172.31.36.0-255,66,303644,1,311182
22487,0.002987,172.217.194.0-255,4967,308611,1,311182
22488,0.00299,172.31.36.0-255,66,308677,1,311182
22489,0.002993,172.217.194.0-255,97,308774,1,311182
22490,0.002996,172.217.194.0-255,105,308879,1,311182
22491,0.004876,172.31.36.0-255,66,308945,1,311182
22492,0.004922,172.31.36.0-255,105,309050,1,311182
22493,0.007398,172.217.194.0-255,66,309116,1,311182
22494,0.033467,172.31.36.0-255,189,309305,1,311182
22495,0.033501,172.31.36.0-255,1114,310419,1,311182
22496,0.033573,172.31.36.0-255,565,310984,1,311182
22497,0.035004,104.244.42.0-255,66,311050,1,311182
22498,0.035054,104.244.42.0-255,66,311116,1,311182
22499,0.035091,104.244.42.0-255,66,311182,1,311182
22500,0.0,74.125.24.0-255,146,146,1,320832
22501,2.2e-05,172.31.36.0-255,66,212,1,320832
22502,2.9e-05,74.125.24.0-255,1484,1696,1,320832
22503,3.3e-05,172.31.36.0-255,66,1762,1,320832
22504,4.5e-05,74.125.24.0-255,2902,4664,1,320832
22505,4.9e-05,172.31.36.0-255,66,4730,1,320832
22506,5.6e-05,74.125.24.0-255,7156,11886,1,320832
22507,5.8e-05,172.31.36.0-255,66,11952,1,320832
22508,7.9e-05,74.125.24.0-255,4320,16272,1,320832
22509,8.5e-05,172.31.36.0-255,66,16338,1,320832
22510,0.000112,74.125.24.0-255,4940,21278,1,320832
22511,0.000115,172.31.36.0-255,66,21344,1,320832
22512,0.000127,172.31.36.0-255,66,21410,1,320832
22513,0.000173,74.125.24.0-255,1484,22894,1,320832
22514,0.000175,172.31.36.0-255,66,22960,1,320832
22515,0.000179,74.125.24.0-255,1484,24444,1,320832
22516,0.000181,172.31.36.0-255,66,24510,1,320832
22517,0.000203,74.125.24.0-255,1484,25994,1,320832
22518,0.00021,172.31.36.0-255,66,26060,1,320832
22519,0.000219,74.125.24.0-255,5738,31798,1,320832
22520,0.000221,172.31.36.0-255,66,31864,1,320832
22521,0.000236,172.31.36.0-255,66,31930,1,320832
22522,0.000263,74.125.24.0-255,7156,39086,1,320832
22523,0.000266,172.31.36.0-255,66,39152,1,320832
22524,0.0003,74.125.24.0-255,1484,40636,1,320832
22525,0.000302,172.31.36.0-255,66,40702,1,320832
22526,0.000307,74.125.24.0-255,2479,43181,1,320832
22527,0.00031,172.31.36.0-255,66,43247,1,320832
22528,0.000806,74.125.24.0-255,131,43378,1,320832
22529,0.000812,172.31.36.0-255,66,43444,1,320832
22530,0.001041,74.125.24.0-255,1484,44928,1,320832
22531,0.001048,74.125.24.0-255,2902,47830,1,320832
22532,0.001051,172.31.36.0-255,66,47896,1,320832
22533,0.001085,74.125.24.0-255,5738,53634,1,320832
22534,0.001088,172.31.36.0-255,66,53700,1,320832
22535,0.001094,74.125.24.0-255,4320,58020,1,320832
22536,0.001096,172.31.36.0-255,66,58086,1,320832
22537,0.001133,172.31.36.0-255,66,58152,1,320832
22538,0.001143,172.31.36.0-255,66,58218,1,320832
22539,0.001154,74.125.24.0-255,1484,59702,1,320832
22540,0.001174,74.125.24.0-255,766,60468,1,320832
22541,0.001177,172.31.36.0-255,66,60534,1,320832
22542,0.001601,74.125.24.0-255,1484,62018,1,320832
22543,0.001618,74.125.24.0-255,2902,64920,1,320832
22544,0.001624,172.31.36.0-255,66,64986,1,320832
22545,0.001651,74.125.24.0-255,4320,69306,1,320832
22546,0.001654,172.31.36.0-255,66,69372,1,320832
22547,0.001678,74.125.24.0-255,1484,70856,1,320832
22548,0.001686,74.125.24.0-255,7156,78012,1,320832
22549,0.001689,172.31.36.0-255,66,78078,1,320832
22550,0.001723,172.31.36.0-255,66,78144,1,320832
22551,0.001752,74.125.24.0-255,5738,83882,1,320832
22552,0.001754,172.31.36.0-255,66,83948,1,320832
22553,0.001759,74.125.24.0-255,2184,86132,1,320832
22554,0.001761,172.31.36.0-255,66,86198,1,320832
22555,0.001844,74.125.24.0-255,1484,87682,1,320832
22556,0.001874,74.125.24.0-255,2902,90584,1,320832
22557,0.001877,172.31.36.0-255,66,90650,1,320832
22558,0.001905,74.125.24.0-255,5738,96388,1,320832
22559,0.001908,172.31.36.0-255,66,96454,1,320832
22560,0.001913,74.125.24.0-255,2902,99356,1,320832
22561,0.001915,172.31.36.0-255,66,99422,1,320832
22562,0.001948,172.31.36.0-255,66,99488,1,320832
22563,0.001975,74.125.24.0-255,4320,103808,1,320832
22564,0.001991,74.125.24.0-255,6438,110246,1,320832
22565,0.002091,74.125.24.0-255,1484,111730,1,320832
22566,0.002105,74.125.24.0-255,2902,114632,1,320832
22567,0.002123,74.125.24.0-255,4320,118952,1,320832
22568,0.00214,74.125.24.0-255,1484,120436,1,320832
22569,0.002165,74.125.24.0-255,4320,124756,1,320832
22570,0.002192,74.125.24.0-255,5738,130494,1,320832
22571,0.002225,74.125.24.0-255,4320,134814,1,320832
22572,0.002242,74.125.24.0-255,4320,139134,1,320832
22573,0.002259,74.125.24.0-255,1484,140618,1,320832
22574,0.002295,74.125.24.0-255,3602,144220,1,320832
22575,0.002455,74.125.24.0-255,1484,145704,1,320832
22576,0.002461,74.125.24.0-255,1484,147188,1,320832
22577,0.002477,74.125.24.0-255,1484,148672,1,320832
22578,0.002482,74.125.24.0-255,2902,151574,1,320832
22579,0.002516,74.125.24.0-255,2902,154476,1,320832
22580,0.002535,74.125.24.0-255,2902,157378,1,320832
22581,0.002555,74.125.24.0-255,2902,160280,1,320832
22582,0.002576,74.125.24.0-255,2902,163182,1,320832
22583,0.00259,74.125.24.0-255,2184,165366,1,320832
22584,0.002659,74.125.24.0-255,1484,166850,1,320832
22585,0.002672,74.125.24.0-255,2902,169752,1,320832
22586,0.002693,74.125.24.0-255,2902,172654,1,320832
22587,0.002695,74.125.24.0-255,1484,174138,1,320832
22588,0.00276,74.125.24.0-255,2902,177040,1,320832
22589,0.002764,74.125.24.0-255,2902,179942,1,320832
22590,0.002768,74.125.24.0-255,2902,182844,1,320832
22591,0.002781,74.125.24.0-255,1484,184328,1,320832
22592,0.002795,74.125.24.0-255,3602,187930,1,320832
22593,0.002823,74.125.24.0-255,1484,189414,1,320832
22594,0.002835,74.125.24.0-255,1484,190898,1,320832
22595,0.00285,74.125.24.0-255,1484,192382,1,320832
22596,0.002872,74.125.24.0-255,1484,193866,1,320832
22597,0.002889,74.125.24.0-255,2902,196768,1,320832
22598,0.002893,74.125.24.0-255,1484,198252,1,320832
22599,0.002911,74.125.24.0-255,4320,202572,1,320832
22600,0.002942,74.125.24.0-255,2902,205474,1,320832
22601,0.002949,74.125.24.0-255,7156,212630,1,320832
22602,0.00296,74.125.24.0-255,766,213396,1,320832
22603,0.003401,74.125.24.0-255,1484,214880,1,320832
22604,0.003417,74.125.24.0-255,2902,217782,1,320832
22605,0.003434,74.125.24.0-255,5738,223520,1,320832
22606,0.003455,74.125.24.0-255,7156,230676,1,320832
22607,0.003459,74.125.24.0-255,2902,233578,1,320832
22608,0.003474,74.125.24.0-255,4320,237898,1,320832
22609,0.00349,74.125.24.0-255,7156,245054,1,320832
22610,0.003495,74.125.24.0-255,2184,247238,1,320832
22611,0.004372,74.125.24.0-255,1484,248722,1,320832
22612,0.004385,74.125.24.0-255,2902,251624,1,320832
22613,0.004388,74.125.24.0-255,1484,253108,1,320832
22614,0.004409,74.125.24.0-255,4320,257428,1,320832
22615,0.004416,74.125.24.0-255,5738,263166,1,320832
22616,0.004463,74.125.24.0-255,1484,264650,1,320832
22617,0.004469,74.125.24.0-255,5020,269670,1,320832
22618,0.004473,74.125.24.0-255,2902,272572,1,320832
22619,0.004478,74.125.24.0-255,4320,276892,1,320832
22620,0.004495,74.125.24.0-255,5738,282630,1,320832
22621,0.004499,74.125.24.0-255,2902,285532,1,320832
22622,0.00452,74.125.24.0-255,4320,289852,1,320832
22623,0.004527,74.125.24.0-255,7156,297008,1,320832
22624,0.004544,74.125.24.0-255,2902,299910,1,320832
22625,0.004547,74.125.24.0-255,1484,301394,1,320832
22626,0.004551,74.125.24.0-255,2184,303578,1,320832
22627,0.004558,74.125.24.0-255,5738,309316,1,320832
22628,0.004578,74.125.24.0-255,5738,315054,1,320832
22629,0.004595,74.125.24.0-255,3387,318441,1,320832
22630,0.004621,74.125.24.0-255,105,318546,1,320832
22631,0.006664,172.31.36.0-255,66,318612,1,320832
22632,0.009064,172.31.36.0-255,105,318717,1,320832
22633,0.011621,74.125.24.0-255,66,318783,1,320832
22634,0.04124,172.31.36.0-255,172,318955,1,320832
22635,0.041275,172.31.36.0-255,1114,320069,1,320832
22636,0.041347,172.31.36.0-255,565,320634,1,320832
22637,0.042753,104.244.42.0-255,66,320700,1,320832
22638,0.042817,104.244.42.0-255,66,320766,1,320832
22639,0.042942,104.244.42.0-255,66,320832,1,320832
22640,0.0,172.217.194.0-255,143,143,1,235099
22641,2.5e-05,172.31.36.0-255,66,209,1,235099
22642,3.2e-05,172.217.194.0-255,1484,1693,1,235099
22643,3.5e-05,172.31.36.0-255,66,1759,1,235099
22644,5.9e-05,172.217.194.0-255,2902,4661,1,235099
22645,6.6e-05,172.31.36.0-255,66,4727,1,235099
22646,7.2e-05,172.217.194.0-255,5738,10465,1,235099
22647,7.5e-05,172.31.36.0-255,66,10531,1,235099
22648,9.7e-05,172.217.194.0-255,1484,12015,1,235099
22649,0.000101,172.31.36.0-255,66,12081,1,235099
22650,0.00012,172.217.194.0-255,2105,14186,1,235099
22651,0.000123,172.31.36.0-255,66,14252,1,235099
22652,0.000571,172.217.194.0-255,1484,15736,1,235099
22653,0.000578,172.31.36.0-255,66,15802,1,235099
22654,0.000587,172.217.194.0-255,2902,18704,1,235099
22655,0.000596,172.31.36.0-255,66,18770,1,235099
22656,0.000604,172.217.194.0-255,5738,24508,1,235099
22657,0.000607,172.31.36.0-255,66,24574,1,235099
22658,0.000658,172.217.194.0-255,6797,31371,1,235099
22659,0.000663,172.31.36.0-255,66,31437,1,235099
22660,0.00101,172.217.194.0-255,1484,32921,1,235099
22661,0.001016,172.31.36.0-255,66,32987,1,235099
22662,0.001022,172.217.194.0-255,2902,35889,1,235099
22663,0.001024,172.31.36.0-255,66,35955,1,235099
22664,0.001052,172.217.194.0-255,5738,41693,1,235099
22665,0.001055,172.31.36.0-255,66,41759,1,235099
22666,0.001062,172.217.194.0-255,6797,48556,1,235099
22667,0.001064,172.31.36.0-255,66,48622,1,235099
22668,0.001086,172.217.194.0-255,4320,52942,1,235099
22669,0.001088,172.31.36.0-255,66,53008,1,235099
22670,0.001124,172.31.36.0-255,66,53074,1,235099
22671,0.001149,172.217.194.0-255,2543,55617,1,235099
22672,0.001151,172.31.36.0-255,66,55683,1,235099
22673,0.001264,172.217.194.0-255,360,56043,1,235099
22674,0.001268,172.217.194.0-255,382,56425,1,235099
22675,0.001792,172.217.194.0-255,1484,57909,1,235099
22676,0.001795,172.31.36.0-255,66,57975,1,235099
22677,0.001799,172.217.194.0-255,2902,60877,1,235099
22678,0.001801,172.31.36.0-255,66,60943,1,235099
22679,0.001827,172.217.194.0-255,5738,66681,1,235099
22680,0.001829,172.31.36.0-255,66,66747,1,235099
22681,0.001863,172.31.36.0-255,66,66813,1,235099
22682,0.001885,172.217.194.0-255,1484,68297,1,235099
22683,0.0019,172.217.194.0-255,5738,74035,1,235099
22684,0.001903,172.31.36.0-255,66,74101,1,235099
22685,0.001926,172.217.194.0-255,1484,75585,1,235099
22686,0.001937,172.217.194.0-255,2184,77769,1,235099
22687,0.00194,172.31.36.0-255,66,77835,1,235099
22688,0.002091,172.217.194.0-255,1484,79319,1,235099
22689,0.00211,172.217.194.0-255,2902,82221,1,235099
22690,0.002112,172.31.36.0-255,66,82287,1,235099
22691,0.002115,172.217.194.0-255,1484,83771,1,235099
22692,0.002139,172.217.194.0-255,2902,86673,1,235099
22693,0.002141,172.31.36.0-255,66,86739,1,235099
22694,0.002148,172.217.194.0-255,7156,93895,1,235099
22695,0.00215,172.31.36.0-255,66,93961,1,235099
22696,0.002179,172.217.194.0-255,1484,95445,1,235099
22697,0.00219,172.31.36.0-255,66,95511,1,235099
22698,0.002231,172.217.194.0-255,4320,99831,1,235099
22699,0.002233,172.31.36.0-255,66,99897,1,235099
22700,0.002269,172.31.36.0-255,66,99963,1,235099
22701,0.002312,172.217.194.0-255,2902,102865,1,235099
22702,0.002315,172.31.36.0-255,66,102931,1,235099
22703,0.002348,172.31.36.0-255,66,102997,1,235099
22704,0.002383,172.31.36.0-255,66,103063,1,235099
22705,0.00461,172.217.194.0-255,5738,108801,1,235099
22706,0.004618,172.31.36.0-255,66,108867,1,235099
22707,0.006868,172.217.194.0-255,5738,114605,1,235099
22708,0.006877,172.31.36.0-255,66,114671,1,235099
22709,0.009121,172.217.194.0-255,5738,120409,1,235099
22710,0.00913,172.31.36.0-255,66,120475,1,235099
22711,0.011386,172.217.194.0-255,5738,126213,1,235099
22712,0.011394,172.31.36.0-255,66,126279,1,235099
22713,0.01367,172.217.194.0-255,5738,132017,1,235099
22714,0.013677,172.31.36.0-255,66,132083,1,235099
22715,0.015941,172.217.194.0-255,5738,137821,1,235099
22716,0.015949,172.31.36.0-255,66,137887,1,235099
22717,0.018194,172.217.194.0-255,5738,143625,1,235099
22718,0.018201,172.31.36.0-255,66,143691,1,235099
22719,0.020451,172.217.194.0-255,5738,149429,1,235099
22720,0.020459,172.31.36.0-255,66,149495,1,235099
22721,0.022714,172.217.194.0-255,5738,155233,1,235099
22722,0.022725,172.31.36.0-255,66,155299,1,235099
22723,0.024973,172.217.194.0-255,5738,161037,1,235099
22724,0.024981,172.31.36.0-255,66,161103,1,235099
22725,0.027235,172.217.194.0-255,5738,166841,1,235099
22726,0.027245,172.31.36.0-255,66,166907,1,235099
22727,0.029499,172.217.194.0-255,5738,172645,1,235099
22728,0.029508,172.31.36.0-255,66,172711,1,235099
22729,0.031764,172.217.194.0-255,5738,178449,1,235099
22730,0.031772,172.31.36.0-255,66,178515,1,235099
22731,0.033204,172.31.36.0-255,172,178687,1,235099
22732,0.033233,172.31.36.0-255,1114,179801,1,235099
22733,0.033284,172.31.36.0-255,1514,181315,1,235099
22734,0.033286,172.31.36.0-255,1514,182829,1,235099
22735,0.033291,172.31.36.0-255,1514,184343,1,235099
22736,0.033292,172.31.36.0-255,1514,185857,1,235099
22737,0.033311,172.31.36.0-255,1490,187347,1,235099
22738,0.034047,172.217.194.0-255,2902,190249,1,235099
22739,0.034053,172.31.36.0-255,66,190315,1,235099
22740,0.034099,172.217.194.0-255,2902,193217,1,235099
22741,0.034103,172.31.36.0-255,66,193283,1,235099
22742,0.034764,104.244.42.0-255,66,193349,1,235099
22743,0.034791,104.244.42.0-255,66,193415,1,235099
22744,0.034843,104.244.42.0-255,66,193481,1,235099
22745,0.034934,104.244.42.0-255,66,193547,1,235099
22746,0.036295,172.217.194.0-255,2902,196449,1,235099
22747,0.0363,172.31.36.0-255,66,196515,1,235099
22748,0.036352,172.217.194.0-255,2902,199417,1,235099
22749,0.036355,172.31.36.0-255,66,199483,1,235099
22750,0.038531,172.217.194.0-255,2902,202385,1,235099
22751,0.038536,172.31.36.0-255,66,202451,1,235099
22752,0.03857,172.217.194.0-255,2902,205353,1,235099
22753,0.038573,172.31.36.0-255,66,205419,1,235099
22754,0.0408,172.217.194.0-255,2902,208321,1,235099
22755,0.040809,172.31.36.0-255,66,208387,1,235099
22756,0.04084,172.217.194.0-255,2902,211289,1,235099
22757,0.040844,172.31.36.0-255,66,211355,1,235099
22758,0.04305,172.217.194.0-255,2902,214257,1,235099
22759,0.043057,172.31.36.0-255,66,214323,1,235099
22760,0.043104,172.217.194.0-255,2902,217225,1,235099
22761,0.043108,172.31.36.0-255,66,217291,1,235099
22762,0.045298,172.217.194.0-255,2902,220193,1,235099
22763,0.045305,172.31.36.0-255,66,220259,1,235099
22764,0.045345,172.217.194.0-255,2902,223161,1,235099
22765,0.045347,172.31.36.0-255,66,223227,1,235099
22766,0.047564,172.217.194.0-255,2902,226129,1,235099
22767,0.047569,172.31.36.0-255,66,226195,1,235099
22768,0.047606,172.217.194.0-255,2902,229097,1,235099
22769,0.047609,172.31.36.0-255,66,229163,1,235099
22770,0.04981,172.217.194.0-255,2902,232065,1,235099
22771,0.049815,172.31.36.0-255,66,232131,1,235099
22772,0.049849,172.217.194.0-255,2902,235033,1,235099
22773,0.049852,172.31.36.0-255,66,235099,1,235099
22774,0.0,74.125.68.0-255,153,153,1,371783
22775,2e-05,172.31.36.0-255,66,219,1,371783
22776,2.8e-05,74.125.68.0-255,1484,1703,1,371783
22777,3.2e-05,172.31.36.0-255,66,1769,1,371783
22778,3.8e-05,74.125.68.0-255,2902,4671,1,371783
22779,4.1e-05,172.31.36.0-255,66,4737,1,371783
22780,4.6e-05,74.125.68.0-255,4320,9057,1,371783
22781,4.9e-05,172.31.36.0-255,66,9123,1,371783
22782,6.8e-05,74.125.68.0-255,1484,10607,1,371783
22783,7e-05,172.31.36.0-255,66,10673,1,371783
22784,9.2e-05,74.125.68.0-255,3437,14110,1,371783
22785,9.5e-05,172.31.36.0-255,66,14176,1,371783
22786,0.000126,74.125.68.0-255,1484,15660,1,371783
22787,0.000129,172.31.36.0-255,66,15726,1,371783
22788,0.000145,74.125.68.0-255,2902,18628,1,371783
22789,0.000147,172.31.36.0-255,66,18694,1,371783
22790,0.000164,74.125.68.0-255,4320,23014,1,371783
22791,0.000167,172.31.36.0-255,66,23080,1,371783
22792,0.000189,74.125.68.0-255,1484,24564,1,371783
22793,0.000191,172.31.36.0-255,66,24630,1,371783
22794,0.000195,74.125.68.0-255,2902,27532,1,371783
22795,0.000197,172.31.36.0-255,66,27598,1,371783
22796,0.000229,74.125.68.0-255,3961,31559,1,371783
22797,0.000231,172.31.36.0-255,66,31625,1,371783
22798,0.000356,74.125.68.0-255,1484,33109,1,371783
22799,0.00036,172.31.36.0-255,66,33175,1,371783
22800,0.000366,74.125.68.0-255,2902,36077,1,371783
22801,0.000368,172.31.36.0-255,66,36143,1,371783
22802,0.000381,74.125.68.0-255,1484,37627,1,371783
22803,0.000383,172.31.36.0-255,66,37693,1,371783
22804,0.000407,74.125.68.0-255,1484,39177,1,371783
22805,0.000409,172.31.36.0-255,66,39243,1,371783
22806,0.000422,74.125.68.0-255,2902,42145,1,371783
22807,0.000425,172.31.36.0-255,66,42211,1,371783
22808,0.000445,74.125.68.0-255,1484,43695,1,371783
22809,0.000465,74.125.68.0-255,5379,49074,1,371783
22810,0.000468,172.31.36.0-255,66,49140,1,371783
22811,0.000491,74.125.68.0-255,4320,53460,1,371783
22812,0.000494,172.31.36.0-255,66,53526,1,371783
22813,0.000512,74.125.68.0-255,5738,59264,1,371783
22814,0.000515,172.31.36.0-255,66,59330,1,371783
22815,0.000549,74.125.68.0-255,6797,66127,1,371783
22816,0.000552,172.31.36.0-255,66,66193,1,371783
22817,0.00063,74.125.68.0-255,414,66607,1,371783
22818,0.000656,74.125.68.0-255,329,66936,1,371783
22819,0.000823,74.125.68.0-255,1484,68420,1,371783
22820,0.000827,172.31.36.0-255,66,68486,1,371783
22821,0.000843,74.125.68.0-255,2902,71388,1,371783
22822,0.000845,172.31.36.0-255,66,71454,1,371783
22823,0.000849,74.125.68.0-255,1484,72938,1,371783
22824,0.000883,74.125.68.0-255,4320,77258,1,371783
22825,0.000887,172.31.36.0-255,66,77324,1,371783
22826,0.000895,74.125.68.0-255,7156,84480,1,371783
22827,0.000898,172.31.36.0-255,66,84546,1,371783
22828,0.000914,74.125.68.0-255,5738,90284,1,371783
22829,0.000916,172.31.36.0-255,66,90350,1,371783
22830,0.000955,74.125.68.0-255,5738,96088,1,371783
22831,0.000959,172.31.36.0-255,66,96154,1,371783
22832,0.00098,74.125.68.0-255,5020,101174,1,371783
22833,0.000983,172.31.36.0-255,66,101240,1,371783
22834,0.001098,74.125.68.0-255,1484,102724,1,371783
22835,0.001117,74.125.68.0-255,2902,105626,1,371783
22836,0.00112,172.31.36.0-255,66,105692,1,371783
22837,0.001124,74.125.68.0-255,1484,107176,1,371783
22838,0.001144,74.125.68.0-255,4320,111496,1,371783
22839,0.001147,172.31.36.0-255,66,111562,1,371783
22840,0.001151,74.125.68.0-255,2902,114464,1,371783
22841,0.001154,172.31.36.0-255,66,114530,1,371783
22842,0.001158,74.125.68.0-255,4320,118850,1,371783
22843,0.001161,172.31.36.0-255,66,118916,1,371783
22844,0.001164,74.125.68.0-255,1484,120400,1,371783
22845,0.001189,74.125.68.0-255,7156,127556,1,371783
22846,0.001192,172.31.36.0-255,66,127622,1,371783
22847,0.001197,74.125.68.0-255,2902,130524,1,371783
22848,0.001199,172.31.36.0-255,66,130590,1,371783
22849,0.001213,74.125.68.0-255,2902,133492,1,371783
22850,0.001216,172.31.36.0-255,66,133558,1,371783
22851,0.001252,74.125.68.0-255,2184,135742,1,371783
22852,0.001255,172.31.36.0-255,66,135808,1,371783
22853,0.001277,74.125.68.0-255,2902,138710,1,371783
22854,0.00128,172.31.36.0-255,66,138776,1,371783
22855,0.001285,74.125.68.0-255,4320,143096,1,371783
22856,0.001287,172.31.36.0-255,66,143162,1,371783
22857,0.001304,74.125.68.0-255,2902,146064,1,371783
22858,0.001308,74.125.68.0-255,2902,148966,1,371783
22859,0.001312,172.31.36.0-255,66,149032,1,371783
22860,0.001319,172.31.36.0-255,66,149098,1,371783
22861,0.001359,74.125.68.0-255,4320,153418,1,371783
22862,0.001362,172.31.36.0-255,66,153484,1,371783
22863,0.001373,74.125.68.0-255,1484,154968,1,371783
22864,0.001428,74.125.68.0-255,5738,160706,1,371783
22865,0.001431,172.31.36.0-255,66,160772,1,371783
22866,0.00146,74.125.68.0-255,1484,162256,1,371783
22867,0.001471,172.31.36.0-255,66,162322,1,371783
22868,0.00151,74.125.68.0-255,1484,163806,1,371783
22869,0.001528,74.125.68.0-255,2902,166708,1,371783
22870,0.001531,172.31.36.0-255,66,166774,1,371783
22871,0.001553,74.125.68.0-255,1484,168258,1,371783
22872,0.001558,74.125.68.0-255,2902,171160,1,371783
22873,0.00156,172.31.36.0-255,66,171226,1,371783
22874,0.001597,74.125.68.0-255,2902,174128,1,371783
22875,0.0016,172.31.36.0-255,66,174194,1,371783
22876,0.001619,74.125.68.0-255,4320,178514,1,371783
22877,0.001622,172.31.36.0-255,66,178580,1,371783
22878,0.00165,74.125.68.0-255,4320,182900,1,371783
22879,0.001652,172.31.36.0-255,66,182966,1,371783
22880,0.001675,74.125.68.0-255,4320,187286,1,371783
22881,0.001678,172.31.36.0-255,66,187352,1,371783
22882,0.001682,74.125.68.0-255,2902,190254,1,371783
22883,0.001684,172.31.36.0-255,66,190320,1,371783
22884,0.00169,74.125.68.0-255,4320,194640,1,371783
22885,0.001692,172.31.36.0-255,66,194706,1,371783
22886,0.001714,74.125.68.0-255,2184,196890,1,371783
22887,0.001717,172.31.36.0-255,66,196956,1,371783
22888,0.001752,74.125.68.0-255,1484,198440,1,371783
22889,0.001768,74.125.68.0-255,2902,201342,1,371783
22890,0.001772,172.31.36.0-255,66,201408,1,371783
22891,0.001796,74.125.68.0-255,5738,207146,1,371783
22892,0.001799,172.31.36.0-255,66,207212,1,371783
22893,0.001802,74.125.68.0-255,1484,208696,1,371783
22894,0.001819,74.125.68.0-255,2902,211598,1,371783
22895,0.001822,172.31.36.0-255,66,211664,1,371783
22896,0.001826,74.125.68.0-255,1484,213148,1,371783
22897,0.001845,74.125.68.0-255,4320,217468,1,371783
22898,0.001847,172.31.36.0-255,66,217534,1,371783
22899,0.001851,74.125.68.0-255,1484,219018,1,371783
22900,0.001854,74.125.68.0-255,1484,220502,1,371783
22901,0.001855,172.31.36.0-255,66,220568,1,371783
22902,0.001869,74.125.68.0-255,1484,222052,1,371783
22903,0.001884,74.125.68.0-255,2902,224954,1,371783
22904,0.001887,172.31.36.0-255,66,225020,1,371783
22905,0.001911,74.125.68.0-255,2902,227922,1,371783
22906,0.001913,172.31.36.0-255,66,227988,1,371783
22907,0.001919,74.125.68.0-255,3602,231590,1,371783
22908,0.001921,172.31.36.0-255,66,231656,1,371783
22909,0.003914,74.125.68.0-255,5738,237394,1,371783
22910,0.003922,172.31.36.0-255,66,237460,1,371783
22911,0.005914,74.125.68.0-255,5738,243198,1,371783
22912,0.005918,172.31.36.0-255,66,243264,1,371783
22913,0.007897,74.125.68.0-255,4320,247584,1,371783
22914,0.007902,172.31.36.0-255,66,247650,1,371783
22915,0.00792,74.125.68.0-255,1484,249134,1,371783
22916,0.009903,74.125.68.0-255,4320,253454,1,371783
22917,0.009909,172.31.36.0-255,66,253520,1,371783
22918,0.011912,74.125.68.0-255,5738,259258,1,371783
22919,0.011921,172.31.36.0-255,66,259324,1,371783
22920,0.01391,74.125.68.0-255,5738,265062,1,371783
22921,0.013917,172.31.36.0-255,66,265128,1,371783
22922,0.015918,74.125.68.0-255,5738,270866,1,371783
22923,0.015926,172.31.36.0-255,66,270932,1,371783
22924,0.017923,74.125.68.0-255,5738,276670,1,371783
22925,0.017931,172.31.36.0-255,66,276736,1,371783
22926,0.01993,74.125.68.0-255,5738,282474,1,371783
22927,0.019937,172.31.36.0-255,66,282540,1,371783
22928,0.021947,74.125.68.0-255,5738,288278,1,371783
22929,0.021957,172.31.36.0-255,66,288344,1,371783
22930,0.023958,74.125.68.0-255,5738,294082,1,371783
22931,0.023966,172.31.36.0-255,66,294148,1,371783
22932,0.025962,74.125.68.0-255,5738,299886,1,371783
22933,0.025971,172.31.36.0-255,66,299952,1,371783
22934,0.027972,74.125.68.0-255,5738,305690,1,371783
22935,0.027978,172.31.36.0-255,66,305756,1,371783
22936,0.029973,74.125.68.0-255,5738,311494,1,371783
22937,0.029981,172.31.36.0-255,66,311560,1,371783
22938,0.031982,74.125.68.0-255,5738,317298,1,371783
22939,0.031989,172.31.36.0-255,66,317364,1,371783
22940,0.033988,74.125.68.0-255,5738,323102,1,371783
22941,0.033995,172.31.36.0-255,66,323168,1,371783
22942,0.03488,172.31.36.0-255,176,323344,1,371783
22943,0.03492,172.31.36.0-255,1115,324459,1,371783
22944,0.034994,172.31.36.0-255,1514,325973,1,371783
22945,0.034996,172.31.36.0-255,1514,327487,1,371783
22946,0.035001,172.31.36.0-255,1514,329001,1,371783
22947,0.035002,172.31.36.0-255,1514,330515,1,371783
22948,0.035024,172.31.36.0-255,1488,332003,1,371783
22949,0.036003,74.125.68.0-255,5738,337741,1,371783
22950,0.036009,172.31.36.0-255,66,337807,1,371783
22951,0.036432,104.244.42.0-255,66,337873,1,371783
22952,0.036459,104.244.42.0-255,66,337939,1,371783
22953,0.036598,104.244.42.0-255,66,338005,1,371783
22954,0.037777,104.244.42.0-255,108,338113,1,371783
22955,0.037786,172.31.36.0-255,66,338179,1,371783
22956,0.038046,74.125.68.0-255,5738,343917,1,371783
22957,0.03805,172.31.36.0-255,66,343983,1,371783
22958,0.040049,74.125.68.0-255,5738,349721,1,371783
22959,0.040055,172.31.36.0-255,66,349787,1,371783
22960,0.042055,74.125.68.0-255,4320,354107,1,371783
22961,0.042062,172.31.36.0-255,66,354173,1,371783
22962,0.042084,74.125.68.0-255,1484,355657,1,371783
22963,0.044066,74.125.68.0-255,4320,359977,1,371783
22964,0.044073,172.31.36.0-255,66,360043,1,371783
22965,0.046085,74.125.68.0-255,5738,365781,1,371783
22966,0.046091,172.31.36.0-255,66,365847,1,371783
22967,0.048095,74.125.68.0-255,2902,368749,1,371783
22968,0.048102,172.31.36.0-255,66,368815,1,371783
22969,0.048129,74.125.68.0-255,2902,371717,1,371783
22970,0.048132,172.31.36.0-255,66,371783,1,371783
22971,0.0,74.125.24.0-255,308,308,1,210336
22972,3.8e-05,172.31.36.0-255,66,374,1,210336
22973,4.4e-05,74.125.24.0-255,1484,1858,1,210336
22974,4.9e-05,172.31.36.0-255,66,1924,1,210336
22975,5.5e-05,74.125.24.0-255,4320,6244,1,210336
22976,6.5e-05,172.31.36.0-255,66,6310,1,210336
22977,7.8e-05,172.31.36.0-255,66,6376,1,210336
22978,0.000607,74.125.24.0-255,1484,7860,1,210336
22979,0.000613,172.31.36.0-255,66,7926,1,210336
22980,0.000621,74.125.24.0-255,2902,10828,1,210336
22981,0.000623,172.31.36.0-255,66,10894,1,210336
22982,0.000638,74.125.24.0-255,5738,16632,1,210336
22983,0.00064,172.31.36.0-255,66,16698,1,210336
22984,0.000668,74.125.24.0-255,4320,21018,1,210336
22985,0.000671,172.31.36.0-255,66,21084,1,210336
22986,0.000697,74.125.24.0-255,2543,23627,1,210336
22987,0.0007,172.31.36.0-255,66,23693,1,210336
22988,0.000708,74.125.24.0-255,7156,30849,1,210336
22989,0.000717,172.31.36.0-255,66,30915,1,210336
22990,0.000755,172.31.36.0-255,66,30981,1,210336
22991,0.000787,74.125.24.0-255,1125,32106,1,210336
22992,0.00079,172.31.36.0-255,66,32172,1,210336
22993,0.000822,74.125.24.0-255,1484,33656,1,210336
22994,0.000825,172.31.36.0-255,66,33722,1,210336
22995,0.00083,74.125.24.0-255,2902,36624,1,210336
22996,0.000831,172.31.36.0-255,66,36690,1,210336
22997,0.000835,74.125.24.0-255,1484,38174,1,210336
22998,0.000837,172.31.36.0-255,66,38240,1,210336
22999,0.000848,74.125.24.0-255,5738,43978,1,210336
23000,0.000851,172.31.36.0-255,66,44044,1,210336
23001,0.000887,74.125.24.0-255,5379,49423,1,210336
23002,0.001662,74.125.24.0-255,1484,50907,1,210336
23003,0.001669,74.125.24.0-255,2902,53809,1,210336
23004,0.001674,74.125.24.0-255,4320,58129,1,210336
23005,0.001693,74.125.24.0-255,4320,62449,1,210336
23006,0.001709,74.125.24.0-255,4269,66718,1,210336
23007,0.001728,74.125.24.0-255,2902,69620,1,210336
23008,0.001748,74.125.24.0-255,7156,76776,1,210336
23009,0.001759,74.125.24.0-255,4320,81096,1,210336
23010,0.001765,74.125.24.0-255,5738,86834,1,210336
23011,0.001801,74.125.24.0-255,3602,90436,1,210336
23012,0.009631,172.31.36.0-255,66,90502,1,210336
23013,0.011154,74.125.24.0-255,1484,91986,1,210336
23014,0.011724,74.125.24.0-255,4320,96306,1,210336
23015,0.011731,172.31.36.0-255,66,96372,1,210336
23016,0.013842,74.125.24.0-255,5738,102110,1,210336
23017,0.013909,172.31.36.0-255,66,102176,1,210336
23018,0.016017,74.125.24.0-255,5738,107914,1,210336
23019,0.016027,172.31.36.0-255,66,107980,1,210336
23020,0.018219,74.125.24.0-255,5738,113718,1,210336
23021,0.018226,172.31.36.0-255,66,113784,1,210336
23022,0.020322,74.125.24.0-255,5738,119522,1,210336
23023,0.020329,172.31.36.0-255,66,119588,1,210336
23024,0.022432,74.125.24.0-255,5738,125326,1,210336
23025,0.02244,172.31.36.0-255,66,125392,1,210336
23026,0.024529,74.125.24.0-255,5738,131130,1,210336
23027,0.024538,172.31.36.0-255,66,131196,1,210336
23028,0.026626,74.125.24.0-255,5738,136934,1,210336
23029,0.026634,172.31.36.0-255,66,137000,1,210336
23030,0.028718,74.125.24.0-255,5738,142738,1,210336
23031,0.028725,172.31.36.0-255,66,142804,1,210336
23032,0.030831,74.125.24.0-255,5738,148542,1,210336
23033,0.030841,172.31.36.0-255,66,148608,1,210336
23034,0.032195,172.31.36.0-255,172,148780,1,210336
23035,0.032251,172.31.36.0-255,1114,149894,1,210336
23036,0.032333,172.31.36.0-255,1514,151408,1,210336
23037,0.032336,172.31.36.0-255,1514,152922,1,210336
23038,0.032342,172.31.36.0-255,1514,154436,1,210336
23039,0.032343,172.31.36.0-255,1514,155950,1,210336
23040,0.032375,172.31.36.0-255,1490,157440,1,210336
23041,0.032946,74.125.24.0-255,5738,163178,1,210336
23042,0.032953,172.31.36.0-255,66,163244,1,210336
23043,0.033757,104.244.42.0-255,66,163310,1,210336
23044,0.033854,104.244.42.0-255,66,163376,1,210336
23045,0.033942,104.244.42.0-255,66,163442,1,210336
23046,0.03399,104.244.42.0-255,66,163508,1,210336
23047,0.035058,74.125.24.0-255,5738,169246,1,210336
23048,0.035063,172.31.36.0-255,66,169312,1,210336
23049,0.037159,74.125.24.0-255,5738,175050,1,210336
23050,0.037166,172.31.36.0-255,66,175116,1,210336
23051,0.039302,74.125.24.0-255,5738,180854,1,210336
23052,0.039308,172.31.36.0-255,66,180920,1,210336
23053,0.041409,74.125.24.0-255,5738,186658,1,210336
23054,0.041415,172.31.36.0-255,66,186724,1,210336
23055,0.043524,74.125.24.0-255,5738,192462,1,210336
23056,0.043529,172.31.36.0-255,66,192528,1,210336
23057,0.045636,74.125.24.0-255,2902,195430,1,210336
23058,0.045641,172.31.36.0-255,66,195496,1,210336
23059,0.045678,74.125.24.0-255,2902,198398,1,210336
23060,0.045693,172.31.36.0-255,66,198464,1,210336
23061,0.047735,74.125.24.0-255,2902,201366,1,210336
23062,0.047741,172.31.36.0-255,66,201432,1,210336
23063,0.047788,74.125.24.0-255,2902,204334,1,210336
23064,0.047796,172.31.36.0-255,66,204400,1,210336
23065,0.049806,74.125.24.0-255,2902,207302,1,210336
23066,0.049812,172.31.36.0-255,66,207368,1,210336
23067,0.049876,74.125.24.0-255,2902,210270,1,210336
23068,0.049882,172.31.36.0-255,66,210336,1,210336
23069,0.0,74.125.68.0-255,146,146,1,336701
23070,2.9e-05,172.31.36.0-255,66,212,1,336701
23071,3.6e-05,74.125.68.0-255,1484,1696,1,336701
23072,4.1e-05,172.31.36.0-255,66,1762,1,336701
23073,4.7e-05,74.125.68.0-255,2902,4664,1,336701
23074,5e-05,172.31.36.0-255,66,4730,1,336701
23075,5.6e-05,74.125.68.0-255,5738,10468,1,336701
23076,5.9e-05,172.31.36.0-255,66,10534,1,336701
23077,0.000108,74.125.68.0-255,3483,14017,1,336701
23078,0.000111,172.31.36.0-255,66,14083,1,336701
23079,0.000116,74.125.68.0-255,4320,18403,1,336701
23080,0.000119,172.31.36.0-255,66,18469,1,336701
23081,0.00013,172.31.36.0-255,66,18535,1,336701
23082,0.000134,74.125.68.0-255,2543,21078,1,336701
23083,0.000136,172.31.36.0-255,66,21144,1,336701
23084,0.000227,74.125.68.0-255,1484,22628,1,336701
23085,0.000233,172.31.36.0-255,66,22694,1,336701
23086,0.000236,74.125.68.0-255,1484,24178,1,336701
23087,0.000239,172.31.36.0-255,66,24244,1,336701
23088,0.000251,74.125.68.0-255,1484,25728,1,336701
23089,0.000254,172.31.36.0-255,66,25794,1,336701
23090,0.000259,74.125.68.0-255,2902,28696,1,336701
23091,0.000262,172.31.36.0-255,66,28762,1,336701
23092,0.000291,74.125.68.0-255,2902,31664,1,336701
23093,0.000294,172.31.36.0-255,66,31730,1,336701
23094,0.0003,74.125.68.0-255,5738,37468,1,336701
23095,0.000303,172.31.36.0-255,66,37534,1,336701
23096,0.00031,74.125.68.0-255,7156,44690,1,336701
23097,0.000313,172.31.36.0-255,66,44756,1,336701
23098,0.00034,74.125.68.0-255,5738,50494,1,336701
23099,0.000344,172.31.36.0-255,66,50560,1,336701
23100,0.000366,74.125.68.0-255,5020,55580,1,336701
23101,0.000369,172.31.36.0-255,66,55646,1,336701
23102,0.000372,74.125.68.0-255,426,56072,1,336701
23103,0.00043,74.125.68.0-255,348,56420,1,336701
23104,0.000508,74.125.68.0-255,1484,57904,1,336701
23105,0.000512,172.31.36.0-255,66,57970,1,336701
23106,0.000517,74.125.68.0-255,2902,60872,1,336701
23107,0.00052,172.31.36.0-255,66,60938,1,336701
23108,0.000547,74.125.68.0-255,1484,62422,1,336701
23109,0.000553,74.125.68.0-255,2902,65324,1,336701
23110,0.000556,172.31.36.0-255,66,65390,1,336701
23111,0.000564,74.125.68.0-255,5738,71128,1,336701
23112,0.000566,172.31.36.0-255,66,71194,1,336701
23113,0.000585,74.125.68.0-255,1994,73188,1,336701
23114,0.000589,172.31.36.0-255,66,73254,1,336701
23115,0.00099,74.125.68.0-255,1484,74738,1,336701
23116,0.001012,74.125.68.0-255,2902,77640,1,336701
23117,0.001015,172.31.36.0-255,66,77706,1,336701
23118,0.001034,74.125.68.0-255,1484,79190,1,336701
23119,0.001052,74.125.68.0-255,4320,83510,1,336701
23120,0.001055,172.31.36.0-255,66,83576,1,336701
23121,0.001075,74.125.68.0-255,4320,87896,1,336701
23122,0.001079,172.31.36.0-255,66,87962,1,336701
23123,0.0011,74.125.68.0-255,2902,90864,1,336701
23124,0.001103,172.31.36.0-255,66,90930,1,336701
23125,0.001108,74.125.68.0-255,4320,95250,1,336701
23126,0.00111,172.31.36.0-255,66,95316,1,336701
23127,0.001114,74.125.68.0-255,1484,96800,1,336701
23128,0.001129,74.125.68.0-255,4320,101120,1,336701
23129,0.001132,172.31.36.0-255,66,101186,1,336701
23130,0.001153,74.125.68.0-255,4320,105506,1,336701
23131,0.001156,172.31.36.0-255,66,105572,1,336701
23132,0.001197,74.125.68.0-255,2184,107756,1,336701
23133,0.0012,172.31.36.0-255,66,107822,1,336701
23134,0.001246,74.125.68.0-255,1484,109306,1,336701
23135,0.001271,74.125.68.0-255,2902,112208,1,336701
23136,0.001274,172.31.36.0-255,66,112274,1,336701
23137,0.001307,74.125.68.0-255,5738,118012,1,336701
23138,0.00131,172.31.36.0-255,66,118078,1,336701
23139,0.001314,74.125.68.0-255,2902,120980,1,336701
23140,0.001317,172.31.36.0-255,66,121046,1,336701
23141,0.001344,172.31.36.0-255,66,121112,1,336701
23142,0.00137,74.125.68.0-255,1484,122596,1,336701
23143,0.001376,74.125.68.0-255,4320,126916,1,336701
23144,0.001379,172.31.36.0-255,66,126982,1,336701
23145,0.001385,74.125.68.0-255,5738,132720,1,336701
23146,0.001387,172.31.36.0-255,66,132786,1,336701
23147,0.00139,74.125.68.0-255,766,133552,1,336701
23148,0.001531,74.125.68.0-255,1484,135036,1,336701
23149,0.001536,172.31.36.0-255,66,135102,1,336701
23150,0.001549,74.125.68.0-255,2902,138004,1,336701
23151,0.001552,172.31.36.0-255,66,138070,1,336701
23152,0.001575,74.125.68.0-255,4320,142390,1,336701
23153,0.001577,172.31.36.0-255,66,142456,1,336701
23154,0.001582,74.125.68.0-255,2902,145358,1,336701
23155,0.001584,172.31.36.0-255,66,145424,1,336701
23156,0.001603,74.125.68.0-255,5738,151162,1,336701
23157,0.001606,172.31.36.0-255,66,151228,1,336701
23158,0.001611,74.125.68.0-255,5738,156966,1,336701
23159,0.001614,172.31.36.0-255,66,157032,1,336701
23160,0.001618,74.125.68.0-255,2902,159934,1,336701
23161,0.00162,172.31.36.0-255,66,160000,1,336701
23162,0.001635,74.125.68.0-255,4320,164320,1,336701
23163,0.001638,172.31.36.0-255,66,164386,1,336701
23164,0.00166,74.125.68.0-255,3602,167988,1,336701
23165,0.001663,172.31.36.0-255,66,168054,1,336701
23166,0.001806,74.125.68.0-255,1484,169538,1,336701
23167,0.001824,74.125.68.0-255,1484,171022,1,336701
23168,0.001828,172.31.36.0-255,66,171088,1,336701
23169,0.001836,74.125.68.0-255,1484,172572,1,336701
23170,0.001862,74.125.68.0-255,5738,178310,1,336701
23171,0.001865,172.31.36.0-255,66,178376,1,336701
23172,0.001924,74.125.68.0-255,7156,185532,1,336701
23173,0.001929,172.31.36.0-255,66,185598,1,336701
23174,0.001933,74.125.68.0-255,2902,188500,1,336701
23175,0.001935,172.31.36.0-255,66,188566,1,336701
23176,0.00194,74.125.68.0-255,4320,192886,1,336701
23177,0.001942,172.31.36.0-255,66,192952,1,336701
23178,0.001945,74.125.68.0-255,1484,194436,1,336701
23179,0.001962,74.125.68.0-255,7156,201592,1,336701
23180,0.001966,172.31.36.0-255,66,201658,1,336701
23181,0.001997,74.125.68.0-255,766,202424,1,336701
23182,0.00212,172.31.36.0-255,66,202490,1,336701
23183,0.004038,74.125.68.0-255,1484,203974,1,336701
23184,0.004055,74.125.68.0-255,2902,206876,1,336701
23185,0.004059,172.31.36.0-255,66,206942,1,336701
23186,0.004196,74.125.68.0-255,1484,208426,1,336701
23187,0.00613,74.125.68.0-255,4320,212746,1,336701
23188,0.006134,172.31.36.0-255,66,212812,1,336701
23189,0.008219,74.125.68.0-255,5738,218550,1,336701
23190,0.008226,172.31.36.0-255,66,218616,1,336701
23191,0.01031,74.125.68.0-255,5738,224354,1,336701
23192,0.010318,172.31.36.0-255,66,224420,1,336701
23193,0.012391,74.125.68.0-255,5738,230158,1,336701
23194,0.012398,172.31.36.0-255,66,230224,1,336701
23195,0.014487,74.125.68.0-255,5738,235962,1,336701
23196,0.014495,172.31.36.0-255,66,236028,1,336701
23197,0.016575,74.125.68.0-255,5738,241766,1,336701
23198,0.016583,172.31.36.0-255,66,241832,1,336701
23199,0.018663,74.125.68.0-255,5738,247570,1,336701
23200,0.018669,172.31.36.0-255,66,247636,1,336701
23201,0.020756,74.125.68.0-255,5738,253374,1,336701
23202,0.020764,172.31.36.0-255,66,253440,1,336701
23203,0.022857,74.125.68.0-255,5738,259178,1,336701
23204,0.022865,172.31.36.0-255,66,259244,1,336701
23205,0.024949,74.125.68.0-255,5738,264982,1,336701
23206,0.024959,172.31.36.0-255,66,265048,1,336701
23207,0.027049,74.125.68.0-255,5738,270786,1,336701
23208,0.027059,172.31.36.0-255,66,270852,1,336701
23209,0.029152,74.125.68.0-255,5738,276590,1,336701
23210,0.029164,172.31.36.0-255,66,276656,1,336701
23211,0.031243,74.125.68.0-255,5738,282394,1,336701
23212,0.031255,172.31.36.0-255,66,282460,1,336701
23213,0.033352,74.125.68.0-255,5738,288198,1,336701
23214,0.033365,172.31.36.0-255,66,288264,1,336701
23215,0.035459,74.125.68.0-255,5738,294002,1,336701
23216,0.035467,172.31.36.0-255,66,294068,1,336701
23217,0.035816,172.31.36.0-255,172,294240,1,336701
23218,0.035862,172.31.36.0-255,1115,295355,1,336701
23219,0.035949,172.31.36.0-255,1514,296869,1,336701
23220,0.035951,172.31.36.0-255,1514,298383,1,336701
23221,0.035956,172.31.36.0-255,1514,299897,1,336701
23222,0.035957,172.31.36.0-255,1514,301411,1,336701
23223,0.035979,172.31.36.0-255,1488,302899,1,336701
23224,0.037382,104.244.42.0-255,66,302965,1,336701
23225,0.037401,104.244.42.0-255,66,303031,1,336701
23226,0.037516,104.244.42.0-255,66,303097,1,336701
23227,0.037548,74.125.68.0-255,4320,307417,1,336701
23228,0.037557,172.31.36.0-255,66,307483,1,336701
23229,0.037582,104.244.42.0-255,66,307549,1,336701
23230,0.037586,74.125.68.0-255,1484,309033,1,336701
23231,0.039649,74.125.68.0-255,4320,313353,1,336701
23232,0.039656,172.31.36.0-255,66,313419,1,336701
23233,0.041741,74.125.68.0-255,5738,319157,1,336701
23234,0.041747,172.31.36.0-255,66,319223,1,336701
23235,0.043832,74.125.68.0-255,1484,320707,1,336701
23236,0.043868,74.125.68.0-255,4320,325027,1,336701
23237,0.043873,172.31.36.0-255,66,325093,1,336701
23238,0.045949,74.125.68.0-255,5738,330831,1,336701
23239,0.045955,172.31.36.0-255,66,330897,1,336701
23240,0.048034,74.125.68.0-255,5738,336635,1,336701
23241,0.048039,172.31.36.0-255,66,336701,1,336701
23242,0.0,74.125.24.0-255,153,153,1,239222
23243,2.1e-05,172.31.36.0-255,66,219,1,239222
23244,2.8e-05,74.125.24.0-255,1484,1703,1,239222
23245,3.2e-05,172.31.36.0-255,66,1769,1,239222
23246,3.7e-05,74.125.24.0-255,2902,4671,1,239222
23247,3.9e-05,172.31.36.0-255,66,4737,1,239222
23248,5.4e-05,74.125.24.0-255,7156,11893,1,239222
23249,5.7e-05,172.31.36.0-255,66,11959,1,239222
23250,6.2e-05,74.125.24.0-255,3474,15433,1,239222
23251,6.4e-05,172.31.36.0-255,66,15499,1,239222
23252,7e-05,74.125.24.0-255,4320,19819,1,239222
23253,7.2e-05,172.31.36.0-255,66,19885,1,239222
23254,9.7e-05,172.31.36.0-255,66,19951,1,239222
23255,0.000104,74.125.24.0-255,1125,21076,1,239222
23256,0.000106,172.31.36.0-255,66,21142,1,239222
23257,0.000298,74.125.24.0-255,1484,22626,1,239222
23258,0.000302,172.31.36.0-255,66,22692,1,239222
23259,0.000307,74.125.24.0-255,2902,25594,1,239222
23260,0.000309,172.31.36.0-255,66,25660,1,239222
23261,0.000337,74.125.24.0-255,5738,31398,1,239222
23262,0.000339,172.31.36.0-255,66,31464,1,239222
23263,0.000402,172.31.36.0-255,66,31530,1,239222
23264,0.000412,172.31.36.0-255,66,31596,1,239222
23265,0.000439,74.125.24.0-255,3602,35198,1,239222
23266,0.000441,172.31.36.0-255,66,35264,1,239222
23267,0.000464,74.125.24.0-255,676,35940,1,239222
23268,0.000466,172.31.36.0-255,66,36006,1,239222
23269,0.001102,74.125.24.0-255,1484,37490,1,239222
23270,0.001108,172.31.36.0-255,66,37556,1,239222
23271,0.001116,74.125.24.0-255,1484,39040,1,239222
23272,0.001133,74.125.24.0-255,1484,40524,1,239222
23273,0.001135,172.31.36.0-255,66,40590,1,239222
23274,0.001141,74.125.24.0-255,4320,44910,1,239222
23275,0.001143,172.31.36.0-255,66,44976,1,239222
23276,0.001171,74.125.24.0-255,1484,46460,1,239222
23277,0.001178,74.125.24.0-255,7156,53616,1,239222
23278,0.00118,172.31.36.0-255,66,53682,1,239222
23279,0.001193,74.125.24.0-255,5738,59420,1,239222
23280,0.001199,172.31.36.0-255,66,59486,1,239222
23281,0.001204,74.125.24.0-255,4320,63806,1,239222
23282,0.001206,172.31.36.0-255,66,63872,1,239222
23283,0.001245,74.125.24.0-255,6438,70310,1,239222
23284,0.001248,172.31.36.0-255,66,70376,1,239222
23285,0.00182,74.125.24.0-255,1484,71860,1,239222
23286,0.001829,74.125.24.0-255,2902,74762,1,239222
23287,0.001833,172.31.36.0-255,66,74828,1,239222
23288,0.001841,74.125.24.0-255,5738,80566,1,239222
23289,0.001843,172.31.36.0-255,66,80632,1,239222
23290,0.001884,172.31.36.0-255,66,80698,1,239222
23291,0.001891,74.125.24.0-255,7156,87854,1,239222
23292,0.001894,172.31.36.0-255,66,87920,1,239222
23293,0.001915,74.125.24.0-255,1484,89404,1,239222
23294,0.001945,74.125.24.0-255,2902,92306,1,239222
23295,0.001948,172.31.36.0-255,66,92372,1,239222
23296,0.001984,172.31.36.0-255,66,92438,1,239222
23297,0.002049,172.31.36.0-255,66,92504,1,239222
23298,0.002054,74.125.24.0-255,4320,96824,1,239222
23299,0.002056,172.31.36.0-255,66,96890,1,239222
23300,0.002059,74.125.24.0-255,766,97656,1,239222
23301,0.002195,74.125.24.0-255,1484,99140,1,239222
23302,0.002198,172.31.36.0-255,66,99206,1,239222
23303,0.00222,74.125.24.0-255,2902,102108,1,239222
23304,0.002223,172.31.36.0-255,66,102174,1,239222
23305,0.002227,74.125.24.0-255,1484,103658,1,239222
23306,0.002251,74.125.24.0-255,1484,105142,1,239222
23307,0.002254,172.31.36.0-255,66,105208,1,239222
23308,0.002272,74.125.24.0-255,4320,109528,1,239222
23309,0.002275,172.31.36.0-255,66,109594,1,239222
23310,0.002278,74.125.24.0-255,1484,111078,1,239222
23311,0.004487,74.125.24.0-255,4320,115398,1,239222
23312,0.004493,172.31.36.0-255,66,115464,1,239222
23313,0.006772,74.125.24.0-255,5738,121202,1,239222
23314,0.006778,172.31.36.0-255,66,121268,1,239222
23315,0.008995,74.125.24.0-255,5738,127006,1,239222
23316,0.009002,172.31.36.0-255,66,127072,1,239222
23317,0.011253,74.125.24.0-255,5738,132810,1,239222
23318,0.011261,172.31.36.0-255,66,132876,1,239222
23319,0.0135,74.125.24.0-255,5738,138614,1,239222
23320,0.013509,172.31.36.0-255,66,138680,1,239222
23321,0.01573,74.125.24.0-255,5738,144418,1,239222
23322,0.01574,172.31.36.0-255,66,144484,1,239222
23323,0.017979,74.125.24.0-255,5738,150222,1,239222
23324,0.017987,172.31.36.0-255,66,150288,1,239222
23325,0.020206,74.125.24.0-255,5738,156026,1,239222
23326,0.020214,172.31.36.0-255,66,156092,1,239222
23327,0.022434,74.125.24.0-255,5738,161830,1,239222
23328,0.022443,172.31.36.0-255,66,161896,1,239222
23329,0.024653,74.125.24.0-255,5738,167634,1,239222
23330,0.02466,172.31.36.0-255,66,167700,1,239222
23331,0.02688,74.125.24.0-255,5738,173438,1,239222
23332,0.026888,172.31.36.0-255,66,173504,1,239222
23333,0.029135,74.125.24.0-255,5738,179242,1,239222
23334,0.029141,172.31.36.0-255,66,179308,1,239222
23335,0.031348,74.125.24.0-255,5738,185046,1,239222
23336,0.031355,172.31.36.0-255,66,185112,1,239222
23337,0.033593,74.125.24.0-255,5738,190850,1,239222
23338,0.033602,172.31.36.0-255,66,190916,1,239222
23339,0.035828,74.125.24.0-255,5738,196654,1,239222
23340,0.035837,172.31.36.0-255,66,196720,1,239222
23341,0.038099,74.125.24.0-255,5738,202458,1,239222
23342,0.038108,172.31.36.0-255,66,202524,1,239222
23343,0.040321,74.125.24.0-255,4320,206844,1,239222
23344,0.040329,172.31.36.0-255,66,206910,1,239222
23345,0.040366,74.125.24.0-255,1484,208394,1,239222
23346,0.040526,172.31.36.0-255,172,208566,1,239222
23347,0.040563,172.31.36.0-255,1115,209681,1,239222
23348,0.040635,172.31.36.0-255,1514,211195,1,239222
23349,0.040637,172.31.36.0-255,1514,212709,1,239222
23350,0.040638,172.31.36.0-255,1514,214223,1,239222
23351,0.040643,172.31.36.0-255,1514,215737,1,239222
23352,0.040644,172.31.36.0-255,1489,217226,1,239222
23353,0.042091,104.244.42.0-255,66,217292,1,239222
23354,0.042106,104.244.42.0-255,66,217358,1,239222
23355,0.04224,104.244.42.0-255,66,217424,1,239222
23356,0.042531,74.125.24.0-255,4320,221744,1,239222
23357,0.042536,172.31.36.0-255,66,221810,1,239222
23358,0.044746,74.125.24.0-255,5738,227548,1,239222
23359,0.044752,172.31.36.0-255,66,227614,1,239222
23360,0.046987,74.125.24.0-255,5738,233352,1,239222
23361,0.046993,172.31.36.0-255,66,233418,1,239222
23362,0.049248,74.125.24.0-255,5738,239156,1,239222
23363,0.049255,172.31.36.0-255,66,239222,1,239222
23364,0.0,74.125.24.0-255,152,152,1,237338
23365,3.2e-05,172.31.36.0-255,66,218,1,237338
23366,3.8e-05,74.125.24.0-255,1484,1702,1,237338
23367,4.2e-05,172.31.36.0-255,66,1768,1,237338
23368,4.7e-05,74.125.24.0-255,2902,4670,1,237338
23369,4.9e-05,172.31.36.0-255,66,4736,1,237338
23370,5.5e-05,74.125.24.0-255,7156,11892,1,237338
23371,5.7e-05,172.31.36.0-255,66,11958,1,237338
23372,8.8e-05,74.125.24.0-255,1992,13950,1,237338
23373,9e-05,172.31.36.0-255,66,14016,1,237338
23374,0.000118,74.125.24.0-255,2902,16918,1,237338
23375,0.000121,172.31.36.0-255,66,16984,1,237338
23376,0.000136,74.125.24.0-255,1484,18468,1,237338
23377,0.000138,172.31.36.0-255,66,18534,1,237338
23378,0.000153,74.125.24.0-255,5738,24272,1,237338
23379,0.000156,172.31.36.0-255,66,24338,1,237338
23380,0.00019,74.125.24.0-255,1484,25822,1,237338
23381,0.000193,172.31.36.0-255,66,25888,1,237338
23382,0.00021,74.125.24.0-255,5379,31267,1,237338
23383,0.000213,172.31.36.0-255,66,31333,1,237338
23384,0.000253,74.125.24.0-255,1484,32817,1,237338
23385,0.000256,172.31.36.0-255,66,32883,1,237338
23386,0.000261,74.125.24.0-255,2902,35785,1,237338
23387,0.000264,172.31.36.0-255,66,35851,1,237338
23388,0.000266,74.125.24.0-255,1484,37335,1,237338
23389,0.000268,172.31.36.0-255,66,37401,1,237338
23390,0.000298,74.125.24.0-255,4320,41721,1,237338
23391,0.000301,172.31.36.0-255,66,41787,1,237338
23392,0.000306,74.125.24.0-255,2902,44689,1,237338
23393,0.000308,172.31.36.0-255,66,44755,1,237338
23394,0.000312,74.125.24.0-255,3961,48716,1,237338
23395,0.000314,172.31.36.0-255,66,48782,1,237338
23396,0.000369,74.125.24.0-255,1484,50266,1,237338
23397,0.000389,74.125.24.0-255,2902,53168,1,237338
23398,0.000392,172.31.36.0-255,66,53234,1,237338
23399,0.000398,74.125.24.0-255,2902,56136,1,237338
23400,0.0004,172.31.36.0-255,66,56202,1,237338
23401,0.000425,74.125.24.0-255,2902,59104,1,237338
23402,0.000433,172.31.36.0-255,66,59170,1,237338
23403,0.000466,74.125.24.0-255,6797,65967,1,237338
23404,0.000469,172.31.36.0-255,66,66033,1,237338
23405,0.001098,74.125.24.0-255,646,66679,1,237338
23406,0.001135,172.31.36.0-255,66,66745,1,237338
23407,0.001404,74.125.24.0-255,1484,68229,1,237338
23408,0.001414,74.125.24.0-255,2902,71131,1,237338
23409,0.001418,172.31.36.0-255,66,71197,1,237338
23410,0.001425,74.125.24.0-255,5738,76935,1,237338
23411,0.001428,172.31.36.0-255,66,77001,1,237338
23412,0.001432,74.125.24.0-255,2902,79903,1,237338
23413,0.001434,172.31.36.0-255,66,79969,1,237338
23414,0.001461,74.125.24.0-255,7156,87125,1,237338
23415,0.001463,172.31.36.0-255,66,87191,1,237338
23416,0.001474,172.31.36.0-255,66,87257,1,237338
23417,0.001478,74.125.24.0-255,2184,89441,1,237338
23418,0.00148,172.31.36.0-255,66,89507,1,237338
23419,0.003444,74.125.24.0-255,5738,95245,1,237338
23420,0.003448,172.31.36.0-255,66,95311,1,237338
23421,0.005465,74.125.24.0-255,5738,101049,1,237338
23422,0.00547,172.31.36.0-255,66,101115,1,237338
23423,0.00743,74.125.24.0-255,5738,106853,1,237338
23424,0.007437,172.31.36.0-255,66,106919,1,237338
23425,0.009449,74.125.24.0-255,5738,112657,1,237338
23426,0.009457,172.31.36.0-255,66,112723,1,237338
23427,0.011449,74.125.24.0-255,5738,118461,1,237338
23428,0.011459,172.31.36.0-255,66,118527,1,237338
23429,0.013448,74.125.24.0-255,5738,124265,1,237338
23430,0.013459,172.31.36.0-255,66,124331,1,237338
23431,0.01544,74.125.24.0-255,4320,128651,1,237338
23432,0.015448,172.31.36.0-255,66,128717,1,237338
23433,0.015473,74.125.24.0-255,1484,130201,1,237338
23434,0.017399,74.125.24.0-255,4320,134521,1,237338
23435,0.017406,172.31.36.0-255,66,134587,1,237338
23436,0.019405,74.125.24.0-255,5738,140325,1,237338
23437,0.019415,172.31.36.0-255,66,140391,1,237338
23438,0.021385,74.125.24.0-255,5738,146129,1,237338
23439,0.021396,172.31.36.0-255,66,146195,1,237338
23440,0.023371,74.125.24.0-255,5738,151933,1,237338
23441,0.023378,172.31.36.0-255,66,151999,1,237338
23442,0.025328,74.125.24.0-255,5738,157737,1,237338
23443,0.025334,172.31.36.0-255,66,157803,1,237338
23444,0.02732,74.125.24.0-255,5738,163541,1,237338
23445,0.027329,172.31.36.0-255,66,163607,1,237338
23446,0.028179,172.31.36.0-255,172,163779,1,237338
23447,0.028223,172.31.36.0-255,1113,164892,1,237338
23448,0.028298,172.31.36.0-255,1514,166406,1,237338
23449,0.0283,172.31.36.0-255,1514,167920,1,237338
23450,0.028305,172.31.36.0-255,1514,169434,1,237338
23451,0.028306,172.31.36.0-255,1514,170948,1,237338
23452,0.028333,172.31.36.0-255,1490,172438,1,237338
23453,0.029285,74.125.24.0-255,5738,178176,1,237338
23454,0.029292,172.31.36.0-255,66,178242,1,237338
23455,0.029725,104.244.42.0-255,66,178308,1,237338
23456,0.029767,104.244.42.0-255,66,178374,1,237338
23457,0.029874,104.244.42.0-255,66,178440,1,237338
23458,0.031301,74.125.24.0-255,5738,184178,1,237338
23459,0.031307,172.31.36.0-255,66,184244,1,237338
23460,0.03327,74.125.24.0-255,5738,189982,1,237338
23461,0.033275,172.31.36.0-255,66,190048,1,237338
23462,0.035234,74.125.24.0-255,5738,195786,1,237338
23463,0.035239,172.31.36.0-255,66,195852,1,237338
23464,0.037232,74.125.24.0-255,2902,198754,1,237338
23465,0.037237,172.31.36.0-255,66,198820,1,237338
23466,0.037268,74.125.24.0-255,2902,201722,1,237338
23467,0.037271,172.31.36.0-255,66,201788,1,237338
23468,0.039231,74.125.24.0-255,2902,204690,1,237338
23469,0.039236,172.31.36.0-255,66,204756,1,237338
23470,0.039266,74.125.24.0-255,2902,207658,1,237338
23471,0.03927,172.31.36.0-255,66,207724,1,237338
23472,0.041197,74.125.24.0-255,2902,210626,1,237338
23473,0.041202,172.31.36.0-255,66,210692,1,237338
23474,0.041228,74.125.24.0-255,2902,213594,1,237338
23475,0.041231,172.31.36.0-255,66,213660,1,237338
23476,0.043174,74.125.24.0-255,2902,216562,1,237338
23477,0.04318,172.31.36.0-255,66,216628,1,237338
23478,0.043215,74.125.24.0-255,2902,219530,1,237338
23479,0.043217,172.31.36.0-255,66,219596,1,237338
23480,0.045132,74.125.24.0-255,2902,222498,1,237338
23481,0.045137,172.31.36.0-255,66,222564,1,237338
23482,0.045172,74.125.24.0-255,2902,225466,1,237338
23483,0.045175,172.31.36.0-255,66,225532,1,237338
23484,0.047111,74.125.24.0-255,2902,228434,1,237338
23485,0.047115,172.31.36.0-255,66,228500,1,237338
23486,0.047144,74.125.24.0-255,2902,231402,1,237338
23487,0.047147,172.31.36.0-255,66,231468,1,237338
23488,0.04912,74.125.24.0-255,1484,232952,1,237338
23489,0.049151,74.125.24.0-255,4320,237272,1,237338
23490,0.049155,172.31.36.0-255,66,237338,1,237338
23491,0.0,74.125.200.0-255,152,152,1,210302
23492,3.4e-05,172.31.36.0-255,66,218,1,210302
23493,4.1e-05,74.125.200.0-255,1484,1702,1,210302
23494,4.6e-05,172.31.36.0-255,66,1768,1,210302
23495,5.2e-05,74.125.200.0-255,2902,4670,1,210302
23496,6.5e-05,172.31.36.0-255,66,4736,1,210302
23497,7e-05,74.125.200.0-255,5738,10474,1,210302
23498,7.4e-05,172.31.36.0-255,66,10540,1,210302
23499,7.7e-05,74.125.200.0-255,1484,12024,1,210302
23500,7.9e-05,172.31.36.0-255,66,12090,1,210302
23501,0.000122,172.31.36.0-255,66,12156,1,210302
23502,0.000135,172.31.36.0-255,66,12222,1,210302
23503,0.000138,74.125.200.0-255,1125,13347,1,210302
23504,0.00014,172.31.36.0-255,66,13413,1,210302
23505,0.000253,74.125.200.0-255,1484,14897,1,210302
23506,0.000259,172.31.36.0-255,66,14963,1,210302
23507,0.000265,74.125.200.0-255,2902,17865,1,210302
23508,0.000267,172.31.36.0-255,66,17931,1,210302
23509,0.000296,74.125.200.0-255,1484,19415,1,210302
23510,0.000301,74.125.200.0-255,2902,22317,1,210302
23511,0.000303,172.31.36.0-255,66,22383,1,210302
23512,0.000306,172.31.36.0-255,66,22449,1,210302
23513,0.000337,74.125.200.0-255,5738,28187,1,210302
23514,0.000342,172.31.36.0-255,66,28253,1,210302
23515,0.000347,74.125.200.0-255,2543,30796,1,210302
23516,0.000349,172.31.36.0-255,66,30862,1,210302
23517,0.000658,74.125.200.0-255,1484,32346,1,210302
23518,0.000662,172.31.36.0-255,66,32412,1,210302
23519,0.000697,74.125.200.0-255,2902,35314,1,210302
23520,0.000701,172.31.36.0-255,66,35380,1,210302
23521,0.000705,74.125.200.0-255,1484,36864,1,210302
23522,0.000712,74.125.200.0-255,2902,39766,1,210302
23523,0.000721,172.31.36.0-255,66,39832,1,210302
23524,0.000751,74.125.200.0-255,4320,44152,1,210302
23525,0.000755,172.31.36.0-255,66,44218,1,210302
23526,0.0008,74.125.200.0-255,4306,48524,1,210302
23527,0.000805,172.31.36.0-255,66,48590,1,210302
23528,0.000877,74.125.200.0-255,333,48923,1,210302
23529,0.000897,172.31.36.0-255,66,48989,1,210302
23530,0.000922,74.125.200.0-255,1484,50473,1,210302
23531,0.000932,74.125.200.0-255,1484,51957,1,210302
23532,0.000935,172.31.36.0-255,66,52023,1,210302
23533,0.000941,74.125.200.0-255,2902,54925,1,210302
23534,0.000944,172.31.36.0-255,66,54991,1,210302
23535,0.000967,74.125.200.0-255,5738,60729,1,210302
23536,0.00097,172.31.36.0-255,66,60795,1,210302
23537,0.001011,172.31.36.0-255,66,60861,1,210302
23538,0.001046,74.125.200.0-255,5738,66599,1,210302
23539,0.00105,172.31.36.0-255,66,66665,1,210302
23540,0.001077,74.125.200.0-255,3602,70267,1,210302
23541,0.00108,172.31.36.0-255,66,70333,1,210302
23542,0.001812,74.125.200.0-255,1484,71817,1,210302
23543,0.001826,74.125.200.0-255,2902,74719,1,210302
23544,0.00183,172.31.36.0-255,66,74785,1,210302
23545,0.001835,74.125.200.0-255,1484,76269,1,210302
23546,0.001859,74.125.200.0-255,2902,79171,1,210302
23547,0.001862,172.31.36.0-255,66,79237,1,210302
23548,0.001869,74.125.200.0-255,5738,84975,1,210302
23549,0.001872,172.31.36.0-255,66,85041,1,210302
23550,0.001917,172.31.36.0-255,66,85107,1,210302
23551,0.001924,74.125.200.0-255,5738,90845,1,210302
23552,0.001926,172.31.36.0-255,66,90911,1,210302
23553,0.001983,74.125.200.0-255,2184,93095,1,210302
23554,0.001986,172.31.36.0-255,66,93161,1,210302
23555,0.004248,74.125.200.0-255,2902,96063,1,210302
23556,0.004254,172.31.36.0-255,66,96129,1,210302
23557,0.004295,74.125.200.0-255,2902,99031,1,210302
23558,0.004298,172.31.36.0-255,66,99097,1,210302
23559,0.006586,74.125.200.0-255,2902,101999,1,210302
23560,0.006591,172.31.36.0-255,66,102065,1,210302
23561,0.006624,74.125.200.0-255,2902,104967,1,210302
23562,0.006628,172.31.36.0-255,66,105033,1,210302
23563,0.008921,74.125.200.0-255,2902,107935,1,210302
23564,0.008928,172.31.36.0-255,66,108001,1,210302
23565,0.00896,74.125.200.0-255,2902,110903,1,210302
23566,0.008963,172.31.36.0-255,66,110969,1,210302
23567,0.011263,74.125.200.0-255,2902,113871,1,210302
23568,0.01127,172.31.36.0-255,66,113937,1,210302
23569,0.011306,74.125.200.0-255,2902,116839,1,210302
23570,0.011309,172.31.36.0-255,66,116905,1,210302
23571,0.013603,74.125.200.0-255,2902,119807,1,210302
23572,0.013611,172.31.36.0-255,66,119873,1,210302
23573,0.01364,74.125.200.0-255,2902,122775,1,210302
23574,0.013645,172.31.36.0-255,66,122841,1,210302
23575,0.015946,74.125.200.0-255,2902,125743,1,210302
23576,0.015954,172.31.36.0-255,66,125809,1,210302
23577,0.015992,74.125.200.0-255,2902,128711,1,210302
23578,0.015996,172.31.36.0-255,66,128777,1,210302
23579,0.018283,74.125.200.0-255,2902,131679,1,210302
23580,0.018293,172.31.36.0-255,66,131745,1,210302
23581,0.018339,74.125.200.0-255,2902,134647,1,210302
23582,0.018343,172.31.36.0-255,66,134713,1,210302
23583,0.020629,74.125.200.0-255,2902,137615,1,210302
23584,0.020637,172.31.36.0-255,66,137681,1,210302
23585,0.020682,74.125.200.0-255,2902,140583,1,210302
23586,0.020686,172.31.36.0-255,66,140649,1,210302
23587,0.022972,74.125.200.0-255,2902,143551,1,210302
23588,0.02298,172.31.36.0-255,66,143617,1,210302
23589,0.023018,74.125.200.0-255,2902,146519,1,210302
23590,0.023021,172.31.36.0-255,66,146585,1,210302
23591,0.025306,74.125.200.0-255,2902,149487,1,210302
23592,0.025313,172.31.36.0-255,66,149553,1,210302
23593,0.02535,74.125.200.0-255,2902,152455,1,210302
23594,0.025353,172.31.36.0-255,66,152521,1,210302
23595,0.027639,74.125.200.0-255,2902,155423,1,210302
23596,0.027645,172.31.36.0-255,66,155489,1,210302
23597,0.027681,74.125.200.0-255,2902,158391,1,210302
23598,0.027684,172.31.36.0-255,66,158457,1,210302
23599,0.029964,74.125.200.0-255,2902,161359,1,210302
23600,0.029971,172.31.36.0-255,66,161425,1,210302
23601,0.03001,74.125.200.0-255,2902,164327,1,210302
23602,0.030015,172.31.36.0-255,66,164393,1,210302
23603,0.032308,74.125.200.0-255,2902,167295,1,210302
23604,0.032314,172.31.36.0-255,66,167361,1,210302
23605,0.03235,74.125.200.0-255,2902,170263,1,210302
23606,0.032354,172.31.36.0-255,66,170329,1,210302
23607,0.03468,74.125.200.0-255,5738,176067,1,210302
23608,0.034687,172.31.36.0-255,66,176133,1,210302
23609,0.035807,172.31.36.0-255,172,176305,1,210302
23610,0.035836,172.31.36.0-255,1116,177421,1,210302
23611,0.035856,172.31.36.0-255,563,177984,1,210302
23612,0.037019,74.125.200.0-255,5738,183722,1,210302
23613,0.037024,172.31.36.0-255,66,183788,1,210302
23614,0.037354,104.244.42.0-255,66,183854,1,210302
23615,0.037397,104.244.42.0-255,66,183920,1,210302
23616,0.037401,104.244.42.0-255,66,183986,1,210302
23617,0.039342,74.125.200.0-255,4320,188306,1,210302
23618,0.039348,172.31.36.0-255,66,188372,1,210302
23619,0.039385,74.125.200.0-255,1484,189856,1,210302
23620,0.041675,74.125.200.0-255,4320,194176,1,210302
23621,0.041681,172.31.36.0-255,66,194242,1,210302
23622,0.044004,74.125.200.0-255,4320,198562,1,210302
23623,0.044009,172.31.36.0-255,66,198628,1,210302
23624,0.044049,74.125.200.0-255,1484,200112,1,210302
23625,0.046333,74.125.200.0-255,4320,204432,1,210302
23626,0.046338,172.31.36.0-255,66,204498,1,210302
23627,0.048672,74.125.200.0-255,5738,210236,1,210302
23628,0.048678,172.31.36.0-255,66,210302,1,210302
23629,0.0,74.125.24.0-255,152,152,1,194004
23630,3.4e-05,172.31.36.0-255,66,218,1,194004
23631,4.1e-05,74.125.24.0-255,1484,1702,1,194004
23632,4.6e-05,172.31.36.0-255,66,1768,1,194004
23633,5.1e-05,74.125.24.0-255,2902,4670,1,194004
23634,5.4e-05,172.31.36.0-255,66,4736,1,194004
23635,6.1e-05,74.125.24.0-255,7156,11892,1,194004
23636,6.3e-05,172.31.36.0-255,66,11958,1,194004
23637,7.3e-05,172.31.36.0-255,66,12024,1,194004
23638,0.000108,172.31.36.0-255,66,12090,1,194004
23639,0.000131,74.125.24.0-255,7156,19246,1,194004
23640,0.000134,172.31.36.0-255,66,19312,1,194004
23641,0.000138,74.125.24.0-255,2902,22214,1,194004
23642,0.000141,172.31.36.0-255,66,22280,1,194004
23643,0.000156,74.125.24.0-255,5738,28018,1,194004
23644,0.000159,172.31.36.0-255,66,28084,1,194004
23645,0.000177,74.125.24.0-255,1125,29209,1,194004
23646,0.00018,172.31.36.0-255,66,29275,1,194004
23647,0.000196,74.125.24.0-255,1484,30759,1,194004
23648,0.000199,172.31.36.0-255,66,30825,1,194004
23649,0.000202,74.125.24.0-255,1484,32309,1,194004
23650,0.000204,172.31.36.0-255,66,32375,1,194004
23651,0.000223,74.125.24.0-255,2902,35277,1,194004
23652,0.000225,172.31.36.0-255,66,35343,1,194004
23653,0.000258,74.125.24.0-255,4320,39663,1,194004
23654,0.000261,172.31.36.0-255,66,39729,1,194004
23655,0.000289,74.125.24.0-255,5738,45467,1,194004
23656,0.000292,172.31.36.0-255,66,45533,1,194004
23657,0.000296,74.125.24.0-255,1488,47021,1,194004
23658,0.000298,172.31.36.0-255,66,47087,1,194004
23659,0.000313,74.125.24.0-255,346,47433,1,194004
23660,0.000617,74.125.24.0-255,1484,48917,1,194004
23661,0.000621,172.31.36.0-255,66,48983,1,194004
23662,0.000627,74.125.24.0-255,2902,51885,1,194004
23663,0.00063,74.125.24.0-255,1484,53369,1,194004
23664,0.00064,172.31.36.0-255,66,53435,1,194004
23665,0.000647,74.125.24.0-255,4320,57755,1,194004
23666,0.000655,172.31.36.0-255,66,57821,1,194004
23667,0.000674,172.31.36.0-255,66,57887,1,194004
23668,0.000704,74.125.24.0-255,4320,62207,1,194004
23669,0.000711,172.31.36.0-255,66,62273,1,194004
23670,0.000725,172.31.36.0-255,66,62339,1,194004
23671,0.000731,74.125.24.0-255,4320,66659,1,194004
23672,0.000734,74.125.24.0-255,1484,68143,1,194004
23673,0.000739,172.31.36.0-255,66,68209,1,194004
23674,0.00075,74.125.24.0-255,4320,72529,1,194004
23675,0.000755,172.31.36.0-255,66,72595,1,194004
23676,0.000764,74.125.24.0-255,4320,76915,1,194004
23677,0.00077,172.31.36.0-255,66,76981,1,194004
23678,0.000782,74.125.24.0-255,7156,84137,1,194004
23679,0.000796,172.31.36.0-255,66,84203,1,194004
23680,0.000806,74.125.24.0-255,3602,87805,1,194004
23681,0.000812,172.31.36.0-255,66,87871,1,194004
23682,0.000827,74.125.24.0-255,2902,90773,1,194004
23683,0.00084,172.31.36.0-255,66,90839,1,194004
23684,0.000857,172.31.36.0-255,66,90905,1,194004
23685,0.000859,74.125.24.0-255,7156,98061,1,194004
23686,0.000871,172.31.36.0-255,66,98127,1,194004
23687,0.000894,74.125.24.0-255,2902,101029,1,194004
23688,0.000899,172.31.36.0-255,66,101095,1,194004
23689,0.000911,74.125.24.0-255,5738,106833,1,194004
23690,0.000919,172.31.36.0-255,66,106899,1,194004
23691,0.00093,74.125.24.0-255,5020,111919,1,194004
23692,0.000934,172.31.36.0-255,66,111985,1,194004
23693,0.000952,74.125.24.0-255,7156,119141,1,194004
23694,0.000957,172.31.36.0-255,66,119207,1,194004
23695,0.000972,74.125.24.0-255,4320,123527,1,194004
23696,0.000978,172.31.36.0-255,66,123593,1,194004
23697,0.000986,74.125.24.0-255,1484,125077,1,194004
23698,0.000991,172.31.36.0-255,66,125143,1,194004
23699,0.001021,172.31.36.0-255,66,125209,1,194004
23700,0.001161,74.125.24.0-255,1484,126693,1,194004
23701,0.001166,74.125.24.0-255,2902,129595,1,194004
23702,0.00117,74.125.24.0-255,1484,131079,1,194004
23703,0.00118,172.31.36.0-255,66,131145,1,194004
23704,0.001189,74.125.24.0-255,4320,135465,1,194004
23705,0.001193,74.125.24.0-255,2902,138367,1,194004
23706,0.001195,172.31.36.0-255,66,138433,1,194004
23707,0.001202,172.31.36.0-255,66,138499,1,194004
23708,0.001224,74.125.24.0-255,1484,139983,1,194004
23709,0.00123,74.125.24.0-255,5738,145721,1,194004
23710,0.001238,172.31.36.0-255,66,145787,1,194004
23711,0.001242,172.31.36.0-255,66,145853,1,194004
23712,0.001261,74.125.24.0-255,2902,148755,1,194004
23713,0.001265,74.125.24.0-255,2184,150939,1,194004
23714,0.001266,172.31.36.0-255,66,151005,1,194004
23715,0.00127,172.31.36.0-255,66,151071,1,194004
23716,0.001328,74.125.24.0-255,2902,153973,1,194004
23717,0.001334,172.31.36.0-255,66,154039,1,194004
23718,0.001357,172.31.36.0-255,66,154105,1,194004
23719,0.001373,74.125.24.0-255,3602,157707,1,194004
23720,0.001373,172.31.36.0-255,66,157773,1,194004
23721,0.001377,172.31.36.0-255,66,157839,1,194004
23722,0.001396,74.125.24.0-255,1484,159323,1,194004
23723,0.0014,74.125.24.0-255,2902,162225,1,194004
23724,0.001416,74.125.24.0-255,4320,166545,1,194004
23725,0.001416,172.31.36.0-255,66,166611,1,194004
23726,0.001423,172.31.36.0-255,66,166677,1,194004
23727,0.001428,74.125.24.0-255,1484,168161,1,194004
23728,0.001433,74.125.24.0-255,2902,171063,1,194004
23729,0.001436,172.31.36.0-255,66,171129,1,194004
23730,0.00147,172.31.36.0-255,66,171195,1,194004
23731,0.001485,172.31.36.0-255,66,171261,1,194004
23732,0.001505,74.125.24.0-255,2184,173445,1,194004
23733,0.00151,172.31.36.0-255,66,173511,1,194004
23734,0.001547,74.125.24.0-255,2902,176413,1,194004
23735,0.001551,74.125.24.0-255,1484,177897,1,194004
23736,0.001554,172.31.36.0-255,66,177963,1,194004
23737,0.001571,74.125.24.0-255,2902,180865,1,194004
23738,0.001582,172.31.36.0-255,66,180931,1,194004
23739,0.001586,172.31.36.0-255,66,180997,1,194004
23740,0.00164,172.31.36.0-255,66,181063,1,194004
23741,0.001646,74.125.24.0-255,2902,183965,1,194004
23742,0.001654,172.31.36.0-255,66,184031,1,194004
23743,0.001678,172.31.36.0-255,66,184097,1,194004
23744,0.001683,172.31.36.0-255,66,184163,1,194004
23745,0.001719,74.125.24.0-255,7156,191319,1,194004
23746,0.001728,172.31.36.0-255,66,191385,1,194004
23747,0.001767,172.31.36.0-255,66,191451,1,194004
23748,0.001772,172.31.36.0-255,66,191517,1,194004
23749,0.001811,74.125.24.0-255,97,191614,1,194004
23750,0.001814,74.125.24.0-255,105,191719,1,194004
23751,0.001817,172.31.36.0-255,66,191785,1,194004
23752,0.0037,172.31.36.0-255,105,191890,1,194004
23753,0.005989,74.125.24.0-255,66,191956,1,194004
23754,0.035705,172.31.36.0-255,172,192128,1,194004
23755,0.03574,172.31.36.0-255,1115,193243,1,194004
23756,0.03577,172.31.36.0-255,563,193806,1,194004
23757,0.037269,104.244.42.0-255,66,193872,1,194004
23758,0.037279,104.244.42.0-255,66,193938,1,194004
23759,0.037296,104.244.42.0-255,66,194004,1,194004
23760,0.0,172.31.36.0-255,66,66,1,66
23761,0.0,172.217.194.0-255,296,296,1,109370
23762,2.1e-05,172.31.36.0-255,66,362,1,109370
23763,2.7e-05,172.217.194.0-255,1484,1846,1,109370
23764,3.1e-05,172.31.36.0-255,66,1912,1,109370
23765,3.7e-05,172.217.194.0-255,4320,6232,1,109370
23766,4.1e-05,172.31.36.0-255,66,6298,1,109370
23767,4.5e-05,172.217.194.0-255,2902,9200,1,109370
23768,4.8e-05,172.31.36.0-255,66,9266,1,109370
23769,7.8e-05,172.217.194.0-255,4705,13971,1,109370
23770,8.1e-05,172.31.36.0-255,66,14037,1,109370
23771,9e-05,172.31.36.0-255,66,14103,1,109370
23772,0.000128,172.31.36.0-255,66,14169,1,109370
23773,0.000175,172.217.194.0-255,1484,15653,1,109370
23774,0.000178,172.31.36.0-255,66,15719,1,109370
23775,0.000183,172.217.194.0-255,2902,18621,1,109370
23776,0.000184,172.31.36.0-255,66,18687,1,109370
23777,0.000199,172.217.194.0-255,5738,24425,1,109370
23778,0.000202,172.31.36.0-255,66,24491,1,109370
23779,0.000246,172.31.36.0-255,66,24557,1,109370
23780,0.000274,172.217.194.0-255,2543,27100,1,109370
23781,0.000276,172.31.36.0-255,66,27166,1,109370
23782,0.000287,172.31.36.0-255,66,27232,1,109370
23783,0.00046,172.217.194.0-255,369,27601,1,109370
23784,0.000465,172.31.36.0-255,66,27667,1,109370
23785,0.000618,172.217.194.0-255,1484,29151,1,109370
23786,0.000623,172.31.36.0-255,66,29217,1,109370
23787,0.000628,172.217.194.0-255,2902,32119,1,109370
23788,0.000631,172.31.36.0-255,66,32185,1,109370
23789,0.000653,172.217.194.0-255,5738,37923,1,109370
23790,0.000656,172.31.36.0-255,66,37989,1,109370
23791,0.000706,172.31.36.0-255,66,38055,1,109370
23792,0.000726,172.217.194.0-255,1484,39539,1,109370
23793,0.000749,172.31.36.0-255,66,39605,1,109370
23794,0.001103,172.217.194.0-255,1484,41089,1,109370
23795,0.001107,172.217.194.0-255,1484,42573,1,109370
23796,0.001115,172.31.36.0-255,66,42639,1,109370
23797,0.001124,172.217.194.0-255,1484,44123,1,109370
23798,0.001129,172.217.194.0-255,2902,47025,1,109370
23799,0.001131,172.31.36.0-255,66,47091,1,109370
23800,0.001158,172.217.194.0-255,7156,54247,1,109370
23801,0.001161,172.31.36.0-255,66,54313,1,109370
23802,0.001179,172.217.194.0-255,1484,55797,1,109370
23803,0.001201,172.31.36.0-255,66,55863,1,109370
23804,0.001221,172.217.194.0-255,2902,58765,1,109370
23805,0.001224,172.31.36.0-255,66,58831,1,109370
23806,0.001226,172.217.194.0-255,1484,60315,1,109370
23807,0.001245,172.217.194.0-255,2184,62499,1,109370
23808,0.001249,172.31.36.0-255,66,62565,1,109370
23809,0.001426,172.217.194.0-255,1484,64049,1,109370
23810,0.001448,172.217.194.0-255,2902,66951,1,109370
23811,0.001451,172.31.36.0-255,66,67017,1,109370
23812,0.001458,172.217.194.0-255,5738,72755,1,109370
23813,0.00146,172.31.36.0-255,66,72821,1,109370
23814,0.001499,172.31.36.0-255,66,72887,1,109370
23815,0.001535,172.217.194.0-255,4320,77207,1,109370
23816,0.001538,172.31.36.0-255,66,77273,1,109370
23817,0.001566,172.217.194.0-255,6438,83711,1,109370
23818,0.001596,172.31.36.0-255,66,83777,1,109370
23819,0.001613,172.217.194.0-255,7156,90933,1,109370
23820,0.001636,172.217.194.0-255,1484,92417,1,109370
23821,0.001657,172.217.194.0-255,1484,93901,1,109370
23822,0.001664,172.31.36.0-255,66,93967,1,109370
23823,0.001692,172.31.36.0-255,66,94033,1,109370
23824,0.001754,172.31.36.0-255,66,94099,1,109370
23825,0.001757,172.217.194.0-255,1484,95583,1,109370
23826,0.001796,172.31.36.0-255,66,95649,1,109370
23827,0.001842,172.217.194.0-255,5738,101387,1,109370
23828,0.001852,172.31.36.0-255,66,101453,1,109370
23829,0.001897,172.217.194.0-255,7156,108609,1,109370
23830,0.001905,172.31.36.0-255,66,108675,1,109370
23831,0.001975,172.31.36.0-255,66,108741,1,109370
23832,0.00203,172.217.194.0-255,287,109028,1,109370
23833,0.002032,172.217.194.0-255,105,109133,1,109370
23834,0.002039,172.31.36.0-255,66,109199,1,109370
23835,0.004361,172.31.36.0-255,105,109304,1,109370
23836,0.006617,172.217.194.0-255,66,109370,1,109370
23837,0.0,74.125.130.0-255,152,152,1,267948
23838,2.3e-05,172.31.36.0-255,66,218,1,267948
23839,3.1e-05,74.125.130.0-255,1484,1702,1,267948
23840,3.5e-05,172.31.36.0-255,66,1768,1,267948
23841,4e-05,74.125.130.0-255,2902,4670,1,267948
23842,5.2e-05,172.31.36.0-255,66,4736,1,267948
23843,5.9e-05,74.125.130.0-255,4320,9056,1,267948
23844,6.2e-05,172.31.36.0-255,66,9122,1,267948
23845,6.9e-05,74.125.130.0-255,4891,14013,1,267948
23846,7.2e-05,172.31.36.0-255,66,14079,1,267948
23847,0.000107,74.125.130.0-255,5738,19817,1,267948
23848,0.00011,172.31.36.0-255,66,19883,1,267948
23849,0.000141,74.125.130.0-255,4320,24203,1,267948
23850,0.000143,172.31.36.0-255,66,24269,1,267948
23851,0.000151,74.125.130.0-255,6797,31066,1,267948
23852,0.000153,172.31.36.0-255,66,31132,1,267948
23853,0.000317,74.125.130.0-255,1484,32616,1,267948
23854,0.000322,172.31.36.0-255,66,32682,1,267948
23855,0.000328,74.125.130.0-255,2902,35584,1,267948
23856,0.000331,172.31.36.0-255,66,35650,1,267948
23857,0.000365,74.125.130.0-255,5738,41388,1,267948
23858,0.000368,172.31.36.0-255,66,41454,1,267948
23859,0.000373,74.125.130.0-255,2902,44356,1,267948
23860,0.000375,172.31.36.0-255,66,44422,1,267948
23861,0.000406,74.125.130.0-255,4320,48742,1,267948
23862,0.000409,172.31.36.0-255,66,48808,1,267948
23863,0.000463,172.31.36.0-255,66,48874,1,267948
23864,0.000468,74.125.130.0-255,2902,51776,1,267948
23865,0.00047,172.31.36.0-255,66,51842,1,267948
23866,0.000477,74.125.130.0-255,5020,56862,1,267948
23867,0.00048,172.31.36.0-255,66,56928,1,267948
23868,0.000483,74.125.130.0-255,410,57338,1,267948
23869,0.00064,74.125.130.0-255,1484,58822,1,267948
23870,0.000647,74.125.130.0-255,2902,61724,1,267948
23871,0.00067,74.125.130.0-255,4320,66044,1,267948
23872,0.000684,74.125.130.0-255,2902,68946,1,267948
23873,0.0007,74.125.130.0-255,5738,74684,1,267948
23874,0.000707,74.125.130.0-255,5738,80422,1,267948
23875,0.000709,74.125.130.0-255,1484,81906,1,267948
23876,0.000728,74.125.130.0-255,5738,87644,1,267948
23877,0.000754,74.125.130.0-255,3602,91246,1,267948
23878,0.000837,172.31.36.0-255,66,91312,1,267948
23879,0.000897,74.125.130.0-255,1484,92796,1,267948
23880,0.000903,74.125.130.0-255,2902,95698,1,267948
23881,0.000924,74.125.130.0-255,2902,98600,1,267948
23882,0.000937,74.125.130.0-255,2902,101502,1,267948
23883,0.000947,172.31.36.0-255,66,101568,1,267948
23884,0.000985,74.125.130.0-255,2902,104470,1,267948
23885,0.001,172.31.36.0-255,66,104536,1,267948
23886,0.001012,74.125.130.0-255,5738,110274,1,267948
23887,0.00103,74.125.130.0-255,5020,115294,1,267948
23888,0.001046,172.31.36.0-255,66,115360,1,267948
23889,0.001459,74.125.130.0-255,1484,116844,1,267948
23890,0.001475,74.125.130.0-255,2902,119746,1,267948
23891,0.001519,172.31.36.0-255,66,119812,1,267948
23892,0.001539,74.125.130.0-255,5738,125550,1,267948
23893,0.001559,74.125.130.0-255,1484,127034,1,267948
23894,0.001579,74.125.130.0-255,3602,130636,1,267948
23895,0.001582,172.31.36.0-255,66,130702,1,267948
23896,0.001587,172.31.36.0-255,66,130768,1,267948
23897,0.002184,74.125.130.0-255,1484,132252,1,267948
23898,0.002204,74.125.130.0-255,2902,135154,1,267948
23899,0.002208,172.31.36.0-255,66,135220,1,267948
23900,0.002213,74.125.130.0-255,2902,138122,1,267948
23901,0.002235,74.125.130.0-255,2902,141024,1,267948
23902,0.002237,74.125.130.0-255,1484,142508,1,267948
23903,0.00224,172.31.36.0-255,66,142574,1,267948
23904,0.002245,172.31.36.0-255,66,142640,1,267948
23905,0.002257,74.125.130.0-255,1484,144124,1,267948
23906,0.004493,74.125.130.0-255,4320,148444,1,267948
23907,0.004501,172.31.36.0-255,66,148510,1,267948
23908,0.006749,74.125.130.0-255,4320,152830,1,267948
23909,0.006766,74.125.130.0-255,1484,154314,1,267948
23910,0.008145,172.31.36.0-255,66,154380,1,267948
23911,0.010382,74.125.130.0-255,5738,160118,1,267948
23912,0.01039,172.31.36.0-255,66,160184,1,267948
23913,0.012634,74.125.130.0-255,5738,165922,1,267948
23914,0.012682,172.31.36.0-255,66,165988,1,267948
23915,0.014925,74.125.130.0-255,5738,171726,1,267948
23916,0.014933,172.31.36.0-255,66,171792,1,267948
23917,0.017174,74.125.130.0-255,5738,177530,1,267948
23918,0.017183,172.31.36.0-255,66,177596,1,267948
23919,0.019435,74.125.130.0-255,5738,183334,1,267948
23920,0.01945,172.31.36.0-255,66,183400,1,267948
23921,0.021688,74.125.130.0-255,5738,189138,1,267948
23922,0.021697,172.31.36.0-255,66,189204,1,267948
23923,0.023937,74.125.130.0-255,5738,194942,1,267948
23924,0.023946,172.31.36.0-255,66,195008,1,267948
23925,0.026185,74.125.130.0-255,5738,200746,1,267948
23926,0.026193,172.31.36.0-255,66,200812,1,267948
23927,0.028443,74.125.130.0-255,5738,206550,1,267948
23928,0.028467,172.31.36.0-255,66,206616,1,267948
23929,0.030706,74.125.130.0-255,5738,212354,1,267948
23930,0.030716,172.31.36.0-255,66,212420,1,267948
23931,0.032969,74.125.130.0-255,5738,218158,1,267948
23932,0.032979,172.31.36.0-255,66,218224,1,267948
23933,0.035226,74.125.130.0-255,5738,223962,1,267948
23934,0.035234,172.31.36.0-255,66,224028,1,267948
23935,0.037481,74.125.130.0-255,5738,229766,1,267948
23936,0.037489,172.31.36.0-255,66,229832,1,267948
23937,0.039741,74.125.130.0-255,5738,235570,1,267948
23938,0.039748,172.31.36.0-255,66,235636,1,267948
23939,0.041515,172.31.36.0-255,172,235808,1,267948
23940,0.041548,172.31.36.0-255,1115,236923,1,267948
23941,0.041619,172.31.36.0-255,1514,238437,1,267948
23942,0.04162,172.31.36.0-255,1514,239951,1,267948
23943,0.041622,172.31.36.0-255,1514,241465,1,267948
23944,0.041623,172.31.36.0-255,1514,242979,1,267948
23945,0.041651,172.31.36.0-255,1489,244468,1,267948
23946,0.041978,74.125.130.0-255,5738,250206,1,267948
23947,0.041984,172.31.36.0-255,66,250272,1,267948
23948,0.043025,104.244.42.0-255,66,250338,1,267948
23949,0.043127,104.244.42.0-255,66,250404,1,267948
23950,0.043175,104.244.42.0-255,66,250470,1,267948
23951,0.043223,104.244.42.0-255,66,250536,1,267948
23952,0.044227,74.125.130.0-255,5738,256274,1,267948
23953,0.044233,172.31.36.0-255,66,256340,1,267948
23954,0.04647,74.125.130.0-255,5738,262078,1,267948
23955,0.046478,172.31.36.0-255,66,262144,1,267948
23956,0.048709,74.125.130.0-255,5738,267882,1,267948
23957,0.048718,172.31.36.0-255,66,267948,1,267948
23958,0.0,74.125.24.0-255,154,154,1,226997
23959,1.6e-05,172.31.36.0-255,66,220,1,226997
23960,2.3e-05,74.125.24.0-255,1484,1704,1,226997
23961,2.8e-05,172.31.36.0-255,66,1770,1,226997
23962,3.3e-05,74.125.24.0-255,2902,4672,1,226997
23963,3.7e-05,172.31.36.0-255,66,4738,1,226997
23964,4.5e-05,74.125.24.0-255,7156,11894,1,226997
23965,4.8e-05,172.31.36.0-255,66,11960,1,226997
23966,5.2e-05,74.125.24.0-255,2033,13993,1,226997
23967,5.6e-05,172.31.36.0-255,66,14059,1,226997
23968,0.000157,74.125.24.0-255,1484,15543,1,226997
23969,0.000161,172.31.36.0-255,66,15609,1,226997
23970,0.000166,74.125.24.0-255,2902,18511,1,226997
23971,0.000169,172.31.36.0-255,66,18577,1,226997
23972,0.000175,74.125.24.0-255,4320,22897,1,226997
23973,0.000177,172.31.36.0-255,66,22963,1,226997
23974,0.000205,74.125.24.0-255,1484,24447,1,226997
23975,0.000208,172.31.36.0-255,66,24513,1,226997
23976,0.000216,74.125.24.0-255,6797,31310,1,226997
23977,0.000218,172.31.36.0-255,66,31376,1,226997
23978,0.000631,74.125.24.0-255,1484,32860,1,226997
23979,0.000637,172.31.36.0-255,66,32926,1,226997
23980,0.000643,74.125.24.0-255,2902,35828,1,226997
23981,0.000645,172.31.36.0-255,66,35894,1,226997
23982,0.000697,74.125.24.0-255,5738,41632,1,226997
23983,0.0007,172.31.36.0-255,66,41698,1,226997
23984,0.000709,74.125.24.0-255,6797,48495,1,226997
23985,0.000711,172.31.36.0-255,66,48561,1,226997
23986,0.000989,74.125.24.0-255,1484,50045,1,226997
23987,0.000994,172.31.36.0-255,66,50111,1,226997
23988,0.001001,74.125.24.0-255,2902,53013,1,226997
23989,0.001003,172.31.36.0-255,66,53079,1,226997
23990,0.001007,74.125.24.0-255,2902,55981,1,226997
23991,0.00101,172.31.36.0-255,66,56047,1,226997
23992,0.001014,74.125.24.0-255,1484,57531,1,226997
23993,0.001038,74.125.24.0-255,2902,60433,1,226997
23994,0.001041,172.31.36.0-255,66,60499,1,226997
23995,0.001046,74.125.24.0-255,2902,63401,1,226997
23996,0.001048,172.31.36.0-255,66,63467,1,226997
23997,0.001063,74.125.24.0-255,2543,66010,1,226997
23998,0.001066,172.31.36.0-255,66,66076,1,226997
23999,0.001493,74.125.24.0-255,1484,67560,1,226997
24000,0.001501,74.125.24.0-255,2902,70462,1,226997
24001,0.001506,172.31.36.0-255,66,70528,1,226997
24002,0.001511,74.125.24.0-255,2902,73430,1,226997
24003,0.001513,172.31.36.0-255,66,73496,1,226997
24004,0.001521,74.125.24.0-255,7156,80652,1,226997
24005,0.001524,172.31.36.0-255,66,80718,1,226997
24006,0.001548,74.125.24.0-255,4320,85038,1,226997
24007,0.001551,172.31.36.0-255,66,85104,1,226997
24008,0.001573,172.31.36.0-255,66,85170,1,226997
24009,0.001578,74.125.24.0-255,3602,88772,1,226997
24010,0.00158,172.31.36.0-255,66,88838,1,226997
24011,0.002153,74.125.24.0-255,1484,90322,1,226997
24012,0.002159,74.125.24.0-255,2902,93224,1,226997
24013,0.002162,172.31.36.0-255,66,93290,1,226997
24014,0.002167,74.125.24.0-255,2902,96192,1,226997
24015,0.002169,172.31.36.0-255,66,96258,1,226997
24016,0.002184,74.125.24.0-255,2902,99160,1,226997
24017,0.002187,172.31.36.0-255,66,99226,1,226997
24018,0.00219,74.125.24.0-255,1484,100710,1,226997
24019,0.002228,172.31.36.0-255,66,100776,1,226997
24020,0.002269,172.31.36.0-255,66,100842,1,226997
24021,0.00229,74.125.24.0-255,2184,103026,1,226997
24022,0.002292,172.31.36.0-255,66,103092,1,226997
24023,0.004624,74.125.24.0-255,5738,108830,1,226997
24024,0.004627,172.31.36.0-255,66,108896,1,226997
24025,0.006952,74.125.24.0-255,5738,114634,1,226997
24026,0.00696,172.31.36.0-255,66,114700,1,226997
24027,0.009347,74.125.24.0-255,5738,120438,1,226997
24028,0.009357,172.31.36.0-255,66,120504,1,226997
24029,0.011696,74.125.24.0-255,5738,126242,1,226997
24030,0.011704,172.31.36.0-255,66,126308,1,226997
24031,0.014062,74.125.24.0-255,5738,132046,1,226997
24032,0.014076,172.31.36.0-255,66,132112,1,226997
24033,0.016426,74.125.24.0-255,5738,137850,1,226997
24034,0.016437,172.31.36.0-255,66,137916,1,226997
24035,0.018778,74.125.24.0-255,5738,143654,1,226997
24036,0.018786,172.31.36.0-255,66,143720,1,226997
24037,0.021111,74.125.24.0-255,5738,149458,1,226997
24038,0.02112,172.31.36.0-255,66,149524,1,226997
24039,0.023467,74.125.24.0-255,5738,155262,1,226997
24040,0.023475,172.31.36.0-255,66,155328,1,226997
24041,0.025792,74.125.24.0-255,4320,159648,1,226997
24042,0.0258,172.31.36.0-255,66,159714,1,226997
24043,0.025818,74.125.24.0-255,1484,161198,1,226997
24044,0.028132,74.125.24.0-255,4320,165518,1,226997
24045,0.028145,172.31.36.0-255,66,165584,1,226997
24046,0.030506,74.125.24.0-255,5738,171322,1,226997
24047,0.030519,172.31.36.0-255,66,171388,1,226997
24048,0.032874,74.125.24.0-255,5738,177126,1,226997
24049,0.032889,172.31.36.0-255,66,177192,1,226997
24050,0.035245,74.125.24.0-255,5738,182930,1,226997
24051,0.03526,172.31.36.0-255,66,182996,1,226997
24052,0.036237,172.31.36.0-255,188,183184,1,226997
24053,0.03628,172.31.36.0-255,958,184142,1,226997
24054,0.036372,172.31.36.0-255,1514,185656,1,226997
24055,0.036374,172.31.36.0-255,1514,187170,1,226997
24056,0.036381,172.31.36.0-255,1514,188684,1,226997
24057,0.036382,172.31.36.0-255,1514,190198,1,226997
24058,0.036401,172.31.36.0-255,1514,191712,1,226997
24059,0.036406,172.31.36.0-255,197,191909,1,226997
24060,0.037603,74.125.24.0-255,5738,197647,1,226997
24061,0.037612,172.31.36.0-255,66,197713,1,226997
24062,0.037787,104.244.42.0-255,66,197779,1,226997
24063,0.037836,104.244.42.0-255,66,197845,1,226997
24064,0.037932,104.244.42.0-255,66,197911,1,226997
24065,0.037984,104.244.42.0-255,66,197977,1,226997
24066,0.039965,74.125.24.0-255,5738,203715,1,226997
24067,0.039973,172.31.36.0-255,66,203781,1,226997
24068,0.042304,74.125.24.0-255,5738,209519,1,226997
24069,0.042313,172.31.36.0-255,66,209585,1,226997
24070,0.044672,74.125.24.0-255,5738,215323,1,226997
24071,0.044679,172.31.36.0-255,66,215389,1,226997
24072,0.047039,74.125.24.0-255,5738,221127,1,226997
24073,0.047046,172.31.36.0-255,66,221193,1,226997
24074,0.04941,74.125.24.0-255,5738,226931,1,226997
24075,0.049417,172.31.36.0-255,66,226997,1,226997
24076,0.0,172.253.118.0-255,146,146,1,334618
24077,2.6e-05,172.31.36.0-255,66,212,1,334618
24078,4.8e-05,172.253.118.0-255,1484,1696,1,334618
24079,5.2e-05,172.31.36.0-255,66,1762,1,334618
24080,7.2e-05,172.253.118.0-255,2902,4664,1,334618
24081,7.5e-05,172.31.36.0-255,66,4730,1,334618
24082,7.9e-05,172.253.118.0-255,1484,6214,1,334618
24083,8.1e-05,172.31.36.0-255,66,6280,1,334618
24084,0.000119,172.253.118.0-255,4320,10600,1,334618
24085,0.000122,172.31.36.0-255,66,10666,1,334618
24086,0.000127,172.253.118.0-255,3522,14188,1,334618
24087,0.00013,172.31.36.0-255,66,14254,1,334618
24088,0.000175,172.253.118.0-255,1484,15738,1,334618
24089,0.000178,172.31.36.0-255,66,15804,1,334618
24090,0.000184,172.253.118.0-255,2902,18706,1,334618
24091,0.000186,172.31.36.0-255,66,18772,1,334618
24092,0.000218,172.253.118.0-255,5738,24510,1,334618
24093,0.000221,172.31.36.0-255,66,24576,1,334618
24094,0.000229,172.253.118.0-255,6797,31373,1,334618
24095,0.000231,172.31.36.0-255,66,31439,1,334618
24096,0.000261,172.253.118.0-255,5738,37177,1,334618
24097,0.000265,172.31.36.0-255,66,37243,1,334618
24098,0.000292,172.253.118.0-255,5738,42981,1,334618
24099,0.000298,172.31.36.0-255,66,43047,1,334618
24100,0.000309,172.253.118.0-255,5379,48426,1,334618
24101,0.000312,172.31.36.0-255,66,48492,1,334618
24102,0.000496,172.253.118.0-255,1484,49976,1,334618
24103,0.0005,172.31.36.0-255,66,50042,1,334618
24104,0.000505,172.253.118.0-255,2902,52944,1,334618
24105,0.000507,172.31.36.0-255,66,53010,1,334618
24106,0.000514,172.253.118.0-255,5738,58748,1,334618
24107,0.000523,172.31.36.0-255,66,58814,1,334618
24108,0.000555,172.253.118.0-255,5738,64552,1,334618
24109,0.000558,172.31.36.0-255,66,64618,1,334618
24110,0.000598,172.31.36.0-255,66,64684,1,334618
24111,0.000603,172.31.36.0-255,66,64750,1,334618
24112,0.000634,172.253.118.0-255,1125,65875,1,334618
24113,0.000741,172.253.118.0-255,1484,67359,1,334618
24114,0.000745,172.31.36.0-255,66,67425,1,334618
24115,0.00075,172.253.118.0-255,2902,70327,1,334618
24116,0.000752,172.31.36.0-255,66,70393,1,334618
24117,0.000755,172.253.118.0-255,1484,71877,1,334618
24118,0.000778,172.253.118.0-255,4320,76197,1,334618
24119,0.000781,172.31.36.0-255,66,76263,1,334618
24120,0.000786,172.253.118.0-255,4320,80583,1,334618
24121,0.000789,172.31.36.0-255,66,80649,1,334618
24122,0.000815,172.253.118.0-255,2543,83192,1,334618
24123,0.000823,172.31.36.0-255,66,83258,1,334618
24124,0.000849,172.253.118.0-255,2902,86160,1,334618
24125,0.000853,172.31.36.0-255,66,86226,1,334618
24126,0.000886,172.253.118.0-255,7156,93382,1,334618
24127,0.000889,172.31.36.0-255,66,93448,1,334618
24128,0.000895,172.253.118.0-255,5738,99186,1,334618
24129,0.000897,172.31.36.0-255,66,99252,1,334618
24130,0.000923,172.253.118.0-255,1156,100408,1,334618
24131,0.001023,172.253.118.0-255,1484,101892,1,334618
24132,0.001027,172.31.36.0-255,66,101958,1,334618
24133,0.001032,172.253.118.0-255,2902,104860,1,334618
24134,0.001033,172.31.36.0-255,66,104926,1,334618
24135,0.001037,172.253.118.0-255,1484,106410,1,334618
24136,0.001055,172.253.118.0-255,4320,110730,1,334618
24137,0.001058,172.31.36.0-255,66,110796,1,334618
24138,0.001069,172.253.118.0-255,4320,115116,1,334618
24139,0.001072,172.31.36.0-255,66,115182,1,334618
24140,0.001119,172.31.36.0-255,66,115248,1,334618
24141,0.001126,172.253.118.0-255,7156,122404,1,334618
24142,0.001129,172.31.36.0-255,66,122470,1,334618
24143,0.001169,172.253.118.0-255,3602,126072,1,334618
24144,0.001173,172.31.36.0-255,66,126138,1,334618
24145,0.001678,172.253.118.0-255,1484,127622,1,334618
24146,0.00169,172.253.118.0-255,2902,130524,1,334618
24147,0.001695,172.31.36.0-255,66,130590,1,334618
24148,0.001703,172.253.118.0-255,5738,136328,1,334618
24149,0.001705,172.31.36.0-255,66,136394,1,334618
24150,0.001715,172.253.118.0-255,1484,137878,1,334618
24151,0.001747,172.31.36.0-255,66,137944,1,334618
24152,0.00179,172.253.118.0-255,2902,140846,1,334618
24153,0.001793,172.31.36.0-255,66,140912,1,334618
24154,0.001832,172.31.36.0-255,66,140978,1,334618
24155,0.001977,172.253.118.0-255,1484,142462,1,334618
24156,0.001984,172.253.118.0-255,2902,145364,1,334618
24157,0.001987,172.31.36.0-255,66,145430,1,334618
24158,0.001992,172.253.118.0-255,1484,146914,1,334618
24159,0.002018,172.253.118.0-255,4320,151234,1,334618
24160,0.002021,172.31.36.0-255,66,151300,1,334618
24161,0.002028,172.253.118.0-255,5738,157038,1,334618
24162,0.00203,172.31.36.0-255,66,157104,1,334618
24163,0.002059,172.253.118.0-255,7156,164260,1,334618
24164,0.002062,172.31.36.0-255,66,164326,1,334618
24165,0.002072,172.31.36.0-255,66,164392,1,334618
24166,0.002094,172.253.118.0-255,2184,166576,1,334618
24167,0.002097,172.31.36.0-255,66,166642,1,334618
24168,0.002159,172.253.118.0-255,1484,168126,1,334618
24169,0.002178,172.253.118.0-255,2902,171028,1,334618
24170,0.002181,172.31.36.0-255,66,171094,1,334618
24171,0.002209,172.253.118.0-255,4320,175414,1,334618
24172,0.002212,172.31.36.0-255,66,175480,1,334618
24173,0.002238,172.253.118.0-255,5738,181218,1,334618
24174,0.002241,172.31.36.0-255,66,181284,1,334618
24175,0.002265,172.253.118.0-255,1484,182768,1,334618
24176,0.002269,172.253.118.0-255,1484,184252,1,334618
24177,0.002271,172.31.36.0-255,66,184318,1,334618
24178,0.002296,172.253.118.0-255,1484,185802,1,334618
24179,0.002319,172.253.118.0-255,1484,187286,1,334618
24180,0.002322,172.31.36.0-255,66,187352,1,334618
24181,0.002343,172.253.118.0-255,2902,190254,1,334618
24182,0.002346,172.31.36.0-255,66,190320,1,334618
24183,0.002351,172.253.118.0-255,2902,193222,1,334618
24184,0.002369,172.31.36.0-255,66,193288,1,334618
24185,0.002393,172.253.118.0-255,2902,196190,1,334618
24186,0.002405,172.253.118.0-255,4320,200510,1,334618
24187,0.002407,172.253.118.0-255,766,201276,1,334618
24188,0.002411,172.31.36.0-255,66,201342,1,334618
24189,0.002555,172.253.118.0-255,1484,202826,1,334618
24190,0.002581,172.253.118.0-255,2902,205728,1,334618
24191,0.002614,172.253.118.0-255,4320,210048,1,334618
24192,0.002616,172.253.118.0-255,1484,211532,1,334618
24193,0.002642,172.253.118.0-255,1484,213016,1,334618
24194,0.002656,172.253.118.0-255,1484,214500,1,334618
24195,0.002675,172.253.118.0-255,2902,217402,1,334618
24196,0.002687,172.253.118.0-255,4320,221722,1,334618
24197,0.002708,172.253.118.0-255,4320,226042,1,334618
24198,0.002727,172.253.118.0-255,7156,233198,1,334618
24199,0.002754,172.253.118.0-255,2184,235382,1,334618
24200,0.002862,172.31.36.0-255,66,235448,1,334618
24201,0.002867,172.31.36.0-255,66,235514,1,334618
24202,0.002869,172.31.36.0-255,66,235580,1,334618
24203,0.002873,172.31.36.0-255,66,235646,1,334618
24204,0.002894,172.31.36.0-255,66,235712,1,334618
24205,0.002896,172.31.36.0-255,66,235778,1,334618
24206,0.002901,172.31.36.0-255,66,235844,1,334618
24207,0.002902,172.31.36.0-255,66,235910,1,334618
24208,0.002903,172.31.36.0-255,66,235976,1,334618
24209,0.002904,172.31.36.0-255,66,236042,1,334618
24210,0.003809,172.253.118.0-255,1484,237526,1,334618
24211,0.003832,172.253.118.0-255,2902,240428,1,334618
24212,0.003835,172.31.36.0-255,66,240494,1,334618
24213,0.003865,172.253.118.0-255,5738,246232,1,334618
24214,0.003867,172.31.36.0-255,66,246298,1,334618
24215,0.003898,172.31.36.0-255,66,246364,1,334618
24216,0.003903,172.253.118.0-255,2902,249266,1,334618
24217,0.003905,172.31.36.0-255,66,249332,1,334618
24218,0.003958,172.253.118.0-255,7156,256488,1,334618
24219,0.003962,172.31.36.0-255,66,256554,1,334618
24220,0.003967,172.253.118.0-255,5020,261574,1,334618
24221,0.003969,172.31.36.0-255,66,261640,1,334618
24222,0.0041,172.253.118.0-255,1484,263124,1,334618
24223,0.004121,172.253.118.0-255,2902,266026,1,334618
24224,0.004123,172.31.36.0-255,66,266092,1,334618
24225,0.004143,172.253.118.0-255,5738,271830,1,334618
24226,0.004145,172.31.36.0-255,66,271896,1,334618
24227,0.004176,172.253.118.0-255,5738,277634,1,334618
24228,0.004179,172.31.36.0-255,66,277700,1,334618
24229,0.004182,172.253.118.0-255,1484,279184,1,334618
24230,0.004207,172.31.36.0-255,66,279250,1,334618
24231,0.004238,172.31.36.0-255,66,279316,1,334618
24232,0.004627,172.253.118.0-255,1484,280800,1,334618
24233,0.004633,172.253.118.0-255,1484,282284,1,334618
24234,0.004637,172.31.36.0-255,66,282350,1,334618
24235,0.004672,172.253.118.0-255,2902,285252,1,334618
24236,0.004674,172.31.36.0-255,66,285318,1,334618
24237,0.004703,172.253.118.0-255,1484,286802,1,334618
24238,0.004713,172.31.36.0-255,66,286868,1,334618
24239,0.00472,172.253.118.0-255,7156,294024,1,334618
24240,0.004722,172.31.36.0-255,66,294090,1,334618
24241,0.004736,172.31.36.0-255,66,294156,1,334618
24242,0.004795,172.253.118.0-255,1484,295640,1,334618
24243,0.004812,172.253.118.0-255,2902,298542,1,334618
24244,0.004815,172.31.36.0-255,66,298608,1,334618
24245,0.00482,172.253.118.0-255,2902,301510,1,334618
24246,0.004821,172.31.36.0-255,66,301576,1,334618
24247,0.004837,172.253.118.0-255,2902,304478,1,334618
24248,0.004839,172.31.36.0-255,66,304544,1,334618
24249,0.004846,172.253.118.0-255,5738,310282,1,334618
24250,0.004848,172.31.36.0-255,66,310348,1,334618
24251,0.004854,172.253.118.0-255,7156,317504,1,334618
24252,0.004856,172.31.36.0-255,66,317570,1,334618
24253,0.004891,172.253.118.0-255,5738,323308,1,334618
24254,0.004893,172.31.36.0-255,66,323374,1,334618
24255,0.004897,172.253.118.0-255,1807,325181,1,334618
24256,0.004899,172.31.36.0-255,66,325247,1,334618
24257,0.004918,172.253.118.0-255,105,325352,1,334618
24258,0.00539,172.31.36.0-255,66,325418,1,334618
24259,0.005424,172.31.36.0-255,105,325523,1,334618
24260,0.007722,172.253.118.0-255,66,325589,1,334618
24261,0.036396,172.31.36.0-255,172,325761,1,334618
24262,0.036424,172.31.36.0-255,1114,326875,1,334618
24263,0.036489,172.31.36.0-255,1514,328389,1,334618
24264,0.036491,172.31.36.0-255,1514,329903,1,334618
24265,0.036497,172.31.36.0-255,1514,331417,1,334618
24266,0.036498,172.31.36.0-255,1514,332931,1,334618
24267,0.036517,172.31.36.0-255,1489,334420,1,334618
24268,0.037933,104.244.42.0-255,66,334486,1,334618
24269,0.03799,104.244.42.0-255,66,334552,1,334618
24270,0.038093,104.244.42.0-255,66,334618,1,334618
24271,0.0,172.217.194.0-255,145,145,1,201295
24272,3.5e-05,172.31.36.0-255,66,211,1,201295
24273,4.2e-05,172.217.194.0-255,1484,1695,1,201295
24274,4.6e-05,172.31.36.0-255,66,1761,1,201295
24275,5.1e-05,172.217.194.0-255,2902,4663,1,201295
24276,5.4e-05,172.31.36.0-255,66,4729,1,201295
24277,6.9e-05,172.217.194.0-255,7156,11885,1,201295
24278,7.2e-05,172.31.36.0-255,66,11951,1,201295
24279,7.6e-05,172.217.194.0-255,2027,13978,1,201295
24280,7.8e-05,172.31.36.0-255,66,14044,1,201295
24281,8.6e-05,172.217.194.0-255,7156,21200,1,201295
24282,8.8e-05,172.31.36.0-255,66,21266,1,201295
24283,0.000118,172.217.194.0-255,4320,25586,1,201295
24284,0.000121,172.31.36.0-255,66,25652,1,201295
24285,0.000126,172.217.194.0-255,5379,31031,1,201295
24286,0.000128,172.31.36.0-255,66,31097,1,201295
24287,0.00018,172.217.194.0-255,1484,32581,1,201295
24288,0.000183,172.31.36.0-255,66,32647,1,201295
24289,0.000187,172.217.194.0-255,2902,35549,1,201295
24290,0.000189,172.31.36.0-255,66,35615,1,201295
24291,0.000207,172.217.194.0-255,1484,37099,1,201295
24292,0.000209,172.31.36.0-255,66,37165,1,201295
24293,0.000237,172.217.194.0-255,4320,41485,1,201295
24294,0.000239,172.31.36.0-255,66,41551,1,201295
24295,0.000246,172.217.194.0-255,7156,48707,1,201295
24296,0.000248,172.31.36.0-255,66,48773,1,201295
24297,0.000282,172.217.194.0-255,6797,55570,1,201295
24298,0.000285,172.31.36.0-255,66,55636,1,201295
24299,0.000295,172.31.36.0-255,66,55702,1,201295
24300,0.000301,172.217.194.0-255,382,56084,1,201295
24301,0.000303,172.31.36.0-255,66,56150,1,201295
24302,0.000341,172.217.194.0-255,363,56513,1,201295
24303,0.000454,172.217.194.0-255,1484,57997,1,201295
24304,0.000458,172.31.36.0-255,66,58063,1,201295
24305,0.000463,172.217.194.0-255,2902,60965,1,201295
24306,0.000466,172.31.36.0-255,66,61031,1,201295
24307,0.00047,172.217.194.0-255,4320,65351,1,201295
24308,0.000472,172.31.36.0-255,66,65417,1,201295
24309,0.00051,172.217.194.0-255,1484,66901,1,201295
24310,0.000523,172.31.36.0-255,66,66967,1,201295
24311,0.000534,172.31.36.0-255,66,67033,1,201295
24312,0.000656,172.217.194.0-255,1484,68517,1,201295
24313,0.000661,172.217.194.0-255,2902,71419,1,201295
24314,0.000664,172.31.36.0-255,66,71485,1,201295
24315,0.000667,172.217.194.0-255,1484,72969,1,201295
24316,0.000693,172.217.194.0-255,4320,77289,1,201295
24317,0.000695,172.31.36.0-255,66,77355,1,201295
24318,0.000705,172.31.36.0-255,66,77421,1,201295
24319,0.000726,172.217.194.0-255,4320,81741,1,201295
24320,0.000728,172.31.36.0-255,66,81807,1,201295
24321,0.000743,172.31.36.0-255,66,81873,1,201295
24322,0.000745,172.217.194.0-255,766,82639,1,201295
24323,0.000834,172.217.194.0-255,1484,84123,1,201295
24324,0.000838,172.31.36.0-255,66,84189,1,201295
24325,0.000843,172.217.194.0-255,2902,87091,1,201295
24326,0.000844,172.31.36.0-255,66,87157,1,201295
24327,0.000864,172.217.194.0-255,5738,92895,1,201295
24328,0.000866,172.31.36.0-255,66,92961,1,201295
24329,0.000901,172.31.36.0-255,66,93027,1,201295
24330,0.000924,172.217.194.0-255,7156,100183,1,201295
24331,0.000927,172.31.36.0-255,66,100249,1,201295
24332,0.000955,172.217.194.0-255,6438,106687,1,201295
24333,0.000958,172.31.36.0-255,66,106753,1,201295
24334,0.000964,172.217.194.0-255,5738,112491,1,201295
24335,0.000966,172.31.36.0-255,66,112557,1,201295
24336,0.00099,172.31.36.0-255,66,112623,1,201295
24337,0.001007,172.31.36.0-255,66,112689,1,201295
24338,0.00103,172.217.194.0-255,1484,114173,1,201295
24339,0.001035,172.217.194.0-255,3602,117775,1,201295
24340,0.001038,172.31.36.0-255,66,117841,1,201295
24341,0.001509,172.217.194.0-255,1484,119325,1,201295
24342,0.001529,172.217.194.0-255,2902,122227,1,201295
24343,0.001532,172.31.36.0-255,66,122293,1,201295
24344,0.001538,172.217.194.0-255,5738,128031,1,201295
24345,0.00154,172.31.36.0-255,66,128097,1,201295
24346,0.001609,172.217.194.0-255,4320,132417,1,201295
24347,0.001613,172.31.36.0-255,66,132483,1,201295
24348,0.001619,172.31.36.0-255,66,132549,1,201295
24349,0.001641,172.217.194.0-255,6438,138987,1,201295
24350,0.001647,172.31.36.0-255,66,139053,1,201295
24351,0.001846,172.217.194.0-255,1484,140537,1,201295
24352,0.001852,172.217.194.0-255,2902,143439,1,201295
24353,0.001855,172.31.36.0-255,66,143505,1,201295
24354,0.001887,172.217.194.0-255,5738,149243,1,201295
24355,0.001892,172.217.194.0-255,4320,153563,1,201295
24356,0.0019,172.31.36.0-255,66,153629,1,201295
24357,0.001903,172.31.36.0-255,66,153695,1,201295
24358,0.001954,172.31.36.0-255,66,153761,1,201295
24359,0.001963,172.31.36.0-255,66,153827,1,201295
24360,0.001985,172.217.194.0-255,1484,155311,1,201295
24361,0.002024,172.31.36.0-255,66,155377,1,201295
24362,0.002036,172.31.36.0-255,66,155443,1,201295
24363,0.002038,172.217.194.0-255,766,156209,1,201295
24364,0.002219,172.217.194.0-255,1484,157693,1,201295
24365,0.002222,172.31.36.0-255,66,157759,1,201295
24366,0.002227,172.217.194.0-255,2902,160661,1,201295
24367,0.002229,172.31.36.0-255,66,160727,1,201295
24368,0.002239,172.217.194.0-255,5738,166465,1,201295
24369,0.002241,172.31.36.0-255,66,166531,1,201295
24370,0.002269,172.31.36.0-255,66,166597,1,201295
24371,0.0023,172.217.194.0-255,2902,169499,1,201295
24372,0.002303,172.31.36.0-255,66,169565,1,201295
24373,0.002314,172.31.36.0-255,66,169631,1,201295
24374,0.002317,172.217.194.0-255,1484,171115,1,201295
24375,0.002321,172.217.194.0-255,2902,174017,1,201295
24376,0.002324,172.31.36.0-255,66,174083,1,201295
24377,0.002355,172.217.194.0-255,5738,179821,1,201295
24378,0.002357,172.31.36.0-255,66,179887,1,201295
24379,0.002367,172.31.36.0-255,66,179953,1,201295
24380,0.002393,172.217.194.0-255,4320,184273,1,201295
24381,0.002396,172.31.36.0-255,66,184339,1,201295
24382,0.002409,172.31.36.0-255,66,184405,1,201295
24383,0.002422,172.31.36.0-255,66,184471,1,201295
24384,0.002495,172.217.194.0-255,7156,191627,1,201295
24385,0.002498,172.31.36.0-255,66,191693,1,201295
24386,0.002537,172.31.36.0-255,66,191759,1,201295
24387,0.00254,172.217.194.0-255,97,191856,1,201295
24388,0.002543,172.217.194.0-255,105,191961,1,201295
24389,0.004573,172.31.36.0-255,66,192027,1,201295
24390,0.004616,172.31.36.0-255,105,192132,1,201295
24391,0.007144,172.217.194.0-255,66,192198,1,201295
24392,0.031771,172.31.36.0-255,172,192370,1,201295
24393,0.031806,172.31.36.0-255,1113,193483,1,201295
24394,0.031851,172.31.36.0-255,1514,194997,1,201295
24395,0.031873,172.31.36.0-255,1514,196511,1,201295
24396,0.031875,172.31.36.0-255,1514,198025,1,201295
24397,0.031897,172.31.36.0-255,1514,199539,1,201295
24398,0.031898,172.31.36.0-255,1492,201031,1,201295
24399,0.033324,104.244.42.0-255,66,201097,1,201295
24400,0.033335,104.244.42.0-255,66,201163,1,201295
24401,0.033432,104.244.42.0-255,66,201229,1,201295
24402,0.033476,104.244.42.0-255,66,201295,1,201295
24403,0.0,74.125.24.0-255,152,152,1,233710
24404,1.6e-05,172.31.36.0-255,66,218,1,233710
24405,2.2e-05,74.125.24.0-255,1484,1702,1,233710
24406,2.6e-05,172.31.36.0-255,66,1768,1,233710
24407,3.1e-05,74.125.24.0-255,2902,4670,1,233710
24408,3.3e-05,172.31.36.0-255,66,4736,1,233710
24409,3.8e-05,74.125.24.0-255,2902,7638,1,233710
24410,4.1e-05,172.31.36.0-255,66,7704,1,233710
24411,7.1e-05,74.125.24.0-255,2902,10606,1,233710
24412,7.4e-05,172.31.36.0-255,66,10672,1,233710
24413,8e-05,74.125.24.0-255,6404,17076,1,233710
24414,8.2e-05,172.31.36.0-255,66,17142,1,233710
24415,8.9e-05,74.125.24.0-255,7156,24298,1,233710
24416,9.2e-05,172.31.36.0-255,66,24364,1,233710
24417,0.000115,74.125.24.0-255,1484,25848,1,233710
24418,0.000118,172.31.36.0-255,66,25914,1,233710
24419,0.000137,74.125.24.0-255,2902,28816,1,233710
24420,0.00014,172.31.36.0-255,66,28882,1,233710
24421,0.000157,74.125.24.0-255,2543,31425,1,233710
24422,0.00016,172.31.36.0-255,66,31491,1,233710
24423,0.000199,74.125.24.0-255,1484,32975,1,233710
24424,0.000202,172.31.36.0-255,66,33041,1,233710
24425,0.000207,74.125.24.0-255,2902,35943,1,233710
24426,0.000209,172.31.36.0-255,66,36009,1,233710
24427,0.000245,74.125.24.0-255,5738,41747,1,233710
24428,0.000248,172.31.36.0-255,66,41813,1,233710
24429,0.000253,74.125.24.0-255,4320,46133,1,233710
24430,0.000255,172.31.36.0-255,66,46199,1,233710
24431,0.000277,74.125.24.0-255,5738,51937,1,233710
24432,0.00028,172.31.36.0-255,66,52003,1,233710
24433,0.000308,74.125.24.0-255,6797,58800,1,233710
24434,0.000311,172.31.36.0-255,66,58866,1,233710
24435,0.000315,74.125.24.0-255,2902,61768,1,233710
24436,0.000317,172.31.36.0-255,66,61834,1,233710
24437,0.000359,74.125.24.0-255,4255,66089,1,233710
24438,0.000362,172.31.36.0-255,66,66155,1,233710
24439,0.000376,74.125.24.0-255,384,66539,1,233710
24440,0.000527,74.125.24.0-255,1484,68023,1,233710
24441,0.000532,172.31.36.0-255,66,68089,1,233710
24442,0.000538,74.125.24.0-255,2902,70991,1,233710
24443,0.00054,172.31.36.0-255,66,71057,1,233710
24444,0.000545,74.125.24.0-255,4320,75377,1,233710
24445,0.000547,172.31.36.0-255,66,75443,1,233710
24446,0.00058,74.125.24.0-255,7156,82599,1,233710
24447,0.000584,172.31.36.0-255,66,82665,1,233710
24448,0.000599,74.125.24.0-255,2543,85208,1,233710
24449,0.000601,172.31.36.0-255,66,85274,1,233710
24450,0.000613,172.31.36.0-255,66,85340,1,233710
24451,0.000648,74.125.24.0-255,3961,89301,1,233710
24452,0.000651,172.31.36.0-255,66,89367,1,233710
24453,0.000794,74.125.24.0-255,1484,90851,1,233710
24454,0.000798,74.125.24.0-255,1484,92335,1,233710
24455,0.0008,172.31.36.0-255,66,92401,1,233710
24456,0.000819,74.125.24.0-255,1484,93885,1,233710
24457,0.000824,74.125.24.0-255,5738,99623,1,233710
24458,0.000839,172.31.36.0-255,66,99689,1,233710
24459,0.000853,74.125.24.0-255,1484,101173,1,233710
24460,0.000868,74.125.24.0-255,5738,106911,1,233710
24461,0.000871,172.31.36.0-255,66,106977,1,233710
24462,0.000889,74.125.24.0-255,1484,108461,1,233710
24463,0.000913,74.125.24.0-255,2902,111363,1,233710
24464,0.000918,172.31.36.0-255,66,111429,1,233710
24465,0.000952,74.125.24.0-255,216,111645,1,233710
24466,0.000976,172.31.36.0-255,66,111711,1,233710
24467,0.001556,74.125.24.0-255,1484,113195,1,233710
24468,0.001562,74.125.24.0-255,2902,116097,1,233710
24469,0.001565,172.31.36.0-255,66,116163,1,233710
24470,0.001571,74.125.24.0-255,5738,121901,1,233710
24471,0.001573,172.31.36.0-255,66,121967,1,233710
24472,0.001589,74.125.24.0-255,7156,129123,1,233710
24473,0.001591,172.31.36.0-255,66,129189,1,233710
24474,0.001618,74.125.24.0-255,5738,134927,1,233710
24475,0.001621,172.31.36.0-255,66,134993,1,233710
24476,0.001627,74.125.24.0-255,7156,142149,1,233710
24477,0.001628,172.31.36.0-255,66,142215,1,233710
24478,0.001652,74.125.24.0-255,3602,145817,1,233710
24479,0.001655,172.31.36.0-255,66,145883,1,233710
24480,0.001772,74.125.24.0-255,1484,147367,1,233710
24481,0.001791,74.125.24.0-255,2902,150269,1,233710
24482,0.001793,172.31.36.0-255,66,150335,1,233710
24483,0.001797,74.125.24.0-255,1484,151819,1,233710
24484,0.001814,74.125.24.0-255,2902,154721,1,233710
24485,0.001816,172.31.36.0-255,66,154787,1,233710
24486,0.001822,74.125.24.0-255,5738,160525,1,233710
24487,0.001823,172.31.36.0-255,66,160591,1,233710
24488,0.001855,172.31.36.0-255,66,160657,1,233710
24489,0.001874,74.125.24.0-255,1484,162141,1,233710
24490,0.001884,172.31.36.0-255,66,162207,1,233710
24491,0.001902,74.125.24.0-255,5738,167945,1,233710
24492,0.001904,172.31.36.0-255,66,168011,1,233710
24493,0.001924,172.31.36.0-255,66,168077,1,233710
24494,0.001939,74.125.24.0-255,2902,170979,1,233710
24495,0.001941,172.31.36.0-255,66,171045,1,233710
24496,0.001946,74.125.24.0-255,4320,175365,1,233710
24497,0.001947,172.31.36.0-255,66,175431,1,233710
24498,0.001971,74.125.24.0-255,1484,176915,1,233710
24499,0.00199,74.125.24.0-255,6438,183353,1,233710
24500,0.001993,172.31.36.0-255,66,183419,1,233710
24501,0.002062,74.125.24.0-255,1484,184903,1,233710
24502,0.002077,74.125.24.0-255,2902,187805,1,233710
24503,0.00208,172.31.36.0-255,66,187871,1,233710
24504,0.002108,74.125.24.0-255,2902,190773,1,233710
24505,0.00211,172.31.36.0-255,66,190839,1,233710
24506,0.002136,74.125.24.0-255,2902,193741,1,233710
24507,0.002149,74.125.24.0-255,7156,200897,1,233710
24508,0.002154,172.31.36.0-255,66,200963,1,233710
24509,0.00216,172.31.36.0-255,66,201029,1,233710
24510,0.002162,172.31.36.0-255,66,201095,1,233710
24511,0.002183,74.125.24.0-255,3602,204697,1,233710
24512,0.002187,74.125.24.0-255,4320,209017,1,233710
24513,0.00219,172.31.36.0-255,66,209083,1,233710
24514,0.002193,172.31.36.0-255,66,209149,1,233710
24515,0.002211,74.125.24.0-255,5738,214887,1,233710
24516,0.002224,74.125.24.0-255,4320,219207,1,233710
24517,0.002226,172.31.36.0-255,66,219273,1,233710
24518,0.00223,172.31.36.0-255,66,219339,1,233710
24519,0.002266,74.125.24.0-255,2902,222241,1,233710
24520,0.002295,172.31.36.0-255,66,222307,1,233710
24521,0.002332,172.31.36.0-255,66,222373,1,233710
24522,0.002381,172.31.36.0-255,66,222439,1,233710
24523,0.002391,74.125.24.0-255,766,223205,1,233710
24524,0.002425,74.125.24.0-255,1484,224689,1,233710
24525,0.002458,172.31.36.0-255,66,224755,1,233710
24526,0.002498,172.31.36.0-255,66,224821,1,233710
24527,0.002509,74.125.24.0-255,2184,227005,1,233710
24528,0.002519,74.125.24.0-255,97,227102,1,233710
24529,0.00255,172.31.36.0-255,66,227168,1,233710
24530,0.005053,74.125.24.0-255,105,227273,1,233710
24531,0.01687,172.31.36.0-255,66,227339,1,233710
24532,0.016919,172.31.36.0-255,105,227444,1,233710
24533,0.019427,74.125.24.0-255,66,227510,1,233710
24534,0.041129,172.31.36.0-255,172,227682,1,233710
24535,0.0412,172.31.36.0-255,1114,228796,1,233710
24536,0.041297,172.31.36.0-255,1514,230310,1,233710
24537,0.041299,172.31.36.0-255,1514,231824,1,233710
24538,0.0413,172.31.36.0-255,1514,233338,1,233710
24539,0.041301,172.31.36.0-255,108,233446,1,233710
24540,0.042696,104.244.42.0-255,66,233512,1,233710
24541,0.042736,104.244.42.0-255,66,233578,1,233710
24542,0.042888,104.244.42.0-255,66,233644,1,233710
24543,0.04289,104.244.42.0-255,66,233710,1,233710
24544,0.0,172.217.194.0-255,149,149,1,150488
24545,2.5e-05,172.31.36.0-255,66,215,1,150488
24546,3.2e-05,172.217.194.0-255,1484,1699,1,150488
24547,3.7e-05,172.31.36.0-255,66,1765,1,150488
24548,4.3e-05,172.217.194.0-255,2902,4667,1,150488
24549,4.7e-05,172.31.36.0-255,66,4733,1,150488
24550,5.6e-05,172.217.194.0-255,7156,11889,1,150488
24551,5.9e-05,172.31.36.0-255,66,11955,1,150488
24552,0.000104,172.217.194.0-255,6293,18248,1,150488
24553,0.000107,172.31.36.0-255,66,18314,1,150488
24554,0.000125,172.217.194.0-255,1484,19798,1,150488
24555,0.000127,172.31.36.0-255,66,19864,1,150488
24556,0.000156,172.31.36.0-255,66,19930,1,150488
24557,0.000238,172.217.194.0-255,1484,21414,1,150488
24558,0.000241,172.31.36.0-255,66,21480,1,150488
24559,0.000247,172.217.194.0-255,2902,24382,1,150488
24560,0.00025,172.31.36.0-255,66,24448,1,150488
24561,0.000257,172.217.194.0-255,5738,30186,1,150488
24562,0.000259,172.31.36.0-255,66,30252,1,150488
24563,0.000275,172.217.194.0-255,2902,33154,1,150488
24564,0.000277,172.31.36.0-255,66,33220,1,150488
24565,0.00029,172.217.194.0-255,3961,37181,1,150488
24566,0.000292,172.31.36.0-255,66,37247,1,150488
24567,0.000332,172.31.36.0-255,66,37313,1,150488
24568,0.000337,172.217.194.0-255,2543,39856,1,150488
24569,0.000338,172.31.36.0-255,66,39922,1,150488
24570,0.004316,172.217.194.0-255,646,40568,1,150488
24571,0.004323,172.31.36.0-255,66,40634,1,150488
24572,0.004428,172.217.194.0-255,1484,42118,1,150488
24573,0.004432,172.31.36.0-255,66,42184,1,150488
24574,0.00444,172.217.194.0-255,2902,45086,1,150488
24575,0.004442,172.31.36.0-255,66,45152,1,150488
24576,0.006874,172.217.194.0-255,1484,46636,1,150488
24577,0.00695,172.217.194.0-255,4320,50956,1,150488
24578,0.006955,172.31.36.0-255,66,51022,1,150488
24579,0.009474,172.217.194.0-255,5738,56760,1,150488
24580,0.009482,172.31.36.0-255,66,56826,1,150488
24581,0.011985,172.217.194.0-255,5738,62564,1,150488
24582,0.011993,172.31.36.0-255,66,62630,1,150488
24583,0.014537,172.217.194.0-255,5738,68368,1,150488
24584,0.014549,172.31.36.0-255,66,68434,1,150488
24585,0.017072,172.217.194.0-255,5738,74172,1,150488
24586,0.017083,172.31.36.0-255,66,74238,1,150488
24587,0.019621,172.217.194.0-255,5738,79976,1,150488
24588,0.019629,172.31.36.0-255,66,80042,1,150488
24589,0.02222,172.217.194.0-255,5738,85780,1,150488
24590,0.022229,172.31.36.0-255,66,85846,1,150488
24591,0.02476,172.217.194.0-255,5738,91584,1,150488
24592,0.024769,172.31.36.0-255,66,91650,1,150488
24593,0.027313,172.217.194.0-255,5738,97388,1,150488
24594,0.027327,172.31.36.0-255,66,97454,1,150488
24595,0.029849,172.217.194.0-255,5738,103192,1,150488
24596,0.02986,172.31.36.0-255,66,103258,1,150488
24597,0.032378,172.217.194.0-255,5738,108996,1,150488
24598,0.032387,172.31.36.0-255,66,109062,1,150488
24599,0.03404,172.31.36.0-255,171,109233,1,150488
24600,0.034102,172.31.36.0-255,1139,110372,1,150488
24601,0.034147,172.31.36.0-255,1514,111886,1,150488
24602,0.034148,172.31.36.0-255,1514,113400,1,150488
24603,0.03415,172.31.36.0-255,1514,114914,1,150488
24604,0.034151,172.31.36.0-255,1514,116428,1,150488
24605,0.034179,172.31.36.0-255,324,116752,1,150488
24606,0.034915,172.217.194.0-255,5738,122490,1,150488
24607,0.034922,172.31.36.0-255,66,122556,1,150488
24608,0.035645,104.244.42.0-255,66,122622,1,150488
24609,0.035671,104.244.42.0-255,66,122688,1,150488
24610,0.035728,104.244.42.0-255,66,122754,1,150488
24611,0.035732,104.244.42.0-255,66,122820,1,150488
24612,0.037427,172.217.194.0-255,5738,128558,1,150488
24613,0.037435,172.31.36.0-255,66,128624,1,150488
24614,0.03996,172.217.194.0-255,4320,132944,1,150488
24615,0.039966,172.31.36.0-255,66,133010,1,150488
24616,0.039984,172.217.194.0-255,1484,134494,1,150488
24617,0.042484,172.217.194.0-255,4320,138814,1,150488
24618,0.04249,172.31.36.0-255,66,138880,1,150488
24619,0.045047,172.217.194.0-255,5738,144618,1,150488
24620,0.045054,172.31.36.0-255,66,144684,1,150488
24621,0.047575,172.217.194.0-255,5738,150422,1,150488
24622,0.047583,172.31.36.0-255,66,150488,1,150488
24623,0.0,172.217.194.0-255,167,167,1,298699
24624,3.1e-05,172.31.36.0-255,66,233,1,298699
24625,3.9e-05,172.217.194.0-255,1484,1717,1,298699
24626,4.3e-05,172.31.36.0-255,66,1783,1,298699
24627,4.8e-05,172.217.194.0-255,2902,4685,1,298699
24628,5.1e-05,172.31.36.0-255,66,4751,1,298699
24629,5.7e-05,172.217.194.0-255,7156,11907,1,298699
24630,6.1e-05,172.31.36.0-255,66,11973,1,298699
24631,6.4e-05,172.217.194.0-255,2058,14031,1,298699
24632,6.8e-05,172.31.36.0-255,66,14097,1,298699
24633,0.000101,172.31.36.0-255,66,14163,1,298699
24634,0.000107,172.217.194.0-255,5379,19542,1,298699
24635,0.000109,172.31.36.0-255,66,19608,1,298699
24636,0.000153,172.217.194.0-255,1484,21092,1,298699
24637,0.000156,172.31.36.0-255,66,21158,1,298699
24638,0.000176,172.217.194.0-255,2902,24060,1,298699
24639,0.00018,172.31.36.0-255,66,24126,1,298699
24640,0.000186,172.217.194.0-255,4320,28446,1,298699
24641,0.000189,172.31.36.0-255,66,28512,1,298699
24642,0.000203,172.217.194.0-255,1484,29996,1,298699
24643,0.000205,172.31.36.0-255,66,30062,1,298699
24644,0.000213,172.217.194.0-255,4320,34382,1,298699
24645,0.000215,172.31.36.0-255,66,34448,1,298699
24646,0.000233,172.217.194.0-255,2543,36991,1,298699
24647,0.000236,172.31.36.0-255,66,37057,1,298699
24648,0.000395,172.217.194.0-255,1484,38541,1,298699
24649,0.000399,172.31.36.0-255,66,38607,1,298699
24650,0.000404,172.217.194.0-255,2902,41509,1,298699
24651,0.000407,172.31.36.0-255,66,41575,1,298699
24652,0.000412,172.217.194.0-255,4320,45895,1,298699
24653,0.000414,172.31.36.0-255,66,45961,1,298699
24654,0.000439,172.217.194.0-255,1484,47445,1,298699
24655,0.000447,172.217.194.0-255,5738,53183,1,298699
24656,0.000449,172.31.36.0-255,66,53249,1,298699
24657,0.00047,172.217.194.0-255,1704,54953,1,298699
24658,0.000473,172.31.36.0-255,66,55019,1,298699
24659,0.000518,172.217.194.0-255,2902,57921,1,298699
24660,0.000522,172.31.36.0-255,66,57987,1,298699
24661,0.000541,172.217.194.0-255,2902,60889,1,298699
24662,0.000544,172.31.36.0-255,66,60955,1,298699
24663,0.000564,172.217.194.0-255,4320,65275,1,298699
24664,0.000567,172.31.36.0-255,66,65341,1,298699
24665,0.000573,172.217.194.0-255,4320,69661,1,298699
24666,0.000575,172.31.36.0-255,66,69727,1,298699
24667,0.00059,172.217.194.0-255,3961,73688,1,298699
24668,0.000592,172.31.36.0-255,66,73754,1,298699
24669,0.000599,172.217.194.0-255,5738,79492,1,298699
24670,0.000601,172.31.36.0-255,66,79558,1,298699
24671,0.000636,172.31.36.0-255,66,79624,1,298699
24672,0.000657,172.217.194.0-255,1484,81108,1,298699
24673,0.000662,172.217.194.0-255,2902,84010,1,298699
24674,0.000665,172.31.36.0-255,66,84076,1,298699
24675,0.000675,172.217.194.0-255,5738,89814,1,298699
24676,0.000678,172.31.36.0-255,66,89880,1,298699
24677,0.000727,172.217.194.0-255,5738,95618,1,298699
24678,0.000732,172.31.36.0-255,66,95684,1,298699
24679,0.00074,172.217.194.0-255,1125,96809,1,298699
24680,0.001039,172.217.194.0-255,1484,98293,1,298699
24681,0.001044,172.31.36.0-255,66,98359,1,298699
24682,0.00105,172.217.194.0-255,2902,101261,1,298699
24683,0.001053,172.31.36.0-255,66,101327,1,298699
24684,0.001059,172.217.194.0-255,5738,107065,1,298699
24685,0.001061,172.31.36.0-255,66,107131,1,298699
24686,0.001094,172.31.36.0-255,66,107197,1,298699
24687,0.001128,172.217.194.0-255,4320,111517,1,298699
24688,0.001133,172.31.36.0-255,66,111583,1,298699
24689,0.001151,172.31.36.0-255,66,111649,1,298699
24690,0.001689,172.217.194.0-255,1484,113133,1,298699
24691,0.001699,172.217.194.0-255,2902,116035,1,298699
24692,0.001703,172.31.36.0-255,66,116101,1,298699
24693,0.00171,172.217.194.0-255,4320,120421,1,298699
24694,0.001713,172.31.36.0-255,66,120487,1,298699
24695,0.001727,172.217.194.0-255,1484,121971,1,298699
24696,0.001742,172.31.36.0-255,66,122037,1,298699
24697,0.001755,172.217.194.0-255,1484,123521,1,298699
24698,0.001766,172.31.36.0-255,66,123587,1,298699
24699,0.001788,172.217.194.0-255,766,124353,1,298699
24700,0.001888,172.217.194.0-255,1484,125837,1,298699
24701,0.001892,172.31.36.0-255,66,125903,1,298699
24702,0.001898,172.217.194.0-255,2902,128805,1,298699
24703,0.0019,172.31.36.0-255,66,128871,1,298699
24704,0.001907,172.217.194.0-255,5738,134609,1,298699
24705,0.001909,172.31.36.0-255,66,134675,1,298699
24706,0.001939,172.217.194.0-255,5738,140413,1,298699
24707,0.001942,172.31.36.0-255,66,140479,1,298699
24708,0.001962,172.217.194.0-255,7156,147635,1,298699
24709,0.001964,172.31.36.0-255,66,147701,1,298699
24710,0.001968,172.217.194.0-255,2902,150603,1,298699
24711,0.00197,172.31.36.0-255,66,150669,1,298699
24712,0.001999,172.31.36.0-255,66,150735,1,298699
24713,0.002002,172.217.194.0-255,1484,152219,1,298699
24714,0.002006,172.217.194.0-255,1484,153703,1,298699
24715,0.002007,172.31.36.0-255,66,153769,1,298699
24716,0.002028,172.217.194.0-255,1484,155253,1,298699
24717,0.002035,172.217.194.0-255,5738,160991,1,298699
24718,0.002037,172.31.36.0-255,66,161057,1,298699
24719,0.002053,172.217.194.0-255,1484,162541,1,298699
24720,0.002086,172.31.36.0-255,66,162607,1,298699
24721,0.002125,172.31.36.0-255,66,162673,1,298699
24722,0.00215,172.31.36.0-255,66,162739,1,298699
24723,0.002162,172.31.36.0-255,66,162805,1,298699
24724,0.004213,172.217.194.0-255,5738,168543,1,298699
24725,0.004218,172.31.36.0-255,66,168609,1,298699
24726,0.006288,172.217.194.0-255,5738,174347,1,298699
24727,0.006293,172.31.36.0-255,66,174413,1,298699
24728,0.00838,172.217.194.0-255,5738,180151,1,298699
24729,0.008386,172.31.36.0-255,66,180217,1,298699
24730,0.010467,172.217.194.0-255,5738,185955,1,298699
24731,0.010474,172.31.36.0-255,66,186021,1,298699
24732,0.012566,172.217.194.0-255,5738,191759,1,298699
24733,0.012574,172.31.36.0-255,66,191825,1,298699
24734,0.014642,172.217.194.0-255,5738,197563,1,298699
24735,0.014649,172.31.36.0-255,66,197629,1,298699
24736,0.016725,172.217.194.0-255,5738,203367,1,298699
24737,0.016732,172.31.36.0-255,66,203433,1,298699
24738,0.018828,172.217.194.0-255,5738,209171,1,298699
24739,0.018835,172.31.36.0-255,66,209237,1,298699
24740,0.020898,172.217.194.0-255,5738,214975,1,298699
24741,0.020905,172.31.36.0-255,66,215041,1,298699
24742,0.023008,172.217.194.0-255,5738,220779,1,298699
24743,0.023018,172.31.36.0-255,66,220845,1,298699
24744,0.025098,172.217.194.0-255,5738,226583,1,298699
24745,0.025106,172.31.36.0-255,66,226649,1,298699
24746,0.02717,172.217.194.0-255,4320,230969,1,298699
24747,0.027177,172.31.36.0-255,66,231035,1,298699
24748,0.027208,172.217.194.0-255,1484,232519,1,298699
24749,0.029267,172.217.194.0-255,4320,236839,1,298699
24750,0.029274,172.31.36.0-255,66,236905,1,298699
24751,0.031365,172.217.194.0-255,5738,242643,1,298699
24752,0.031371,172.31.36.0-255,66,242709,1,298699
24753,0.033435,172.217.194.0-255,5738,248447,1,298699
24754,0.033442,172.31.36.0-255,66,248513,1,298699
24755,0.035526,172.217.194.0-255,5738,254251,1,298699
24756,0.035531,172.31.36.0-255,66,254317,1,298699
24757,0.035666,172.31.36.0-255,172,254489,1,298699
24758,0.035691,172.31.36.0-255,1115,255604,1,298699
24759,0.035746,172.31.36.0-255,1514,257118,1,298699
24760,0.035748,172.31.36.0-255,1514,258632,1,298699
24761,0.035749,172.31.36.0-255,1514,260146,1,298699
24762,0.03575,172.31.36.0-255,1514,261660,1,298699
24763,0.035752,172.31.36.0-255,1489,263149,1,298699
24764,0.037246,104.244.42.0-255,66,263215,1,298699
24765,0.037254,104.244.42.0-255,66,263281,1,298699
24766,0.037345,104.244.42.0-255,66,263347,1,298699
24767,0.037591,172.217.194.0-255,5738,269085,1,298699
24768,0.037597,172.31.36.0-255,66,269151,1,298699
24769,0.039664,172.217.194.0-255,5738,274889,1,298699
24770,0.039669,172.31.36.0-255,66,274955,1,298699
24771,0.041742,172.217.194.0-255,2902,277857,1,298699
24772,0.041747,172.31.36.0-255,66,277923,1,298699
24773,0.041782,172.217.194.0-255,2902,280825,1,298699
24774,0.041785,172.31.36.0-255,66,280891,1,298699
24775,0.043815,172.217.194.0-255,2902,283793,1,298699
24776,0.043822,172.31.36.0-255,66,283859,1,298699
24777,0.04385,172.217.194.0-255,2902,286761,1,298699
24778,0.043853,172.31.36.0-255,66,286827,1,298699
24779,0.045885,172.217.194.0-255,2902,289729,1,298699
24780,0.04589,172.31.36.0-255,66,289795,1,298699
24781,0.045922,172.217.194.0-255,2902,292697,1,298699
24782,0.045925,172.31.36.0-255,66,292763,1,298699
24783,0.047955,172.217.194.0-255,2902,295665,1,298699
24784,0.04796,172.31.36.0-255,66,295731,1,298699
24785,0.047992,172.217.194.0-255,2902,298633,1,298699
24786,0.047995,172.31.36.0-255,66,298699,1,298699
24787,0.0,172.217.27.0-255,150,150,1,276795
24788,2.3e-05,172.31.36.0-255,66,216,1,276795
24789,3e-05,172.217.27.0-255,1484,1700,1,276795
24790,3.3e-05,172.31.36.0-255,66,1766,1,276795
24791,3.6e-05,172.217.27.0-255,1484,3250,1,276795
24792,3.9e-05,172.31.36.0-255,66,3316,1,276795
24793,5.8e-05,172.217.27.0-255,1484,4800,1,276795
24794,6.1e-05,172.31.36.0-255,66,4866,1,276795
24795,6.7e-05,172.217.27.0-255,5738,10604,1,276795
24796,7e-05,172.31.36.0-255,66,10670,1,276795
24797,7.3e-05,172.217.27.0-255,2902,13572,1,276795
24798,7.5e-05,172.31.36.0-255,66,13638,1,276795
24799,0.000101,172.217.27.0-255,650,14288,1,276795
24800,0.000103,172.31.36.0-255,66,14354,1,276795
24801,0.00012,172.217.27.0-255,1484,15838,1,276795
24802,0.000121,172.31.36.0-255,66,15904,1,276795
24803,0.000147,172.217.27.0-255,4320,20224,1,276795
24804,0.000149,172.31.36.0-255,66,20290,1,276795
24805,0.000153,172.217.27.0-255,2902,23192,1,276795
24806,0.000155,172.31.36.0-255,66,23258,1,276795
24807,0.00017,172.217.27.0-255,7156,30414,1,276795
24808,0.000173,172.31.36.0-255,66,30480,1,276795
24809,0.000175,172.217.27.0-255,1125,31605,1,276795
24810,0.000177,172.31.36.0-255,66,31671,1,276795
24811,0.000459,172.217.27.0-255,1484,33155,1,276795
24812,0.000464,172.31.36.0-255,66,33221,1,276795
24813,0.000469,172.217.27.0-255,2902,36123,1,276795
24814,0.000472,172.31.36.0-255,66,36189,1,276795
24815,0.000477,172.217.27.0-255,4320,40509,1,276795
24816,0.000479,172.31.36.0-255,66,40575,1,276795
24817,0.000508,172.217.27.0-255,5738,46313,1,276795
24818,0.000511,172.31.36.0-255,66,46379,1,276795
24819,0.000532,172.217.27.0-255,3961,50340,1,276795
24820,0.000534,172.31.36.0-255,66,50406,1,276795
24821,0.000546,172.31.36.0-255,66,50472,1,276795
24822,0.000566,172.217.27.0-255,5379,55851,1,276795
24823,0.000568,172.31.36.0-255,66,55917,1,276795
24824,0.001119,172.217.27.0-255,646,56563,1,276795
24825,0.001206,172.217.27.0-255,1484,58047,1,276795
24826,0.001212,172.31.36.0-255,66,58113,1,276795
24827,0.001217,172.217.27.0-255,2902,61015,1,276795
24828,0.001219,172.31.36.0-255,66,61081,1,276795
24829,0.001226,172.217.27.0-255,5738,66819,1,276795
24830,0.001228,172.31.36.0-255,66,66885,1,276795
24831,0.001247,172.217.27.0-255,1484,68369,1,276795
24832,0.001266,172.217.27.0-255,5379,73748,1,276795
24833,0.001268,172.31.36.0-255,66,73814,1,276795
24834,0.001271,172.217.27.0-255,1484,75298,1,276795
24835,0.001288,172.217.27.0-255,2902,78200,1,276795
24836,0.00129,172.31.36.0-255,66,78266,1,276795
24837,0.001295,172.217.27.0-255,2902,81168,1,276795
24838,0.001297,172.31.36.0-255,66,81234,1,276795
24839,0.00131,172.217.27.0-255,2902,84136,1,276795
24840,0.001312,172.31.36.0-255,66,84202,1,276795
24841,0.001346,172.217.27.0-255,6797,90999,1,276795
24842,0.001349,172.31.36.0-255,66,91065,1,276795
24843,0.001442,172.217.27.0-255,1484,92549,1,276795
24844,0.001448,172.217.27.0-255,2902,95451,1,276795
24845,0.001451,172.31.36.0-255,66,95517,1,276795
24846,0.001458,172.217.27.0-255,5738,101255,1,276795
24847,0.00146,172.31.36.0-255,66,101321,1,276795
24848,0.001499,172.31.36.0-255,66,101387,1,276795
24849,0.001519,172.217.27.0-255,1484,102871,1,276795
24850,0.001529,172.31.36.0-255,66,102937,1,276795
24851,0.001549,172.217.27.0-255,2184,105121,1,276795
24852,0.001551,172.31.36.0-255,66,105187,1,276795
24853,0.003187,172.217.27.0-255,5738,110925,1,276795
24854,0.003195,172.31.36.0-255,66,110991,1,276795
24855,0.004854,172.217.27.0-255,5738,116729,1,276795
24856,0.004863,172.31.36.0-255,66,116795,1,276795
24857,0.006519,172.217.27.0-255,5738,122533,1,276795
24858,0.006524,172.31.36.0-255,66,122599,1,276795
24859,0.008203,172.217.27.0-255,5738,128337,1,276795
24860,0.008209,172.31.36.0-255,66,128403,1,276795
24861,0.009871,172.217.27.0-255,5738,134141,1,276795
24862,0.009879,172.31.36.0-255,66,134207,1,276795
24863,0.011541,172.217.27.0-255,5738,139945,1,276795
24864,0.011547,172.31.36.0-255,66,140011,1,276795
24865,0.013229,172.217.27.0-255,5738,145749,1,276795
24866,0.013236,172.31.36.0-255,66,145815,1,276795
24867,0.0149,172.217.27.0-255,5738,151553,1,276795
24868,0.014908,172.31.36.0-255,66,151619,1,276795
24869,0.01657,172.217.27.0-255,5738,157357,1,276795
24870,0.01658,172.31.36.0-255,66,157423,1,276795
24871,0.018239,172.217.27.0-255,5738,163161,1,276795
24872,0.018245,172.31.36.0-255,66,163227,1,276795
24873,0.019936,172.217.27.0-255,5738,168965,1,276795
24874,0.019944,172.31.36.0-255,66,169031,1,276795
24875,0.021601,172.217.27.0-255,5738,174769,1,276795
24876,0.021608,172.31.36.0-255,66,174835,1,276795
24877,0.023267,172.217.27.0-255,5738,180573,1,276795
24878,0.023274,172.31.36.0-255,66,180639,1,276795
24879,0.024934,172.217.27.0-255,5738,186377,1,276795
24880,0.024941,172.31.36.0-255,66,186443,1,276795
24881,0.0266,172.217.27.0-255,5738,192181,1,276795
24882,0.026606,172.31.36.0-255,66,192247,1,276795
24883,0.028264,172.217.27.0-255,5738,197985,1,276795
24884,0.028271,172.31.36.0-255,66,198051,1,276795
24885,0.029934,172.217.27.0-255,5738,203789,1,276795
24886,0.029941,172.31.36.0-255,66,203855,1,276795
24887,0.031598,172.217.27.0-255,5738,209593,1,276795
24888,0.031605,172.31.36.0-255,66,209659,1,276795
24889,0.033266,172.217.27.0-255,5738,215397,1,276795
24890,0.033272,172.31.36.0-255,66,215463,1,276795
24891,0.033815,172.31.36.0-255,172,215635,1,276795
24892,0.033856,172.31.36.0-255,1114,216749,1,276795
24893,0.033936,172.31.36.0-255,1514,218263,1,276795
24894,0.033938,172.31.36.0-255,1514,219777,1,276795
24895,0.033944,172.31.36.0-255,1514,221291,1,276795
24896,0.033968,172.31.36.0-255,1514,222805,1,276795
24897,0.033989,172.31.36.0-255,1490,224295,1,276795
24898,0.034927,172.217.27.0-255,5738,230033,1,276795
24899,0.034933,172.31.36.0-255,66,230099,1,276795
24900,0.03536,104.244.42.0-255,66,230165,1,276795
24901,0.035416,104.244.42.0-255,66,230231,1,276795
24902,0.035513,104.244.42.0-255,66,230297,1,276795
24903,0.035564,104.244.42.0-255,66,230363,1,276795
24904,0.036591,172.217.27.0-255,5738,236101,1,276795
24905,0.036597,172.31.36.0-255,66,236167,1,276795
24906,0.038287,172.217.27.0-255,5738,241905,1,276795
24907,0.038294,172.31.36.0-255,66,241971,1,276795
24908,0.039953,172.217.27.0-255,5738,247709,1,276795
24909,0.039958,172.31.36.0-255,66,247775,1,276795
24910,0.04163,172.217.27.0-255,5738,253513,1,276795
24911,0.041642,172.31.36.0-255,66,253579,1,276795
24912,0.04331,172.217.27.0-255,5738,259317,1,276795
24913,0.043317,172.31.36.0-255,66,259383,1,276795
24914,0.044979,172.217.27.0-255,5738,265121,1,276795
24915,0.044986,172.31.36.0-255,66,265187,1,276795
24916,0.04666,172.217.27.0-255,5738,270925,1,276795
24917,0.046667,172.31.36.0-255,66,270991,1,276795
24918,0.048337,172.217.27.0-255,5738,276729,1,276795
24919,0.048344,172.31.36.0-255,66,276795,1,276795
24920,0.0,74.125.24.0-255,153,153,1,243861
24921,2.1e-05,172.31.36.0-255,66,219,1,243861
24922,2.7e-05,74.125.24.0-255,1484,1703,1,243861
24923,3.1e-05,172.31.36.0-255,66,1769,1,243861
24924,3.6e-05,74.125.24.0-255,2902,4671,1,243861
24925,3.9e-05,172.31.36.0-255,66,4737,1,243861
24926,5.3e-05,74.125.24.0-255,5738,10475,1,243861
24927,5.6e-05,172.31.36.0-255,66,10541,1,243861
24928,6.2e-05,74.125.24.0-255,5738,16279,1,243861
24929,6.5e-05,172.31.36.0-255,66,16345,1,243861
24930,0.000104,172.31.36.0-255,66,16411,1,243861
24931,0.00011,74.125.24.0-255,6797,23208,1,243861
24932,0.000112,172.31.36.0-255,66,23274,1,243861
24933,0.0003,74.125.24.0-255,1484,24758,1,243861
24934,0.000305,172.31.36.0-255,66,24824,1,243861
24935,0.00031,74.125.24.0-255,2902,27726,1,243861
24936,0.000312,172.31.36.0-255,66,27792,1,243861
24937,0.000317,74.125.24.0-255,4320,32112,1,243861
24938,0.000319,172.31.36.0-255,66,32178,1,243861
24939,0.000359,74.125.24.0-255,1484,33662,1,243861
24940,0.000362,172.31.36.0-255,66,33728,1,243861
24941,0.000367,74.125.24.0-255,4320,38048,1,243861
24942,0.000369,172.31.36.0-255,66,38114,1,243861
24943,0.000385,172.31.36.0-255,66,38180,1,243861
24944,0.000394,172.31.36.0-255,66,38246,1,243861
24945,0.000482,74.125.24.0-255,390,38636,1,243861
24946,0.000485,172.31.36.0-255,66,38702,1,243861
24947,0.000515,74.125.24.0-255,1484,40186,1,243861
24948,0.000517,172.31.36.0-255,66,40252,1,243861
24949,0.000524,74.125.24.0-255,4320,44572,1,243861
24950,0.000529,74.125.24.0-255,4320,48892,1,243861
24951,0.000559,172.31.36.0-255,66,48958,1,243861
24952,0.000564,74.125.24.0-255,4320,53278,1,243861
24953,0.000568,172.31.36.0-255,66,53344,1,243861
24954,0.000628,172.31.36.0-255,66,53410,1,243861
24955,0.001191,74.125.24.0-255,1484,54894,1,243861
24956,0.001195,74.125.24.0-255,1484,56378,1,243861
24957,0.001198,172.31.36.0-255,66,56444,1,243861
24958,0.001226,74.125.24.0-255,1484,57928,1,243861
24959,0.001232,74.125.24.0-255,5738,63666,1,243861
24960,0.001235,74.125.24.0-255,1484,65150,1,243861
24961,0.001244,172.31.36.0-255,66,65216,1,243861
24962,0.001257,74.125.24.0-255,5738,70954,1,243861
24963,0.001276,172.31.36.0-255,66,71020,1,243861
24964,0.001288,74.125.24.0-255,5738,76758,1,243861
24965,0.001303,74.125.24.0-255,2184,78942,1,243861
24966,0.001321,172.31.36.0-255,66,79008,1,243861
24967,0.001412,74.125.24.0-255,352,79360,1,243861
24968,0.00143,74.125.24.0-255,1484,80844,1,243861
24969,0.001433,172.31.36.0-255,66,80910,1,243861
24970,0.001468,74.125.24.0-255,2902,83812,1,243861
24971,0.001488,74.125.24.0-255,1484,85296,1,243861
24972,0.00149,74.125.24.0-255,1484,86780,1,243861
24973,0.001496,74.125.24.0-255,7156,93936,1,243861
24974,0.0015,74.125.24.0-255,4320,98256,1,243861
24975,0.001523,172.31.36.0-255,66,98322,1,243861
24976,0.001532,172.31.36.0-255,66,98388,1,243861
24977,0.001552,74.125.24.0-255,3602,101990,1,243861
24978,0.001575,172.31.36.0-255,66,102056,1,243861
24979,0.003612,74.125.24.0-255,1484,103540,1,243861
24980,0.003649,74.125.24.0-255,4320,107860,1,243861
24981,0.003654,172.31.36.0-255,66,107926,1,243861
24982,0.005711,74.125.24.0-255,2902,110828,1,243861
24983,0.005715,172.31.36.0-255,66,110894,1,243861
24984,0.005741,74.125.24.0-255,2902,113796,1,243861
24985,0.005743,172.31.36.0-255,66,113862,1,243861
24986,0.007768,74.125.24.0-255,2902,116764,1,243861
24987,0.007774,172.31.36.0-255,66,116830,1,243861
24988,0.007803,74.125.24.0-255,2902,119732,1,243861
24989,0.007805,172.31.36.0-255,66,119798,1,243861
24990,0.009883,74.125.24.0-255,5738,125536,1,243861
24991,0.009894,172.31.36.0-255,66,125602,1,243861
24992,0.011961,74.125.24.0-255,5738,131340,1,243861
24993,0.012247,172.31.36.0-255,66,131406,1,243861
24994,0.014323,74.125.24.0-255,5738,137144,1,243861
24995,0.014334,172.31.36.0-255,66,137210,1,243861
24996,0.016399,74.125.24.0-255,5738,142948,1,243861
24997,0.01641,172.31.36.0-255,66,143014,1,243861
24998,0.018547,74.125.24.0-255,5738,148752,1,243861
24999,0.018554,172.31.36.0-255,66,148818,1,243861
25000,0.020631,74.125.24.0-255,5738,154556,1,243861
25001,0.020639,172.31.36.0-255,66,154622,1,243861
25002,0.02269,74.125.24.0-255,5738,160360,1,243861
25003,0.022698,172.31.36.0-255,66,160426,1,243861
25004,0.024745,74.125.24.0-255,5738,166164,1,243861
25005,0.024753,172.31.36.0-255,66,166230,1,243861
25006,0.026823,74.125.24.0-255,5738,171968,1,243861
25007,0.026831,172.31.36.0-255,66,172034,1,243861
25008,0.028888,74.125.24.0-255,5738,177772,1,243861
25009,0.028895,172.31.36.0-255,66,177838,1,243861
25010,0.029679,172.31.36.0-255,172,178010,1,243861
25011,0.029721,172.31.36.0-255,1115,179125,1,243861
25012,0.029798,172.31.36.0-255,1514,180639,1,243861
25013,0.0298,172.31.36.0-255,1514,182153,1,243861
25014,0.029801,172.31.36.0-255,1514,183667,1,243861
25015,0.029802,172.31.36.0-255,1514,185181,1,243861
25016,0.02984,172.31.36.0-255,1488,186669,1,243861
25017,0.030994,74.125.24.0-255,2902,189571,1,243861
25018,0.031001,172.31.36.0-255,66,189637,1,243861
25019,0.031027,74.125.24.0-255,2902,192539,1,243861
25020,0.031031,172.31.36.0-255,66,192605,1,243861
25021,0.031244,104.244.42.0-255,66,192671,1,243861
25022,0.031268,104.244.42.0-255,66,192737,1,243861
25023,0.031399,104.244.42.0-255,66,192803,1,243861
25024,0.032467,104.244.42.0-255,108,192911,1,243861
25025,0.032476,172.31.36.0-255,66,192977,1,243861
25026,0.033082,74.125.24.0-255,5738,198715,1,243861
25027,0.033087,172.31.36.0-255,66,198781,1,243861
25028,0.035145,74.125.24.0-255,5738,204519,1,243861
25029,0.035151,172.31.36.0-255,66,204585,1,243861
25030,0.037227,74.125.24.0-255,5738,210323,1,243861
25031,0.037236,172.31.36.0-255,66,210389,1,243861
25032,0.039332,74.125.24.0-255,5738,216127,1,243861
25033,0.039338,172.31.36.0-255,66,216193,1,243861
25034,0.041379,74.125.24.0-255,5738,221931,1,243861
25035,0.041385,172.31.36.0-255,66,221997,1,243861
25036,0.043449,74.125.24.0-255,4320,226317,1,243861
25037,0.043455,172.31.36.0-255,66,226383,1,243861
25038,0.043483,74.125.24.0-255,1484,227867,1,243861
25039,0.045528,74.125.24.0-255,4320,232187,1,243861
25040,0.045533,172.31.36.0-255,66,232253,1,243861
25041,0.047573,74.125.24.0-255,5738,237991,1,243861
25042,0.047579,172.31.36.0-255,66,238057,1,243861
25043,0.049652,74.125.24.0-255,5738,243795,1,243861
25044,0.049658,172.31.36.0-255,66,243861,1,243861
25045,0.0,172.217.194.0-255,153,153,1,241419
25046,2.5e-05,172.31.36.0-255,66,219,1,241419
25047,3.2e-05,172.217.194.0-255,1484,1703,1,241419
25048,3.7e-05,172.31.36.0-255,66,1769,1,241419
25049,5e-05,172.217.194.0-255,2902,4671,1,241419
25050,5.3e-05,172.31.36.0-255,66,4737,1,241419
25051,5.7e-05,172.217.194.0-255,2902,7639,1,241419
25052,6.1e-05,172.31.36.0-255,66,7705,1,241419
25053,7.3e-05,172.31.36.0-255,66,7771,1,241419
25054,7.9e-05,172.217.194.0-255,4320,12091,1,241419
25055,8.2e-05,172.31.36.0-255,66,12157,1,241419
25056,0.00011,172.217.194.0-255,7156,19313,1,241419
25057,0.000118,172.31.36.0-255,66,19379,1,241419
25058,0.000148,172.217.194.0-255,3961,23340,1,241419
25059,0.000151,172.31.36.0-255,66,23406,1,241419
25060,0.000199,172.217.194.0-255,1484,24890,1,241419
25061,0.000202,172.31.36.0-255,66,24956,1,241419
25062,0.000207,172.217.194.0-255,2902,27858,1,241419
25063,0.000209,172.31.36.0-255,66,27924,1,241419
25064,0.000227,172.217.194.0-255,2902,30826,1,241419
25065,0.000229,172.31.36.0-255,66,30892,1,241419
25066,0.000248,172.217.194.0-255,2902,33794,1,241419
25067,0.000251,172.31.36.0-255,66,33860,1,241419
25068,0.00026,172.217.194.0-255,2902,36762,1,241419
25069,0.000262,172.31.36.0-255,66,36828,1,241419
25070,0.000285,172.217.194.0-255,3961,40789,1,241419
25071,0.000288,172.31.36.0-255,66,40855,1,241419
25072,0.000299,172.31.36.0-255,66,40921,1,241419
25073,0.000333,172.217.194.0-255,5738,46659,1,241419
25074,0.000336,172.31.36.0-255,66,46725,1,241419
25075,0.000363,172.217.194.0-255,2831,49556,1,241419
25076,0.000423,172.217.194.0-255,367,49923,1,241419
25077,0.000457,172.217.194.0-255,1484,51407,1,241419
25078,0.000462,172.217.194.0-255,2902,54309,1,241419
25079,0.000477,172.217.194.0-255,2902,57211,1,241419
25080,0.000494,172.217.194.0-255,2902,60113,1,241419
25081,0.000561,172.217.194.0-255,5379,65492,1,241419
25082,0.000644,172.31.36.0-255,66,65558,1,241419
25083,0.001402,172.217.194.0-255,1484,67042,1,241419
25084,0.00141,172.217.194.0-255,2902,69944,1,241419
25085,0.001414,172.31.36.0-255,66,70010,1,241419
25086,0.001422,172.217.194.0-255,5738,75748,1,241419
25087,0.001443,172.217.194.0-255,1484,77232,1,241419
25088,0.001459,172.217.194.0-255,5738,82970,1,241419
25089,0.001469,172.31.36.0-255,66,83036,1,241419
25090,0.00148,172.217.194.0-255,5738,88774,1,241419
25091,0.001489,172.31.36.0-255,66,88840,1,241419
25092,0.001501,172.217.194.0-255,4320,93160,1,241419
25093,0.001519,172.217.194.0-255,5738,98898,1,241419
25094,0.001556,172.217.194.0-255,5738,104636,1,241419
25095,0.001588,172.31.36.0-255,66,104702,1,241419
25096,0.003646,172.217.194.0-255,5738,110440,1,241419
25097,0.003654,172.31.36.0-255,66,110506,1,241419
25098,0.005694,172.217.194.0-255,5738,116244,1,241419
25099,0.005699,172.31.36.0-255,66,116310,1,241419
25100,0.007749,172.217.194.0-255,5738,122048,1,241419
25101,0.00787,172.31.36.0-255,66,122114,1,241419
25102,0.009919,172.217.194.0-255,5738,127852,1,241419
25103,0.009927,172.31.36.0-255,66,127918,1,241419
25104,0.011974,172.217.194.0-255,5738,133656,1,241419
25105,0.012995,172.31.36.0-255,66,133722,1,241419
25106,0.015048,172.217.194.0-255,5738,139460,1,241419
25107,0.015059,172.31.36.0-255,66,139526,1,241419
25108,0.017106,172.217.194.0-255,5738,145264,1,241419
25109,0.017118,172.31.36.0-255,66,145330,1,241419
25110,0.019189,172.217.194.0-255,5738,151068,1,241419
25111,0.019203,172.31.36.0-255,66,151134,1,241419
25112,0.021258,172.217.194.0-255,5738,156872,1,241419
25113,0.021267,172.31.36.0-255,66,156938,1,241419
25114,0.023317,172.217.194.0-255,5738,162676,1,241419
25115,0.023326,172.31.36.0-255,66,162742,1,241419
25116,0.02537,172.217.194.0-255,5738,168480,1,241419
25117,0.025377,172.31.36.0-255,66,168546,1,241419
25118,0.027426,172.217.194.0-255,5738,174284,1,241419
25119,0.027433,172.31.36.0-255,66,174350,1,241419
25120,0.029501,172.217.194.0-255,5738,180088,1,241419
25121,0.02951,172.31.36.0-255,66,180154,1,241419
25122,0.031574,172.217.194.0-255,5738,185892,1,241419
25123,0.031582,172.31.36.0-255,66,185958,1,241419
25124,0.033647,172.217.194.0-255,5738,191696,1,241419
25125,0.033655,172.31.36.0-255,66,191762,1,241419
25126,0.035703,172.217.194.0-255,5738,197500,1,241419
25127,0.03571,172.31.36.0-255,66,197566,1,241419
25128,0.036249,172.31.36.0-255,172,197738,1,241419
25129,0.03628,172.31.36.0-255,1114,198852,1,241419
25130,0.036344,172.31.36.0-255,1514,200366,1,241419
25131,0.036345,172.31.36.0-255,1514,201880,1,241419
25132,0.036351,172.31.36.0-255,1514,203394,1,241419
25133,0.036352,172.31.36.0-255,1514,204908,1,241419
25134,0.036371,172.31.36.0-255,1489,206397,1,241419
25135,0.037751,104.244.42.0-255,66,206463,1,241419
25136,0.037781,172.217.194.0-255,5738,212201,1,241419
25137,0.037786,172.31.36.0-255,66,212267,1,241419
25138,0.037855,104.244.42.0-255,66,212333,1,241419
25139,0.037958,104.244.42.0-255,66,212399,1,241419
25140,0.039843,172.217.194.0-255,5738,218137,1,241419
25141,0.03985,172.31.36.0-255,66,218203,1,241419
25142,0.041899,172.217.194.0-255,5738,223941,1,241419
25143,0.041907,172.31.36.0-255,66,224007,1,241419
25144,0.043951,172.217.194.0-255,5738,229745,1,241419
25145,0.043958,172.31.36.0-255,66,229811,1,241419
25146,0.046018,172.217.194.0-255,5738,235549,1,241419
25147,0.046025,172.31.36.0-255,66,235615,1,241419
25148,0.048079,172.217.194.0-255,5738,241353,1,241419
25149,0.048087,172.31.36.0-255,66,241419,1,241419
25150,0.0,74.125.24.0-255,150,150,1,172782
25151,3e-05,172.31.36.0-255,66,216,1,172782
25152,3.8e-05,74.125.24.0-255,1484,1700,1,172782
25153,4.2e-05,172.31.36.0-255,66,1766,1,172782
25154,4.6e-05,74.125.24.0-255,2902,4668,1,172782
25155,4.9e-05,172.31.36.0-255,66,4734,1,172782
25156,5.6e-05,74.125.24.0-255,7156,11890,1,172782
25157,5.9e-05,172.31.36.0-255,66,11956,1,172782
25158,6.4e-05,74.125.24.0-255,2055,14011,1,172782
25159,6.6e-05,172.31.36.0-255,66,14077,1,172782
25160,0.000106,172.31.36.0-255,66,14143,1,172782
25161,0.000131,74.125.24.0-255,5379,19522,1,172782
25162,0.000134,172.31.36.0-255,66,19588,1,172782
25163,0.000163,74.125.24.0-255,1484,21072,1,172782
25164,0.000166,172.31.36.0-255,66,21138,1,172782
25165,0.000185,74.125.24.0-255,2902,24040,1,172782
25166,0.000187,172.31.36.0-255,66,24106,1,172782
25167,0.000195,74.125.24.0-255,5738,29844,1,172782
25168,0.000198,172.31.36.0-255,66,29910,1,172782
25169,0.000231,172.31.36.0-255,66,29976,1,172782
25170,0.000253,74.125.24.0-255,4320,34296,1,172782
25171,0.000256,172.31.36.0-255,66,34362,1,172782
25172,0.000288,172.31.36.0-255,66,34428,1,172782
25173,0.000291,74.125.24.0-255,112,34540,1,172782
25174,0.000293,172.31.36.0-255,66,34606,1,172782
25175,0.000495,74.125.24.0-255,1484,36090,1,172782
25176,0.000501,172.31.36.0-255,66,36156,1,172782
25177,0.00051,74.125.24.0-255,2902,39058,1,172782
25178,0.000513,172.31.36.0-255,66,39124,1,172782
25179,0.000534,74.125.24.0-255,1484,40608,1,172782
25180,0.000555,74.125.24.0-255,4320,44928,1,172782
25181,0.000559,172.31.36.0-255,66,44994,1,172782
25182,0.000595,172.31.36.0-255,66,45060,1,172782
25183,0.0006,74.125.24.0-255,2902,47962,1,172782
25184,0.000602,172.31.36.0-255,66,48028,1,172782
25185,0.000632,172.31.36.0-255,66,48094,1,172782
25186,0.000945,74.125.24.0-255,1484,49578,1,172782
25187,0.000966,74.125.24.0-255,2902,52480,1,172782
25188,0.000969,172.31.36.0-255,66,52546,1,172782
25189,0.000976,74.125.24.0-255,5738,58284,1,172782
25190,0.000978,172.31.36.0-255,66,58350,1,172782
25191,0.001,74.125.24.0-255,2902,61252,1,172782
25192,0.001003,172.31.36.0-255,66,61318,1,172782
25193,0.001022,74.125.24.0-255,4320,65638,1,172782
25194,0.001025,172.31.36.0-255,66,65704,1,172782
25195,0.00104,172.31.36.0-255,66,65770,1,172782
25196,0.001056,74.125.24.0-255,1484,67254,1,172782
25197,0.001061,74.125.24.0-255,2184,69438,1,172782
25198,0.001063,172.31.36.0-255,66,69504,1,172782
25199,0.001148,74.125.24.0-255,1484,70988,1,172782
25200,0.001164,74.125.24.0-255,2902,73890,1,172782
25201,0.001168,172.31.36.0-255,66,73956,1,172782
25202,0.001175,74.125.24.0-255,5738,79694,1,172782
25203,0.001177,172.31.36.0-255,66,79760,1,172782
25204,0.001213,172.31.36.0-255,66,79826,1,172782
25205,0.001226,172.31.36.0-255,66,79892,1,172782
25206,0.001244,74.125.24.0-255,1484,81376,1,172782
25207,0.001249,74.125.24.0-255,2902,84278,1,172782
25208,0.001252,172.31.36.0-255,66,84344,1,172782
25209,0.001277,74.125.24.0-255,6438,90782,1,172782
25210,0.00128,172.31.36.0-255,66,90848,1,172782
25211,0.001285,74.125.24.0-255,2902,93750,1,172782
25212,0.001287,172.31.36.0-255,66,93816,1,172782
25213,0.001303,74.125.24.0-255,5738,99554,1,172782
25214,0.001306,172.31.36.0-255,66,99620,1,172782
25215,0.001369,172.31.36.0-255,66,99686,1,172782
25216,0.001374,74.125.24.0-255,4320,104006,1,172782
25217,0.001376,172.31.36.0-255,66,104072,1,172782
25218,0.001392,74.125.24.0-255,5020,109092,1,172782
25219,0.001396,172.31.36.0-255,66,109158,1,172782
25220,0.001584,74.125.24.0-255,1484,110642,1,172782
25221,0.001607,74.125.24.0-255,2902,113544,1,172782
25222,0.001611,172.31.36.0-255,66,113610,1,172782
25223,0.001635,74.125.24.0-255,5738,119348,1,172782
25224,0.001638,172.31.36.0-255,66,119414,1,172782
25225,0.001643,74.125.24.0-255,2902,122316,1,172782
25226,0.001645,172.31.36.0-255,66,122382,1,172782
25227,0.001686,172.31.36.0-255,66,122448,1,172782
25228,0.001695,74.125.24.0-255,1484,123932,1,172782
25229,0.001717,172.31.36.0-255,66,123998,1,172782
25230,0.001886,74.125.24.0-255,1484,125482,1,172782
25231,0.001901,74.125.24.0-255,2902,128384,1,172782
25232,0.001904,172.31.36.0-255,66,128450,1,172782
25233,0.00191,74.125.24.0-255,4320,132770,1,172782
25234,0.001913,172.31.36.0-255,66,132836,1,172782
25235,0.001925,74.125.24.0-255,1484,134320,1,172782
25236,0.001928,74.125.24.0-255,1484,135804,1,172782
25237,0.001931,172.31.36.0-255,66,135870,1,172782
25238,0.001967,172.31.36.0-255,66,135936,1,172782
25239,0.001976,172.31.36.0-255,66,136002,1,172782
25240,0.001994,74.125.24.0-255,1484,137486,1,172782
25241,0.001997,172.31.36.0-255,78,137564,1,172782
25242,0.002003,74.125.24.0-255,5738,143302,1,172782
25243,0.002007,172.31.36.0-255,78,143380,1,172782
25244,0.00204,172.31.36.0-255,66,143446,1,172782
25245,0.00208,172.31.36.0-255,66,143512,1,172782
25246,0.002086,74.125.24.0-255,5738,149250,1,172782
25247,0.002088,172.31.36.0-255,66,149316,1,172782
25248,0.002091,74.125.24.0-255,1484,150800,1,172782
25249,0.002095,74.125.24.0-255,1484,152284,1,172782
25250,0.002097,172.31.36.0-255,66,152350,1,172782
25251,0.002102,74.125.24.0-255,4320,156670,1,172782
25252,0.002104,172.31.36.0-255,66,156736,1,172782
25253,0.002148,172.31.36.0-255,66,156802,1,172782
25254,0.002158,172.31.36.0-255,66,156868,1,172782
25255,0.002161,74.125.24.0-255,1484,158352,1,172782
25256,0.002163,172.31.36.0-255,78,158430,1,172782
25257,0.002181,172.31.36.0-255,66,158496,1,172782
25258,0.002186,172.31.36.0-255,66,158562,1,172782
25259,0.002189,74.125.24.0-255,1484,160046,1,172782
25260,0.002226,74.125.24.0-255,1484,161530,1,172782
25261,0.00223,172.31.36.0-255,66,161596,1,172782
25262,0.002265,172.31.36.0-255,66,161662,1,172782
25263,0.00228,172.31.36.0-255,66,161728,1,172782
25264,0.00229,172.31.36.0-255,66,161794,1,172782
25265,0.002293,74.125.24.0-255,1484,163278,1,172782
25266,0.002321,172.31.36.0-255,66,163344,1,172782
25267,0.002325,74.125.24.0-255,105,163449,1,172782
25268,0.003522,172.31.36.0-255,66,163515,1,172782
25269,0.003548,172.31.36.0-255,105,163620,1,172782
25270,0.005456,74.125.24.0-255,66,163686,1,172782
25271,0.038287,172.31.36.0-255,172,163858,1,172782
25272,0.03832,172.31.36.0-255,1115,164973,1,172782
25273,0.038369,172.31.36.0-255,1514,166487,1,172782
25274,0.038371,172.31.36.0-255,1514,168001,1,172782
25275,0.038377,172.31.36.0-255,1514,169515,1,172782
25276,0.038378,172.31.36.0-255,1514,171029,1,172782
25277,0.038404,172.31.36.0-255,1489,172518,1,172782
25278,0.039827,104.244.42.0-255,66,172584,1,172782
25279,0.039876,104.244.42.0-255,66,172650,1,172782
25280,0.039968,104.244.42.0-255,66,172716,1,172782
25281,0.040014,104.244.42.0-255,66,172782,1,172782
25282,0.0,74.125.68.0-255,153,153,1,314801
25283,3.5e-05,172.31.36.0-255,66,219,1,314801
25284,4.2e-05,74.125.68.0-255,1484,1703,1,314801
25285,4.7e-05,172.31.36.0-255,66,1769,1,314801
25286,5.2e-05,74.125.68.0-255,2902,4671,1,314801
25287,5.6e-05,172.31.36.0-255,66,4737,1,314801
25288,6.3e-05,74.125.68.0-255,7156,11893,1,314801
25289,6.6e-05,172.31.36.0-255,66,11959,1,314801
25290,9.2e-05,74.125.68.0-255,2048,14007,1,314801
25291,9.4e-05,172.31.36.0-255,66,14073,1,314801
25292,0.00011,74.125.68.0-255,2902,16975,1,314801
25293,0.000113,172.31.36.0-255,66,17041,1,314801
25294,0.000134,74.125.68.0-255,7156,24197,1,314801
25295,0.000137,172.31.36.0-255,66,24263,1,314801
25296,0.00014,74.125.68.0-255,1484,25747,1,314801
25297,0.000142,172.31.36.0-255,66,25813,1,314801
25298,0.000161,74.125.68.0-255,1484,27297,1,314801
25299,0.000164,172.31.36.0-255,66,27363,1,314801
25300,0.00017,74.125.68.0-255,3961,31324,1,314801
25301,0.000172,172.31.36.0-255,66,31390,1,314801
25302,0.000304,74.125.68.0-255,1484,32874,1,314801
25303,0.000308,172.31.36.0-255,66,32940,1,314801
25304,0.000343,74.125.68.0-255,2902,35842,1,314801
25305,0.000347,172.31.36.0-255,66,35908,1,314801
25306,0.000364,74.125.68.0-255,1484,37392,1,314801
25307,0.000367,172.31.36.0-255,66,37458,1,314801
25308,0.000372,74.125.68.0-255,2902,40360,1,314801
25309,0.000375,172.31.36.0-255,66,40426,1,314801
25310,0.000402,74.125.68.0-255,5738,46164,1,314801
25311,0.000406,172.31.36.0-255,66,46230,1,314801
25312,0.00041,74.125.68.0-255,2543,48773,1,314801
25313,0.000412,172.31.36.0-255,66,48839,1,314801
25314,0.000416,74.125.68.0-255,2902,51741,1,314801
25315,0.000431,172.31.36.0-255,66,51807,1,314801
25316,0.000453,74.125.68.0-255,5738,57545,1,314801
25317,0.00046,172.31.36.0-255,66,57611,1,314801
25318,0.000511,74.125.68.0-255,2902,60513,1,314801
25319,0.000514,172.31.36.0-255,66,60579,1,314801
25320,0.000529,74.125.68.0-255,2902,63481,1,314801
25321,0.000541,172.31.36.0-255,66,63547,1,314801
25322,0.000571,74.125.68.0-255,2854,66401,1,314801
25323,0.000582,172.31.36.0-255,66,66467,1,314801
25324,0.000612,74.125.68.0-255,109,66576,1,314801
25325,0.0008,172.31.36.0-255,66,66642,1,314801
25326,0.000917,74.125.68.0-255,1484,68126,1,314801
25327,0.000926,74.125.68.0-255,2902,71028,1,314801
25328,0.000949,74.125.68.0-255,5738,76766,1,314801
25329,0.00097,74.125.68.0-255,2902,79668,1,314801
25330,0.000983,172.31.36.0-255,66,79734,1,314801
25331,0.00099,74.125.68.0-255,4320,84054,1,314801
25332,0.001001,74.125.68.0-255,1484,85538,1,314801
25333,0.001004,172.31.36.0-255,66,85604,1,314801
25334,0.001049,172.31.36.0-255,66,85670,1,314801
25335,0.001072,74.125.68.0-255,3602,89272,1,314801
25336,0.001089,172.31.36.0-255,66,89338,1,314801
25337,0.001117,74.125.68.0-255,1484,90822,1,314801
25338,0.001121,74.125.68.0-255,1484,92306,1,314801
25339,0.00114,74.125.68.0-255,1484,93790,1,314801
25340,0.001143,74.125.68.0-255,1484,95274,1,314801
25341,0.001162,74.125.68.0-255,4320,99594,1,314801
25342,0.001165,74.125.68.0-255,1484,101078,1,314801
25343,0.001168,74.125.68.0-255,2902,103980,1,314801
25344,0.001178,172.31.36.0-255,66,104046,1,314801
25345,0.001186,74.125.68.0-255,2902,106948,1,314801
25346,0.001195,172.31.36.0-255,66,107014,1,314801
25347,0.001203,74.125.68.0-255,2902,109916,1,314801
25348,0.001212,74.125.68.0-255,1484,111400,1,314801
25349,0.001229,74.125.68.0-255,7156,118556,1,314801
25350,0.001237,172.31.36.0-255,66,118622,1,314801
25351,0.001248,74.125.68.0-255,4320,122942,1,314801
25352,0.001266,172.31.36.0-255,66,123008,1,314801
25353,0.001283,74.125.68.0-255,1484,124492,1,314801
25354,0.001297,74.125.68.0-255,4320,128812,1,314801
25355,0.001309,172.31.36.0-255,66,128878,1,314801
25356,0.001333,74.125.68.0-255,5738,134616,1,314801
25357,0.00134,172.31.36.0-255,66,134682,1,314801
25358,0.001368,172.31.36.0-255,66,134748,1,314801
25359,0.001389,74.125.68.0-255,2902,137650,1,314801
25360,0.001394,172.31.36.0-255,66,137716,1,314801
25361,0.001407,74.125.68.0-255,3602,141318,1,314801
25362,0.001458,74.125.68.0-255,4320,145638,1,314801
25363,0.001463,172.31.36.0-255,66,145704,1,314801
25364,0.001474,74.125.68.0-255,2902,148606,1,314801
25365,0.001509,74.125.68.0-255,2902,151508,1,314801
25366,0.001516,172.31.36.0-255,66,151574,1,314801
25367,0.001547,172.31.36.0-255,66,151640,1,314801
25368,0.001563,74.125.68.0-255,3602,155242,1,314801
25369,0.001577,172.31.36.0-255,66,155308,1,314801
25370,0.001619,74.125.68.0-255,4320,159628,1,314801
25371,0.001624,74.125.68.0-255,1484,161112,1,314801
25372,0.001628,172.31.36.0-255,66,161178,1,314801
25373,0.001646,74.125.68.0-255,4320,165498,1,314801
25374,0.001673,172.31.36.0-255,66,165564,1,314801
25375,0.001683,172.31.36.0-255,66,165630,1,314801
25376,0.001698,74.125.68.0-255,1484,167114,1,314801
25377,0.001714,74.125.68.0-255,4320,171434,1,314801
25378,0.001719,172.31.36.0-255,66,171500,1,314801
25379,0.001764,74.125.68.0-255,6438,177938,1,314801
25380,0.001784,172.31.36.0-255,66,178004,1,314801
25381,0.003787,74.125.68.0-255,5738,183742,1,314801
25382,0.003794,172.31.36.0-255,66,183808,1,314801
25383,0.005808,74.125.68.0-255,2902,186710,1,314801
25384,0.005824,74.125.68.0-255,2902,189612,1,314801
25385,0.007378,172.31.36.0-255,66,189678,1,314801
25386,0.009403,74.125.68.0-255,5738,195416,1,314801
25387,0.009412,172.31.36.0-255,66,195482,1,314801
25388,0.011462,74.125.68.0-255,5738,201220,1,314801
25389,0.011469,172.31.36.0-255,66,201286,1,314801
25390,0.013488,74.125.68.0-255,5738,207024,1,314801
25391,0.013498,172.31.36.0-255,66,207090,1,314801
25392,0.015508,74.125.68.0-255,5738,212828,1,314801
25393,0.015517,172.31.36.0-255,66,212894,1,314801
25394,0.017527,74.125.68.0-255,5738,218632,1,314801
25395,0.017724,172.31.36.0-255,66,218698,1,314801
25396,0.019753,74.125.68.0-255,5738,224436,1,314801
25397,0.019761,172.31.36.0-255,66,224502,1,314801
25398,0.021803,74.125.68.0-255,5738,230240,1,314801
25399,0.021814,172.31.36.0-255,66,230306,1,314801
25400,0.023823,74.125.68.0-255,5738,236044,1,314801
25401,0.023834,172.31.36.0-255,66,236110,1,314801
25402,0.02584,74.125.68.0-255,5738,241848,1,314801
25403,0.025846,172.31.36.0-255,66,241914,1,314801
25404,0.02785,74.125.68.0-255,5738,247652,1,314801
25405,0.027857,172.31.36.0-255,66,247718,1,314801
25406,0.029872,74.125.68.0-255,5738,253456,1,314801
25407,0.029877,172.31.36.0-255,66,253522,1,314801
25408,0.031892,74.125.68.0-255,5738,259260,1,314801
25409,0.031898,172.31.36.0-255,66,259326,1,314801
25410,0.033929,74.125.68.0-255,5738,265064,1,314801
25411,0.033937,172.31.36.0-255,66,265130,1,314801
25412,0.035945,74.125.68.0-255,5738,270868,1,314801
25413,0.035953,172.31.36.0-255,66,270934,1,314801
25414,0.03797,74.125.68.0-255,5738,276672,1,314801
25415,0.037978,172.31.36.0-255,66,276738,1,314801
25416,0.038336,172.31.36.0-255,172,276910,1,314801
25417,0.038375,172.31.36.0-255,1112,278022,1,314801
25418,0.038418,172.31.36.0-255,1514,279536,1,314801
25419,0.03842,172.31.36.0-255,1514,281050,1,314801
25420,0.038425,172.31.36.0-255,1514,282564,1,314801
25421,0.038427,172.31.36.0-255,1514,284078,1,314801
25422,0.038448,172.31.36.0-255,1505,285583,1,314801
25423,0.03989,104.244.42.0-255,66,285649,1,314801
25424,0.039929,104.244.42.0-255,66,285715,1,314801
25425,0.039977,104.244.42.0-255,66,285781,1,314801
25426,0.039984,74.125.68.0-255,5738,291519,1,314801
25427,0.039989,172.31.36.0-255,66,291585,1,314801
25428,0.04201,74.125.68.0-255,5738,297323,1,314801
25429,0.042017,172.31.36.0-255,66,297389,1,314801
25430,0.044066,74.125.68.0-255,5738,303127,1,314801
25431,0.044073,172.31.36.0-255,66,303193,1,314801
25432,0.046107,74.125.68.0-255,5738,308931,1,314801
25433,0.046114,172.31.36.0-255,66,308997,1,314801
25434,0.048129,74.125.68.0-255,5738,314735,1,314801
25435,0.048135,172.31.36.0-255,66,314801,1,314801
25436,0.0,74.125.24.0-255,152,152,1,214025
25437,2.7e-05,172.31.36.0-255,66,218,1,214025
25438,3.5e-05,74.125.24.0-255,1484,1702,1,214025
25439,4e-05,172.31.36.0-255,66,1768,1,214025
25440,4.6e-05,74.125.24.0-255,2902,4670,1,214025
25441,4.9e-05,172.31.36.0-255,66,4736,1,214025
25442,5.7e-05,74.125.24.0-255,7156,11892,1,214025
25443,6e-05,172.31.36.0-255,66,11958,1,214025
25444,6.4e-05,74.125.24.0-255,2040,13998,1,214025
25445,6.6e-05,172.31.36.0-255,66,14064,1,214025
25446,0.000101,74.125.24.0-255,1484,15548,1,214025
25447,0.000104,172.31.36.0-255,66,15614,1,214025
25448,0.000109,74.125.24.0-255,2902,18516,1,214025
25449,0.000112,172.31.36.0-255,66,18582,1,214025
25450,0.000115,74.125.24.0-255,1484,20066,1,214025
25451,0.000117,172.31.36.0-255,66,20132,1,214025
25452,0.000134,74.125.24.0-255,4320,24452,1,214025
25453,0.000137,172.31.36.0-255,66,24518,1,214025
25454,0.000142,74.125.24.0-255,2902,27420,1,214025
25455,0.000144,172.31.36.0-255,66,27486,1,214025
25456,0.000167,74.125.24.0-255,3961,31447,1,214025
25457,0.00017,172.31.36.0-255,66,31513,1,214025
25458,0.000227,74.125.24.0-255,1484,32997,1,214025
25459,0.00023,172.31.36.0-255,66,33063,1,214025
25460,0.000242,74.125.24.0-255,1484,34547,1,214025
25461,0.000244,172.31.36.0-255,66,34613,1,214025
25462,0.000265,74.125.24.0-255,1484,36097,1,214025
25463,0.000267,172.31.36.0-255,66,36163,1,214025
25464,0.000274,74.125.24.0-255,5738,41901,1,214025
25465,0.000277,172.31.36.0-255,66,41967,1,214025
25466,0.00028,74.125.24.0-255,1484,43451,1,214025
25467,0.000281,172.31.36.0-255,66,43517,1,214025
25468,0.000372,74.125.24.0-255,110,43627,1,214025
25469,0.000423,172.31.36.0-255,66,43693,1,214025
25470,0.000441,74.125.24.0-255,333,44026,1,214025
25471,0.000966,172.31.36.0-255,66,44092,1,214025
25472,0.001698,74.125.24.0-255,1484,45576,1,214025
25473,0.00171,74.125.24.0-255,2902,48478,1,214025
25474,0.001714,172.31.36.0-255,66,48544,1,214025
25475,0.001719,74.125.24.0-255,1484,50028,1,214025
25476,0.001747,74.125.24.0-255,5738,55766,1,214025
25477,0.001762,74.125.24.0-255,2902,58668,1,214025
25478,0.001776,172.31.36.0-255,66,58734,1,214025
25479,0.001797,74.125.24.0-255,4320,63054,1,214025
25480,0.001804,172.31.36.0-255,66,63120,1,214025
25481,0.001829,74.125.24.0-255,5020,68140,1,214025
25482,0.001864,172.31.36.0-255,66,68206,1,214025
25483,0.002019,74.125.24.0-255,1484,69690,1,214025
25484,0.002026,74.125.24.0-255,2902,72592,1,214025
25485,0.002032,172.31.36.0-255,66,72658,1,214025
25486,0.002044,74.125.24.0-255,5738,78396,1,214025
25487,0.002112,74.125.24.0-255,2902,81298,1,214025
25488,0.002142,172.31.36.0-255,66,81364,1,214025
25489,0.004131,74.125.24.0-255,5738,87102,1,214025
25490,0.006708,172.31.36.0-255,66,87168,1,214025
25491,0.008769,74.125.24.0-255,4320,91488,1,214025
25492,0.008775,172.31.36.0-255,66,91554,1,214025
25493,0.008795,74.125.24.0-255,1484,93038,1,214025
25494,0.010809,74.125.24.0-255,4320,97358,1,214025
25495,0.010815,172.31.36.0-255,66,97424,1,214025
25496,0.012885,74.125.24.0-255,5738,103162,1,214025
25497,0.012892,172.31.36.0-255,66,103228,1,214025
25498,0.014933,74.125.24.0-255,5738,108966,1,214025
25499,0.014941,172.31.36.0-255,66,109032,1,214025
25500,0.016999,74.125.24.0-255,5738,114770,1,214025
25501,0.01701,172.31.36.0-255,66,114836,1,214025
25502,0.01905,74.125.24.0-255,5738,120574,1,214025
25503,0.019059,172.31.36.0-255,66,120640,1,214025
25504,0.021066,74.125.24.0-255,4320,124960,1,214025
25505,0.021072,172.31.36.0-255,66,125026,1,214025
25506,0.021095,74.125.24.0-255,1484,126510,1,214025
25507,0.023184,74.125.24.0-255,4320,130830,1,214025
25508,0.02319,172.31.36.0-255,66,130896,1,214025
25509,0.025278,74.125.24.0-255,5738,136634,1,214025
25510,0.025284,172.31.36.0-255,66,136700,1,214025
25511,0.027319,74.125.24.0-255,5738,142438,1,214025
25512,0.027326,172.31.36.0-255,66,142504,1,214025
25513,0.029359,74.125.24.0-255,5738,148242,1,214025
25514,0.029367,172.31.36.0-255,66,148308,1,214025
25515,0.03122,172.31.36.0-255,172,148480,1,214025
25516,0.031258,172.31.36.0-255,1113,149593,1,214025
25517,0.031304,172.31.36.0-255,1514,151107,1,214025
25518,0.031306,172.31.36.0-255,1514,152621,1,214025
25519,0.031307,172.31.36.0-255,1514,154135,1,214025
25520,0.031308,172.31.36.0-255,1514,155649,1,214025
25521,0.031333,172.31.36.0-255,1490,157139,1,214025
25522,0.031414,74.125.24.0-255,5738,162877,1,214025
25523,0.03142,172.31.36.0-255,66,162943,1,214025
25524,0.032804,104.244.42.0-255,66,163009,1,214025
25525,0.032851,104.244.42.0-255,66,163075,1,214025
25526,0.032921,104.244.42.0-255,66,163141,1,214025
25527,0.033465,74.125.24.0-255,5738,168879,1,214025
25528,0.033473,172.31.36.0-255,66,168945,1,214025
25529,0.035507,74.125.24.0-255,4320,173265,1,214025
25530,0.035513,172.31.36.0-255,66,173331,1,214025
25531,0.035539,74.125.24.0-255,1484,174815,1,214025
25532,0.037549,74.125.24.0-255,4320,179135,1,214025
25533,0.037556,172.31.36.0-255,66,179201,1,214025
25534,0.039608,74.125.24.0-255,5738,184939,1,214025
25535,0.039614,172.31.36.0-255,66,185005,1,214025
25536,0.041662,74.125.24.0-255,5738,190743,1,214025
25537,0.041672,172.31.36.0-255,66,190809,1,214025
25538,0.043734,74.125.24.0-255,5738,196547,1,214025
25539,0.043742,172.31.36.0-255,66,196613,1,214025
25540,0.045773,74.125.24.0-255,5738,202351,1,214025
25541,0.04578,172.31.36.0-255,66,202417,1,214025
25542,0.047829,74.125.24.0-255,5738,208155,1,214025
25543,0.047837,172.31.36.0-255,66,208221,1,214025
25544,0.049907,74.125.24.0-255,5738,213959,1,214025
25545,0.049914,172.31.36.0-255,66,214025,1,214025
25546,0.0,172.31.36.0-255,105,105,1,276
25547,0.001793,157.240.13.0-255,105,210,1,276
25548,0.001808,172.31.36.0-255,66,276,1,276
25549,0.0,172.31.36.0-255,66,66,1,66
25550,0.0,172.217.194.0-255,153,153,1,186496
25551,2.3e-05,172.31.36.0-255,66,219,1,186496
25552,3.1e-05,172.217.194.0-255,1484,1703,1,186496
25553,3.6e-05,172.31.36.0-255,66,1769,1,186496
25554,4.2e-05,172.217.194.0-255,2902,4671,1,186496
25555,4.6e-05,172.31.36.0-255,66,4737,1,186496
25556,5.4e-05,172.217.194.0-255,7156,11893,1,186496
25557,5.8e-05,172.31.36.0-255,66,11959,1,186496
25558,6.2e-05,172.217.194.0-255,2019,13978,1,186496
25559,6.5e-05,172.31.36.0-255,66,14044,1,186496
25560,9.9e-05,172.217.194.0-255,4320,18364,1,186496
25561,0.000102,172.31.36.0-255,66,18430,1,186496
25562,0.000132,172.217.194.0-255,7156,25586,1,186496
25563,0.000135,172.31.36.0-255,66,25652,1,186496
25564,0.00014,172.217.194.0-255,2902,28554,1,186496
25565,0.000142,172.31.36.0-255,66,28620,1,186496
25566,0.00017,172.217.194.0-255,2543,31163,1,186496
25567,0.000173,172.31.36.0-255,66,31229,1,186496
25568,0.000209,172.217.194.0-255,1484,32713,1,186496
25569,0.000211,172.31.36.0-255,66,32779,1,186496
25570,0.000217,172.217.194.0-255,2902,35681,1,186496
25571,0.00022,172.31.36.0-255,66,35747,1,186496
25572,0.000223,172.217.194.0-255,1484,37231,1,186496
25573,0.000225,172.31.36.0-255,66,37297,1,186496
25574,0.000246,172.217.194.0-255,4320,41617,1,186496
25575,0.000249,172.31.36.0-255,66,41683,1,186496
25576,0.000284,172.31.36.0-255,66,41749,1,186496
25577,0.000316,172.217.194.0-255,5738,47487,1,186496
25578,0.000319,172.31.36.0-255,66,47553,1,186496
25579,0.000345,172.217.194.0-255,2902,50455,1,186496
25580,0.000348,172.31.36.0-255,66,50521,1,186496
25581,0.000357,172.217.194.0-255,7089,57610,1,186496
25582,0.000359,172.31.36.0-255,66,57676,1,186496
25583,0.000362,172.217.194.0-255,98,57774,1,186496
25584,0.000366,172.217.194.0-255,363,58137,1,186496
25585,0.000552,172.217.194.0-255,1484,59621,1,186496
25586,0.000558,172.217.194.0-255,2902,62523,1,186496
25587,0.000563,172.31.36.0-255,66,62589,1,186496
25588,0.000568,172.31.36.0-255,66,62655,1,186496
25589,0.000583,172.217.194.0-255,5738,68393,1,186496
25590,0.000585,172.31.36.0-255,66,68459,1,186496
25591,0.000604,172.217.194.0-255,4320,72779,1,186496
25592,0.000607,172.31.36.0-255,66,72845,1,186496
25593,0.000644,172.31.36.0-255,66,72911,1,186496
25594,0.000653,172.217.194.0-255,7156,80067,1,186496
25595,0.000655,172.31.36.0-255,66,80133,1,186496
25596,0.000671,172.217.194.0-255,3602,83735,1,186496
25597,0.000673,172.31.36.0-255,66,83801,1,186496
25598,0.00076,172.217.194.0-255,1484,85285,1,186496
25599,0.000764,172.217.194.0-255,1484,86769,1,186496
25600,0.000767,172.31.36.0-255,66,86835,1,186496
25601,0.000781,172.217.194.0-255,1484,88319,1,186496
25602,0.000788,172.217.194.0-255,5738,94057,1,186496
25603,0.000791,172.31.36.0-255,66,94123,1,186496
25604,0.000796,172.217.194.0-255,4320,98443,1,186496
25605,0.000798,172.31.36.0-255,66,98509,1,186496
25606,0.000825,172.31.36.0-255,66,98575,1,186496
25607,0.000838,172.31.36.0-255,66,98641,1,186496
25608,0.00088,172.217.194.0-255,4320,102961,1,186496
25609,0.000883,172.31.36.0-255,66,103027,1,186496
25610,0.000919,172.217.194.0-255,3602,106629,1,186496
25611,0.000923,172.31.36.0-255,66,106695,1,186496
25612,0.000927,172.31.36.0-255,66,106761,1,186496
25613,0.000929,172.31.36.0-255,66,106827,1,186496
25614,0.00098,172.217.194.0-255,7156,113983,1,186496
25615,0.000984,172.31.36.0-255,66,114049,1,186496
25616,0.001006,172.217.194.0-255,2902,116951,1,186496
25617,0.001008,172.31.36.0-255,66,117017,1,186496
25618,0.001022,172.31.36.0-255,66,117083,1,186496
25619,0.001043,172.217.194.0-255,5738,122821,1,186496
25620,0.001045,172.31.36.0-255,66,122887,1,186496
25621,0.001073,172.217.194.0-255,6438,129325,1,186496
25622,0.001076,172.31.36.0-255,66,129391,1,186496
25623,0.001082,172.217.194.0-255,4320,133711,1,186496
25624,0.001084,172.31.36.0-255,66,133777,1,186496
25625,0.001091,172.217.194.0-255,5738,139515,1,186496
25626,0.001093,172.31.36.0-255,66,139581,1,186496
25627,0.001125,172.31.36.0-255,66,139647,1,186496
25628,0.001147,172.31.36.0-255,66,139713,1,186496
25629,0.001168,172.217.194.0-255,2184,141897,1,186496
25630,0.00117,172.31.36.0-255,66,141963,1,186496
25631,0.001238,172.31.36.0-255,66,142029,1,186496
25632,0.001257,172.31.36.0-255,66,142095,1,186496
25633,0.001278,172.31.36.0-255,66,142161,1,186496
25634,0.001329,172.31.36.0-255,66,142227,1,186496
25635,0.001335,172.217.194.0-255,4320,146547,1,186496
25636,0.001337,172.31.36.0-255,66,146613,1,186496
25637,0.001359,172.31.36.0-255,66,146679,1,186496
25638,0.001378,172.217.194.0-255,5738,152417,1,186496
25639,0.00138,172.31.36.0-255,66,152483,1,186496
25640,0.001412,172.31.36.0-255,66,152549,1,186496
25641,0.001419,172.217.194.0-255,6438,158987,1,186496
25642,0.001421,172.31.36.0-255,66,159053,1,186496
25643,0.00144,172.217.194.0-255,1484,160537,1,186496
25644,0.001444,172.217.194.0-255,2902,163439,1,186496
25645,0.001447,172.31.36.0-255,66,163505,1,186496
25646,0.001452,172.217.194.0-255,4320,167825,1,186496
25647,0.001454,172.31.36.0-255,66,167891,1,186496
25648,0.001473,172.217.194.0-255,1484,169375,1,186496
25649,0.001489,172.31.36.0-255,66,169441,1,186496
25650,0.001522,172.31.36.0-255,66,169507,1,186496
25651,0.001557,172.217.194.0-255,5738,175245,1,186496
25652,0.00156,172.31.36.0-255,66,175311,1,186496
25653,0.001588,172.31.36.0-255,66,175377,1,186496
25654,0.001617,172.31.36.0-255,66,175443,1,186496
25655,0.001636,172.217.194.0-255,1484,176927,1,186496
25656,0.001647,172.31.36.0-255,66,176993,1,186496
25657,0.001675,172.31.36.0-255,66,177059,1,186496
25658,0.001678,172.217.194.0-255,105,177164,1,186496
25659,0.01079,172.31.36.0-255,66,177230,1,186496
25660,0.010838,172.31.36.0-255,105,177335,1,186496
25661,0.013036,172.217.194.0-255,66,177401,1,186496
25662,0.044855,172.31.36.0-255,172,177573,1,186496
25663,0.04489,172.31.36.0-255,1115,178688,1,186496
25664,0.044959,172.31.36.0-255,1514,180202,1,186496
25665,0.044961,172.31.36.0-255,1514,181716,1,186496
25666,0.044966,172.31.36.0-255,1514,183230,1,186496
25667,0.044968,172.31.36.0-255,1514,184744,1,186496
25668,0.044995,172.31.36.0-255,1488,186232,1,186496
25669,0.046387,104.244.42.0-255,66,186298,1,186496
25670,0.046425,104.244.42.0-255,66,186364,1,186496
25671,0.046574,104.244.42.0-255,66,186430,1,186496
25672,0.046609,104.244.42.0-255,66,186496,1,186496
25673,0.0,74.125.24.0-255,153,153,1,284369
25674,2.4e-05,172.31.36.0-255,66,219,1,284369
25675,3.2e-05,74.125.24.0-255,1484,1703,1,284369
25676,3.7e-05,172.31.36.0-255,66,1769,1,284369
25677,4.3e-05,74.125.24.0-255,2902,4671,1,284369
25678,4.7e-05,172.31.36.0-255,66,4737,1,284369
25679,5.2e-05,74.125.24.0-255,2902,7639,1,284369
25680,5.5e-05,172.31.36.0-255,66,7705,1,284369
25681,6.7e-05,172.31.36.0-255,66,7771,1,284369
25682,7.4e-05,74.125.24.0-255,4320,12091,1,284369
25683,7.6e-05,172.31.36.0-255,66,12157,1,284369
25684,0.000102,74.125.24.0-255,2902,15059,1,284369
25685,0.000104,172.31.36.0-255,66,15125,1,284369
25686,0.000117,172.31.36.0-255,66,15191,1,284369
25687,0.000152,172.31.36.0-255,66,15257,1,284369
25688,0.000163,172.31.36.0-255,66,15323,1,284369
25689,0.00023,74.125.24.0-255,1484,16807,1,284369
25690,0.000233,172.31.36.0-255,66,16873,1,284369
25691,0.000238,74.125.24.0-255,2902,19775,1,284369
25692,0.00024,172.31.36.0-255,66,19841,1,284369
25693,0.00027,74.125.24.0-255,5738,25579,1,284369
25694,0.000273,172.31.36.0-255,66,25645,1,284369
25695,0.000278,74.125.24.0-255,2902,28547,1,284369
25696,0.00028,172.31.36.0-255,66,28613,1,284369
25697,0.000294,74.125.24.0-255,1484,30097,1,284369
25698,0.000296,172.31.36.0-255,66,30163,1,284369
25699,0.000318,74.125.24.0-255,2816,32979,1,284369
25700,0.000321,172.31.36.0-255,66,33045,1,284369
25701,0.00085,74.125.24.0-255,1484,34529,1,284369
25702,0.000859,74.125.24.0-255,2902,37431,1,284369
25703,0.000863,172.31.36.0-255,66,37497,1,284369
25704,0.00087,74.125.24.0-255,5738,43235,1,284369
25705,0.000887,172.31.36.0-255,66,43301,1,284369
25706,0.000895,74.125.24.0-255,7091,50392,1,284369
25707,0.000897,172.31.36.0-255,66,50458,1,284369
25708,0.000925,74.125.24.0-255,7156,57614,1,284369
25709,0.000927,172.31.36.0-255,66,57680,1,284369
25710,0.000955,74.125.24.0-255,7156,64836,1,284369
25711,0.000958,172.31.36.0-255,66,64902,1,284369
25712,0.000965,74.125.24.0-255,5738,70640,1,284369
25713,0.000966,172.31.36.0-255,66,70706,1,284369
25714,0.001028,172.31.36.0-255,66,70772,1,284369
25715,0.001397,74.125.24.0-255,1484,72256,1,284369
25716,0.001406,74.125.24.0-255,2902,75158,1,284369
25717,0.00141,172.31.36.0-255,66,75224,1,284369
25718,0.001434,74.125.24.0-255,5738,80962,1,284369
25719,0.001437,172.31.36.0-255,66,81028,1,284369
25720,0.001444,74.125.24.0-255,5738,86766,1,284369
25721,0.001446,172.31.36.0-255,66,86832,1,284369
25722,0.001473,74.125.24.0-255,2902,89734,1,284369
25723,0.001476,172.31.36.0-255,66,89800,1,284369
25724,0.00151,172.31.36.0-255,66,89866,1,284369
25725,0.001516,74.125.24.0-255,5020,94886,1,284369
25726,0.001519,172.31.36.0-255,66,94952,1,284369
25727,0.001538,74.125.24.0-255,2902,97854,1,284369
25728,0.001541,172.31.36.0-255,66,97920,1,284369
25729,0.001563,172.31.36.0-255,66,97986,1,284369
25730,0.001589,74.125.24.0-255,5738,103724,1,284369
25731,0.001592,172.31.36.0-255,66,103790,1,284369
25732,0.0016,74.125.24.0-255,7156,110946,1,284369
25733,0.001602,172.31.36.0-255,66,111012,1,284369
25734,0.001621,74.125.24.0-255,6438,117450,1,284369
25735,0.001624,172.31.36.0-255,66,117516,1,284369
25736,0.001705,74.125.24.0-255,1484,119000,1,284369
25737,0.001711,74.125.24.0-255,2902,121902,1,284369
25738,0.001715,172.31.36.0-255,66,121968,1,284369
25739,0.001722,74.125.24.0-255,5738,127706,1,284369
25740,0.001725,172.31.36.0-255,66,127772,1,284369
25741,0.001728,74.125.24.0-255,1484,129256,1,284369
25742,0.001772,172.31.36.0-255,66,129322,1,284369
25743,0.001779,74.125.24.0-255,7156,136478,1,284369
25744,0.001783,172.31.36.0-255,66,136544,1,284369
25745,0.001799,74.125.24.0-255,2902,139446,1,284369
25746,0.001801,172.31.36.0-255,66,139512,1,284369
25747,0.001805,74.125.24.0-255,766,140278,1,284369
25748,0.002173,74.125.24.0-255,1484,141762,1,284369
25749,0.00218,172.31.36.0-255,66,141828,1,284369
25750,0.002187,74.125.24.0-255,2902,144730,1,284369
25751,0.00219,172.31.36.0-255,66,144796,1,284369
25752,0.002197,74.125.24.0-255,5738,150534,1,284369
25753,0.0022,172.31.36.0-255,66,150600,1,284369
25754,0.002203,74.125.24.0-255,1484,152084,1,284369
25755,0.002219,74.125.24.0-255,1484,153568,1,284369
25756,0.002221,172.31.36.0-255,66,153634,1,284369
25757,0.002225,74.125.24.0-255,1484,155118,1,284369
25758,0.002252,172.31.36.0-255,66,155184,1,284369
25759,0.002259,74.125.24.0-255,5738,160922,1,284369
25760,0.002261,172.31.36.0-255,66,160988,1,284369
25761,0.002292,74.125.24.0-255,5020,166008,1,284369
25762,0.002294,172.31.36.0-255,66,166074,1,284369
25763,0.0023,74.125.24.0-255,4320,170394,1,284369
25764,0.002302,172.31.36.0-255,66,170460,1,284369
25765,0.00232,74.125.24.0-255,7156,177616,1,284369
25766,0.002323,172.31.36.0-255,66,177682,1,284369
25767,0.00234,172.31.36.0-255,66,177748,1,284369
25768,0.002393,74.125.24.0-255,5738,183486,1,284369
25769,0.002396,172.31.36.0-255,66,183552,1,284369
25770,0.002426,74.125.24.0-255,3602,187154,1,284369
25771,0.002428,172.31.36.0-255,66,187220,1,284369
25772,0.00244,172.31.36.0-255,66,187286,1,284369
25773,0.002457,172.31.36.0-255,66,187352,1,284369
25774,0.002462,74.125.24.0-255,3602,190954,1,284369
25775,0.002464,172.31.36.0-255,66,191020,1,284369
25776,0.00487,74.125.24.0-255,1484,192504,1,284369
25777,0.004911,74.125.24.0-255,4320,196824,1,284369
25778,0.004916,172.31.36.0-255,66,196890,1,284369
25779,0.007307,74.125.24.0-255,5738,202628,1,284369
25780,0.007329,172.31.36.0-255,66,202694,1,284369
25781,0.00974,74.125.24.0-255,5738,208432,1,284369
25782,0.009757,172.31.36.0-255,66,208498,1,284369
25783,0.012208,74.125.24.0-255,5738,214236,1,284369
25784,0.012223,172.31.36.0-255,66,214302,1,284369
25785,0.014615,74.125.24.0-255,5738,220040,1,284369
25786,0.014622,172.31.36.0-255,66,220106,1,284369
25787,0.01702,74.125.24.0-255,5738,225844,1,284369
25788,0.017026,172.31.36.0-255,66,225910,1,284369
25789,0.019397,74.125.24.0-255,5738,231648,1,284369
25790,0.019404,172.31.36.0-255,66,231714,1,284369
25791,0.021824,74.125.24.0-255,5738,237452,1,284369
25792,0.021835,172.31.36.0-255,66,237518,1,284369
25793,0.024236,74.125.24.0-255,5738,243256,1,284369
25794,0.024245,172.31.36.0-255,66,243322,1,284369
25795,0.026687,74.125.24.0-255,5738,249060,1,284369
25796,0.026694,172.31.36.0-255,66,249126,1,284369
25797,0.029093,74.125.24.0-255,5738,254864,1,284369
25798,0.029101,172.31.36.0-255,66,254930,1,284369
25799,0.031509,74.125.24.0-255,5738,260668,1,284369
25800,0.031521,172.31.36.0-255,66,260734,1,284369
25801,0.033895,74.125.24.0-255,5738,266472,1,284369
25802,0.033903,172.31.36.0-255,66,266538,1,284369
25803,0.03629,74.125.24.0-255,5738,272276,1,284369
25804,0.036299,172.31.36.0-255,66,272342,1,284369
25805,0.038759,74.125.24.0-255,5738,278080,1,284369
25806,0.038767,172.31.36.0-255,66,278146,1,284369
25807,0.041137,74.125.24.0-255,5738,283884,1,284369
25808,0.041146,172.31.36.0-255,66,283950,1,284369
25809,0.043559,74.125.24.0-255,182,284132,1,284369
25810,0.043692,172.31.36.0-255,66,284198,1,284369
25811,0.043731,172.31.36.0-255,105,284303,1,284369
25812,0.046076,74.125.24.0-255,66,284369,1,284369
25813,0.0,172.217.194.0-255,174,174,1,161727
25814,1.6e-05,172.31.36.0-255,66,240,1,161727
25815,2.4e-05,172.217.194.0-255,1484,1724,1,161727
25816,2.7e-05,172.31.36.0-255,66,1790,1,161727
25817,4e-05,172.217.194.0-255,2902,4692,1,161727
25818,4.5e-05,172.31.36.0-255,66,4758,1,161727
25819,5.2e-05,172.217.194.0-255,7156,11914,1,161727
25820,5.6e-05,172.31.36.0-255,66,11980,1,161727
25821,0.000152,172.217.194.0-255,3438,15418,1,161727
25822,0.000156,172.31.36.0-255,66,15484,1,161727
25823,0.000222,172.31.36.0-255,66,15550,1,161727
25824,0.000413,172.217.194.0-255,2543,18093,1,161727
25825,0.000419,172.31.36.0-255,66,18159,1,161727
25826,0.000446,172.217.194.0-255,4320,22479,1,161727
25827,0.000449,172.31.36.0-255,66,22545,1,161727
25828,0.000496,172.31.36.0-255,66,22611,1,161727
25829,0.000833,172.31.36.0-255,66,22677,1,161727
25830,0.000951,172.217.194.0-255,98,22775,1,161727
25831,0.000957,172.31.36.0-255,66,22841,1,161727
25832,0.000987,172.217.194.0-255,7156,29997,1,161727
25833,0.00099,172.31.36.0-255,66,30063,1,161727
25834,0.001044,172.31.36.0-255,66,30129,1,161727
25835,0.00163,172.31.36.0-255,66,30195,1,161727
25836,0.001765,172.217.194.0-255,5738,35933,1,161727
25837,0.001769,172.31.36.0-255,66,35999,1,161727
25838,0.001825,172.31.36.0-255,66,36065,1,161727
25839,0.002868,172.217.194.0-255,5738,41803,1,161727
25840,0.003724,172.217.194.0-255,7156,48959,1,161727
25841,0.004136,172.31.36.0-255,66,49025,1,161727
25842,0.006402,172.217.194.0-255,5738,54763,1,161727
25843,0.006411,172.31.36.0-255,66,54829,1,161727
25844,0.008677,172.217.194.0-255,5738,60567,1,161727
25845,0.008684,172.31.36.0-255,66,60633,1,161727
25846,0.010963,172.217.194.0-255,5738,66371,1,161727
25847,0.01097,172.31.36.0-255,66,66437,1,161727
25848,0.013233,172.217.194.0-255,5738,72175,1,161727
25849,0.01324,172.31.36.0-255,66,72241,1,161727
25850,0.015481,172.217.194.0-255,5738,77979,1,161727
25851,0.015488,172.31.36.0-255,66,78045,1,161727
25852,0.017738,172.217.194.0-255,5738,83783,1,161727
25853,0.017959,172.31.36.0-255,66,83849,1,161727
25854,0.020228,172.217.194.0-255,5738,89587,1,161727
25855,0.020238,172.31.36.0-255,66,89653,1,161727
25856,0.0225,172.217.194.0-255,5738,95391,1,161727
25857,0.02251,172.31.36.0-255,66,95457,1,161727
25858,0.024763,172.217.194.0-255,5738,101195,1,161727
25859,0.024771,172.31.36.0-255,66,101261,1,161727
25860,0.027029,172.217.194.0-255,5738,106999,1,161727
25861,0.027037,172.31.36.0-255,66,107065,1,161727
25862,0.029298,172.217.194.0-255,5738,112803,1,161727
25863,0.029304,172.31.36.0-255,66,112869,1,161727
25864,0.031562,172.217.194.0-255,2902,115771,1,161727
25865,0.031568,172.31.36.0-255,66,115837,1,161727
25866,0.031597,172.217.194.0-255,2902,118739,1,161727
25867,0.033201,172.31.36.0-255,66,118805,1,161727
25868,0.03382,172.217.194.0-255,2902,121707,1,161727
25869,0.033827,172.31.36.0-255,66,121773,1,161727
25870,0.035461,172.217.194.0-255,2902,124675,1,161727
25871,0.035469,172.31.36.0-255,66,124741,1,161727
25872,0.036077,172.217.194.0-255,2902,127643,1,161727
25873,0.036082,172.31.36.0-255,66,127709,1,161727
25874,0.037718,172.217.194.0-255,2902,130611,1,161727
25875,0.037726,172.31.36.0-255,66,130677,1,161727
25876,0.038336,172.217.194.0-255,2902,133579,1,161727
25877,0.038343,172.31.36.0-255,66,133645,1,161727
25878,0.039969,172.217.194.0-255,2902,136547,1,161727
25879,0.039977,172.31.36.0-255,66,136613,1,161727
25880,0.040596,172.217.194.0-255,2902,139515,1,161727
25881,0.040602,172.31.36.0-255,66,139581,1,161727
25882,0.041185,172.31.36.0-255,172,139753,1,161727
25883,0.041215,172.31.36.0-255,1115,140868,1,161727
25884,0.041263,172.31.36.0-255,564,141432,1,161727
25885,0.042233,172.217.194.0-255,2902,144334,1,161727
25886,0.042242,172.31.36.0-255,66,144400,1,161727
25887,0.042654,104.244.42.0-255,66,144466,1,161727
25888,0.04268,104.244.42.0-255,66,144532,1,161727
25889,0.04272,104.244.42.0-255,66,144598,1,161727
25890,0.04285,172.217.194.0-255,2902,147500,1,161727
25891,0.042855,172.31.36.0-255,66,147566,1,161727
25892,0.044518,172.217.194.0-255,2902,150468,1,161727
25893,0.044527,172.31.36.0-255,66,150534,1,161727
25894,0.0451,172.217.194.0-255,2902,153436,1,161727
25895,0.045107,172.31.36.0-255,66,153502,1,161727
25896,0.046803,172.217.194.0-255,2902,156404,1,161727
25897,0.04681,172.31.36.0-255,66,156470,1,161727
25898,0.047368,172.217.194.0-255,2902,159372,1,161727
25899,0.047375,172.31.36.0-255,66,159438,1,161727
25900,0.049072,172.217.194.0-255,2118,161556,1,161727
25901,0.049078,172.31.36.0-255,66,161622,1,161727
25902,0.049234,172.31.36.0-255,105,161727,1,161727
25903,0.0,74.125.24.0-255,153,153,1,236671
25904,1.7e-05,172.31.36.0-255,66,219,1,236671
25905,2.4e-05,74.125.24.0-255,1484,1703,1,236671
25906,2.9e-05,172.31.36.0-255,66,1769,1,236671
25907,3.5e-05,74.125.24.0-255,2902,4671,1,236671
25908,3.8e-05,172.31.36.0-255,66,4737,1,236671
25909,4.5e-05,74.125.24.0-255,5738,10475,1,236671
25910,4.8e-05,172.31.36.0-255,66,10541,1,236671
25911,0.0001,74.125.24.0-255,6282,16823,1,236671
25912,0.000104,172.31.36.0-255,66,16889,1,236671
25913,0.000112,74.125.24.0-255,7156,24045,1,236671
25914,0.000114,172.31.36.0-255,66,24111,1,236671
25915,0.000155,74.125.24.0-255,6797,30908,1,236671
25916,0.000159,172.31.36.0-255,66,30974,1,236671
25917,0.00033,74.125.24.0-255,1484,32458,1,236671
25918,0.000335,172.31.36.0-255,66,32524,1,236671
25919,0.000341,74.125.24.0-255,2902,35426,1,236671
25920,0.000343,172.31.36.0-255,66,35492,1,236671
25921,0.000347,74.125.24.0-255,1484,36976,1,236671
25922,0.000349,172.31.36.0-255,66,37042,1,236671
25923,0.000369,74.125.24.0-255,2902,39944,1,236671
25924,0.000371,172.31.36.0-255,66,40010,1,236671
25925,0.000392,74.125.24.0-255,2902,42912,1,236671
25926,0.000395,172.31.36.0-255,66,42978,1,236671
25927,0.000426,74.125.24.0-255,6797,49775,1,236671
25928,0.000429,172.31.36.0-255,66,49841,1,236671
25929,0.000444,172.31.36.0-255,66,49907,1,236671
25930,0.000447,74.125.24.0-255,1472,51379,1,236671
25931,0.000449,172.31.36.0-255,66,51445,1,236671
25932,0.000619,74.125.24.0-255,331,51776,1,236671
25933,0.000622,172.31.36.0-255,66,51842,1,236671
25934,0.001021,74.125.24.0-255,1484,53326,1,236671
25935,0.001029,74.125.24.0-255,2902,56228,1,236671
25936,0.001032,172.31.36.0-255,66,56294,1,236671
25937,0.001038,74.125.24.0-255,4320,60614,1,236671
25938,0.00104,172.31.36.0-255,66,60680,1,236671
25939,0.001054,74.125.24.0-255,1484,62164,1,236671
25940,0.001058,74.125.24.0-255,2902,65066,1,236671
25941,0.00106,172.31.36.0-255,66,65132,1,236671
25942,0.001087,172.31.36.0-255,66,65198,1,236671
25943,0.001108,74.125.24.0-255,1484,66682,1,236671
25944,0.001124,74.125.24.0-255,5738,72420,1,236671
25945,0.001126,172.31.36.0-255,66,72486,1,236671
25946,0.001147,74.125.24.0-255,3602,76088,1,236671
25947,0.001149,172.31.36.0-255,66,76154,1,236671
25948,0.001855,74.125.24.0-255,1484,77638,1,236671
25949,0.001862,74.125.24.0-255,2902,80540,1,236671
25950,0.001866,172.31.36.0-255,66,80606,1,236671
25951,0.001871,74.125.24.0-255,4320,84926,1,236671
25952,0.001873,172.31.36.0-255,66,84992,1,236671
25953,0.001886,74.125.24.0-255,1484,86476,1,236671
25954,0.001898,74.125.24.0-255,2902,89378,1,236671
25955,0.0019,172.31.36.0-255,66,89444,1,236671
25956,0.001923,172.31.36.0-255,66,89510,1,236671
25957,0.001929,74.125.24.0-255,5738,95248,1,236671
25958,0.001931,172.31.36.0-255,66,95314,1,236671
25959,0.001955,74.125.24.0-255,2902,98216,1,236671
25960,0.001957,172.31.36.0-255,66,98282,1,236671
25961,0.00197,74.125.24.0-255,2184,100466,1,236671
25962,0.001972,172.31.36.0-255,66,100532,1,236671
25963,0.002234,74.125.24.0-255,1484,102016,1,236671
25964,0.002246,74.125.24.0-255,2902,104918,1,236671
25965,0.002249,172.31.36.0-255,66,104984,1,236671
25966,0.002273,74.125.24.0-255,5738,110722,1,236671
25967,0.002276,172.31.36.0-255,66,110788,1,236671
25968,0.002279,74.125.24.0-255,1484,112272,1,236671
25969,0.002305,172.31.36.0-255,66,112338,1,236671
25970,0.002325,172.31.36.0-255,66,112404,1,236671
25971,0.002346,74.125.24.0-255,2184,114588,1,236671
25972,0.002348,172.31.36.0-255,66,114654,1,236671
25973,0.002561,74.125.24.0-255,1484,116138,1,236671
25974,0.002597,74.125.24.0-255,1484,117622,1,236671
25975,0.0026,172.31.36.0-255,66,117688,1,236671
25976,0.002618,74.125.24.0-255,1484,119172,1,236671
25977,0.002625,74.125.24.0-255,5738,124910,1,236671
25978,0.002628,172.31.36.0-255,66,124976,1,236671
25979,0.002641,172.31.36.0-255,66,125042,1,236671
25980,0.002653,172.31.36.0-255,66,125108,1,236671
25981,0.002655,74.125.24.0-255,766,125874,1,236671
25982,0.005234,74.125.24.0-255,2902,128776,1,236671
25983,0.005237,172.31.36.0-255,66,128842,1,236671
25984,0.005254,74.125.24.0-255,1484,130326,1,236671
25985,0.007846,74.125.24.0-255,4320,134646,1,236671
25986,0.007853,172.31.36.0-255,66,134712,1,236671
25987,0.010465,74.125.24.0-255,5738,140450,1,236671
25988,0.010473,172.31.36.0-255,66,140516,1,236671
25989,0.013092,74.125.24.0-255,5738,146254,1,236671
25990,0.013102,172.31.36.0-255,66,146320,1,236671
25991,0.015729,74.125.24.0-255,5738,152058,1,236671
25992,0.015748,172.31.36.0-255,66,152124,1,236671
25993,0.01835,74.125.24.0-255,5738,157862,1,236671
25994,0.018364,172.31.36.0-255,66,157928,1,236671
25995,0.021027,74.125.24.0-255,5738,163666,1,236671
25996,0.021036,172.31.36.0-255,66,163732,1,236671
25997,0.023664,74.125.24.0-255,5738,169470,1,236671
25998,0.023668,172.31.36.0-255,66,169536,1,236671
25999,0.026286,74.125.24.0-255,5738,175274,1,236671
26000,0.026293,172.31.36.0-255,66,175340,1,236671
26001,0.028926,74.125.24.0-255,5738,181078,1,236671
26002,0.028934,172.31.36.0-255,66,181144,1,236671
26003,0.031549,74.125.24.0-255,5738,186882,1,236671
26004,0.031557,172.31.36.0-255,66,186948,1,236671
26005,0.034165,74.125.24.0-255,5738,192686,1,236671
26006,0.034175,172.31.36.0-255,66,192752,1,236671
26007,0.034686,172.31.36.0-255,172,192924,1,236671
26008,0.034717,172.31.36.0-255,1115,194039,1,236671
26009,0.034791,172.31.36.0-255,1514,195553,1,236671
26010,0.034794,172.31.36.0-255,1514,197067,1,236671
26011,0.034795,172.31.36.0-255,1514,198581,1,236671
26012,0.034796,172.31.36.0-255,1514,200095,1,236671
26013,0.034797,172.31.36.0-255,1488,201583,1,236671
26014,0.036228,104.244.42.0-255,66,201649,1,236671
26015,0.036276,104.244.42.0-255,66,201715,1,236671
26016,0.036376,104.244.42.0-255,66,201781,1,236671
26017,0.036382,104.244.42.0-255,66,201847,1,236671
26018,0.03682,74.125.24.0-255,5738,207585,1,236671
26019,0.036826,172.31.36.0-255,66,207651,1,236671
26020,0.039442,74.125.24.0-255,5738,213389,1,236671
26021,0.039449,172.31.36.0-255,66,213455,1,236671
26022,0.042066,74.125.24.0-255,5738,219193,1,236671
26023,0.042073,172.31.36.0-255,66,219259,1,236671
26024,0.044692,74.125.24.0-255,5738,224997,1,236671
26025,0.044701,172.31.36.0-255,66,225063,1,236671
26026,0.047322,74.125.24.0-255,5738,230801,1,236671
26027,0.047329,172.31.36.0-255,66,230867,1,236671
26028,0.049959,74.125.24.0-255,5738,236605,1,236671
26029,0.049966,172.31.36.0-255,66,236671,1,236671
26030,0.0,172.217.27.0-255,151,151,1,279016
26031,2.2e-05,172.31.36.0-255,66,217,1,279016
26032,3e-05,172.217.27.0-255,1484,1701,1,279016
26033,3.5e-05,172.31.36.0-255,66,1767,1,279016
26034,4.8e-05,172.217.27.0-255,2902,4669,1,279016
26035,5.1e-05,172.31.36.0-255,66,4735,1,279016
26036,5.9e-05,172.217.27.0-255,7156,11891,1,279016
26037,6.2e-05,172.31.36.0-255,66,11957,1,279016
26038,6.6e-05,172.217.27.0-255,2007,13964,1,279016
26039,6.8e-05,172.31.36.0-255,66,14030,1,279016
26040,7.3e-05,172.217.27.0-255,2902,16932,1,279016
26041,7.6e-05,172.31.36.0-255,66,16998,1,279016
26042,8.3e-05,172.217.27.0-255,7156,24154,1,279016
26043,8.6e-05,172.31.36.0-255,66,24220,1,279016
26044,9.3e-05,172.217.27.0-255,6797,31017,1,279016
26045,9.7e-05,172.31.36.0-255,66,31083,1,279016
26046,0.000142,172.217.27.0-255,1484,32567,1,279016
26047,0.000145,172.31.36.0-255,66,32633,1,279016
26048,0.00015,172.217.27.0-255,2902,35535,1,279016
26049,0.000152,172.31.36.0-255,66,35601,1,279016
26050,0.000183,172.217.27.0-255,4320,39921,1,279016
26051,0.000186,172.31.36.0-255,66,39987,1,279016
26052,0.000213,172.217.27.0-255,1484,41471,1,279016
26053,0.000215,172.31.36.0-255,66,41537,1,279016
26054,0.000221,172.217.27.0-255,5738,47275,1,279016
26055,0.000224,172.31.36.0-255,66,47341,1,279016
26056,0.000231,172.217.27.0-255,1125,48466,1,279016
26057,0.000233,172.31.36.0-255,66,48532,1,279016
26058,0.000262,172.217.27.0-255,1484,50016,1,279016
26059,0.000264,172.31.36.0-255,66,50082,1,279016
26060,0.00027,172.217.27.0-255,4320,54402,1,279016
26061,0.000272,172.31.36.0-255,66,54468,1,279016
26062,0.000276,172.217.27.0-255,1484,55952,1,279016
26063,0.000303,172.217.27.0-255,4320,60272,1,279016
26064,0.000306,172.31.36.0-255,66,60338,1,279016
26065,0.000335,172.217.27.0-255,5674,66012,1,279016
26066,0.000339,172.31.36.0-255,66,66078,1,279016
26067,0.000661,172.217.27.0-255,385,66463,1,279016
26068,0.000814,172.217.27.0-255,1484,67947,1,279016
26069,0.000819,172.31.36.0-255,66,68013,1,279016
26070,0.000825,172.217.27.0-255,2902,70915,1,279016
26071,0.000827,172.31.36.0-255,66,70981,1,279016
26072,0.000836,172.217.27.0-255,2902,73883,1,279016
26073,0.000838,172.31.36.0-255,66,73949,1,279016
26074,0.000843,172.217.27.0-255,4320,78269,1,279016
26075,0.000845,172.31.36.0-255,66,78335,1,279016
26076,0.000893,172.31.36.0-255,66,78401,1,279016
26077,0.000908,172.31.36.0-255,66,78467,1,279016
26078,0.001471,172.217.27.0-255,1484,79951,1,279016
26079,0.001477,172.217.27.0-255,2902,82853,1,279016
26080,0.001481,172.31.36.0-255,66,82919,1,279016
26081,0.001514,172.217.27.0-255,4320,87239,1,279016
26082,0.001517,172.31.36.0-255,66,87305,1,279016
26083,0.001527,172.31.36.0-255,66,87371,1,279016
26084,0.001539,172.217.27.0-255,7156,94527,1,279016
26085,0.001541,172.31.36.0-255,66,94593,1,279016
26086,0.001564,172.217.27.0-255,1484,96077,1,279016
26087,0.00159,172.217.27.0-255,2902,98979,1,279016
26088,0.001593,172.31.36.0-255,66,99045,1,279016
26089,0.001624,172.217.27.0-255,5020,104065,1,279016
26090,0.001626,172.31.36.0-255,66,104131,1,279016
26091,0.00168,172.217.27.0-255,1484,105615,1,279016
26092,0.001685,172.217.27.0-255,2902,108517,1,279016
26093,0.001688,172.31.36.0-255,66,108583,1,279016
26094,0.003293,172.217.27.0-255,1484,110067,1,279016
26095,0.003352,172.217.27.0-255,4320,114387,1,279016
26096,0.003357,172.31.36.0-255,66,114453,1,279016
26097,0.005023,172.217.27.0-255,5738,120191,1,279016
26098,0.005027,172.31.36.0-255,66,120257,1,279016
26099,0.006699,172.217.27.0-255,5738,125995,1,279016
26100,0.006702,172.31.36.0-255,66,126061,1,279016
26101,0.008389,172.217.27.0-255,5738,131799,1,279016
26102,0.008396,172.31.36.0-255,66,131865,1,279016
26103,0.01007,172.217.27.0-255,4320,136185,1,279016
26104,0.010078,172.31.36.0-255,66,136251,1,279016
26105,0.010101,172.217.27.0-255,1484,137735,1,279016
26106,0.011772,172.217.27.0-255,4320,142055,1,279016
26107,0.01178,172.31.36.0-255,66,142121,1,279016
26108,0.013456,172.217.27.0-255,5738,147859,1,279016
26109,0.013464,172.31.36.0-255,66,147925,1,279016
26110,0.015147,172.217.27.0-255,5738,153663,1,279016
26111,0.015154,172.31.36.0-255,66,153729,1,279016
26112,0.016839,172.217.27.0-255,5738,159467,1,279016
26113,0.016848,172.31.36.0-255,66,159533,1,279016
26114,0.01853,172.217.27.0-255,5738,165271,1,279016
26115,0.018538,172.31.36.0-255,66,165337,1,279016
26116,0.020231,172.217.27.0-255,5738,171075,1,279016
26117,0.020238,172.31.36.0-255,66,171141,1,279016
26118,0.021982,172.217.27.0-255,5738,176879,1,279016
26119,0.021997,172.31.36.0-255,66,176945,1,279016
26120,0.023694,172.217.27.0-255,5738,182683,1,279016
26121,0.023703,172.31.36.0-255,66,182749,1,279016
26122,0.025386,172.217.27.0-255,5738,188487,1,279016
26123,0.025393,172.31.36.0-255,66,188553,1,279016
26124,0.027118,172.217.27.0-255,5738,194291,1,279016
26125,0.027126,172.31.36.0-255,66,194357,1,279016
26126,0.028806,172.217.27.0-255,5738,200095,1,279016
26127,0.028814,172.31.36.0-255,66,200161,1,279016
26128,0.030501,172.217.27.0-255,5738,205899,1,279016
26129,0.030511,172.31.36.0-255,66,205965,1,279016
26130,0.032206,172.217.27.0-255,5738,211703,1,279016
26131,0.032216,172.31.36.0-255,66,211769,1,279016
26132,0.033905,172.217.27.0-255,5738,217507,1,279016
26133,0.033915,172.31.36.0-255,66,217573,1,279016
26134,0.035596,172.217.27.0-255,5738,223311,1,279016
26135,0.035604,172.31.36.0-255,66,223377,1,279016
26136,0.03728,172.217.27.0-255,5738,229115,1,279016
26137,0.037288,172.31.36.0-255,66,229181,1,279016
26138,0.038975,172.217.27.0-255,5738,234919,1,279016
26139,0.038982,172.31.36.0-255,66,234985,1,279016
26140,0.040192,172.31.36.0-255,216,235201,1,279016
26141,0.040222,172.31.36.0-255,958,236159,1,279016
26142,0.040293,172.31.36.0-255,1514,237673,1,279016
26143,0.040295,172.31.36.0-255,1514,239187,1,279016
26144,0.0403,172.31.36.0-255,1514,240701,1,279016
26145,0.040301,172.31.36.0-255,1514,242215,1,279016
26146,0.040319,172.31.36.0-255,1514,243729,1,279016
26147,0.04032,172.31.36.0-255,199,243928,1,279016
26148,0.040669,172.217.27.0-255,5738,249666,1,279016
26149,0.040676,172.31.36.0-255,66,249732,1,279016
26150,0.041749,104.244.42.0-255,66,249798,1,279016
26151,0.041758,104.244.42.0-255,66,249864,1,279016
26152,0.041841,104.244.42.0-255,66,249930,1,279016
26153,0.041846,104.244.42.0-255,66,249996,1,279016
26154,0.04237,172.217.27.0-255,5738,255734,1,279016
26155,0.042377,172.31.36.0-255,66,255800,1,279016
26156,0.044058,172.217.27.0-255,5738,261538,1,279016
26157,0.044064,172.31.36.0-255,66,261604,1,279016
26158,0.045758,172.217.27.0-255,5738,267342,1,279016
26159,0.045766,172.31.36.0-255,66,267408,1,279016
26160,0.047458,172.217.27.0-255,5738,273146,1,279016
26161,0.04747,172.31.36.0-255,66,273212,1,279016
26162,0.049176,172.217.27.0-255,5738,278950,1,279016
26163,0.049187,172.31.36.0-255,66,279016,1,279016
26164,0.0,74.125.24.0-255,153,153,1,260892
26165,2.3e-05,172.31.36.0-255,66,219,1,260892
26166,3e-05,74.125.24.0-255,1484,1703,1,260892
26167,3.5e-05,172.31.36.0-255,66,1769,1,260892
26168,4.1e-05,74.125.24.0-255,2902,4671,1,260892
26169,4.5e-05,172.31.36.0-255,66,4737,1,260892
26170,5.3e-05,74.125.24.0-255,7156,11893,1,260892
26171,5.6e-05,172.31.36.0-255,66,11959,1,260892
26172,6e-05,74.125.24.0-255,2012,13971,1,260892
26173,6.3e-05,172.31.36.0-255,66,14037,1,260892
26174,9.9e-05,74.125.24.0-255,4320,18357,1,260892
26175,0.000102,172.31.36.0-255,66,18423,1,260892
26176,0.000113,74.125.24.0-255,1484,19907,1,260892
26177,0.000116,172.31.36.0-255,66,19973,1,260892
26178,0.000124,74.125.24.0-255,7156,27129,1,260892
26179,0.000126,172.31.36.0-255,66,27195,1,260892
26180,0.00016,74.125.24.0-255,2902,30097,1,260892
26181,0.000162,172.31.36.0-255,66,30163,1,260892
26182,0.00018,74.125.24.0-255,1125,31288,1,260892
26183,0.000182,172.31.36.0-255,66,31354,1,260892
26184,0.000238,74.125.24.0-255,1484,32838,1,260892
26185,0.000241,172.31.36.0-255,66,32904,1,260892
26186,0.000246,74.125.24.0-255,2902,35806,1,260892
26187,0.000249,172.31.36.0-255,66,35872,1,260892
26188,0.000274,74.125.24.0-255,5738,41610,1,260892
26189,0.000277,172.31.36.0-255,66,41676,1,260892
26190,0.000301,74.125.24.0-255,2902,44578,1,260892
26191,0.000304,172.31.36.0-255,66,44644,1,260892
26192,0.000327,74.125.24.0-255,5738,50382,1,260892
26193,0.00033,172.31.36.0-255,66,50448,1,260892
26194,0.000349,74.125.24.0-255,5379,55827,1,260892
26195,0.000353,172.31.36.0-255,66,55893,1,260892
26196,0.000386,74.125.24.0-255,5738,61631,1,260892
26197,0.000408,74.125.24.0-255,4257,65888,1,260892
26198,0.000523,74.125.24.0-255,130,66018,1,260892
26199,0.000532,172.31.36.0-255,66,66084,1,260892
26200,0.000596,74.125.24.0-255,349,66433,1,260892
26201,0.001023,74.125.24.0-255,1484,67917,1,260892
26202,0.001027,172.31.36.0-255,66,67983,1,260892
26203,0.001033,74.125.24.0-255,2902,70885,1,260892
26204,0.001038,74.125.24.0-255,4320,75205,1,260892
26205,0.001049,74.125.24.0-255,1484,76689,1,260892
26206,0.001059,172.31.36.0-255,66,76755,1,260892
26207,0.00107,74.125.24.0-255,2902,79657,1,260892
26208,0.001105,172.31.36.0-255,66,79723,1,260892
26209,0.00111,74.125.24.0-255,2902,82625,1,260892
26210,0.001115,172.31.36.0-255,66,82691,1,260892
26211,0.001153,172.31.36.0-255,66,82757,1,260892
26212,0.001447,74.125.24.0-255,1484,84241,1,260892
26213,0.001462,74.125.24.0-255,2902,87143,1,260892
26214,0.001466,172.31.36.0-255,66,87209,1,260892
26215,0.001489,74.125.24.0-255,5738,92947,1,260892
26216,0.001492,172.31.36.0-255,66,93013,1,260892
26217,0.00151,74.125.24.0-255,2902,95915,1,260892
26218,0.001513,172.31.36.0-255,66,95981,1,260892
26219,0.001536,74.125.24.0-255,4320,100301,1,260892
26220,0.001545,172.31.36.0-255,66,100367,1,260892
26221,0.001556,74.125.24.0-255,5738,106105,1,260892
26222,0.001593,74.125.24.0-255,4320,110425,1,260892
26223,0.001616,74.125.24.0-255,6438,116863,1,260892
26224,0.00163,74.125.24.0-255,1484,118347,1,260892
26225,0.001636,172.31.36.0-255,66,118413,1,260892
26226,0.001658,74.125.24.0-255,4320,122733,1,260892
26227,0.001674,74.125.24.0-255,4320,127053,1,260892
26228,0.001689,172.31.36.0-255,66,127119,1,260892
26229,0.001706,172.31.36.0-255,66,127185,1,260892
26230,0.001716,74.125.24.0-255,766,127951,1,260892
26231,0.002089,74.125.24.0-255,1484,129435,1,260892
26232,0.002094,172.31.36.0-255,66,129501,1,260892
26233,0.002101,74.125.24.0-255,2902,132403,1,260892
26234,0.002115,74.125.24.0-255,2902,135305,1,260892
26235,0.002128,172.31.36.0-255,66,135371,1,260892
26236,0.002133,74.125.24.0-255,2902,138273,1,260892
26237,0.002135,74.125.24.0-255,1484,139757,1,260892
26238,0.002143,172.31.36.0-255,66,139823,1,260892
26239,0.002161,74.125.24.0-255,1484,141307,1,260892
26240,0.002175,172.31.36.0-255,66,141373,1,260892
26241,0.002196,172.31.36.0-255,66,141439,1,260892
26242,0.004585,74.125.24.0-255,5738,147177,1,260892
26243,0.004602,172.31.36.0-255,66,147243,1,260892
26244,0.006962,74.125.24.0-255,5738,152981,1,260892
26245,0.006973,172.31.36.0-255,66,153047,1,260892
26246,0.009454,74.125.24.0-255,5738,158785,1,260892
26247,0.009466,172.31.36.0-255,66,158851,1,260892
26248,0.011924,74.125.24.0-255,5738,164589,1,260892
26249,0.011934,172.31.36.0-255,66,164655,1,260892
26250,0.014337,74.125.24.0-255,5738,170393,1,260892
26251,0.014352,172.31.36.0-255,66,170459,1,260892
26252,0.016707,74.125.24.0-255,5738,176197,1,260892
26253,0.016717,172.31.36.0-255,66,176263,1,260892
26254,0.019095,74.125.24.0-255,5738,182001,1,260892
26255,0.019109,172.31.36.0-255,66,182067,1,260892
26256,0.021493,74.125.24.0-255,5738,187805,1,260892
26257,0.021509,172.31.36.0-255,66,187871,1,260892
26258,0.023922,74.125.24.0-255,5738,193609,1,260892
26259,0.023935,172.31.36.0-255,66,193675,1,260892
26260,0.02634,74.125.24.0-255,5738,199413,1,260892
26261,0.026354,172.31.36.0-255,66,199479,1,260892
26262,0.028726,74.125.24.0-255,5738,205217,1,260892
26263,0.028743,172.31.36.0-255,66,205283,1,260892
26264,0.031114,74.125.24.0-255,5738,211021,1,260892
26265,0.031129,172.31.36.0-255,66,211087,1,260892
26266,0.033485,74.125.24.0-255,5738,216825,1,260892
26267,0.033503,172.31.36.0-255,66,216891,1,260892
26268,0.035902,74.125.24.0-255,5738,222629,1,260892
26269,0.035913,172.31.36.0-255,66,222695,1,260892
26270,0.038254,74.125.24.0-255,5738,228433,1,260892
26271,0.038263,172.31.36.0-255,66,228499,1,260892
26272,0.040619,74.125.24.0-255,5738,234237,1,260892
26273,0.040632,172.31.36.0-255,66,234303,1,260892
26274,0.042256,172.31.36.0-255,188,234491,1,260892
26275,0.042288,172.31.36.0-255,958,235449,1,260892
26276,0.042363,172.31.36.0-255,1514,236963,1,260892
26277,0.042365,172.31.36.0-255,1514,238477,1,260892
26278,0.042366,172.31.36.0-255,1514,239991,1,260892
26279,0.042372,172.31.36.0-255,1514,241505,1,260892
26280,0.042373,172.31.36.0-255,1514,243019,1,260892
26281,0.042374,172.31.36.0-255,197,243216,1,260892
26282,0.042993,74.125.24.0-255,5738,248954,1,260892
26283,0.043001,172.31.36.0-255,66,249020,1,260892
26284,0.043831,104.244.42.0-255,66,249086,1,260892
26285,0.043941,104.244.42.0-255,66,249152,1,260892
26286,0.043947,104.244.42.0-255,66,249218,1,260892
26287,0.043951,104.244.42.0-255,66,249284,1,260892
26288,0.045372,74.125.24.0-255,5738,255022,1,260892
26289,0.045379,172.31.36.0-255,66,255088,1,260892
26290,0.047779,74.125.24.0-255,5738,260826,1,260892
26291,0.047785,172.31.36.0-255,66,260892,1,260892
26292,0.0,172.217.194.0-255,66,66,1,132
26293,0.032524,172.31.36.0-255,66,132,1,132
26294,0.0,74.125.200.0-255,153,153,1,292881
26295,1.6e-05,172.31.36.0-255,66,219,1,292881
26296,2.3e-05,74.125.200.0-255,1484,1703,1,292881
26297,2.7e-05,172.31.36.0-255,66,1769,1,292881
26298,3.2e-05,74.125.200.0-255,2902,4671,1,292881
26299,3.5e-05,172.31.36.0-255,66,4737,1,292881
26300,3.7e-05,74.125.200.0-255,1484,6221,1,292881
26301,3.9e-05,172.31.36.0-255,66,6287,1,292881
26302,6.2e-05,74.125.200.0-255,2902,9189,1,292881
26303,6.4e-05,172.31.36.0-255,66,9255,1,292881
26304,0.00011,74.125.200.0-255,6311,15566,1,292881
26305,0.000113,172.31.36.0-255,66,15632,1,292881
26306,0.000117,74.125.200.0-255,2902,18534,1,292881
26307,0.000119,172.31.36.0-255,66,18600,1,292881
26308,0.000126,74.125.200.0-255,5738,24338,1,292881
26309,0.000128,172.31.36.0-255,66,24404,1,292881
26310,0.00016,74.125.200.0-255,5738,30142,1,292881
26311,0.000164,172.31.36.0-255,66,30208,1,292881
26312,0.000167,74.125.200.0-255,1125,31333,1,292881
26313,0.000169,172.31.36.0-255,66,31399,1,292881
26314,0.000242,74.125.200.0-255,1484,32883,1,292881
26315,0.000245,172.31.36.0-255,66,32949,1,292881
26316,0.000248,74.125.200.0-255,1484,34433,1,292881
26317,0.00025,172.31.36.0-255,66,34499,1,292881
26318,0.000263,74.125.200.0-255,1484,35983,1,292881
26319,0.000265,172.31.36.0-255,66,36049,1,292881
26320,0.000281,74.125.200.0-255,5738,41787,1,292881
26321,0.000284,172.31.36.0-255,66,41853,1,292881
26322,0.000314,74.125.200.0-255,5738,47591,1,292881
26323,0.000318,172.31.36.0-255,66,47657,1,292881
26324,0.00032,74.125.200.0-255,1484,49141,1,292881
26325,0.000322,172.31.36.0-255,66,49207,1,292881
26326,0.000343,74.125.200.0-255,5379,54586,1,292881
26327,0.000346,172.31.36.0-255,66,54652,1,292881
26328,0.00035,74.125.200.0-255,2902,57554,1,292881
26329,0.000354,172.31.36.0-255,66,57620,1,292881
26330,0.000363,74.125.200.0-255,2902,60522,1,292881
26331,0.000365,172.31.36.0-255,66,60588,1,292881
26332,0.000403,74.125.200.0-255,5648,66236,1,292881
26333,0.000407,172.31.36.0-255,66,66302,1,292881
26334,0.000421,74.125.200.0-255,386,66688,1,292881
26335,0.000537,74.125.200.0-255,1484,68172,1,292881
26336,0.000541,172.31.36.0-255,66,68238,1,292881
26337,0.000558,74.125.200.0-255,2902,71140,1,292881
26338,0.000561,172.31.36.0-255,66,71206,1,292881
26339,0.000587,74.125.200.0-255,5738,76944,1,292881
26340,0.00059,172.31.36.0-255,66,77010,1,292881
26341,0.000605,74.125.200.0-255,4320,81330,1,292881
26342,0.000607,172.31.36.0-255,66,81396,1,292881
26343,0.000623,74.125.200.0-255,5738,87134,1,292881
26344,0.000626,172.31.36.0-255,66,87200,1,292881
26345,0.000633,74.125.200.0-255,7156,94356,1,292881
26346,0.000635,172.31.36.0-255,66,94422,1,292881
26347,0.000662,74.125.200.0-255,4320,98742,1,292881
26348,0.000665,172.31.36.0-255,66,98808,1,292881
26349,0.000669,74.125.200.0-255,2184,100992,1,292881
26350,0.000671,172.31.36.0-255,66,101058,1,292881
26351,0.00103,74.125.200.0-255,1484,102542,1,292881
26352,0.001043,74.125.200.0-255,1484,104026,1,292881
26353,0.001046,172.31.36.0-255,66,104092,1,292881
26354,0.001059,74.125.200.0-255,1484,105576,1,292881
26355,0.001062,74.125.200.0-255,1484,107060,1,292881
26356,0.001064,172.31.36.0-255,66,107126,1,292881
26357,0.001089,74.125.200.0-255,2902,110028,1,292881
26358,0.001092,172.31.36.0-255,66,110094,1,292881
26359,0.001101,172.31.36.0-255,66,110160,1,292881
26360,0.001108,74.125.200.0-255,5738,115898,1,292881
26361,0.00111,172.31.36.0-255,66,115964,1,292881
26362,0.001167,74.125.200.0-255,7156,123120,1,292881
26363,0.00117,172.31.36.0-255,66,123186,1,292881
26364,0.001176,74.125.200.0-255,3602,126788,1,292881
26365,0.001177,172.31.36.0-255,66,126854,1,292881
26366,0.001692,74.125.200.0-255,1484,128338,1,292881
26367,0.001702,74.125.200.0-255,2902,131240,1,292881
26368,0.001706,172.31.36.0-255,66,131306,1,292881
26369,0.001731,74.125.200.0-255,4320,135626,1,292881
26370,0.001733,172.31.36.0-255,66,135692,1,292881
26371,0.001739,74.125.200.0-255,5738,141430,1,292881
26372,0.001742,172.31.36.0-255,66,141496,1,292881
26373,0.001763,74.125.200.0-255,2902,144398,1,292881
26374,0.001766,172.31.36.0-255,66,144464,1,292881
26375,0.001794,172.31.36.0-255,66,144530,1,292881
26376,0.001799,74.125.200.0-255,4320,148850,1,292881
26377,0.001801,172.31.36.0-255,66,148916,1,292881
26378,0.001823,74.125.200.0-255,1484,150400,1,292881
26379,0.001841,74.125.200.0-255,2184,152584,1,292881
26380,0.001844,172.31.36.0-255,66,152650,1,292881
26381,0.001921,74.125.200.0-255,1484,154134,1,292881
26382,0.001939,74.125.200.0-255,2902,157036,1,292881
26383,0.001941,172.31.36.0-255,66,157102,1,292881
26384,0.001948,74.125.200.0-255,4320,161422,1,292881
26385,0.00195,172.31.36.0-255,66,161488,1,292881
26386,0.00196,74.125.200.0-255,1484,162972,1,292881
26387,0.001993,172.31.36.0-255,66,163038,1,292881
26388,0.002007,74.125.200.0-255,1484,164522,1,292881
26389,0.00203,172.31.36.0-255,66,164588,1,292881
26390,0.00425,74.125.200.0-255,5738,170326,1,292881
26391,0.004256,172.31.36.0-255,66,170392,1,292881
26392,0.006468,74.125.200.0-255,5738,176130,1,292881
26393,0.006473,172.31.36.0-255,66,176196,1,292881
26394,0.008704,74.125.200.0-255,5738,181934,1,292881
26395,0.00871,172.31.36.0-255,66,182000,1,292881
26396,0.010927,74.125.200.0-255,5738,187738,1,292881
26397,0.010935,172.31.36.0-255,66,187804,1,292881
26398,0.013152,74.125.200.0-255,5738,193542,1,292881
26399,0.013159,172.31.36.0-255,66,193608,1,292881
26400,0.015439,74.125.200.0-255,5738,199346,1,292881
26401,0.015447,172.31.36.0-255,66,199412,1,292881
26402,0.017664,74.125.200.0-255,5738,205150,1,292881
26403,0.017672,172.31.36.0-255,66,205216,1,292881
26404,0.019933,74.125.200.0-255,5738,210954,1,292881
26405,0.01994,172.31.36.0-255,66,211020,1,292881
26406,0.022156,74.125.200.0-255,5738,216758,1,292881
26407,0.022162,172.31.36.0-255,66,216824,1,292881
26408,0.024399,74.125.200.0-255,5738,222562,1,292881
26409,0.024405,172.31.36.0-255,66,222628,1,292881
26410,0.026623,74.125.200.0-255,5738,228366,1,292881
26411,0.02663,172.31.36.0-255,66,228432,1,292881
26412,0.028856,74.125.200.0-255,5738,234170,1,292881
26413,0.028865,172.31.36.0-255,66,234236,1,292881
26414,0.031084,74.125.200.0-255,5738,239974,1,292881
26415,0.03109,172.31.36.0-255,66,240040,1,292881
26416,0.031641,172.31.36.0-255,190,240230,1,292881
26417,0.031684,172.31.36.0-255,1115,241345,1,292881
26418,0.031755,172.31.36.0-255,1514,242859,1,292881
26419,0.031758,172.31.36.0-255,1514,244373,1,292881
26420,0.031764,172.31.36.0-255,1514,245887,1,292881
26421,0.031766,172.31.36.0-255,1514,247401,1,292881
26422,0.031806,172.31.36.0-255,1488,248889,1,292881
26423,0.033194,104.244.42.0-255,66,248955,1,292881
26424,0.03329,104.244.42.0-255,66,249021,1,292881
26425,0.033293,74.125.200.0-255,1484,250505,1,292881
26426,0.033325,74.125.200.0-255,4320,254825,1,292881
26427,0.03333,172.31.36.0-255,66,254891,1,292881
26428,0.033347,104.244.42.0-255,66,254957,1,292881
26429,0.035551,74.125.200.0-255,5738,260695,1,292881
26430,0.035557,172.31.36.0-255,66,260761,1,292881
26431,0.037777,74.125.200.0-255,4320,265081,1,292881
26432,0.037781,172.31.36.0-255,66,265147,1,292881
26433,0.037803,74.125.200.0-255,1484,266631,1,292881
26434,0.039997,74.125.200.0-255,4320,270951,1,292881
26435,0.040002,172.31.36.0-255,66,271017,1,292881
26436,0.04224,74.125.200.0-255,5738,276755,1,292881
26437,0.042245,172.31.36.0-255,66,276821,1,292881
26438,0.044474,74.125.200.0-255,4320,281141,1,292881
26439,0.044479,172.31.36.0-255,66,281207,1,292881
26440,0.044506,74.125.200.0-255,1484,282691,1,292881
26441,0.046696,74.125.200.0-255,4320,287011,1,292881
26442,0.046701,172.31.36.0-255,66,287077,1,292881
26443,0.048914,74.125.200.0-255,5738,292815,1,292881
26444,0.048919,172.31.36.0-255,66,292881,1,292881
26445,0.0,172.217.194.0-255,153,153,1,305999
26446,5.1e-05,172.31.36.0-255,66,219,1,305999
26447,7.9e-05,172.217.194.0-255,1484,1703,1,305999
26448,8.3e-05,172.31.36.0-255,66,1769,1,305999
26449,0.000103,172.217.194.0-255,2902,4671,1,305999
26450,0.000106,172.31.36.0-255,66,4737,1,305999
26451,0.000112,172.217.194.0-255,5738,10475,1,305999
26452,0.000114,172.31.36.0-255,66,10541,1,305999
26453,0.000118,172.217.194.0-255,2902,13443,1,305999
26454,0.000121,172.31.36.0-255,66,13509,1,305999
26455,0.000144,172.217.194.0-255,1987,15496,1,305999
26456,0.000147,172.31.36.0-255,66,15562,1,305999
26457,0.000153,172.217.194.0-255,5738,21300,1,305999
26458,0.000155,172.31.36.0-255,66,21366,1,305999
26459,0.000171,172.217.194.0-255,1484,22850,1,305999
26460,0.000173,172.31.36.0-255,66,22916,1,305999
26461,0.000188,172.217.194.0-255,5738,28654,1,305999
26462,0.000191,172.31.36.0-255,66,28720,1,305999
26463,0.000205,172.217.194.0-255,2543,31263,1,305999
26464,0.000207,172.31.36.0-255,66,31329,1,305999
26465,0.001133,172.217.194.0-255,1484,32813,1,305999
26466,0.001139,172.31.36.0-255,66,32879,1,305999
26467,0.001161,172.217.194.0-255,2902,35781,1,305999
26468,0.001164,172.31.36.0-255,66,35847,1,305999
26469,0.001196,172.217.194.0-255,5738,41585,1,305999
26470,0.001199,172.31.36.0-255,66,41651,1,305999
26471,0.001208,172.31.36.0-255,66,41717,1,305999
26472,0.001228,172.217.194.0-255,4320,46037,1,305999
26473,0.00123,172.31.36.0-255,66,46103,1,305999
26474,0.001243,172.31.36.0-255,66,46169,1,305999
26475,0.001382,172.217.194.0-255,356,46525,1,305999
26476,0.001427,172.217.194.0-255,1484,48009,1,305999
26477,0.001429,172.31.36.0-255,66,48075,1,305999
26478,0.001434,172.217.194.0-255,4320,52395,1,305999
26479,0.001436,172.31.36.0-255,66,52461,1,305999
26480,0.001482,172.217.194.0-255,2902,55363,1,305999
26481,0.001484,172.31.36.0-255,66,55429,1,305999
26482,0.001489,172.217.194.0-255,4320,59749,1,305999
26483,0.001491,172.31.36.0-255,66,59815,1,305999
26484,0.001495,172.217.194.0-255,2902,62717,1,305999
26485,0.001497,172.31.36.0-255,66,62783,1,305999
26486,0.001517,172.217.194.0-255,5738,68521,1,305999
26487,0.001519,172.31.36.0-255,66,68587,1,305999
26488,0.001564,172.217.194.0-255,2902,71489,1,305999
26489,0.001567,172.31.36.0-255,66,71555,1,305999
26490,0.001581,172.217.194.0-255,1484,73039,1,305999
26491,0.001592,172.217.194.0-255,2902,75941,1,305999
26492,0.001594,172.31.36.0-255,66,76007,1,305999
26493,0.001615,172.217.194.0-255,5020,81027,1,305999
26494,0.001617,172.31.36.0-255,66,81093,1,305999
26495,0.001746,172.217.194.0-255,1484,82577,1,305999
26496,0.001764,172.217.194.0-255,2902,85479,1,305999
26497,0.001766,172.31.36.0-255,66,85545,1,305999
26498,0.001783,172.217.194.0-255,2902,88447,1,305999
26499,0.001785,172.31.36.0-255,66,88513,1,305999
26500,0.001804,172.217.194.0-255,2902,91415,1,305999
26501,0.001806,172.31.36.0-255,66,91481,1,305999
26502,0.001848,172.217.194.0-255,5738,97219,1,305999
26503,0.00185,172.31.36.0-255,66,97285,1,305999
26504,0.001868,172.217.194.0-255,5738,103023,1,305999
26505,0.00187,172.31.36.0-255,66,103089,1,305999
26506,0.001882,172.31.36.0-255,66,103155,1,305999
26507,0.001885,172.217.194.0-255,1484,104639,1,305999
26508,0.001915,172.31.36.0-255,66,104705,1,305999
26509,0.001921,172.217.194.0-255,7156,111861,1,305999
26510,0.001923,172.31.36.0-255,66,111927,1,305999
26511,0.001956,172.31.36.0-255,66,111993,1,305999
26512,0.001959,172.217.194.0-255,1484,113477,1,305999
26513,0.001975,172.217.194.0-255,3602,117079,1,305999
26514,0.001977,172.31.36.0-255,66,117145,1,305999
26515,0.002057,172.217.194.0-255,1484,118629,1,305999
26516,0.002072,172.217.194.0-255,2902,121531,1,305999
26517,0.002074,172.31.36.0-255,66,121597,1,305999
26518,0.002087,172.217.194.0-255,2902,124499,1,305999
26519,0.002089,172.31.36.0-255,66,124565,1,305999
26520,0.002108,172.217.194.0-255,2902,127467,1,305999
26521,0.00211,172.31.36.0-255,66,127533,1,305999
26522,0.002123,172.31.36.0-255,66,127599,1,305999
26523,0.002129,172.217.194.0-255,7156,134755,1,305999
26524,0.002132,172.31.36.0-255,66,134821,1,305999
26525,0.002175,172.217.194.0-255,3602,138423,1,305999
26526,0.002177,172.31.36.0-255,66,138489,1,305999
26527,0.002252,172.217.194.0-255,1484,139973,1,305999
26528,0.002256,172.217.194.0-255,2902,142875,1,305999
26529,0.002258,172.31.36.0-255,66,142941,1,305999
26530,0.002262,172.217.194.0-255,2902,145843,1,305999
26531,0.002265,172.31.36.0-255,66,145909,1,305999
26532,0.002278,172.217.194.0-255,2902,148811,1,305999
26533,0.00228,172.31.36.0-255,66,148877,1,305999
26534,0.002283,172.217.194.0-255,1484,150361,1,305999
26535,0.002302,172.217.194.0-255,1484,151845,1,305999
26536,0.002304,172.31.36.0-255,66,151911,1,305999
26537,0.002326,172.217.194.0-255,7156,159067,1,305999
26538,0.002328,172.31.36.0-255,66,159133,1,305999
26539,0.002335,172.217.194.0-255,7156,166289,1,305999
26540,0.002338,172.31.36.0-255,66,166355,1,305999
26541,0.002354,172.217.194.0-255,2902,169257,1,305999
26542,0.002356,172.31.36.0-255,66,169323,1,305999
26543,0.002386,172.31.36.0-255,66,169389,1,305999
26544,0.002391,172.217.194.0-255,4320,173709,1,305999
26545,0.002392,172.31.36.0-255,66,173775,1,305999
26546,0.002465,172.217.194.0-255,2902,176677,1,305999
26547,0.002467,172.31.36.0-255,66,176743,1,305999
26548,0.002495,172.31.36.0-255,66,176809,1,305999
26549,0.002501,172.217.194.0-255,5020,181829,1,305999
26550,0.002503,172.31.36.0-255,66,181895,1,305999
26551,0.002513,172.31.36.0-255,66,181961,1,305999
26552,0.002558,172.217.194.0-255,1484,183445,1,305999
26553,0.002581,172.31.36.0-255,66,183511,1,305999
26554,0.002585,172.217.194.0-255,2902,186413,1,305999
26555,0.002586,172.31.36.0-255,66,186479,1,305999
26556,0.002591,172.217.194.0-255,4320,190799,1,305999
26557,0.002593,172.31.36.0-255,66,190865,1,305999
26558,0.002602,172.31.36.0-255,66,190931,1,305999
26559,0.002648,172.217.194.0-255,1484,192415,1,305999
26560,0.002671,172.217.194.0-255,7156,199571,1,305999
26561,0.002674,172.31.36.0-255,66,199637,1,305999
26562,0.002702,172.217.194.0-255,7156,206793,1,305999
26563,0.002705,172.31.36.0-255,66,206859,1,305999
26564,0.00271,172.217.194.0-255,4320,211179,1,305999
26565,0.002712,172.31.36.0-255,66,211245,1,305999
26566,0.002729,172.217.194.0-255,4320,215565,1,305999
26567,0.002731,172.31.36.0-255,66,215631,1,305999
26568,0.002736,172.217.194.0-255,4320,219951,1,305999
26569,0.002738,172.31.36.0-255,66,220017,1,305999
26570,0.002758,172.217.194.0-255,4320,224337,1,305999
26571,0.002761,172.31.36.0-255,66,224403,1,305999
26572,0.002789,172.31.36.0-255,66,224469,1,305999
26573,0.00549,172.217.194.0-255,5738,230207,1,305999
26574,0.005497,172.31.36.0-255,66,230273,1,305999
26575,0.008226,172.217.194.0-255,4320,234593,1,305999
26576,0.008232,172.31.36.0-255,66,234659,1,305999
26577,0.008249,172.217.194.0-255,1484,236143,1,305999
26578,0.01089,172.217.194.0-255,4320,240463,1,305999
26579,0.010902,172.31.36.0-255,66,240529,1,305999
26580,0.013574,172.217.194.0-255,5738,246267,1,305999
26581,0.013583,172.31.36.0-255,66,246333,1,305999
26582,0.016262,172.217.194.0-255,5738,252071,1,305999
26583,0.016271,172.31.36.0-255,66,252137,1,305999
26584,0.018903,172.217.194.0-255,5738,257875,1,305999
26585,0.018913,172.31.36.0-255,66,257941,1,305999
26586,0.021575,172.217.194.0-255,5738,263679,1,305999
26587,0.021584,172.31.36.0-255,66,263745,1,305999
26588,0.024258,172.217.194.0-255,5738,269483,1,305999
26589,0.024265,172.31.36.0-255,66,269549,1,305999
26590,0.026896,172.217.194.0-255,5738,275287,1,305999
26591,0.026903,172.31.36.0-255,66,275353,1,305999
26592,0.029561,172.217.194.0-255,5738,281091,1,305999
26593,0.029569,172.31.36.0-255,66,281157,1,305999
26594,0.032224,172.217.194.0-255,5738,286895,1,305999
26595,0.032232,172.31.36.0-255,66,286961,1,305999
26596,0.034888,172.217.194.0-255,5738,292699,1,305999
26597,0.034896,172.31.36.0-255,66,292765,1,305999
26598,0.035343,172.31.36.0-255,172,292937,1,305999
26599,0.035373,172.31.36.0-255,1114,294051,1,305999
26600,0.03542,172.31.36.0-255,1514,295565,1,305999
26601,0.035422,172.31.36.0-255,1514,297079,1,305999
26602,0.035424,172.31.36.0-255,1514,298593,1,305999
26603,0.035425,172.31.36.0-255,1514,300107,1,305999
26604,0.035451,172.31.36.0-255,1489,301596,1,305999
26605,0.036885,104.244.42.0-255,66,301662,1,305999
26606,0.036946,104.244.42.0-255,66,301728,1,305999
26607,0.037043,104.244.42.0-255,66,301794,1,305999
26608,0.037534,172.217.194.0-255,3968,305762,1,305999
26609,0.03754,172.31.36.0-255,66,305828,1,305999
26610,0.037721,172.31.36.0-255,105,305933,1,305999
26611,0.040356,172.217.194.0-255,66,305999,1,305999
26612,0.0,74.125.24.0-255,146,146,1,236606
26613,2.3e-05,172.31.36.0-255,66,212,1,236606
26614,3.1e-05,74.125.24.0-255,1484,1696,1,236606
26615,3.6e-05,172.31.36.0-255,66,1762,1,236606
26616,4.2e-05,74.125.24.0-255,2902,4664,1,236606
26617,5.3e-05,172.31.36.0-255,66,4730,1,236606
26618,9.1e-05,74.125.24.0-255,5738,10468,1,236606
26619,9.4e-05,172.31.36.0-255,66,10534,1,236606
26620,0.0001,74.125.24.0-255,3464,13998,1,236606
26621,0.000103,172.31.36.0-255,66,14064,1,236606
26622,0.000127,74.125.24.0-255,2902,16966,1,236606
26623,0.00013,172.31.36.0-255,66,17032,1,236606
26624,0.000134,74.125.24.0-255,1484,18516,1,236606
26625,0.000136,172.31.36.0-255,66,18582,1,236606
26626,0.000167,74.125.24.0-255,2902,21484,1,236606
26627,0.00017,172.31.36.0-255,66,21550,1,236606
26628,0.000181,172.31.36.0-255,66,21616,1,236606
26629,0.000187,74.125.24.0-255,5738,27354,1,236606
26630,0.000189,172.31.36.0-255,66,27420,1,236606
26631,0.000254,172.31.36.0-255,66,27486,1,236606
26632,0.000278,74.125.24.0-255,3602,31088,1,236606
26633,0.00028,172.31.36.0-255,66,31154,1,236606
26634,0.000284,74.125.24.0-255,1484,32638,1,236606
26635,0.000285,172.31.36.0-255,66,32704,1,236606
26636,0.000328,74.125.24.0-255,4320,37024,1,236606
26637,0.00033,172.31.36.0-255,66,37090,1,236606
26638,0.000338,74.125.24.0-255,7156,44246,1,236606
26639,0.00034,172.31.36.0-255,66,44312,1,236606
26640,0.000346,74.125.24.0-255,4286,48598,1,236606
26641,0.000351,172.31.36.0-255,66,48664,1,236606
26642,0.000885,74.125.24.0-255,1484,50148,1,236606
26643,0.000894,74.125.24.0-255,2902,53050,1,236606
26644,0.00091,74.125.24.0-255,2902,55952,1,236606
26645,0.000923,172.31.36.0-255,66,56018,1,236606
26646,0.000936,74.125.24.0-255,7156,63174,1,236606
26647,0.000945,172.31.36.0-255,66,63240,1,236606
26648,0.000958,74.125.24.0-255,5738,68978,1,236606
26649,0.001001,74.125.24.0-255,3961,72939,1,236606
26650,0.001007,172.31.36.0-255,66,73005,1,236606
26651,0.001447,74.125.24.0-255,1484,74489,1,236606
26652,0.001455,74.125.24.0-255,2902,77391,1,236606
26653,0.001458,172.31.36.0-255,66,77457,1,236606
26654,0.001463,74.125.24.0-255,2902,80359,1,236606
26655,0.001492,74.125.24.0-255,7156,87515,1,236606
26656,0.0015,74.125.24.0-255,7156,94671,1,236606
26657,0.001526,74.125.24.0-255,3602,98273,1,236606
26658,0.001531,172.31.36.0-255,66,98339,1,236606
26659,0.002184,74.125.24.0-255,1484,99823,1,236606
26660,0.002194,74.125.24.0-255,2902,102725,1,236606
26661,0.002198,172.31.36.0-255,66,102791,1,236606
26662,0.002206,74.125.24.0-255,5738,108529,1,236606
26663,0.002226,74.125.24.0-255,2902,111431,1,236606
26664,0.002284,74.125.24.0-255,5738,117169,1,236606
26665,0.002297,74.125.24.0-255,2902,120071,1,236606
26666,0.002335,74.125.24.0-255,2902,122973,1,236606
26667,0.005963,172.31.36.0-255,66,123039,1,236606
26668,0.008251,74.125.24.0-255,5738,128777,1,236606
26669,0.008259,172.31.36.0-255,66,128843,1,236606
26670,0.010512,74.125.24.0-255,5738,134581,1,236606
26671,0.010524,172.31.36.0-255,66,134647,1,236606
26672,0.012816,74.125.24.0-255,5738,140385,1,236606
26673,0.014132,172.31.36.0-255,66,140451,1,236606
26674,0.016395,74.125.24.0-255,5738,146189,1,236606
26675,0.016412,172.31.36.0-255,66,146255,1,236606
26676,0.018742,74.125.24.0-255,5738,151993,1,236606
26677,0.01876,172.31.36.0-255,66,152059,1,236606
26678,0.021008,74.125.24.0-255,5738,157797,1,236606
26679,0.021014,172.31.36.0-255,66,157863,1,236606
26680,0.023249,74.125.24.0-255,5738,163601,1,236606
26681,0.023257,172.31.36.0-255,66,163667,1,236606
26682,0.025527,74.125.24.0-255,5738,169405,1,236606
26683,0.025535,172.31.36.0-255,66,169471,1,236606
26684,0.027796,74.125.24.0-255,5738,175209,1,236606
26685,0.027803,172.31.36.0-255,66,175275,1,236606
26686,0.030098,74.125.24.0-255,5738,181013,1,236606
26687,0.030107,172.31.36.0-255,66,181079,1,236606
26688,0.032376,74.125.24.0-255,5738,186817,1,236606
26689,0.032384,172.31.36.0-255,66,186883,1,236606
26690,0.034668,74.125.24.0-255,5738,192621,1,236606
26691,0.034678,172.31.36.0-255,66,192687,1,236606
26692,0.036633,172.31.36.0-255,172,192859,1,236606
26693,0.036669,172.31.36.0-255,1115,193974,1,236606
26694,0.036739,172.31.36.0-255,1514,195488,1,236606
26695,0.036762,172.31.36.0-255,1514,197002,1,236606
26696,0.036764,172.31.36.0-255,1514,198516,1,236606
26697,0.036786,172.31.36.0-255,1514,200030,1,236606
26698,0.036789,172.31.36.0-255,1488,201518,1,236606
26699,0.036926,74.125.24.0-255,5738,207256,1,236606
26700,0.036934,172.31.36.0-255,66,207322,1,236606
26701,0.038178,104.244.42.0-255,66,207388,1,236606
26702,0.038229,104.244.42.0-255,66,207454,1,236606
26703,0.03837,104.244.42.0-255,66,207520,1,236606
26704,0.03842,104.244.42.0-255,66,207586,1,236606
26705,0.039164,74.125.24.0-255,5738,213324,1,236606
26706,0.039171,172.31.36.0-255,66,213390,1,236606
26707,0.041423,74.125.24.0-255,5738,219128,1,236606
26708,0.04143,172.31.36.0-255,66,219194,1,236606
26709,0.043694,74.125.24.0-255,5738,224932,1,236606
26710,0.043702,172.31.36.0-255,66,224998,1,236606
26711,0.045972,74.125.24.0-255,5738,230736,1,236606
26712,0.045978,172.31.36.0-255,66,230802,1,236606
26713,0.048249,74.125.24.0-255,5738,236540,1,236606
26714,0.048256,172.31.36.0-255,66,236606,1,236606
26715,0.0,172.217.194.0-255,475,475,1,245604
26716,3.3e-05,172.31.36.0-255,66,541,1,245604
26717,4e-05,172.217.194.0-255,1484,2025,1,245604
26718,4.4e-05,172.31.36.0-255,66,2091,1,245604
26719,5e-05,172.217.194.0-255,4320,6411,1,245604
26720,5.2e-05,172.31.36.0-255,66,6477,1,245604
26721,5.7e-05,172.217.194.0-255,4320,10797,1,245604
26722,6e-05,172.31.36.0-255,66,10863,1,245604
26723,6.4e-05,172.217.194.0-255,2902,13765,1,245604
26724,6.6e-05,172.31.36.0-255,66,13831,1,245604
26725,9.3e-05,172.31.36.0-255,66,13897,1,245604
26726,0.000106,172.31.36.0-255,66,13963,1,245604
26727,0.000158,172.217.194.0-255,1484,15447,1,245604
26728,0.000161,172.31.36.0-255,66,15513,1,245604
26729,0.000184,172.217.194.0-255,2902,18415,1,245604
26730,0.000186,172.31.36.0-255,66,18481,1,245604
26731,0.000192,172.217.194.0-255,5738,24219,1,245604
26732,0.000195,172.31.36.0-255,66,24285,1,245604
26733,0.0002,172.217.194.0-255,5738,30023,1,245604
26734,0.000202,172.31.36.0-255,66,30089,1,245604
26735,0.00023,172.217.194.0-255,5738,35827,1,245604
26736,0.000234,172.31.36.0-255,66,35893,1,245604
26737,0.000265,172.31.36.0-255,66,35959,1,245604
26738,0.000269,172.217.194.0-255,3961,39920,1,245604
26739,0.000271,172.31.36.0-255,66,39986,1,245604
26740,0.000336,172.217.194.0-255,367,40353,1,245604
26741,0.00034,172.31.36.0-255,66,40419,1,245604
26742,0.00074,172.217.194.0-255,378,40797,1,245604
26743,0.000745,172.31.36.0-255,66,40863,1,245604
26744,0.001398,172.217.194.0-255,1484,42347,1,245604
26745,0.00141,172.217.194.0-255,2902,45249,1,245604
26746,0.001414,172.31.36.0-255,66,45315,1,245604
26747,0.001422,172.217.194.0-255,5738,51053,1,245604
26748,0.001425,172.31.36.0-255,66,51119,1,245604
26749,0.001458,172.31.36.0-255,66,51185,1,245604
26750,0.001477,172.217.194.0-255,2902,54087,1,245604
26751,0.00148,172.31.36.0-255,66,54153,1,245604
26752,0.001491,172.31.36.0-255,66,54219,1,245604
26753,0.001646,172.217.194.0-255,1484,55703,1,245604
26754,0.00167,172.217.194.0-255,2902,58605,1,245604
26755,0.001674,172.31.36.0-255,66,58671,1,245604
26756,0.001681,172.217.194.0-255,5738,64409,1,245604
26757,0.001684,172.31.36.0-255,66,64475,1,245604
26758,0.001724,172.31.36.0-255,66,64541,1,245604
26759,0.001731,172.217.194.0-255,5738,70279,1,245604
26760,0.001734,172.31.36.0-255,66,70345,1,245604
26761,0.001753,172.217.194.0-255,5020,75365,1,245604
26762,0.001755,172.31.36.0-255,66,75431,1,245604
26763,0.001994,172.217.194.0-255,1484,76915,1,245604
26764,0.002002,172.217.194.0-255,2902,79817,1,245604
26765,0.002006,172.31.36.0-255,66,79883,1,245604
26766,0.00201,172.217.194.0-255,1484,81367,1,245604
26767,0.00203,172.217.194.0-255,2902,84269,1,245604
26768,0.002033,172.31.36.0-255,66,84335,1,245604
26769,0.002037,172.217.194.0-255,2902,87237,1,245604
26770,0.002039,172.31.36.0-255,66,87303,1,245604
26771,0.002065,172.217.194.0-255,5738,93041,1,245604
26772,0.002067,172.31.36.0-255,66,93107,1,245604
26773,0.00208,172.217.194.0-255,4320,97427,1,245604
26774,0.002082,172.31.36.0-255,66,97493,1,245604
26775,0.002101,172.217.194.0-255,7156,104649,1,245604
26776,0.002104,172.31.36.0-255,66,104715,1,245604
26777,0.002107,172.217.194.0-255,1484,106199,1,245604
26778,0.002123,172.217.194.0-255,3602,109801,1,245604
26779,0.002125,172.31.36.0-255,66,109867,1,245604
26780,0.00419,172.217.194.0-255,2902,112769,1,245604
26781,0.004193,172.31.36.0-255,66,112835,1,245604
26782,0.004209,172.217.194.0-255,2902,115737,1,245604
26783,0.004211,172.31.36.0-255,66,115803,1,245604
26784,0.006317,172.217.194.0-255,5738,121541,1,245604
26785,0.006324,172.31.36.0-255,66,121607,1,245604
26786,0.008403,172.217.194.0-255,5738,127345,1,245604
26787,0.008409,172.31.36.0-255,66,127411,1,245604
26788,0.010487,172.217.194.0-255,5738,133149,1,245604
26789,0.010493,172.31.36.0-255,66,133215,1,245604
26790,0.012609,172.217.194.0-255,5738,138953,1,245604
26791,0.012616,172.31.36.0-255,66,139019,1,245604
26792,0.014675,172.217.194.0-255,5738,144757,1,245604
26793,0.014683,172.31.36.0-255,66,144823,1,245604
26794,0.016744,172.217.194.0-255,5738,150561,1,245604
26795,0.016753,172.31.36.0-255,66,150627,1,245604
26796,0.018821,172.217.194.0-255,5738,156365,1,245604
26797,0.018827,172.31.36.0-255,66,156431,1,245604
26798,0.020912,172.217.194.0-255,5738,162169,1,245604
26799,0.020918,172.31.36.0-255,66,162235,1,245604
26800,0.023021,172.217.194.0-255,5738,167973,1,245604
26801,0.02303,172.31.36.0-255,66,168039,1,245604
26802,0.025139,172.217.194.0-255,5738,173777,1,245604
26803,0.025146,172.31.36.0-255,66,173843,1,245604
26804,0.027183,172.217.194.0-255,5738,179581,1,245604
26805,0.02719,172.31.36.0-255,66,179647,1,245604
26806,0.029307,172.217.194.0-255,5738,185385,1,245604
26807,0.029316,172.31.36.0-255,66,185451,1,245604
26808,0.031102,172.31.36.0-255,172,185623,1,245604
26809,0.031146,172.31.36.0-255,1113,186736,1,245604
26810,0.031226,172.31.36.0-255,1514,188250,1,245604
26811,0.031228,172.31.36.0-255,1514,189764,1,245604
26812,0.031229,172.31.36.0-255,1514,191278,1,245604
26813,0.03123,172.31.36.0-255,1514,192792,1,245604
26814,0.031285,172.31.36.0-255,1490,194282,1,245604
26815,0.0314,172.217.194.0-255,5738,200020,1,245604
26816,0.031406,172.31.36.0-255,66,200086,1,245604
26817,0.032669,104.244.42.0-255,66,200152,1,245604
26818,0.032697,104.244.42.0-255,66,200218,1,245604
26819,0.032799,104.244.42.0-255,66,200284,1,245604
26820,0.032841,104.244.42.0-255,66,200350,1,245604
26821,0.033478,172.217.194.0-255,4320,204670,1,245604
26822,0.033488,172.31.36.0-255,66,204736,1,245604
26823,0.033508,172.217.194.0-255,1484,206220,1,245604
26824,0.034011,104.244.42.0-255,108,206328,1,245604
26825,0.034021,172.31.36.0-255,66,206394,1,245604
26826,0.035572,172.217.194.0-255,4320,210714,1,245604
26827,0.035577,172.31.36.0-255,66,210780,1,245604
26828,0.037655,172.217.194.0-255,5738,216518,1,245604
26829,0.037661,172.31.36.0-255,66,216584,1,245604
26830,0.039712,172.217.194.0-255,5738,222322,1,245604
26831,0.039717,172.31.36.0-255,66,222388,1,245604
26832,0.04181,172.217.194.0-255,5738,228126,1,245604
26833,0.041815,172.31.36.0-255,66,228192,1,245604
26834,0.043898,172.217.194.0-255,5738,233930,1,245604
26835,0.043904,172.31.36.0-255,66,233996,1,245604
26836,0.046008,172.217.194.0-255,5738,239734,1,245604
26837,0.046012,172.31.36.0-255,66,239800,1,245604
26838,0.04807,172.217.194.0-255,5738,245538,1,245604
26839,0.048075,172.31.36.0-255,66,245604,1,245604
26840,0.0,172.217.194.0-255,198,198,1,259532
26841,2.3e-05,172.31.36.0-255,66,264,1,259532
26842,3.1e-05,172.217.194.0-255,1484,1748,1,259532
26843,3.6e-05,172.31.36.0-255,66,1814,1,259532
26844,5e-05,172.217.194.0-255,2902,4716,1,259532
26845,5.3e-05,172.31.36.0-255,66,4782,1,259532
26846,5.8e-05,172.217.194.0-255,2902,7684,1,259532
26847,6.1e-05,172.31.36.0-255,66,7750,1,259532
26848,7e-05,172.217.194.0-255,6328,14078,1,259532
26849,7.3e-05,172.31.36.0-255,66,14144,1,259532
26850,0.000112,172.217.194.0-255,1484,15628,1,259532
26851,0.000115,172.31.36.0-255,66,15694,1,259532
26852,0.000121,172.217.194.0-255,2902,18596,1,259532
26853,0.000123,172.31.36.0-255,66,18662,1,259532
26854,0.000158,172.217.194.0-255,5738,24400,1,259532
26855,0.00016,172.31.36.0-255,66,24466,1,259532
26856,0.000164,172.217.194.0-255,1484,25950,1,259532
26857,0.000165,172.31.36.0-255,66,26016,1,259532
26858,0.000199,172.217.194.0-255,5379,31395,1,259532
26859,0.000202,172.31.36.0-255,66,31461,1,259532
26860,0.000228,172.217.194.0-255,1484,32945,1,259532
26861,0.00023,172.31.36.0-255,66,33011,1,259532
26862,0.000235,172.217.194.0-255,2902,35913,1,259532
26863,0.000237,172.31.36.0-255,66,35979,1,259532
26864,0.000249,172.217.194.0-255,5738,41717,1,259532
26865,0.000251,172.31.36.0-255,66,41783,1,259532
26866,0.000255,172.217.194.0-255,1484,43267,1,259532
26867,0.000256,172.31.36.0-255,66,43333,1,259532
26868,0.000292,172.217.194.0-255,5379,48712,1,259532
26869,0.000294,172.31.36.0-255,66,48778,1,259532
26870,0.000697,172.217.194.0-255,1484,50262,1,259532
26871,0.000703,172.217.194.0-255,2902,53164,1,259532
26872,0.000706,172.217.194.0-255,1484,54648,1,259532
26873,0.000711,172.31.36.0-255,66,54714,1,259532
26874,0.000715,172.31.36.0-255,66,54780,1,259532
26875,0.000743,172.217.194.0-255,4320,59100,1,259532
26876,0.000746,172.31.36.0-255,66,59166,1,259532
26877,0.000757,172.217.194.0-255,5738,64904,1,259532
26878,0.000759,172.31.36.0-255,66,64970,1,259532
26879,0.000762,172.217.194.0-255,1420,66390,1,259532
26880,0.000803,172.217.194.0-255,381,66771,1,259532
26881,0.000806,172.31.36.0-255,66,66837,1,259532
26882,0.000868,172.217.194.0-255,1484,68321,1,259532
26883,0.000874,172.217.194.0-255,4320,72641,1,259532
26884,0.000877,172.31.36.0-255,66,72707,1,259532
26885,0.00088,172.217.194.0-255,1484,74191,1,259532
26886,0.000937,172.217.194.0-255,4320,78511,1,259532
26887,0.00094,172.31.36.0-255,66,78577,1,259532
26888,0.000961,172.217.194.0-255,5379,83956,1,259532
26889,0.000964,172.31.36.0-255,66,84022,1,259532
26890,0.000967,172.217.194.0-255,1484,85506,1,259532
26891,0.001007,172.31.36.0-255,66,85572,1,259532
26892,0.001013,172.217.194.0-255,5738,91310,1,259532
26893,0.001016,172.31.36.0-255,66,91376,1,259532
26894,0.001041,172.217.194.0-255,1125,92501,1,259532
26895,0.00157,172.31.36.0-255,66,92567,1,259532
26896,0.001955,172.217.194.0-255,1484,94051,1,259532
26897,0.001966,172.217.194.0-255,2902,96953,1,259532
26898,0.00197,172.31.36.0-255,66,97019,1,259532
26899,0.002008,172.217.194.0-255,5738,102757,1,259532
26900,0.002011,172.31.36.0-255,66,102823,1,259532
26901,0.002025,172.31.36.0-255,66,102889,1,259532
26902,0.002038,172.217.194.0-255,7156,110045,1,259532
26903,0.00204,172.31.36.0-255,66,110111,1,259532
26904,0.002065,172.217.194.0-255,3602,113713,1,259532
26905,0.002071,172.31.36.0-255,66,113779,1,259532
26906,0.002171,172.217.194.0-255,1484,115263,1,259532
26907,0.002177,172.217.194.0-255,2902,118165,1,259532
26908,0.00218,172.31.36.0-255,66,118231,1,259532
26909,0.002184,172.217.194.0-255,1484,119715,1,259532
26910,0.002208,172.217.194.0-255,4320,124035,1,259532
26911,0.002211,172.31.36.0-255,66,124101,1,259532
26912,0.002217,172.217.194.0-255,4320,128421,1,259532
26913,0.002219,172.31.36.0-255,66,128487,1,259532
26914,0.002247,172.217.194.0-255,7156,135643,1,259532
26915,0.00225,172.31.36.0-255,66,135709,1,259532
26916,0.002265,172.31.36.0-255,66,135775,1,259532
26917,0.004537,172.217.194.0-255,5738,141513,1,259532
26918,0.004545,172.31.36.0-255,66,141579,1,259532
26919,0.006817,172.217.194.0-255,5738,147317,1,259532
26920,0.006822,172.31.36.0-255,66,147383,1,259532
26921,0.009113,172.217.194.0-255,5738,153121,1,259532
26922,0.00912,172.31.36.0-255,66,153187,1,259532
26923,0.011417,172.217.194.0-255,5738,158925,1,259532
26924,0.011426,172.31.36.0-255,66,158991,1,259532
26925,0.013714,172.217.194.0-255,5738,164729,1,259532
26926,0.013723,172.31.36.0-255,66,164795,1,259532
26927,0.016027,172.217.194.0-255,5738,170533,1,259532
26928,0.016036,172.31.36.0-255,66,170599,1,259532
26929,0.018325,172.217.194.0-255,5738,176337,1,259532
26930,0.018333,172.31.36.0-255,66,176403,1,259532
26931,0.020642,172.217.194.0-255,5738,182141,1,259532
26932,0.020649,172.31.36.0-255,66,182207,1,259532
26933,0.022941,172.217.194.0-255,5738,187945,1,259532
26934,0.022948,172.31.36.0-255,66,188011,1,259532
26935,0.025236,172.217.194.0-255,5738,193749,1,259532
26936,0.025244,172.31.36.0-255,66,193815,1,259532
26937,0.027529,172.217.194.0-255,5738,199553,1,259532
26938,0.027537,172.31.36.0-255,66,199619,1,259532
26939,0.029817,172.217.194.0-255,5738,205357,1,259532
26940,0.029825,172.31.36.0-255,66,205423,1,259532
26941,0.03213,172.217.194.0-255,4320,209743,1,259532
26942,0.032137,172.31.36.0-255,66,209809,1,259532
26943,0.032158,172.217.194.0-255,1484,211293,1,259532
26944,0.03412,172.31.36.0-255,172,211465,1,259532
26945,0.034168,172.31.36.0-255,1114,212579,1,259532
26946,0.034235,172.31.36.0-255,1514,214093,1,259532
26947,0.034237,172.31.36.0-255,1514,215607,1,259532
26948,0.034238,172.31.36.0-255,1514,217121,1,259532
26949,0.03424,172.31.36.0-255,1514,218635,1,259532
26950,0.034272,172.31.36.0-255,1489,220124,1,259532
26951,0.034407,172.217.194.0-255,4320,224444,1,259532
26952,0.034413,172.31.36.0-255,66,224510,1,259532
26953,0.035676,104.244.42.0-255,66,224576,1,259532
26954,0.035729,104.244.42.0-255,66,224642,1,259532
26955,0.035848,104.244.42.0-255,66,224708,1,259532
26956,0.036743,172.217.194.0-255,5738,230446,1,259532
26957,0.03675,172.31.36.0-255,66,230512,1,259532
26958,0.039083,172.217.194.0-255,5738,236250,1,259532
26959,0.039091,172.31.36.0-255,66,236316,1,259532
26960,0.041405,172.217.194.0-255,5738,242054,1,259532
26961,0.041412,172.31.36.0-255,66,242120,1,259532
26962,0.04374,172.217.194.0-255,5738,247858,1,259532
26963,0.043747,172.31.36.0-255,66,247924,1,259532
26964,0.04607,172.217.194.0-255,5738,253662,1,259532
26965,0.046077,172.31.36.0-255,66,253728,1,259532
26966,0.048357,172.217.194.0-255,5738,259466,1,259532
26967,0.048363,172.31.36.0-255,66,259532,1,259532
26968,0.0,172.217.194.0-255,153,153,1,203803
26969,2.2e-05,172.31.36.0-255,66,219,1,203803
26970,2.9e-05,172.217.194.0-255,1484,1703,1,203803
26971,3.3e-05,172.31.36.0-255,66,1769,1,203803
26972,4.7e-05,172.217.194.0-255,2902,4671,1,203803
26973,5e-05,172.31.36.0-255,66,4737,1,203803
26974,5.8e-05,172.217.194.0-255,5738,10475,1,203803
26975,6e-05,172.31.36.0-255,66,10541,1,203803
26976,0.000108,172.217.194.0-255,3501,14042,1,203803
26977,0.000111,172.31.36.0-255,66,14108,1,203803
26978,0.000763,172.217.194.0-255,1484,15592,1,203803
26979,0.00077,172.31.36.0-255,66,15658,1,203803
26980,0.000779,172.217.194.0-255,2902,18560,1,203803
26981,0.000781,172.31.36.0-255,66,18626,1,203803
26982,0.000794,172.217.194.0-255,5738,24364,1,203803
26983,0.000796,172.31.36.0-255,66,24430,1,203803
26984,0.000802,172.217.194.0-255,4320,28750,1,203803
26985,0.000804,172.31.36.0-255,66,28816,1,203803
26986,0.000836,172.217.194.0-255,2543,31359,1,203803
26987,0.00084,172.31.36.0-255,66,31425,1,203803
26988,0.001428,172.217.194.0-255,1484,32909,1,203803
26989,0.001435,172.31.36.0-255,66,32975,1,203803
26990,0.001442,172.217.194.0-255,2902,35877,1,203803
26991,0.001445,172.31.36.0-255,66,35943,1,203803
26992,0.001471,172.217.194.0-255,5738,41681,1,203803
26993,0.001478,172.31.36.0-255,66,41747,1,203803
26994,0.001481,172.217.194.0-255,1484,43231,1,203803
26995,0.001483,172.31.36.0-255,66,43297,1,203803
26996,0.001523,172.31.36.0-255,66,43363,1,203803
26997,0.001535,172.31.36.0-255,66,43429,1,203803
26998,0.001564,172.217.194.0-255,2543,45972,1,203803
26999,0.001566,172.31.36.0-255,66,46038,1,203803
27000,0.004744,172.217.194.0-255,646,46684,1,203803
27001,0.005273,172.217.194.0-255,1484,48168,1,203803
27002,0.00528,172.31.36.0-255,66,48234,1,203803
27003,0.005287,172.217.194.0-255,2902,51136,1,203803
27004,0.005289,172.31.36.0-255,66,51202,1,203803
27005,0.005297,172.217.194.0-255,1484,52686,1,203803
27006,0.005328,172.217.194.0-255,4320,57006,1,203803
27007,0.005331,172.31.36.0-255,66,57072,1,203803
27008,0.005346,172.31.36.0-255,66,57138,1,203803
27009,0.005372,172.217.194.0-255,4320,61458,1,203803
27010,0.005374,172.31.36.0-255,66,61524,1,203803
27011,0.005416,172.31.36.0-255,66,61590,1,203803
27012,0.006924,172.217.194.0-255,1484,63074,1,203803
27013,0.006933,172.217.194.0-255,2902,65976,1,203803
27014,0.006939,172.31.36.0-255,66,66042,1,203803
27015,0.006945,172.217.194.0-255,2902,68944,1,203803
27016,0.006947,172.31.36.0-255,66,69010,1,203803
27017,0.00698,172.217.194.0-255,7156,76166,1,203803
27018,0.006982,172.31.36.0-255,66,76232,1,203803
27019,0.006996,172.31.36.0-255,66,76298,1,203803
27020,0.007024,172.217.194.0-255,5738,82036,1,203803
27021,0.007027,172.31.36.0-255,66,82102,1,203803
27022,0.007032,172.217.194.0-255,3602,85704,1,203803
27023,0.007034,172.31.36.0-255,66,85770,1,203803
27024,0.007141,172.217.194.0-255,1484,87254,1,203803
27025,0.007149,172.217.194.0-255,2902,90156,1,203803
27026,0.007153,172.31.36.0-255,66,90222,1,203803
27027,0.007157,172.217.194.0-255,1484,91706,1,203803
27028,0.007183,172.217.194.0-255,2902,94608,1,203803
27029,0.007186,172.31.36.0-255,66,94674,1,203803
27030,0.007198,172.31.36.0-255,66,94740,1,203803
27031,0.007239,172.217.194.0-255,4320,99060,1,203803
27032,0.007242,172.31.36.0-255,66,99126,1,203803
27033,0.007274,172.217.194.0-255,5738,104864,1,203803
27034,0.007277,172.31.36.0-255,66,104930,1,203803
27035,0.007284,172.217.194.0-255,6438,111368,1,203803
27036,0.007286,172.31.36.0-255,66,111434,1,203803
27037,0.007803,172.217.194.0-255,1484,112918,1,203803
27038,0.00781,172.217.194.0-255,2902,115820,1,203803
27039,0.007814,172.31.36.0-255,66,115886,1,203803
27040,0.00782,172.217.194.0-255,5738,121624,1,203803
27041,0.007822,172.31.36.0-255,66,121690,1,203803
27042,0.007855,172.31.36.0-255,66,121756,1,203803
27043,0.007888,172.31.36.0-255,66,121822,1,203803
27044,0.007977,172.217.194.0-255,1484,123306,1,203803
27045,0.007982,172.217.194.0-255,2902,126208,1,203803
27046,0.007985,172.31.36.0-255,66,126274,1,203803
27047,0.007989,172.217.194.0-255,2902,129176,1,203803
27048,0.007991,172.31.36.0-255,66,129242,1,203803
27049,0.008011,172.217.194.0-255,2902,132144,1,203803
27050,0.008017,172.31.36.0-255,66,132210,1,203803
27051,0.008022,172.217.194.0-255,5738,137948,1,203803
27052,0.008025,172.31.36.0-255,66,138014,1,203803
27053,0.008049,172.217.194.0-255,7156,145170,1,203803
27054,0.008062,172.31.36.0-255,66,145236,1,203803
27055,0.008064,172.31.36.0-255,66,145302,1,203803
27056,0.008128,172.217.194.0-255,1484,146786,1,203803
27057,0.008142,172.217.194.0-255,2902,149688,1,203803
27058,0.008144,172.31.36.0-255,66,149754,1,203803
27059,0.008164,172.217.194.0-255,5738,155492,1,203803
27060,0.008169,172.31.36.0-255,66,155558,1,203803
27061,0.008181,172.217.194.0-255,2902,158460,1,203803
27062,0.008183,172.31.36.0-255,66,158526,1,203803
27063,0.008222,172.31.36.0-255,66,158592,1,203803
27064,0.008238,172.31.36.0-255,66,158658,1,203803
27065,0.008314,172.217.194.0-255,1484,160142,1,203803
27066,0.008317,172.217.194.0-255,1484,161626,1,203803
27067,0.00832,172.31.36.0-255,66,161692,1,203803
27068,0.008341,172.217.194.0-255,1484,163176,1,203803
27069,0.008347,172.217.194.0-255,5738,168914,1,203803
27070,0.008349,172.31.36.0-255,66,168980,1,203803
27071,0.008352,172.217.194.0-255,1484,170464,1,203803
27072,0.008383,172.217.194.0-255,4320,174784,1,203803
27073,0.008386,172.31.36.0-255,66,174850,1,203803
27074,0.008398,172.31.36.0-255,66,174916,1,203803
27075,0.008408,172.217.194.0-255,7156,182072,1,203803
27076,0.008411,172.31.36.0-255,66,182138,1,203803
27077,0.008472,172.31.36.0-255,66,182204,1,203803
27078,0.008491,172.31.36.0-255,66,182270,1,203803
27079,0.008501,172.31.36.0-255,66,182336,1,203803
27080,0.008536,172.217.194.0-255,7156,189492,1,203803
27081,0.008539,172.31.36.0-255,66,189558,1,203803
27082,0.008578,172.31.36.0-255,66,189624,1,203803
27083,0.008603,172.31.36.0-255,66,189690,1,203803
27084,0.008615,172.31.36.0-255,66,189756,1,203803
27085,0.00862,172.217.194.0-255,4529,194285,1,203803
27086,0.008623,172.31.36.0-255,66,194351,1,203803
27087,0.008626,172.217.194.0-255,105,194456,1,203803
27088,0.015131,172.31.36.0-255,66,194522,1,203803
27089,0.015188,172.31.36.0-255,105,194627,1,203803
27090,0.017494,172.217.194.0-255,66,194693,1,203803
27091,0.033443,172.31.36.0-255,172,194865,1,203803
27092,0.033479,172.31.36.0-255,1112,195977,1,203803
27093,0.033563,172.31.36.0-255,1514,197491,1,203803
27094,0.033565,172.31.36.0-255,1514,199005,1,203803
27095,0.033566,172.31.36.0-255,1514,200519,1,203803
27096,0.033568,172.31.36.0-255,1514,202033,1,203803
27097,0.033595,172.31.36.0-255,1506,203539,1,203803
27098,0.034978,104.244.42.0-255,66,203605,1,203803
27099,0.035021,104.244.42.0-255,66,203671,1,203803
27100,0.035171,104.244.42.0-255,66,203737,1,203803
27101,0.035178,104.244.42.0-255,66,203803,1,203803
27102,0.0,74.125.24.0-255,152,152,1,227636
27103,3.5e-05,172.31.36.0-255,66,218,1,227636
27104,4.2e-05,74.125.24.0-255,1484,1702,1,227636
27105,4.6e-05,172.31.36.0-255,66,1768,1,227636
27106,5.1e-05,74.125.24.0-255,2902,4670,1,227636
27107,5.4e-05,172.31.36.0-255,66,4736,1,227636
27108,6.9e-05,74.125.24.0-255,7156,11892,1,227636
27109,7.2e-05,172.31.36.0-255,66,11958,1,227636
27110,7.6e-05,74.125.24.0-255,2065,14023,1,227636
27111,7.8e-05,172.31.36.0-255,66,14089,1,227636
27112,8.3e-05,74.125.24.0-255,4320,18409,1,227636
27113,8.5e-05,172.31.36.0-255,66,18475,1,227636
27114,0.000135,172.31.36.0-255,66,18541,1,227636
27115,0.000138,74.125.24.0-255,1125,19666,1,227636
27116,0.00014,172.31.36.0-255,66,19732,1,227636
27117,0.000182,74.125.24.0-255,1484,21216,1,227636
27118,0.000186,172.31.36.0-255,66,21282,1,227636
27119,0.000204,74.125.24.0-255,1484,22766,1,227636
27120,0.000207,172.31.36.0-255,66,22832,1,227636
27121,0.000211,74.125.24.0-255,2902,25734,1,227636
27122,0.000214,172.31.36.0-255,66,25800,1,227636
27123,0.000249,74.125.24.0-255,5738,31538,1,227636
27124,0.000252,172.31.36.0-255,66,31604,1,227636
27125,0.000263,172.31.36.0-255,66,31670,1,227636
27126,0.000303,172.31.36.0-255,66,31736,1,227636
27127,0.00031,74.125.24.0-255,5687,37423,1,227636
27128,0.000312,172.31.36.0-255,66,37489,1,227636
27129,0.001014,74.125.24.0-255,114,37603,1,227636
27130,0.00102,172.31.36.0-255,66,37669,1,227636
27131,0.001153,74.125.24.0-255,1484,39153,1,227636
27132,0.001161,74.125.24.0-255,2902,42055,1,227636
27133,0.001165,172.31.36.0-255,66,42121,1,227636
27134,0.001173,74.125.24.0-255,5738,47859,1,227636
27135,0.001175,172.31.36.0-255,66,47925,1,227636
27136,0.001247,172.31.36.0-255,66,47991,1,227636
27137,0.001259,172.31.36.0-255,66,48057,1,227636
27138,0.001964,74.125.24.0-255,1484,49541,1,227636
27139,0.00197,74.125.24.0-255,2902,52443,1,227636
27140,0.001975,172.31.36.0-255,66,52509,1,227636
27141,0.00198,74.125.24.0-255,2902,55411,1,227636
27142,0.001982,172.31.36.0-255,66,55477,1,227636
27143,0.002005,74.125.24.0-255,2902,58379,1,227636
27144,0.002009,172.31.36.0-255,66,58445,1,227636
27145,0.002017,74.125.24.0-255,7156,65601,1,227636
27146,0.002021,172.31.36.0-255,66,65667,1,227636
27147,0.00206,172.31.36.0-255,66,65733,1,227636
27148,0.002065,74.125.24.0-255,2184,67917,1,227636
27149,0.002067,172.31.36.0-255,66,67983,1,227636
27150,0.00225,74.125.24.0-255,1484,69467,1,227636
27151,0.002258,74.125.24.0-255,2902,72369,1,227636
27152,0.002261,172.31.36.0-255,66,72435,1,227636
27153,0.002266,74.125.24.0-255,2902,75337,1,227636
27154,0.002268,172.31.36.0-255,66,75403,1,227636
27155,0.002292,74.125.24.0-255,2902,78305,1,227636
27156,0.002294,172.31.36.0-255,66,78371,1,227636
27157,0.002301,74.125.24.0-255,7156,85527,1,227636
27158,0.002303,172.31.36.0-255,66,85593,1,227636
27159,0.002332,74.125.24.0-255,5738,91331,1,227636
27160,0.002334,172.31.36.0-255,66,91397,1,227636
27161,0.002339,74.125.24.0-255,5738,97135,1,227636
27162,0.002341,172.31.36.0-255,66,97201,1,227636
27163,0.002362,74.125.24.0-255,1484,98685,1,227636
27164,0.00238,74.125.24.0-255,3602,102287,1,227636
27165,0.002382,172.31.36.0-255,66,102353,1,227636
27166,0.004767,74.125.24.0-255,5738,108091,1,227636
27167,0.004771,172.31.36.0-255,66,108157,1,227636
27168,0.007146,74.125.24.0-255,5738,113895,1,227636
27169,0.007153,172.31.36.0-255,66,113961,1,227636
27170,0.009499,74.125.24.0-255,5738,119699,1,227636
27171,0.009508,172.31.36.0-255,66,119765,1,227636
27172,0.011853,74.125.24.0-255,5738,125503,1,227636
27173,0.01186,172.31.36.0-255,66,125569,1,227636
27174,0.014206,74.125.24.0-255,5738,131307,1,227636
27175,0.01422,172.31.36.0-255,66,131373,1,227636
27176,0.016558,74.125.24.0-255,5738,137111,1,227636
27177,0.016568,172.31.36.0-255,66,137177,1,227636
27178,0.018917,74.125.24.0-255,5738,142915,1,227636
27179,0.018925,172.31.36.0-255,66,142981,1,227636
27180,0.021296,74.125.24.0-255,5738,148719,1,227636
27181,0.021304,172.31.36.0-255,66,148785,1,227636
27182,0.023655,74.125.24.0-255,5738,154523,1,227636
27183,0.023663,172.31.36.0-255,66,154589,1,227636
27184,0.02601,74.125.24.0-255,5738,160327,1,227636
27185,0.026017,172.31.36.0-255,66,160393,1,227636
27186,0.028351,74.125.24.0-255,5738,166131,1,227636
27187,0.028361,172.31.36.0-255,66,166197,1,227636
27188,0.029861,172.31.36.0-255,172,166369,1,227636
27189,0.029888,172.31.36.0-255,1114,167483,1,227636
27190,0.029939,172.31.36.0-255,1514,168997,1,227636
27191,0.02994,172.31.36.0-255,1514,170511,1,227636
27192,0.029942,172.31.36.0-255,1514,172025,1,227636
27193,0.029942,172.31.36.0-255,1514,173539,1,227636
27194,0.029969,172.31.36.0-255,1489,175028,1,227636
27195,0.030711,74.125.24.0-255,5738,180766,1,227636
27196,0.030718,172.31.36.0-255,66,180832,1,227636
27197,0.031401,104.244.42.0-255,66,180898,1,227636
27198,0.031461,104.244.42.0-255,66,180964,1,227636
27199,0.031547,104.244.42.0-255,66,181030,1,227636
27200,0.032052,104.244.42.0-255,108,181138,1,227636
27201,0.032058,172.31.36.0-255,66,181204,1,227636
27202,0.033052,74.125.24.0-255,5738,186942,1,227636
27203,0.033059,172.31.36.0-255,66,187008,1,227636
27204,0.035423,74.125.24.0-255,5738,192746,1,227636
27205,0.035429,172.31.36.0-255,66,192812,1,227636
27206,0.037783,74.125.24.0-255,5738,198550,1,227636
27207,0.037789,172.31.36.0-255,66,198616,1,227636
27208,0.040127,74.125.24.0-255,5738,204354,1,227636
27209,0.040132,172.31.36.0-255,66,204420,1,227636
27210,0.042459,74.125.24.0-255,5738,210158,1,227636
27211,0.04248,172.31.36.0-255,66,210224,1,227636
27212,0.044842,74.125.24.0-255,5738,215962,1,227636
27213,0.044847,172.31.36.0-255,66,216028,1,227636
27214,0.047186,74.125.24.0-255,5738,221766,1,227636
27215,0.047191,172.31.36.0-255,66,221832,1,227636
27216,0.049553,74.125.24.0-255,5738,227570,1,227636
27217,0.049559,172.31.36.0-255,66,227636,1,227636
27218,0.0,74.125.24.0-255,153,153,1,298845
27219,2.2e-05,172.31.36.0-255,66,219,1,298845
27220,2.9e-05,74.125.24.0-255,1484,1703,1,298845
27221,3.4e-05,172.31.36.0-255,66,1769,1,298845
27222,3.9e-05,74.125.24.0-255,2902,4671,1,298845
27223,4.3e-05,172.31.36.0-255,66,4737,1,298845
27224,5e-05,74.125.24.0-255,7156,11893,1,298845
27225,5.3e-05,172.31.36.0-255,66,11959,1,298845
27226,5.8e-05,74.125.24.0-255,2040,13999,1,298845
27227,6e-05,172.31.36.0-255,66,14065,1,298845
27228,7.6e-05,172.31.36.0-255,66,14131,1,298845
27229,0.000102,74.125.24.0-255,1484,15615,1,298845
27230,0.000104,172.31.36.0-255,66,15681,1,298845
27231,0.000112,74.125.24.0-255,5379,21060,1,298845
27232,0.000114,172.31.36.0-255,66,21126,1,298845
27233,0.000171,74.125.24.0-255,1484,22610,1,298845
27234,0.000174,172.31.36.0-255,66,22676,1,298845
27235,0.000194,74.125.24.0-255,2902,25578,1,298845
27236,0.000197,172.31.36.0-255,66,25644,1,298845
27237,0.000221,74.125.24.0-255,5738,31382,1,298845
27238,0.000223,172.31.36.0-255,66,31448,1,298845
27239,0.000229,74.125.24.0-255,5738,37186,1,298845
27240,0.000231,172.31.36.0-255,66,37252,1,298845
27241,0.000261,172.31.36.0-255,66,37318,1,298845
27242,0.000274,74.125.24.0-255,1484,38802,1,298845
27243,0.000276,172.31.36.0-255,66,38868,1,298845
27244,0.000283,74.125.24.0-255,5020,43888,1,298845
27245,0.000285,172.31.36.0-255,66,43954,1,298845
27246,0.000301,74.125.24.0-255,361,44315,1,298845
27247,0.000304,172.31.36.0-255,66,44381,1,298845
27248,0.000479,74.125.24.0-255,1484,45865,1,298845
27249,0.000484,74.125.24.0-255,2902,48767,1,298845
27250,0.000491,172.31.36.0-255,66,48833,1,298845
27251,0.000503,74.125.24.0-255,5738,54571,1,298845
27252,0.000505,172.31.36.0-255,66,54637,1,298845
27253,0.000538,172.31.36.0-255,66,54703,1,298845
27254,0.000558,74.125.24.0-255,1484,56187,1,298845
27255,0.000566,74.125.24.0-255,7156,63343,1,298845
27256,0.000569,172.31.36.0-255,66,63409,1,298845
27257,0.000587,74.125.24.0-255,1484,64893,1,298845
27258,0.000599,74.125.24.0-255,1484,66377,1,298845
27259,0.000601,172.31.36.0-255,66,66443,1,298845
27260,0.000622,172.31.36.0-255,66,66509,1,298845
27261,0.000656,172.31.36.0-255,66,66575,1,298845
27262,0.000722,74.125.24.0-255,1484,68059,1,298845
27263,0.000738,74.125.24.0-255,2902,70961,1,298845
27264,0.000742,172.31.36.0-255,66,71027,1,298845
27265,0.000755,74.125.24.0-255,4320,75347,1,298845
27266,0.000757,172.31.36.0-255,66,75413,1,298845
27267,0.000768,74.125.24.0-255,1484,76897,1,298845
27268,0.000791,74.125.24.0-255,4320,81217,1,298845
27269,0.000793,172.31.36.0-255,66,81283,1,298845
27270,0.000821,172.31.36.0-255,66,81349,1,298845
27271,0.000876,172.31.36.0-255,66,81415,1,298845
27272,0.000881,74.125.24.0-255,2902,84317,1,298845
27273,0.000883,172.31.36.0-255,66,84383,1,298845
27274,0.000899,74.125.24.0-255,5738,90121,1,298845
27275,0.000903,74.125.24.0-255,2902,93023,1,298845
27276,0.000906,172.31.36.0-255,66,93089,1,298845
27277,0.000909,172.31.36.0-255,66,93155,1,298845
27278,0.000922,74.125.24.0-255,7156,100311,1,298845
27279,0.000932,172.31.36.0-255,66,100377,1,298845
27280,0.000937,74.125.24.0-255,2902,103279,1,298845
27281,0.000939,172.31.36.0-255,66,103345,1,298845
27282,0.000955,74.125.24.0-255,5738,109083,1,298845
27283,0.000958,172.31.36.0-255,66,109149,1,298845
27284,0.000985,74.125.24.0-255,5738,114887,1,298845
27285,0.000987,172.31.36.0-255,66,114953,1,298845
27286,0.00099,74.125.24.0-255,766,115719,1,298845
27287,0.001122,74.125.24.0-255,1484,117203,1,298845
27288,0.001126,172.31.36.0-255,66,117269,1,298845
27289,0.001131,74.125.24.0-255,2902,120171,1,298845
27290,0.001133,172.31.36.0-255,66,120237,1,298845
27291,0.001146,74.125.24.0-255,1484,121721,1,298845
27292,0.001164,74.125.24.0-255,4320,126041,1,298845
27293,0.001166,172.31.36.0-255,66,126107,1,298845
27294,0.001198,172.31.36.0-255,66,126173,1,298845
27295,0.001204,74.125.24.0-255,4320,130493,1,298845
27296,0.001207,172.31.36.0-255,66,130559,1,298845
27297,0.001239,74.125.24.0-255,1484,132043,1,298845
27298,0.001257,74.125.24.0-255,5020,137063,1,298845
27299,0.001259,172.31.36.0-255,66,137129,1,298845
27300,0.001307,74.125.24.0-255,1484,138613,1,298845
27301,0.001327,74.125.24.0-255,2902,141515,1,298845
27302,0.00133,172.31.36.0-255,66,141581,1,298845
27303,0.001338,74.125.24.0-255,5738,147319,1,298845
27304,0.001341,172.31.36.0-255,66,147385,1,298845
27305,0.001368,74.125.24.0-255,4320,151705,1,298845
27306,0.001371,172.31.36.0-255,66,151771,1,298845
27307,0.001385,172.31.36.0-255,66,151837,1,298845
27308,0.001423,172.31.36.0-255,66,151903,1,298845
27309,0.001428,74.125.24.0-255,2902,154805,1,298845
27310,0.00143,172.31.36.0-255,66,154871,1,298845
27311,0.00146,74.125.24.0-255,5738,160609,1,298845
27312,0.001463,172.31.36.0-255,66,160675,1,298845
27313,0.001471,74.125.24.0-255,5738,166413,1,298845
27314,0.001473,172.31.36.0-255,66,166479,1,298845
27315,0.001508,172.31.36.0-255,66,166545,1,298845
27316,0.001517,74.125.24.0-255,6438,172983,1,298845
27317,0.001519,172.31.36.0-255,66,173049,1,298845
27318,0.001749,74.125.24.0-255,1484,174533,1,298845
27319,0.001756,74.125.24.0-255,2902,177435,1,298845
27320,0.001759,172.31.36.0-255,66,177501,1,298845
27321,0.001785,74.125.24.0-255,5738,183239,1,298845
27322,0.001787,172.31.36.0-255,66,183305,1,298845
27323,0.001818,74.125.24.0-255,5738,189043,1,298845
27324,0.00182,172.31.36.0-255,66,189109,1,298845
27325,0.001844,74.125.24.0-255,5738,194847,1,298845
27326,0.001846,172.31.36.0-255,66,194913,1,298845
27327,0.001861,172.31.36.0-255,66,194979,1,298845
27328,0.003908,74.125.24.0-255,5738,200717,1,298845
27329,0.003915,172.31.36.0-255,66,200783,1,298845
27330,0.005922,74.125.24.0-255,5738,206521,1,298845
27331,0.005928,172.31.36.0-255,66,206587,1,298845
27332,0.007942,74.125.24.0-255,5738,212325,1,298845
27333,0.00795,172.31.36.0-255,66,212391,1,298845
27334,0.00996,74.125.24.0-255,5738,218129,1,298845
27335,0.009965,172.31.36.0-255,66,218195,1,298845
27336,0.011975,74.125.24.0-255,5738,223933,1,298845
27337,0.011983,172.31.36.0-255,66,223999,1,298845
27338,0.013985,74.125.24.0-255,5738,229737,1,298845
27339,0.013993,172.31.36.0-255,66,229803,1,298845
27340,0.015999,74.125.24.0-255,5738,235541,1,298845
27341,0.016006,172.31.36.0-255,66,235607,1,298845
27342,0.018012,74.125.24.0-255,5738,241345,1,298845
27343,0.01802,172.31.36.0-255,66,241411,1,298845
27344,0.020061,74.125.24.0-255,5738,247149,1,298845
27345,0.020073,172.31.36.0-255,66,247215,1,298845
27346,0.022066,74.125.24.0-255,5738,252953,1,298845
27347,0.022075,172.31.36.0-255,66,253019,1,298845
27348,0.024059,74.125.24.0-255,5738,258757,1,298845
27349,0.024067,172.31.36.0-255,66,258823,1,298845
27350,0.026078,74.125.24.0-255,5738,264561,1,298845
27351,0.026084,172.31.36.0-255,66,264627,1,298845
27352,0.028083,74.125.24.0-255,5738,270365,1,298845
27353,0.02809,172.31.36.0-255,66,270431,1,298845
27354,0.03008,74.125.24.0-255,5738,276169,1,298845
27355,0.030088,172.31.36.0-255,66,276235,1,298845
27356,0.032099,74.125.24.0-255,4320,280555,1,298845
27357,0.032106,172.31.36.0-255,66,280621,1,298845
27358,0.032126,74.125.24.0-255,1484,282105,1,298845
27359,0.034134,74.125.24.0-255,4320,286425,1,298845
27360,0.034141,172.31.36.0-255,66,286491,1,298845
27361,0.036136,74.125.24.0-255,3087,289578,1,298845
27362,0.036144,172.31.36.0-255,66,289644,1,298845
27363,0.036336,172.31.36.0-255,105,289749,1,298845
27364,0.038297,74.125.24.0-255,66,289815,1,298845
27365,0.042767,172.31.36.0-255,172,289987,1,298845
27366,0.042804,172.31.36.0-255,1113,291100,1,298845
27367,0.042867,172.31.36.0-255,1514,292614,1,298845
27368,0.042869,172.31.36.0-255,1514,294128,1,298845
27369,0.042875,172.31.36.0-255,1514,295642,1,298845
27370,0.042876,172.31.36.0-255,1514,297156,1,298845
27371,0.042895,172.31.36.0-255,1491,298647,1,298845
27372,0.044307,104.244.42.0-255,66,298713,1,298845
27373,0.044359,104.244.42.0-255,66,298779,1,298845
27374,0.044534,104.244.42.0-255,66,298845,1,298845
27375,0.0,172.217.194.0-255,147,147,1,225703
27376,3.5e-05,172.31.36.0-255,66,213,1,225703
27377,4.2e-05,172.217.194.0-255,1484,1697,1,225703
27378,4.7e-05,172.31.36.0-255,66,1763,1,225703
27379,5.2e-05,172.217.194.0-255,2902,4665,1,225703
27380,5.5e-05,172.31.36.0-255,66,4731,1,225703
27381,6e-05,172.217.194.0-255,4320,9051,1,225703
27382,6.3e-05,172.31.36.0-255,66,9117,1,225703
27383,8e-05,172.217.194.0-255,1484,10601,1,225703
27384,8.3e-05,172.31.36.0-255,66,10667,1,225703
27385,0.000113,172.217.194.0-255,3469,14136,1,225703
27386,0.000116,172.31.36.0-255,66,14202,1,225703
27387,0.000121,172.217.194.0-255,5738,19940,1,225703
27388,0.000123,172.31.36.0-255,66,20006,1,225703
27389,0.000155,172.31.36.0-255,66,20072,1,225703
27390,0.000168,172.217.194.0-255,1125,21197,1,225703
27391,0.000171,172.31.36.0-255,66,21263,1,225703
27392,0.000173,172.217.194.0-255,1484,22747,1,225703
27393,0.000177,172.31.36.0-255,66,22813,1,225703
27394,0.000195,172.217.194.0-255,4320,27133,1,225703
27395,0.000197,172.31.36.0-255,66,27199,1,225703
27396,0.000225,172.31.36.0-255,66,27265,1,225703
27397,0.000713,172.217.194.0-255,1484,28749,1,225703
27398,0.000718,172.31.36.0-255,66,28815,1,225703
27399,0.000726,172.217.194.0-255,2902,31717,1,225703
27400,0.000728,172.31.36.0-255,66,31783,1,225703
27401,0.000743,172.217.194.0-255,5738,37521,1,225703
27402,0.000745,172.31.36.0-255,66,37587,1,225703
27403,0.00075,172.217.194.0-255,2902,40489,1,225703
27404,0.000752,172.31.36.0-255,66,40555,1,225703
27405,0.000776,172.217.194.0-255,4541,45096,1,225703
27406,0.00079,172.217.194.0-255,2902,47998,1,225703
27407,0.000813,172.217.194.0-255,5738,53736,1,225703
27408,0.000816,172.217.194.0-255,1484,55220,1,225703
27409,0.000834,172.217.194.0-255,6248,61468,1,225703
27410,0.001948,172.217.194.0-255,1484,62952,1,225703
27411,0.001955,172.217.194.0-255,2902,65854,1,225703
27412,0.001966,172.217.194.0-255,1484,67338,1,225703
27413,0.001979,172.217.194.0-255,2902,70240,1,225703
27414,0.001999,172.217.194.0-255,5738,75978,1,225703
27415,0.002004,172.217.194.0-255,4320,80298,1,225703
27416,0.002032,172.217.194.0-255,6438,86736,1,225703
27417,0.002125,172.217.194.0-255,1484,88220,1,225703
27418,0.002143,172.217.194.0-255,2902,91122,1,225703
27419,0.002148,172.217.194.0-255,4320,95442,1,225703
27420,0.002162,172.217.194.0-255,1484,96926,1,225703
27421,0.002164,172.217.194.0-255,1484,98410,1,225703
27422,0.002197,172.217.194.0-255,7156,105566,1,225703
27423,0.002256,172.217.194.0-255,1484,107050,1,225703
27424,0.002262,172.217.194.0-255,5020,112070,1,225703
27425,0.006231,172.31.36.0-255,66,112136,1,225703
27426,0.008606,172.217.194.0-255,5738,117874,1,225703
27427,0.008613,172.31.36.0-255,66,117940,1,225703
27428,0.010952,172.217.194.0-255,5738,123678,1,225703
27429,0.010959,172.31.36.0-255,66,123744,1,225703
27430,0.013314,172.217.194.0-255,5738,129482,1,225703
27431,0.013321,172.31.36.0-255,66,129548,1,225703
27432,0.015622,172.217.194.0-255,5738,135286,1,225703
27433,0.015629,172.31.36.0-255,66,135352,1,225703
27434,0.017961,172.217.194.0-255,5738,141090,1,225703
27435,0.017968,172.31.36.0-255,66,141156,1,225703
27436,0.020288,172.217.194.0-255,5738,146894,1,225703
27437,0.020298,172.31.36.0-255,66,146960,1,225703
27438,0.022615,172.217.194.0-255,5738,152698,1,225703
27439,0.022623,172.31.36.0-255,66,152764,1,225703
27440,0.024947,172.217.194.0-255,5738,158502,1,225703
27441,0.024955,172.31.36.0-255,66,158568,1,225703
27442,0.027265,172.217.194.0-255,5738,164306,1,225703
27443,0.027274,172.31.36.0-255,66,164372,1,225703
27444,0.029604,172.217.194.0-255,5738,170110,1,225703
27445,0.029613,172.31.36.0-255,66,170176,1,225703
27446,0.031932,172.217.194.0-255,5738,175914,1,225703
27447,0.03194,172.31.36.0-255,66,175980,1,225703
27448,0.033507,172.31.36.0-255,172,176152,1,225703
27449,0.033537,172.31.36.0-255,1113,177265,1,225703
27450,0.033593,172.31.36.0-255,1514,178779,1,225703
27451,0.033595,172.31.36.0-255,1514,180293,1,225703
27452,0.0336,172.31.36.0-255,1514,181807,1,225703
27453,0.033601,172.31.36.0-255,1514,183321,1,225703
27454,0.033621,172.31.36.0-255,1490,184811,1,225703
27455,0.034288,172.217.194.0-255,5738,190549,1,225703
27456,0.034297,172.31.36.0-255,66,190615,1,225703
27457,0.035067,104.244.42.0-255,66,190681,1,225703
27458,0.035076,104.244.42.0-255,66,190747,1,225703
27459,0.035151,104.244.42.0-255,66,190813,1,225703
27460,0.035201,104.244.42.0-255,66,190879,1,225703
27461,0.036624,172.217.194.0-255,5738,196617,1,225703
27462,0.03663,172.31.36.0-255,66,196683,1,225703
27463,0.038927,172.217.194.0-255,5738,202421,1,225703
27464,0.038948,172.31.36.0-255,66,202487,1,225703
27465,0.041278,172.217.194.0-255,5738,208225,1,225703
27466,0.041284,172.31.36.0-255,66,208291,1,225703
27467,0.043584,172.217.194.0-255,5738,214029,1,225703
27468,0.043591,172.31.36.0-255,66,214095,1,225703
27469,0.045955,172.217.194.0-255,5738,219833,1,225703
27470,0.045962,172.31.36.0-255,66,219899,1,225703
27471,0.048279,172.217.194.0-255,5738,225637,1,225703
27472,0.048284,172.31.36.0-255,66,225703,1,225703
27473,0.0,172.31.36.0-255,66,66,1,66
27474,0.0,74.125.24.0-255,152,152,1,239102
27475,3.2e-05,172.31.36.0-255,66,218,1,239102
27476,4e-05,74.125.24.0-255,1484,1702,1,239102
27477,4.4e-05,172.31.36.0-255,66,1768,1,239102
27478,5.7e-05,74.125.24.0-255,2902,4670,1,239102
27479,6e-05,172.31.36.0-255,66,4736,1,239102
27480,6.7e-05,74.125.24.0-255,7156,11892,1,239102
27481,7e-05,172.31.36.0-255,66,11958,1,239102
27482,7.4e-05,74.125.24.0-255,2099,14057,1,239102
27483,7.6e-05,172.31.36.0-255,66,14123,1,239102
27484,0.000304,74.125.24.0-255,1484,15607,1,239102
27485,0.00031,172.31.36.0-255,66,15673,1,239102
27486,0.000316,74.125.24.0-255,2902,18575,1,239102
27487,0.000319,172.31.36.0-255,66,18641,1,239102
27488,0.000331,74.125.24.0-255,2902,21543,1,239102
27489,0.000334,172.31.36.0-255,66,21609,1,239102
27490,0.000343,74.125.24.0-255,7156,28765,1,239102
27491,0.000346,172.31.36.0-255,66,28831,1,239102
27492,0.000375,74.125.24.0-255,1484,30315,1,239102
27493,0.000379,172.31.36.0-255,66,30381,1,239102
27494,0.000417,172.31.36.0-255,66,30447,1,239102
27495,0.000422,74.125.24.0-255,2902,33349,1,239102
27496,0.000426,172.31.36.0-255,66,33415,1,239102
27497,0.00045,74.125.24.0-255,6797,40212,1,239102
27498,0.000453,172.31.36.0-255,66,40278,1,239102
27499,0.000974,74.125.24.0-255,1484,41762,1,239102
27500,0.000981,172.31.36.0-255,66,41828,1,239102
27501,0.00099,74.125.24.0-255,2902,44730,1,239102
27502,0.000992,172.31.36.0-255,66,44796,1,239102
27503,0.001005,74.125.24.0-255,5738,50534,1,239102
27504,0.001008,172.31.36.0-255,66,50600,1,239102
27505,0.001042,172.31.36.0-255,66,50666,1,239102
27506,0.001056,172.31.36.0-255,66,50732,1,239102
27507,0.001109,172.31.36.0-255,66,50798,1,239102
27508,0.001112,74.125.24.0-255,645,51443,1,239102
27509,0.001506,74.125.24.0-255,1484,52927,1,239102
27510,0.001512,172.31.36.0-255,66,52993,1,239102
27511,0.001518,74.125.24.0-255,2902,55895,1,239102
27512,0.001521,172.31.36.0-255,66,55961,1,239102
27513,0.001526,74.125.24.0-255,4320,60281,1,239102
27514,0.001534,172.31.36.0-255,66,60347,1,239102
27515,0.001566,74.125.24.0-255,1484,61831,1,239102
27516,0.001577,172.31.36.0-255,66,61897,1,239102
27517,0.001587,172.31.36.0-255,66,61963,1,239102
27518,0.001606,74.125.24.0-255,5020,66983,1,239102
27519,0.001612,172.31.36.0-255,66,67049,1,239102
27520,0.001782,74.125.24.0-255,1484,68533,1,239102
27521,0.001786,74.125.24.0-255,1484,70017,1,239102
27522,0.001788,172.31.36.0-255,66,70083,1,239102
27523,0.001813,74.125.24.0-255,1484,71567,1,239102
27524,0.001819,74.125.24.0-255,5738,77305,1,239102
27525,0.001821,172.31.36.0-255,66,77371,1,239102
27526,0.001864,172.31.36.0-255,66,77437,1,239102
27527,0.001873,172.31.36.0-255,66,77503,1,239102
27528,0.001882,74.125.24.0-255,2184,79687,1,239102
27529,0.001884,172.31.36.0-255,66,79753,1,239102
27530,0.002029,74.125.24.0-255,1484,81237,1,239102
27531,0.002034,74.125.24.0-255,2902,84139,1,239102
27532,0.002037,172.31.36.0-255,66,84205,1,239102
27533,0.002086,74.125.24.0-255,1484,85689,1,239102
27534,0.002105,74.125.24.0-255,4320,90009,1,239102
27535,0.002107,172.31.36.0-255,66,90075,1,239102
27536,0.002124,172.31.36.0-255,66,90141,1,239102
27537,0.002135,172.31.36.0-255,66,90207,1,239102
27538,0.002267,74.125.24.0-255,1484,91691,1,239102
27539,0.002284,74.125.24.0-255,2902,94593,1,239102
27540,0.002286,172.31.36.0-255,66,94659,1,239102
27541,0.002291,74.125.24.0-255,2902,97561,1,239102
27542,0.002292,172.31.36.0-255,66,97627,1,239102
27543,0.002309,74.125.24.0-255,2902,100529,1,239102
27544,0.002312,172.31.36.0-255,66,100595,1,239102
27545,0.002318,74.125.24.0-255,7156,107751,1,239102
27546,0.002321,172.31.36.0-255,66,107817,1,239102
27547,0.002342,74.125.24.0-255,5738,113555,1,239102
27548,0.002345,172.31.36.0-255,66,113621,1,239102
27549,0.004618,74.125.24.0-255,5738,119359,1,239102
27550,0.004622,172.31.36.0-255,66,119425,1,239102
27551,0.00687,74.125.24.0-255,5738,125163,1,239102
27552,0.006877,172.31.36.0-255,66,125229,1,239102
27553,0.009148,74.125.24.0-255,5738,130967,1,239102
27554,0.009157,172.31.36.0-255,66,131033,1,239102
27555,0.011451,74.125.24.0-255,5738,136771,1,239102
27556,0.01146,172.31.36.0-255,66,136837,1,239102
27557,0.013767,74.125.24.0-255,5738,142575,1,239102
27558,0.013778,172.31.36.0-255,66,142641,1,239102
27559,0.016072,74.125.24.0-255,5738,148379,1,239102
27560,0.016081,172.31.36.0-255,66,148445,1,239102
27561,0.018372,74.125.24.0-255,5738,154183,1,239102
27562,0.018381,172.31.36.0-255,66,154249,1,239102
27563,0.020632,74.125.24.0-255,5738,159987,1,239102
27564,0.020639,172.31.36.0-255,66,160053,1,239102
27565,0.022931,74.125.24.0-255,5738,165791,1,239102
27566,0.022939,172.31.36.0-255,66,165857,1,239102
27567,0.025228,74.125.24.0-255,5738,171595,1,239102
27568,0.025234,172.31.36.0-255,66,171661,1,239102
27569,0.027521,74.125.24.0-255,5738,177399,1,239102
27570,0.027529,172.31.36.0-255,66,177465,1,239102
27571,0.029844,74.125.24.0-255,5738,183203,1,239102
27572,0.029859,172.31.36.0-255,66,183269,1,239102
27573,0.032156,74.125.24.0-255,5738,189007,1,239102
27574,0.032166,172.31.36.0-255,66,189073,1,239102
27575,0.03255,172.31.36.0-255,172,189245,1,239102
27576,0.032595,172.31.36.0-255,1114,190359,1,239102
27577,0.03267,172.31.36.0-255,1514,191873,1,239102
27578,0.032696,172.31.36.0-255,1514,193387,1,239102
27579,0.032697,172.31.36.0-255,1514,194901,1,239102
27580,0.032719,172.31.36.0-255,1514,196415,1,239102
27581,0.03273,172.31.36.0-255,1489,197904,1,239102
27582,0.034101,104.244.42.0-255,66,197970,1,239102
27583,0.034151,104.244.42.0-255,66,198036,1,239102
27584,0.034304,104.244.42.0-255,66,198102,1,239102
27585,0.034307,104.244.42.0-255,66,198168,1,239102
27586,0.034421,74.125.24.0-255,5738,203906,1,239102
27587,0.034425,172.31.36.0-255,66,203972,1,239102
27588,0.035374,104.244.42.0-255,108,204080,1,239102
27589,0.035391,172.31.36.0-255,66,204146,1,239102
27590,0.036706,74.125.24.0-255,5738,209884,1,239102
27591,0.03671,172.31.36.0-255,66,209950,1,239102
27592,0.038992,74.125.24.0-255,5738,215688,1,239102
27593,0.038997,172.31.36.0-255,66,215754,1,239102
27594,0.041282,74.125.24.0-255,5738,221492,1,239102
27595,0.041303,172.31.36.0-255,66,221558,1,239102
27596,0.043553,74.125.24.0-255,5738,227296,1,239102
27597,0.043559,172.31.36.0-255,66,227362,1,239102
27598,0.04582,74.125.24.0-255,5738,233100,1,239102
27599,0.045827,172.31.36.0-255,66,233166,1,239102
27600,0.048104,74.125.24.0-255,2902,236068,1,239102
27601,0.048109,172.31.36.0-255,66,236134,1,239102
27602,0.048144,74.125.24.0-255,2902,239036,1,239102
27603,0.048147,172.31.36.0-255,66,239102,1,239102
27604,0.0,172.217.194.0-255,157,157,1,295737
27605,1.8e-05,172.31.36.0-255,66,223,1,295737
27606,2.4e-05,172.217.194.0-255,1484,1707,1,295737
27607,2.9e-05,172.31.36.0-255,66,1773,1,295737
27608,5.4e-05,172.217.194.0-255,2902,4675,1,295737
27609,6.2e-05,172.31.36.0-255,66,4741,1,295737
27610,7e-05,172.217.194.0-255,5738,10479,1,295737
27611,7.3e-05,172.31.36.0-255,66,10545,1,295737
27612,0.000118,172.31.36.0-255,66,10611,1,295737
27613,0.000147,172.217.194.0-255,2049,12660,1,295737
27614,0.000149,172.31.36.0-255,66,12726,1,295737
27615,0.000165,172.31.36.0-255,66,12792,1,295737
27616,0.000177,172.31.36.0-255,66,12858,1,295737
27617,0.000205,172.217.194.0-255,1484,14342,1,295737
27618,0.000208,172.31.36.0-255,66,14408,1,295737
27619,0.000213,172.217.194.0-255,2902,17310,1,295737
27620,0.000215,172.31.36.0-255,66,17376,1,295737
27621,0.000223,172.217.194.0-255,5738,23114,1,295737
27622,0.000225,172.31.36.0-255,66,23180,1,295737
27623,0.000248,172.217.194.0-255,1484,24664,1,295737
27624,0.000251,172.31.36.0-255,66,24730,1,295737
27625,0.000274,172.217.194.0-255,4320,29050,1,295737
27626,0.000277,172.31.36.0-255,66,29116,1,295737
27627,0.000303,172.217.194.0-255,1444,30560,1,295737
27628,0.000306,172.31.36.0-255,66,30626,1,295737
27629,0.000309,172.217.194.0-255,366,30992,1,295737
27630,0.000311,172.31.36.0-255,66,31058,1,295737
27631,0.000501,172.217.194.0-255,1484,32542,1,295737
27632,0.000507,172.31.36.0-255,66,32608,1,295737
27633,0.000513,172.217.194.0-255,2902,35510,1,295737
27634,0.000515,172.31.36.0-255,66,35576,1,295737
27635,0.000546,172.217.194.0-255,5738,41314,1,295737
27636,0.000553,172.217.194.0-255,7156,48470,1,295737
27637,0.000591,172.217.194.0-255,1484,49954,1,295737
27638,0.000608,172.217.194.0-255,7156,57110,1,295737
27639,0.000629,172.217.194.0-255,5738,62848,1,295737
27640,0.000634,172.217.194.0-255,1636,64484,1,295737
27641,0.000659,172.217.194.0-255,2902,67386,1,295737
27642,0.000688,172.217.194.0-255,7156,74542,1,295737
27643,0.000706,172.217.194.0-255,5738,80280,1,295737
27644,0.000733,172.217.194.0-255,4320,84600,1,295737
27645,0.000767,172.217.194.0-255,3602,88202,1,295737
27646,0.000819,172.31.36.0-255,66,88268,1,295737
27647,0.000955,172.217.194.0-255,1484,89752,1,295737
27648,0.000973,172.217.194.0-255,2902,92654,1,295737
27649,0.00098,172.31.36.0-255,66,92720,1,295737
27650,0.000997,172.217.194.0-255,5738,98458,1,295737
27651,0.001031,172.31.36.0-255,66,98524,1,295737
27652,0.001065,172.217.194.0-255,2902,101426,1,295737
27653,0.001104,172.31.36.0-255,66,101492,1,295737
27654,0.001447,172.217.194.0-255,1484,102976,1,295737
27655,0.001453,172.217.194.0-255,2902,105878,1,295737
27656,0.001457,172.31.36.0-255,66,105944,1,295737
27657,0.001462,172.217.194.0-255,2902,108846,1,295737
27658,0.001493,172.217.194.0-255,2902,111748,1,295737
27659,0.001504,172.31.36.0-255,66,111814,1,295737
27660,0.001515,172.31.36.0-255,66,111880,1,295737
27661,0.001523,172.217.194.0-255,2902,114782,1,295737
27662,0.001567,172.31.36.0-255,66,114848,1,295737
27663,0.0016,172.217.194.0-255,1484,116332,1,295737
27664,0.001623,172.217.194.0-255,2902,119234,1,295737
27665,0.00163,172.31.36.0-255,66,119300,1,295737
27666,0.001652,172.217.194.0-255,5738,125038,1,295737
27667,0.001688,172.31.36.0-255,66,125104,1,295737
27668,0.001727,172.217.194.0-255,7156,132260,1,295737
27669,0.001747,172.217.194.0-255,3602,135862,1,295737
27670,0.001756,172.31.36.0-255,66,135928,1,295737
27671,0.001786,172.217.194.0-255,1484,137412,1,295737
27672,0.001791,172.217.194.0-255,2902,140314,1,295737
27673,0.001798,172.217.194.0-255,5738,146052,1,295737
27674,0.001865,172.31.36.0-255,66,146118,1,295737
27675,0.001905,172.217.194.0-255,2184,148302,1,295737
27676,0.001912,172.31.36.0-255,66,148368,1,295737
27677,0.002008,172.217.194.0-255,1484,149852,1,295737
27678,0.002014,172.217.194.0-255,2902,152754,1,295737
27679,0.002027,172.217.194.0-255,1484,154238,1,295737
27680,0.00204,172.31.36.0-255,66,154304,1,295737
27681,0.002058,172.217.194.0-255,4320,158624,1,295737
27682,0.002063,172.217.194.0-255,2902,161526,1,295737
27683,0.002077,172.31.36.0-255,66,161592,1,295737
27684,0.004136,172.217.194.0-255,5738,167330,1,295737
27685,0.004145,172.31.36.0-255,66,167396,1,295737
27686,0.006172,172.217.194.0-255,5738,173134,1,295737
27687,0.007209,172.31.36.0-255,66,173200,1,295737
27688,0.009225,172.217.194.0-255,4320,177520,1,295737
27689,0.009231,172.31.36.0-255,66,177586,1,295737
27690,0.009256,172.217.194.0-255,1484,179070,1,295737
27691,0.011231,172.217.194.0-255,4320,183390,1,295737
27692,0.01124,172.31.36.0-255,66,183456,1,295737
27693,0.013301,172.217.194.0-255,5738,189194,1,295737
27694,0.013309,172.31.36.0-255,66,189260,1,295737
27695,0.015327,172.217.194.0-255,5738,194998,1,295737
27696,0.015335,172.31.36.0-255,66,195064,1,295737
27697,0.017366,172.217.194.0-255,5738,200802,1,295737
27698,0.017374,172.31.36.0-255,66,200868,1,295737
27699,0.019451,172.217.194.0-255,5738,206606,1,295737
27700,0.019468,172.31.36.0-255,66,206672,1,295737
27701,0.021579,172.217.194.0-255,5738,212410,1,295737
27702,0.021588,172.31.36.0-255,66,212476,1,295737
27703,0.023645,172.217.194.0-255,5738,218214,1,295737
27704,0.023653,172.31.36.0-255,66,218280,1,295737
27705,0.025702,172.217.194.0-255,5738,224018,1,295737
27706,0.025716,172.31.36.0-255,66,224084,1,295737
27707,0.027774,172.217.194.0-255,5738,229822,1,295737
27708,0.027783,172.31.36.0-255,66,229888,1,295737
27709,0.029854,172.217.194.0-255,5738,235626,1,295737
27710,0.029864,172.31.36.0-255,66,235692,1,295737
27711,0.031926,172.217.194.0-255,5738,241430,1,295737
27712,0.031933,172.31.36.0-255,66,241496,1,295737
27713,0.033986,172.217.194.0-255,1484,242980,1,295737
27714,0.03401,172.217.194.0-255,4320,247300,1,295737
27715,0.034015,172.31.36.0-255,66,247366,1,295737
27716,0.036055,172.217.194.0-255,5738,253104,1,295737
27717,0.036063,172.31.36.0-255,66,253170,1,295737
27718,0.03812,172.217.194.0-255,5738,258908,1,295737
27719,0.038127,172.31.36.0-255,66,258974,1,295737
27720,0.040178,172.217.194.0-255,5738,264712,1,295737
27721,0.040186,172.31.36.0-255,66,264778,1,295737
27722,0.042235,172.217.194.0-255,5738,270516,1,295737
27723,0.042242,172.31.36.0-255,66,270582,1,295737
27724,0.044286,172.217.194.0-255,4320,274902,1,295737
27725,0.044292,172.31.36.0-255,66,274968,1,295737
27726,0.044326,172.217.194.0-255,1484,276452,1,295737
27727,0.04511,172.31.36.0-255,172,276624,1,295737
27728,0.045142,172.31.36.0-255,1114,277738,1,295737
27729,0.045207,172.31.36.0-255,1514,279252,1,295737
27730,0.045209,172.31.36.0-255,1514,280766,1,295737
27731,0.045214,172.31.36.0-255,1514,282280,1,295737
27732,0.045216,172.31.36.0-255,1514,283794,1,295737
27733,0.045234,172.31.36.0-255,1489,285283,1,295737
27734,0.046313,172.217.194.0-255,4320,289603,1,295737
27735,0.046321,172.31.36.0-255,66,289669,1,295737
27736,0.046664,104.244.42.0-255,66,289735,1,295737
27737,0.046704,104.244.42.0-255,66,289801,1,295737
27738,0.046764,104.244.42.0-255,66,289867,1,295737
27739,0.046818,104.244.42.0-255,66,289933,1,295737
27740,0.048351,172.217.194.0-255,5738,295671,1,295737
27741,0.048358,172.31.36.0-255,66,295737,1,295737
27742,0.0,74.125.24.0-255,153,153,1,242753
27743,1.5e-05,172.31.36.0-255,66,219,1,242753
27744,2.3e-05,74.125.24.0-255,1484,1703,1,242753
27745,2.8e-05,172.31.36.0-255,66,1769,1,242753
27746,3.4e-05,74.125.24.0-255,2902,4671,1,242753
27747,3.6e-05,172.31.36.0-255,66,4737,1,242753
27748,4.5e-05,74.125.24.0-255,7156,11893,1,242753
27749,4.7e-05,172.31.36.0-255,66,11959,1,242753
27750,6.9e-05,74.125.24.0-255,2902,14861,1,242753
27751,7.2e-05,172.31.36.0-255,66,14927,1,242753
27752,0.000118,172.31.36.0-255,66,14993,1,242753
27753,0.000122,74.125.24.0-255,2543,17536,1,242753
27754,0.000124,172.31.36.0-255,66,17602,1,242753
27755,0.00015,74.125.24.0-255,1484,19086,1,242753
27756,0.000152,172.31.36.0-255,66,19152,1,242753
27757,0.000168,74.125.24.0-255,2902,22054,1,242753
27758,0.00017,172.31.36.0-255,66,22120,1,242753
27759,0.000177,74.125.24.0-255,5738,27858,1,242753
27760,0.000179,172.31.36.0-255,66,27924,1,242753
27761,0.0002,74.125.24.0-255,4320,32244,1,242753
27762,0.000202,172.31.36.0-255,66,32310,1,242753
27763,0.000231,74.125.24.0-255,1484,33794,1,242753
27764,0.000234,172.31.36.0-255,66,33860,1,242753
27765,0.000249,172.31.36.0-255,66,33926,1,242753
27766,0.000254,74.125.24.0-255,4271,38197,1,242753
27767,0.000257,172.31.36.0-255,66,38263,1,242753
27768,0.00026,74.125.24.0-255,110,38373,1,242753
27769,0.000263,172.31.36.0-255,66,38439,1,242753
27770,0.000286,74.125.24.0-255,332,38771,1,242753
27771,0.000288,172.31.36.0-255,66,38837,1,242753
27772,0.000597,74.125.24.0-255,1484,40321,1,242753
27773,0.000604,74.125.24.0-255,2902,43223,1,242753
27774,0.000609,172.31.36.0-255,66,43289,1,242753
27775,0.000614,74.125.24.0-255,2902,46191,1,242753
27776,0.000617,172.31.36.0-255,66,46257,1,242753
27777,0.000633,74.125.24.0-255,2902,49159,1,242753
27778,0.000636,74.125.24.0-255,1484,50643,1,242753
27779,0.000641,172.31.36.0-255,66,50709,1,242753
27780,0.000667,172.31.36.0-255,66,50775,1,242753
27781,0.000672,74.125.24.0-255,4320,55095,1,242753
27782,0.000674,172.31.36.0-255,66,55161,1,242753
27783,0.000726,74.125.24.0-255,6438,61599,1,242753
27784,0.000729,172.31.36.0-255,66,61665,1,242753
27785,0.001008,74.125.24.0-255,1484,63149,1,242753
27786,0.001013,74.125.24.0-255,1484,64633,1,242753
27787,0.001015,172.31.36.0-255,66,64699,1,242753
27788,0.001034,74.125.24.0-255,1484,66183,1,242753
27789,0.001041,74.125.24.0-255,5738,71921,1,242753
27790,0.001043,172.31.36.0-255,66,71987,1,242753
27791,0.001051,74.125.24.0-255,5738,77725,1,242753
27792,0.001052,172.31.36.0-255,66,77791,1,242753
27793,0.001081,74.125.24.0-255,7156,84947,1,242753
27794,0.001083,172.31.36.0-255,66,85013,1,242753
27795,0.001098,74.125.24.0-255,5738,90751,1,242753
27796,0.001101,172.31.36.0-255,66,90817,1,242753
27797,0.001107,74.125.24.0-255,5020,95837,1,242753
27798,0.001109,172.31.36.0-255,66,95903,1,242753
27799,0.00116,74.125.24.0-255,1484,97387,1,242753
27800,0.001164,74.125.24.0-255,1484,98871,1,242753
27801,0.001166,172.31.36.0-255,66,98937,1,242753
27802,0.001187,74.125.24.0-255,1484,100421,1,242753
27803,0.001194,74.125.24.0-255,5738,106159,1,242753
27804,0.001197,172.31.36.0-255,66,106225,1,242753
27805,0.001216,74.125.24.0-255,4320,110545,1,242753
27806,0.001219,172.31.36.0-255,66,110611,1,242753
27807,0.001242,74.125.24.0-255,4320,114931,1,242753
27808,0.001257,74.125.24.0-255,5020,119951,1,242753
27809,0.001261,172.31.36.0-255,66,120017,1,242753
27810,0.001265,172.31.36.0-255,66,120083,1,242753
27811,0.001272,172.31.36.0-255,66,120149,1,242753
27812,0.00132,74.125.24.0-255,1484,121633,1,242753
27813,0.001325,74.125.24.0-255,1484,123117,1,242753
27814,0.001328,172.31.36.0-255,66,123183,1,242753
27815,0.001349,74.125.24.0-255,1484,124667,1,242753
27816,0.001356,74.125.24.0-255,5738,130405,1,242753
27817,0.001358,172.31.36.0-255,66,130471,1,242753
27818,0.001363,74.125.24.0-255,4320,134791,1,242753
27819,0.001366,172.31.36.0-255,66,134857,1,242753
27820,0.001406,172.31.36.0-255,66,134923,1,242753
27821,0.001426,172.31.36.0-255,66,134989,1,242753
27822,0.001498,74.125.24.0-255,1484,136473,1,242753
27823,0.001514,74.125.24.0-255,2902,139375,1,242753
27824,0.001518,172.31.36.0-255,66,139441,1,242753
27825,0.001525,74.125.24.0-255,5738,145179,1,242753
27826,0.001527,172.31.36.0-255,66,145245,1,242753
27827,0.001553,74.125.24.0-255,4320,149565,1,242753
27828,0.001556,172.31.36.0-255,66,149631,1,242753
27829,0.001586,172.31.36.0-255,66,149697,1,242753
27830,0.001592,74.125.24.0-255,5738,155435,1,242753
27831,0.001595,172.31.36.0-255,66,155501,1,242753
27832,0.001619,74.125.24.0-255,2902,158403,1,242753
27833,0.001622,172.31.36.0-255,66,158469,1,242753
27834,0.00164,74.125.24.0-255,2184,160653,1,242753
27835,0.001642,172.31.36.0-255,66,160719,1,242753
27836,0.001729,74.125.24.0-255,1484,162203,1,242753
27837,0.001732,74.125.24.0-255,1484,163687,1,242753
27838,0.001744,172.31.36.0-255,66,163753,1,242753
27839,0.001748,74.125.24.0-255,1484,165237,1,242753
27840,0.001755,74.125.24.0-255,5738,170975,1,242753
27841,0.001758,172.31.36.0-255,66,171041,1,242753
27842,0.001793,172.31.36.0-255,66,171107,1,242753
27843,0.001814,74.125.24.0-255,4320,175427,1,242753
27844,0.001818,74.125.24.0-255,2902,178329,1,242753
27845,0.001826,172.31.36.0-255,66,178395,1,242753
27846,0.001908,172.31.36.0-255,66,178461,1,242753
27847,0.00192,74.125.24.0-255,5738,184199,1,242753
27848,0.001955,74.125.24.0-255,6438,190637,1,242753
27849,0.001968,172.31.36.0-255,66,190703,1,242753
27850,0.001986,74.125.24.0-255,2902,193605,1,242753
27851,0.002016,172.31.36.0-255,66,193671,1,242753
27852,0.002062,74.125.24.0-255,5738,199409,1,242753
27853,0.002086,172.31.36.0-255,66,199475,1,242753
27854,0.004076,74.125.24.0-255,5738,205213,1,242753
27855,0.007133,172.31.36.0-255,66,205279,1,242753
27856,0.009141,74.125.24.0-255,5738,211017,1,242753
27857,0.009147,172.31.36.0-255,66,211083,1,242753
27858,0.011135,74.125.24.0-255,5738,216821,1,242753
27859,0.011142,172.31.36.0-255,66,216887,1,242753
27860,0.013123,74.125.24.0-255,5738,222625,1,242753
27861,0.013131,172.31.36.0-255,66,222691,1,242753
27862,0.015136,74.125.24.0-255,5738,228429,1,242753
27863,0.015144,172.31.36.0-255,66,228495,1,242753
27864,0.017161,74.125.24.0-255,4926,233421,1,242753
27865,0.017169,172.31.36.0-255,66,233487,1,242753
27866,0.020257,172.31.36.0-255,105,233592,1,242753
27867,0.022211,74.125.24.0-255,66,233658,1,242753
27868,0.041897,172.31.36.0-255,172,233830,1,242753
27869,0.041933,172.31.36.0-255,1114,234944,1,242753
27870,0.041999,172.31.36.0-255,1514,236458,1,242753
27871,0.042001,172.31.36.0-255,1514,237972,1,242753
27872,0.042006,172.31.36.0-255,1514,239486,1,242753
27873,0.042007,172.31.36.0-255,1514,241000,1,242753
27874,0.042028,172.31.36.0-255,1489,242489,1,242753
27875,0.043426,104.244.42.0-255,66,242555,1,242753
27876,0.043437,104.244.42.0-255,66,242621,1,242753
27877,0.043502,104.244.42.0-255,66,242687,1,242753
27878,0.043626,104.244.42.0-255,66,242753,1,242753
27879,0.0,172.217.160.0-255,153,153,1,251397
27880,2.3e-05,172.31.36.0-255,66,219,1,251397
27881,3.1e-05,172.217.160.0-255,1484,1703,1,251397
27882,3.6e-05,172.31.36.0-255,66,1769,1,251397
27883,4.2e-05,172.217.160.0-255,2902,4671,1,251397
27884,4.5e-05,172.31.36.0-255,66,4737,1,251397
27885,5.4e-05,172.217.160.0-255,7156,11893,1,251397
27886,5.8e-05,172.31.36.0-255,66,11959,1,251397
27887,8.4e-05,172.31.36.0-255,66,12025,1,251397
27888,0.000101,172.217.160.0-255,2068,14093,1,251397
27889,0.000104,172.31.36.0-255,66,14159,1,251397
27890,0.000113,172.217.160.0-255,6797,20956,1,251397
27891,0.000116,172.31.36.0-255,66,21022,1,251397
27892,0.000373,172.217.160.0-255,1484,22506,1,251397
27893,0.000378,172.31.36.0-255,66,22572,1,251397
27894,0.000385,172.217.160.0-255,2902,25474,1,251397
27895,0.000387,172.31.36.0-255,66,25540,1,251397
27896,0.000394,172.217.160.0-255,5738,31278,1,251397
27897,0.000397,172.31.36.0-255,66,31344,1,251397
27898,0.000445,172.217.160.0-255,6797,38141,1,251397
27899,0.000448,172.31.36.0-255,66,38207,1,251397
27900,0.000469,172.217.160.0-255,4320,42527,1,251397
27901,0.000472,172.31.36.0-255,66,42593,1,251397
27902,0.000504,172.217.160.0-255,2902,45495,1,251397
27903,0.000507,172.31.36.0-255,66,45561,1,251397
27904,0.00052,172.31.36.0-255,66,45627,1,251397
27905,0.000522,172.217.160.0-255,374,46001,1,251397
27906,0.000524,172.31.36.0-255,66,46067,1,251397
27907,0.00089,172.217.160.0-255,103,46170,1,251397
27908,0.000895,172.31.36.0-255,66,46236,1,251397
27909,0.00099,172.217.160.0-255,1484,47720,1,251397
27910,0.000997,172.217.160.0-255,2902,50622,1,251397
27911,0.001001,172.31.36.0-255,66,50688,1,251397
27912,0.001008,172.217.160.0-255,5738,56426,1,251397
27913,0.00101,172.31.36.0-255,66,56492,1,251397
27914,0.001037,172.217.160.0-255,6797,63289,1,251397
27915,0.00104,172.31.36.0-255,66,63355,1,251397
27916,0.001047,172.217.160.0-255,5738,69093,1,251397
27917,0.00105,172.31.36.0-255,66,69159,1,251397
27918,0.001071,172.217.160.0-255,1484,70643,1,251397
27919,0.001095,172.31.36.0-255,66,70709,1,251397
27920,0.001658,172.217.160.0-255,1484,72193,1,251397
27921,0.001669,172.217.160.0-255,2902,75095,1,251397
27922,0.001674,172.31.36.0-255,66,75161,1,251397
27923,0.001678,172.217.160.0-255,1484,76645,1,251397
27924,0.003325,172.217.160.0-255,4320,80965,1,251397
27925,0.003332,172.31.36.0-255,66,81031,1,251397
27926,0.004977,172.217.160.0-255,5738,86769,1,251397
27927,0.004981,172.31.36.0-255,66,86835,1,251397
27928,0.006624,172.217.160.0-255,4320,91155,1,251397
27929,0.006627,172.31.36.0-255,66,91221,1,251397
27930,0.006639,172.217.160.0-255,1484,92705,1,251397
27931,0.008274,172.217.160.0-255,4320,97025,1,251397
27932,0.008281,172.31.36.0-255,66,97091,1,251397
27933,0.009958,172.217.160.0-255,5738,102829,1,251397
27934,0.009966,172.31.36.0-255,66,102895,1,251397
27935,0.011615,172.217.160.0-255,5738,108633,1,251397
27936,0.011622,172.31.36.0-255,66,108699,1,251397
27937,0.013277,172.217.160.0-255,5738,114437,1,251397
27938,0.013285,172.31.36.0-255,66,114503,1,251397
27939,0.014955,172.217.160.0-255,5738,120241,1,251397
27940,0.014962,172.31.36.0-255,66,120307,1,251397
27941,0.016624,172.217.160.0-255,5738,126045,1,251397
27942,0.016632,172.31.36.0-255,66,126111,1,251397
27943,0.018287,172.217.160.0-255,5738,131849,1,251397
27944,0.018294,172.31.36.0-255,66,131915,1,251397
27945,0.019948,172.217.160.0-255,5738,137653,1,251397
27946,0.019955,172.31.36.0-255,66,137719,1,251397
27947,0.021645,172.217.160.0-255,5738,143457,1,251397
27948,0.021655,172.31.36.0-255,66,143523,1,251397
27949,0.023311,172.217.160.0-255,5738,149261,1,251397
27950,0.023319,172.31.36.0-255,66,149327,1,251397
27951,0.024976,172.217.160.0-255,5738,155065,1,251397
27952,0.024983,172.31.36.0-255,66,155131,1,251397
27953,0.026637,172.217.160.0-255,5738,160869,1,251397
27954,0.026644,172.31.36.0-255,66,160935,1,251397
27955,0.028294,172.217.160.0-255,5738,166673,1,251397
27956,0.028301,172.31.36.0-255,66,166739,1,251397
27957,0.02996,172.217.160.0-255,5738,172477,1,251397
27958,0.029968,172.31.36.0-255,66,172543,1,251397
27959,0.031621,172.217.160.0-255,5738,178281,1,251397
27960,0.031629,172.31.36.0-255,66,178347,1,251397
27961,0.03328,172.217.160.0-255,5738,184085,1,251397
27962,0.03329,172.31.36.0-255,66,184151,1,251397
27963,0.034963,172.217.160.0-255,5738,189889,1,251397
27964,0.034971,172.31.36.0-255,66,189955,1,251397
27965,0.036635,172.217.160.0-255,5738,195693,1,251397
27966,0.036643,172.31.36.0-255,66,195759,1,251397
27967,0.038297,172.217.160.0-255,5738,201497,1,251397
27968,0.038304,172.31.36.0-255,66,201563,1,251397
27969,0.039961,172.217.160.0-255,5738,207301,1,251397
27970,0.039968,172.31.36.0-255,66,207367,1,251397
27971,0.041621,172.217.160.0-255,5738,213105,1,251397
27972,0.041629,172.31.36.0-255,66,213171,1,251397
27973,0.043285,172.217.160.0-255,5738,218909,1,251397
27974,0.043292,172.31.36.0-255,66,218975,1,251397
27975,0.044109,172.31.36.0-255,172,219147,1,251397
27976,0.04414,172.31.36.0-255,1114,220261,1,251397
27977,0.044206,172.31.36.0-255,1514,221775,1,251397
27978,0.044208,172.31.36.0-255,1514,223289,1,251397
27979,0.044214,172.31.36.0-255,1514,224803,1,251397
27980,0.044219,172.31.36.0-255,1514,226317,1,251397
27981,0.044221,172.31.36.0-255,1492,227809,1,251397
27982,0.044955,172.217.160.0-255,5738,233547,1,251397
27983,0.044962,172.31.36.0-255,66,233613,1,251397
27984,0.045609,104.244.42.0-255,66,233679,1,251397
27985,0.045633,104.244.42.0-255,66,233745,1,251397
27986,0.045745,104.244.42.0-255,66,233811,1,251397
27987,0.04642,104.244.42.0-255,108,233919,1,251397
27988,0.046429,172.31.36.0-255,66,233985,1,251397
27989,0.046608,172.217.160.0-255,5738,239723,1,251397
27990,0.046612,172.31.36.0-255,66,239789,1,251397
27991,0.048258,172.217.160.0-255,5738,245527,1,251397
27992,0.048266,172.31.36.0-255,66,245593,1,251397
27993,0.049919,172.217.160.0-255,5738,251331,1,251397
27994,0.049926,172.31.36.0-255,66,251397,1,251397
27995,0.0,74.125.24.0-255,142,142,1,313238
27996,3.3e-05,172.31.36.0-255,66,208,1,313238
27997,4.1e-05,74.125.24.0-255,1484,1692,1,313238
27998,4.5e-05,172.31.36.0-255,66,1758,1,313238
27999,4.9e-05,74.125.24.0-255,2902,4660,1,313238
28000,5.2e-05,172.31.36.0-255,66,4726,1,313238
28001,5.8e-05,74.125.24.0-255,7156,11882,1,313238
28002,6.1e-05,172.31.36.0-255,66,11948,1,313238
28003,6.5e-05,74.125.24.0-255,2054,14002,1,313238
28004,6.8e-05,172.31.36.0-255,66,14068,1,313238
28005,0.000125,74.125.24.0-255,1484,15552,1,313238
28006,0.000128,172.31.36.0-255,66,15618,1,313238
28007,0.000133,74.125.24.0-255,2902,18520,1,313238
28008,0.000135,172.31.36.0-255,66,18586,1,313238
28009,0.000153,74.125.24.0-255,5738,24324,1,313238
28010,0.000156,172.31.36.0-255,66,24390,1,313238
28011,0.000203,74.125.24.0-255,6797,31187,1,313238
28012,0.000206,172.31.36.0-255,66,31253,1,313238
28013,0.000796,74.125.24.0-255,1484,32737,1,313238
28014,0.000802,172.31.36.0-255,66,32803,1,313238
28015,0.000812,74.125.24.0-255,2902,35705,1,313238
28016,0.000814,172.31.36.0-255,66,35771,1,313238
28017,0.00082,74.125.24.0-255,4320,40091,1,313238
28018,0.000822,172.31.36.0-255,66,40157,1,313238
28019,0.000839,74.125.24.0-255,1484,41641,1,313238
28020,0.000842,172.31.36.0-255,66,41707,1,313238
28021,0.000847,74.125.24.0-255,5738,47445,1,313238
28022,0.000849,172.31.36.0-255,66,47511,1,313238
28023,0.000872,74.125.24.0-255,1125,48636,1,313238
28024,0.000874,172.31.36.0-255,66,48702,1,313238
28025,0.000891,74.125.24.0-255,1484,50186,1,313238
28026,0.000893,172.31.36.0-255,66,50252,1,313238
28027,0.000897,74.125.24.0-255,1484,51736,1,313238
28028,0.000912,74.125.24.0-255,2902,54638,1,313238
28029,0.000915,172.31.36.0-255,66,54704,1,313238
28030,0.000921,74.125.24.0-255,7156,61860,1,313238
28031,0.000923,172.31.36.0-255,66,61926,1,313238
28032,0.000935,74.125.24.0-255,2902,64828,1,313238
28033,0.000938,172.31.36.0-255,66,64894,1,313238
28034,0.000941,74.125.24.0-255,1452,66346,1,313238
28035,0.000984,74.125.24.0-255,380,66726,1,313238
28036,0.000988,172.31.36.0-255,66,66792,1,313238
28037,0.001082,74.125.24.0-255,1484,68276,1,313238
28038,0.001098,74.125.24.0-255,2902,71178,1,313238
28039,0.001101,172.31.36.0-255,66,71244,1,313238
28040,0.001109,74.125.24.0-255,5738,76982,1,313238
28041,0.001112,172.31.36.0-255,66,77048,1,313238
28042,0.001136,74.125.24.0-255,4320,81368,1,313238
28043,0.001138,172.31.36.0-255,66,81434,1,313238
28044,0.001164,172.31.36.0-255,66,81500,1,313238
28045,0.001167,74.125.24.0-255,1484,82984,1,313238
28046,0.001196,74.125.24.0-255,5738,88722,1,313238
28047,0.001199,172.31.36.0-255,66,88788,1,313238
28048,0.001211,74.125.24.0-255,2543,91331,1,313238
28049,0.001213,172.31.36.0-255,66,91397,1,313238
28050,0.001233,74.125.24.0-255,4320,95717,1,313238
28051,0.001235,172.31.36.0-255,66,95783,1,313238
28052,0.001252,74.125.24.0-255,1484,97267,1,313238
28053,0.001259,74.125.24.0-255,7156,104423,1,313238
28054,0.001261,172.31.36.0-255,66,104489,1,313238
28055,0.001304,172.31.36.0-255,66,104555,1,313238
28056,0.001339,74.125.24.0-255,2902,107457,1,313238
28057,0.001341,172.31.36.0-255,66,107523,1,313238
28058,0.001358,74.125.24.0-255,3602,111125,1,313238
28059,0.001361,172.31.36.0-255,66,111191,1,313238
28060,0.001376,74.125.24.0-255,1484,112675,1,313238
28061,0.0014,74.125.24.0-255,5738,118413,1,313238
28062,0.001402,172.31.36.0-255,66,118479,1,313238
28063,0.001407,74.125.24.0-255,5738,124217,1,313238
28064,0.001409,172.31.36.0-255,66,124283,1,313238
28065,0.001422,74.125.24.0-255,4320,128603,1,313238
28066,0.001424,172.31.36.0-255,66,128669,1,313238
28067,0.001443,172.31.36.0-255,66,128735,1,313238
28068,0.001448,74.125.24.0-255,4320,133055,1,313238
28069,0.00145,172.31.36.0-255,66,133121,1,313238
28070,0.001468,74.125.24.0-255,2184,135305,1,313238
28071,0.00147,172.31.36.0-255,66,135371,1,313238
28072,0.001726,74.125.24.0-255,1484,136855,1,313238
28073,0.001739,74.125.24.0-255,2902,139757,1,313238
28074,0.001742,172.31.36.0-255,66,139823,1,313238
28075,0.001745,74.125.24.0-255,1484,141307,1,313238
28076,0.00176,74.125.24.0-255,4320,145627,1,313238
28077,0.001762,172.31.36.0-255,66,145693,1,313238
28078,0.001788,74.125.24.0-255,2902,148595,1,313238
28079,0.001791,172.31.36.0-255,66,148661,1,313238
28080,0.001802,74.125.24.0-255,2902,151563,1,313238
28081,0.001804,172.31.36.0-255,66,151629,1,313238
28082,0.00181,74.125.24.0-255,7156,158785,1,313238
28083,0.001812,172.31.36.0-255,66,158851,1,313238
28084,0.001851,74.125.24.0-255,1484,160335,1,313238
28085,0.001871,172.31.36.0-255,66,160401,1,313238
28086,0.001888,74.125.24.0-255,2902,163303,1,313238
28087,0.00189,172.31.36.0-255,66,163369,1,313238
28088,0.00191,74.125.24.0-255,4320,167689,1,313238
28089,0.001912,172.31.36.0-255,66,167755,1,313238
28090,0.001914,74.125.24.0-255,1484,169239,1,313238
28091,0.001935,74.125.24.0-255,7156,176395,1,313238
28092,0.001938,172.31.36.0-255,66,176461,1,313238
28093,0.001942,74.125.24.0-255,2902,179363,1,313238
28094,0.001943,172.31.36.0-255,66,179429,1,313238
28095,0.001962,74.125.24.0-255,7156,186585,1,313238
28096,0.001964,172.31.36.0-255,66,186651,1,313238
28097,0.002002,74.125.24.0-255,2902,189553,1,313238
28098,0.002004,172.31.36.0-255,66,189619,1,313238
28099,0.002018,74.125.24.0-255,5020,194639,1,313238
28100,0.00202,172.31.36.0-255,66,194705,1,313238
28101,0.002054,74.125.24.0-255,1484,196189,1,313238
28102,0.002072,74.125.24.0-255,2902,199091,1,313238
28103,0.002075,172.31.36.0-255,66,199157,1,313238
28104,0.002079,74.125.24.0-255,4320,203477,1,313238
28105,0.002081,172.31.36.0-255,66,203543,1,313238
28106,0.002091,74.125.24.0-255,1484,205027,1,313238
28107,0.002145,74.125.24.0-255,2902,207929,1,313238
28108,0.002147,172.31.36.0-255,66,207995,1,313238
28109,0.002184,172.31.36.0-255,66,208061,1,313238
28110,0.002187,74.125.24.0-255,1484,209545,1,313238
28111,0.002202,172.31.36.0-255,66,209611,1,313238
28112,0.002215,172.31.36.0-255,66,209677,1,313238
28113,0.002259,172.31.36.0-255,66,209743,1,313238
28114,0.002297,74.125.24.0-255,1484,211227,1,313238
28115,0.002317,172.31.36.0-255,66,211293,1,313238
28116,0.002338,74.125.24.0-255,1484,212777,1,313238
28117,0.00235,172.31.36.0-255,66,212843,1,313238
28118,0.002368,74.125.24.0-255,7156,219999,1,313238
28119,0.002371,172.31.36.0-255,66,220065,1,313238
28120,0.002394,74.125.24.0-255,3602,223667,1,313238
28121,0.002397,172.31.36.0-255,66,223733,1,313238
28122,0.004929,74.125.24.0-255,5738,229471,1,313238
28123,0.004935,172.31.36.0-255,66,229537,1,313238
28124,0.00745,74.125.24.0-255,5738,235275,1,313238
28125,0.007455,172.31.36.0-255,66,235341,1,313238
28126,0.010001,74.125.24.0-255,5738,241079,1,313238
28127,0.010009,172.31.36.0-255,66,241145,1,313238
28128,0.012563,74.125.24.0-255,5738,246883,1,313238
28129,0.012571,172.31.36.0-255,66,246949,1,313238
28130,0.015122,74.125.24.0-255,5738,252687,1,313238
28131,0.01513,172.31.36.0-255,66,252753,1,313238
28132,0.017708,74.125.24.0-255,5738,258491,1,313238
28133,0.017718,172.31.36.0-255,66,258557,1,313238
28134,0.02027,74.125.24.0-255,5738,264295,1,313238
28135,0.020277,172.31.36.0-255,66,264361,1,313238
28136,0.022808,74.125.24.0-255,5738,270099,1,313238
28137,0.02282,172.31.36.0-255,66,270165,1,313238
28138,0.025361,74.125.24.0-255,5738,275903,1,313238
28139,0.02537,172.31.36.0-255,66,275969,1,313238
28140,0.027932,74.125.24.0-255,5738,281707,1,313238
28141,0.02794,172.31.36.0-255,66,281773,1,313238
28142,0.03049,74.125.24.0-255,5738,287511,1,313238
28143,0.030498,172.31.36.0-255,66,287577,1,313238
28144,0.033051,74.125.24.0-255,5738,293315,1,313238
28145,0.03306,172.31.36.0-255,66,293381,1,313238
28146,0.035603,74.125.24.0-255,5738,299119,1,313238
28147,0.035613,172.31.36.0-255,66,299185,1,313238
28148,0.038156,74.125.24.0-255,4782,303967,1,313238
28149,0.038164,172.31.36.0-255,66,304033,1,313238
28150,0.038641,172.31.36.0-255,176,304209,1,313238
28151,0.038685,172.31.36.0-255,1115,305324,1,313238
28152,0.03878,172.31.36.0-255,1514,306838,1,313238
28153,0.038782,172.31.36.0-255,1514,308352,1,313238
28154,0.038784,172.31.36.0-255,1514,309866,1,313238
28155,0.038785,172.31.36.0-255,1514,311380,1,313238
28156,0.038818,172.31.36.0-255,1489,312869,1,313238
28157,0.038879,172.31.36.0-255,105,312974,1,313238
28158,0.040159,104.244.42.0-255,66,313040,1,313238
28159,0.040255,104.244.42.0-255,66,313106,1,313238
28160,0.040384,104.244.42.0-255,66,313172,1,313238
28161,0.041372,74.125.24.0-255,66,313238,1,313238
28162,0.0,172.217.194.0-255,153,153,1,223383
28163,2.4e-05,172.31.36.0-255,66,219,1,223383
28164,3.2e-05,172.217.194.0-255,1484,1703,1,223383
28165,3.6e-05,172.31.36.0-255,66,1769,1,223383
28166,5e-05,172.217.194.0-255,2902,4671,1,223383
28167,5.4e-05,172.31.36.0-255,66,4737,1,223383
28168,6.3e-05,172.217.194.0-255,7156,11893,1,223383
28169,6.7e-05,172.31.36.0-255,66,11959,1,223383
28170,7.3e-05,172.217.194.0-255,4889,16848,1,223383
28171,7.6e-05,172.31.36.0-255,66,16914,1,223383
28172,9.3e-05,172.31.36.0-255,66,16980,1,223383
28173,0.000146,172.217.194.0-255,1484,18464,1,223383
28174,0.000149,172.31.36.0-255,66,18530,1,223383
28175,0.000153,172.217.194.0-255,1484,20014,1,223383
28176,0.000155,172.31.36.0-255,66,20080,1,223383
28177,0.000176,172.217.194.0-255,1484,21564,1,223383
28178,0.000182,172.31.36.0-255,66,21630,1,223383
28179,0.000188,172.217.194.0-255,5738,27368,1,223383
28180,0.000191,172.31.36.0-255,66,27434,1,223383
28181,0.000197,172.217.194.0-255,4320,31754,1,223383
28182,0.000199,172.31.36.0-255,66,31820,1,223383
28183,0.00024,172.31.36.0-255,66,31886,1,223383
28184,0.000277,172.217.194.0-255,7156,39042,1,223383
28185,0.00028,172.31.36.0-255,66,39108,1,223383
28186,0.000298,172.217.194.0-255,2889,41997,1,223383
28187,0.0003,172.31.36.0-255,66,42063,1,223383
28188,0.000303,172.217.194.0-255,362,42425,1,223383
28189,0.000305,172.31.36.0-255,66,42491,1,223383
28190,0.000401,172.217.194.0-255,1484,43975,1,223383
28191,0.000405,172.31.36.0-255,66,44041,1,223383
28192,0.00041,172.217.194.0-255,2902,46943,1,223383
28193,0.000413,172.31.36.0-255,66,47009,1,223383
28194,0.000437,172.217.194.0-255,5738,52747,1,223383
28195,0.00044,172.31.36.0-255,66,52813,1,223383
28196,0.000455,172.31.36.0-255,66,52879,1,223383
28197,0.000486,172.217.194.0-255,4320,57199,1,223383
28198,0.000492,172.31.36.0-255,66,57265,1,223383
28199,0.000507,172.31.36.0-255,66,57331,1,223383
28200,0.000513,172.217.194.0-255,4320,61651,1,223383
28201,0.000515,172.31.36.0-255,66,61717,1,223383
28202,0.00056,172.31.36.0-255,66,61783,1,223383
28203,0.000681,172.217.194.0-255,1484,63267,1,223383
28204,0.000687,172.217.194.0-255,2902,66169,1,223383
28205,0.000691,172.31.36.0-255,66,66235,1,223383
28206,0.000696,172.217.194.0-255,2902,69137,1,223383
28207,0.000698,172.31.36.0-255,66,69203,1,223383
28208,0.000731,172.217.194.0-255,2902,72105,1,223383
28209,0.000734,172.31.36.0-255,66,72171,1,223383
28210,0.000741,172.217.194.0-255,5738,77909,1,223383
28211,0.000743,172.31.36.0-255,66,77975,1,223383
28212,0.000761,172.31.36.0-255,66,78041,1,223383
28213,0.000764,172.217.194.0-255,1484,79525,1,223383
28214,0.000811,172.31.36.0-255,66,79591,1,223383
28215,0.000826,172.31.36.0-255,66,79657,1,223383
28216,0.000846,172.31.36.0-255,66,79723,1,223383
28217,0.000871,172.217.194.0-255,1484,81207,1,223383
28218,0.000877,172.217.194.0-255,2902,84109,1,223383
28219,0.000879,172.31.36.0-255,66,84175,1,223383
28220,0.000889,172.217.194.0-255,5738,89913,1,223383
28221,0.000892,172.31.36.0-255,66,89979,1,223383
28222,0.000899,172.217.194.0-255,5738,95717,1,223383
28223,0.000901,172.31.36.0-255,66,95783,1,223383
28224,0.000943,172.217.194.0-255,7156,102939,1,223383
28225,0.000946,172.31.36.0-255,66,103005,1,223383
28226,0.000964,172.31.36.0-255,66,103071,1,223383
28227,0.001032,172.217.194.0-255,1484,104555,1,223383
28228,0.001037,172.217.194.0-255,2902,107457,1,223383
28229,0.001039,172.31.36.0-255,66,107523,1,223383
28230,0.001046,172.217.194.0-255,5738,113261,1,223383
28231,0.001048,172.31.36.0-255,66,113327,1,223383
28232,0.00106,172.217.194.0-255,6797,120124,1,223383
28233,0.001062,172.31.36.0-255,66,120190,1,223383
28234,0.001065,172.217.194.0-255,1484,121674,1,223383
28235,0.001101,172.217.194.0-255,4320,125994,1,223383
28236,0.001104,172.31.36.0-255,66,126060,1,223383
28237,0.001112,172.217.194.0-255,7156,133216,1,223383
28238,0.001114,172.31.36.0-255,66,133282,1,223383
28239,0.001139,172.31.36.0-255,66,133348,1,223383
28240,0.001146,172.217.194.0-255,6438,139786,1,223383
28241,0.001149,172.31.36.0-255,66,139852,1,223383
28242,0.001271,172.217.194.0-255,1484,141336,1,223383
28243,0.001278,172.217.194.0-255,2902,144238,1,223383
28244,0.001281,172.31.36.0-255,66,144304,1,223383
28245,0.001284,172.217.194.0-255,1484,145788,1,223383
28246,0.001312,172.217.194.0-255,4320,150108,1,223383
28247,0.001315,172.31.36.0-255,66,150174,1,223383
28248,0.001333,172.31.36.0-255,66,150240,1,223383
28249,0.001352,172.31.36.0-255,66,150306,1,223383
28250,0.001386,172.217.194.0-255,7156,157462,1,223383
28251,0.001411,172.217.194.0-255,7156,164618,1,223383
28252,0.001431,172.31.36.0-255,66,164684,1,223383
28253,0.00146,172.217.194.0-255,3602,168286,1,223383
28254,0.001462,172.31.36.0-255,66,168352,1,223383
28255,0.00149,172.217.194.0-255,4320,172672,1,223383
28256,0.001497,172.217.194.0-255,7156,179828,1,223383
28257,0.001501,172.31.36.0-255,66,179894,1,223383
28258,0.001546,172.217.194.0-255,5738,185632,1,223383
28259,0.001575,172.31.36.0-255,66,185698,1,223383
28260,0.001581,172.217.194.0-255,3602,189300,1,223383
28261,0.001586,172.217.194.0-255,4320,193620,1,223383
28262,0.001601,172.31.36.0-255,66,193686,1,223383
28263,0.001612,172.217.194.0-255,5738,199424,1,223383
28264,0.001625,172.217.194.0-255,7156,206580,1,223383
28265,0.001645,172.217.194.0-255,4320,210900,1,223383
28266,0.001708,172.217.194.0-255,2184,213084,1,223383
28267,0.001722,172.217.194.0-255,927,214011,1,223383
28268,0.001724,172.217.194.0-255,105,214116,1,223383
28269,0.001735,172.31.36.0-255,66,214182,1,223383
28270,0.01146,172.31.36.0-255,105,214287,1,223383
28271,0.013448,172.217.194.0-255,66,214353,1,223383
28272,0.037956,172.31.36.0-255,172,214525,1,223383
28273,0.037989,172.31.36.0-255,1115,215640,1,223383
28274,0.038072,172.31.36.0-255,1514,217154,1,223383
28275,0.038074,172.31.36.0-255,1514,218668,1,223383
28276,0.03808,172.31.36.0-255,1514,220182,1,223383
28277,0.038081,172.31.36.0-255,1514,221696,1,223383
28278,0.03811,172.31.36.0-255,1489,223185,1,223383
28279,0.039496,104.244.42.0-255,66,223251,1,223383
28280,0.039533,104.244.42.0-255,66,223317,1,223383
28281,0.039651,104.244.42.0-255,66,223383,1,223383
28282,0.0,172.217.194.0-255,153,153,1,176102
28283,2.4e-05,172.31.36.0-255,66,219,1,176102
28284,3.2e-05,172.217.194.0-255,1484,1703,1,176102
28285,3.8e-05,172.31.36.0-255,66,1769,1,176102
28286,4.3e-05,172.217.194.0-255,2902,4671,1,176102
28287,4.7e-05,172.31.36.0-255,66,4737,1,176102
28288,5.5e-05,172.217.194.0-255,7156,11893,1,176102
28289,5.8e-05,172.31.36.0-255,66,11959,1,176102
28290,7e-05,172.31.36.0-255,66,12025,1,176102
28291,0.000115,172.217.194.0-255,7156,19181,1,176102
28292,0.000118,172.31.36.0-255,66,19247,1,176102
28293,0.000142,172.217.194.0-255,3961,23208,1,176102
28294,0.000146,172.31.36.0-255,66,23274,1,176102
28295,0.000179,172.31.36.0-255,66,23340,1,176102
28296,0.00019,172.31.36.0-255,66,23406,1,176102
28297,0.000203,172.217.194.0-255,2902,26308,1,176102
28298,0.000206,172.31.36.0-255,66,26374,1,176102
28299,0.000222,172.31.36.0-255,66,26440,1,176102
28300,0.000241,172.217.194.0-255,3944,30384,1,176102
28301,0.000244,172.31.36.0-255,66,30450,1,176102
28302,0.000367,172.217.194.0-255,1484,31934,1,176102
28303,0.000372,172.31.36.0-255,66,32000,1,176102
28304,0.000378,172.217.194.0-255,2902,34902,1,176102
28305,0.00038,172.31.36.0-255,66,34968,1,176102
28306,0.000402,172.217.194.0-255,5738,40706,1,176102
28307,0.000405,172.31.36.0-255,66,40772,1,176102
28308,0.000411,172.217.194.0-255,4320,45092,1,176102
28309,0.000413,172.31.36.0-255,66,45158,1,176102
28310,0.00043,172.217.194.0-255,4320,49478,1,176102
28311,0.000433,172.31.36.0-255,66,49544,1,176102
28312,0.000482,172.31.36.0-255,66,49610,1,176102
28313,0.000505,172.217.194.0-255,6738,56348,1,176102
28314,0.000509,172.31.36.0-255,66,56414,1,176102
28315,0.000716,172.217.194.0-255,1484,57898,1,176102
28316,0.000734,172.217.194.0-255,2902,60800,1,176102
28317,0.00074,172.31.36.0-255,66,60866,1,176102
28318,0.000747,172.217.194.0-255,1484,62350,1,176102
28319,0.000763,172.217.194.0-255,4320,66670,1,176102
28320,0.000766,172.31.36.0-255,66,66736,1,176102
28321,0.000778,172.31.36.0-255,66,66802,1,176102
28322,0.000795,172.217.194.0-255,2902,69704,1,176102
28323,0.000798,172.31.36.0-255,66,69770,1,176102
28324,0.000841,172.31.36.0-255,66,69836,1,176102
28325,0.000874,172.217.194.0-255,1484,71320,1,176102
28326,0.000888,172.217.194.0-255,2902,74222,1,176102
28327,0.000891,172.31.36.0-255,66,74288,1,176102
28328,0.000916,172.217.194.0-255,2902,77190,1,176102
28329,0.00092,172.31.36.0-255,66,77256,1,176102
28330,0.000948,172.217.194.0-255,2902,80158,1,176102
28331,0.000951,172.31.36.0-255,66,80224,1,176102
28332,0.000959,172.217.194.0-255,7156,87380,1,176102
28333,0.000961,172.31.36.0-255,66,87446,1,176102
28334,0.000965,172.217.194.0-255,1484,88930,1,176102
28335,0.00099,172.217.194.0-255,2184,91114,1,176102
28336,0.000992,172.31.36.0-255,66,91180,1,176102
28337,0.000996,172.31.36.0-255,66,91246,1,176102
28338,0.001031,172.217.194.0-255,4320,95566,1,176102
28339,0.001035,172.31.36.0-255,66,95632,1,176102
28340,0.001039,172.217.194.0-255,2902,98534,1,176102
28341,0.001041,172.31.36.0-255,66,98600,1,176102
28342,0.001055,172.217.194.0-255,2902,101502,1,176102
28343,0.001058,172.31.36.0-255,66,101568,1,176102
28344,0.001092,172.31.36.0-255,66,101634,1,176102
28345,0.001105,172.31.36.0-255,66,101700,1,176102
28346,0.001129,172.217.194.0-255,1484,103184,1,176102
28347,0.001156,172.217.194.0-255,5020,108204,1,176102
28348,0.001161,172.31.36.0-255,66,108270,1,176102
28349,0.001162,172.217.194.0-255,7156,115426,1,176102
28350,0.001165,172.31.36.0-255,66,115492,1,176102
28351,0.001176,172.217.194.0-255,1484,116976,1,176102
28352,0.001214,172.217.194.0-255,4320,121296,1,176102
28353,0.001215,172.31.36.0-255,66,121362,1,176102
28354,0.001216,172.217.194.0-255,766,122128,1,176102
28355,0.001218,172.31.36.0-255,66,122194,1,176102
28356,0.001253,172.217.194.0-255,1484,123678,1,176102
28357,0.001256,172.31.36.0-255,66,123744,1,176102
28358,0.001261,172.217.194.0-255,2902,126646,1,176102
28359,0.001264,172.31.36.0-255,66,126712,1,176102
28360,0.00129,172.217.194.0-255,1484,128196,1,176102
28361,0.001302,172.31.36.0-255,66,128262,1,176102
28362,0.001318,172.31.36.0-255,66,128328,1,176102
28363,0.00138,172.31.36.0-255,66,128394,1,176102
28364,0.001413,172.217.194.0-255,1484,129878,1,176102
28365,0.001424,172.217.194.0-255,1484,131362,1,176102
28366,0.001427,172.31.36.0-255,66,131428,1,176102
28367,0.001446,172.217.194.0-255,1484,132912,1,176102
28368,0.001453,172.217.194.0-255,5738,138650,1,176102
28369,0.001455,172.31.36.0-255,66,138716,1,176102
28370,0.001463,172.217.194.0-255,7156,145872,1,176102
28371,0.001466,172.31.36.0-255,66,145938,1,176102
28372,0.00151,172.31.36.0-255,66,146004,1,176102
28373,0.001515,172.217.194.0-255,2184,148188,1,176102
28374,0.001517,172.31.36.0-255,66,148254,1,176102
28375,0.001543,172.217.194.0-255,2902,151156,1,176102
28376,0.001546,172.31.36.0-255,66,151222,1,176102
28377,0.001549,172.217.194.0-255,1484,152706,1,176102
28378,0.001568,172.217.194.0-255,5738,158444,1,176102
28379,0.001572,172.31.36.0-255,66,158510,1,176102
28380,0.001584,172.31.36.0-255,66,158576,1,176102
28381,0.001643,172.31.36.0-255,66,158642,1,176102
28382,0.00166,172.31.36.0-255,66,158708,1,176102
28383,0.001699,172.31.36.0-255,66,158774,1,176102
28384,0.001735,172.31.36.0-255,66,158840,1,176102
28385,0.00174,172.217.194.0-255,4320,163160,1,176102
28386,0.001742,172.31.36.0-255,66,163226,1,176102
28387,0.00178,172.31.36.0-255,66,163292,1,176102
28388,0.001797,172.217.194.0-255,3128,166420,1,176102
28389,0.0018,172.31.36.0-255,66,166486,1,176102
28390,0.001803,172.217.194.0-255,97,166583,1,176102
28391,0.001805,172.217.194.0-255,105,166688,1,176102
28392,0.003651,172.31.36.0-255,66,166754,1,176102
28393,0.003678,172.31.36.0-255,105,166859,1,176102
28394,0.006165,172.217.194.0-255,66,166925,1,176102
28395,0.036853,172.31.36.0-255,188,167113,1,176102
28396,0.036885,172.31.36.0-255,958,168071,1,176102
28397,0.036952,172.31.36.0-255,1514,169585,1,176102
28398,0.036954,172.31.36.0-255,1514,171099,1,176102
28399,0.036955,172.31.36.0-255,1514,172613,1,176102
28400,0.036957,172.31.36.0-255,1514,174127,1,176102
28401,0.036985,172.31.36.0-255,1514,175641,1,176102
28402,0.036987,172.31.36.0-255,197,175838,1,176102
28403,0.038384,104.244.42.0-255,66,175904,1,176102
28404,0.038428,104.244.42.0-255,66,175970,1,176102
28405,0.038543,104.244.42.0-255,66,176036,1,176102
28406,0.038605,104.244.42.0-255,66,176102,1,176102
28407,0.0,172.217.194.0-255,152,152,1,181030
28408,2.4e-05,172.31.36.0-255,66,218,1,181030
28409,3.2e-05,172.217.194.0-255,1484,1702,1,181030
28410,3.7e-05,172.31.36.0-255,66,1768,1,181030
28411,5e-05,172.217.194.0-255,2902,4670,1,181030
28412,5.2e-05,172.31.36.0-255,66,4736,1,181030
28413,6.1e-05,172.217.194.0-255,7156,11892,1,181030
28414,6.4e-05,172.31.36.0-255,66,11958,1,181030
28415,6.8e-05,172.217.194.0-255,2067,14025,1,181030
28416,7.1e-05,172.31.36.0-255,66,14091,1,181030
28417,8.5e-05,172.31.36.0-255,66,14157,1,181030
28418,9.7e-05,172.31.36.0-255,66,14223,1,181030
28419,0.000124,172.217.194.0-255,7156,21379,1,181030
28420,0.000131,172.31.36.0-255,66,21445,1,181030
28421,0.000138,172.217.194.0-255,6438,27883,1,181030
28422,0.000141,172.31.36.0-255,66,27949,1,181030
28423,0.000171,172.217.194.0-255,5738,33687,1,181030
28424,0.000173,172.31.36.0-255,66,33753,1,181030
28425,0.000202,172.217.194.0-255,1484,35237,1,181030
28426,0.000205,172.31.36.0-255,66,35303,1,181030
28427,0.000216,172.31.36.0-255,66,35369,1,181030
28428,0.000246,172.217.194.0-255,1713,37082,1,181030
28429,0.000249,172.31.36.0-255,66,37148,1,181030
28430,0.000359,172.217.194.0-255,1484,38632,1,181030
28431,0.000364,172.31.36.0-255,66,38698,1,181030
28432,0.00037,172.217.194.0-255,2902,41600,1,181030
28433,0.000373,172.31.36.0-255,66,41666,1,181030
28434,0.000406,172.217.194.0-255,4320,45986,1,181030
28435,0.000409,172.31.36.0-255,66,46052,1,181030
28436,0.000426,172.31.36.0-255,66,46118,1,181030
28437,0.00046,172.31.36.0-255,66,46184,1,181030
28438,0.000488,172.217.194.0-255,3602,49786,1,181030
28439,0.00049,172.31.36.0-255,66,49852,1,181030
28440,0.003783,172.217.194.0-255,1484,51336,1,181030
28441,0.0038,172.217.194.0-255,1484,52820,1,181030
28442,0.003805,172.31.36.0-255,66,52886,1,181030
28443,0.003831,172.217.194.0-255,1484,54370,1,181030
28444,0.003835,172.217.194.0-255,1484,55854,1,181030
28445,0.003837,172.31.36.0-255,66,55920,1,181030
28446,0.0061,172.217.194.0-255,5738,61658,1,181030
28447,0.006106,172.31.36.0-255,66,61724,1,181030
28448,0.00838,172.217.194.0-255,5738,67462,1,181030
28449,0.008387,172.31.36.0-255,66,67528,1,181030
28450,0.010659,172.217.194.0-255,5738,73266,1,181030
28451,0.010667,172.31.36.0-255,66,73332,1,181030
28452,0.012944,172.217.194.0-255,5738,79070,1,181030
28453,0.012953,172.31.36.0-255,66,79136,1,181030
28454,0.015205,172.217.194.0-255,5738,84874,1,181030
28455,0.015213,172.31.36.0-255,66,84940,1,181030
28456,0.017474,172.217.194.0-255,5738,90678,1,181030
28457,0.017484,172.31.36.0-255,66,90744,1,181030
28458,0.019773,172.217.194.0-255,5738,96482,1,181030
28459,0.019789,172.31.36.0-255,66,96548,1,181030
28460,0.022088,172.217.194.0-255,5738,102286,1,181030
28461,0.022096,172.31.36.0-255,66,102352,1,181030
28462,0.024384,172.217.194.0-255,5738,108090,1,181030
28463,0.024391,172.31.36.0-255,66,108156,1,181030
28464,0.02671,172.217.194.0-255,5738,113894,1,181030
28465,0.026718,172.31.36.0-255,66,113960,1,181030
28466,0.029017,172.217.194.0-255,5738,119698,1,181030
28467,0.029029,172.31.36.0-255,66,119764,1,181030
28468,0.031331,172.217.194.0-255,5738,125502,1,181030
28469,0.03134,172.31.36.0-255,66,125568,1,181030
28470,0.033602,172.217.194.0-255,5738,131306,1,181030
28471,0.033611,172.31.36.0-255,66,131372,1,181030
28472,0.035874,172.217.194.0-255,5738,137110,1,181030
28473,0.035882,172.31.36.0-255,66,137176,1,181030
28474,0.037702,172.31.36.0-255,172,137348,1,181030
28475,0.037737,172.31.36.0-255,1114,138462,1,181030
28476,0.037813,172.31.36.0-255,1514,139976,1,181030
28477,0.037815,172.31.36.0-255,1514,141490,1,181030
28478,0.03782,172.31.36.0-255,1514,143004,1,181030
28479,0.037822,172.31.36.0-255,1514,144518,1,181030
28480,0.037844,172.31.36.0-255,1490,146008,1,181030
28481,0.038132,172.217.194.0-255,5738,151746,1,181030
28482,0.03814,172.31.36.0-255,66,151812,1,181030
28483,0.039247,104.244.42.0-255,66,151878,1,181030
28484,0.039348,104.244.42.0-255,66,151944,1,181030
28485,0.039408,104.244.42.0-255,66,152010,1,181030
28486,0.040429,172.217.194.0-255,5738,157748,1,181030
28487,0.040435,172.31.36.0-255,66,157814,1,181030
28488,0.04267,172.217.194.0-255,5738,163552,1,181030
28489,0.04268,172.31.36.0-255,66,163618,1,181030
28490,0.044923,172.217.194.0-255,5738,169356,1,181030
28491,0.04493,172.31.36.0-255,66,169422,1,181030
28492,0.047194,172.217.194.0-255,5738,175160,1,181030
28493,0.047209,172.31.36.0-255,66,175226,1,181030
28494,0.049474,172.217.194.0-255,5738,180964,1,181030
28495,0.049481,172.31.36.0-255,66,181030,1,181030
28496,0.0,74.125.68.0-255,297,297,1,282494
28497,2.7e-05,172.31.36.0-255,66,363,1,282494
28498,3.3e-05,74.125.68.0-255,1484,1847,1,282494
28499,3.8e-05,172.31.36.0-255,66,1913,1,282494
28500,4e-05,74.125.68.0-255,1484,3397,1,282494
28501,4.3e-05,172.31.36.0-255,66,3463,1,282494
28502,7.4e-05,74.125.68.0-255,2902,6365,1,282494
28503,7.9e-05,172.31.36.0-255,66,6431,1,282494
28504,8e-05,74.125.68.0-255,5738,12169,1,282494
28505,8.3e-05,172.31.36.0-255,66,12235,1,282494
28506,0.000122,172.31.36.0-255,66,12301,1,282494
28507,0.000146,74.125.68.0-255,416,12717,1,282494
28508,0.000148,172.31.36.0-255,66,12783,1,282494
28509,0.000154,74.125.68.0-255,4320,17103,1,282494
28510,0.000156,172.31.36.0-255,66,17169,1,282494
28511,0.000179,74.125.68.0-255,3961,21130,1,282494
28512,0.000184,172.31.36.0-255,66,21196,1,282494
28513,0.000287,74.125.68.0-255,1484,22680,1,282494
28514,0.000292,172.31.36.0-255,66,22746,1,282494
28515,0.000297,74.125.68.0-255,2902,25648,1,282494
28516,0.000299,172.31.36.0-255,66,25714,1,282494
28517,0.000334,74.125.68.0-255,4320,30034,1,282494
28518,0.000338,172.31.36.0-255,66,30100,1,282494
28519,0.000364,74.125.68.0-255,7156,37256,1,282494
28520,0.000367,172.31.36.0-255,66,37322,1,282494
28521,0.000379,74.125.68.0-255,2543,39865,1,282494
28522,0.000386,172.31.36.0-255,66,39931,1,282494
28523,0.000389,74.125.68.0-255,1484,41415,1,282494
28524,0.000391,172.31.36.0-255,66,41481,1,282494
28525,0.000437,74.125.68.0-255,4320,45801,1,282494
28526,0.000438,172.31.36.0-255,66,45867,1,282494
28527,0.000442,172.31.36.0-255,66,45933,1,282494
28528,0.000449,74.125.68.0-255,1434,47367,1,282494
28529,0.00048,74.125.68.0-255,112,47479,1,282494
28530,0.000579,74.125.68.0-255,1484,48963,1,282494
28531,0.000584,172.31.36.0-255,66,49029,1,282494
28532,0.000603,74.125.68.0-255,1484,50513,1,282494
28533,0.000608,74.125.68.0-255,2902,53415,1,282494
28534,0.000611,172.31.36.0-255,66,53481,1,282494
28535,0.00062,74.125.68.0-255,2902,56383,1,282494
28536,0.000622,172.31.36.0-255,66,56449,1,282494
28537,0.000645,74.125.68.0-255,2902,59351,1,282494
28538,0.000648,172.31.36.0-255,66,59417,1,282494
28539,0.000655,74.125.68.0-255,5379,64796,1,282494
28540,0.000657,172.31.36.0-255,66,64862,1,282494
28541,0.000739,74.125.68.0-255,1484,66346,1,282494
28542,0.000743,74.125.68.0-255,1484,67830,1,282494
28543,0.000746,172.31.36.0-255,66,67896,1,282494
28544,0.00077,74.125.68.0-255,1484,69380,1,282494
28545,0.000775,74.125.68.0-255,4320,73700,1,282494
28546,0.000777,172.31.36.0-255,66,73766,1,282494
28547,0.000828,74.125.68.0-255,4320,78086,1,282494
28548,0.000832,172.31.36.0-255,66,78152,1,282494
28549,0.000876,74.125.68.0-255,4227,82379,1,282494
28550,0.00088,172.31.36.0-255,66,82445,1,282494
28551,0.001193,74.125.68.0-255,1484,83929,1,282494
28552,0.001213,74.125.68.0-255,1484,85413,1,282494
28553,0.001217,172.31.36.0-255,66,85479,1,282494
28554,0.001223,74.125.68.0-255,2902,88381,1,282494
28555,0.001225,172.31.36.0-255,66,88447,1,282494
28556,0.00128,74.125.68.0-255,5738,94185,1,282494
28557,0.001285,172.31.36.0-255,66,94251,1,282494
28558,0.001288,74.125.68.0-255,1484,95735,1,282494
28559,0.001293,74.125.68.0-255,2902,98637,1,282494
28560,0.001295,172.31.36.0-255,66,98703,1,282494
28561,0.001318,74.125.68.0-255,1484,100187,1,282494
28562,0.001322,74.125.68.0-255,2902,103089,1,282494
28563,0.001325,172.31.36.0-255,66,103155,1,282494
28564,0.001356,74.125.68.0-255,5738,108893,1,282494
28565,0.001361,172.31.36.0-255,66,108959,1,282494
28566,0.001364,74.125.68.0-255,1484,110443,1,282494
28567,0.001384,74.125.68.0-255,2902,113345,1,282494
28568,0.001388,172.31.36.0-255,66,113411,1,282494
28569,0.00143,74.125.68.0-255,3602,117013,1,282494
28570,0.001433,172.31.36.0-255,66,117079,1,282494
28571,0.001979,74.125.68.0-255,1484,118563,1,282494
28572,0.001987,74.125.68.0-255,2902,121465,1,282494
28573,0.001991,172.31.36.0-255,66,121531,1,282494
28574,0.002024,74.125.68.0-255,2902,124433,1,282494
28575,0.002027,172.31.36.0-255,66,124499,1,282494
28576,0.002053,74.125.68.0-255,1484,125983,1,282494
28577,0.002071,74.125.68.0-255,5738,131721,1,282494
28578,0.002074,172.31.36.0-255,66,131787,1,282494
28579,0.002102,74.125.68.0-255,2902,134689,1,282494
28580,0.002106,172.31.36.0-255,66,134755,1,282494
28581,0.002131,74.125.68.0-255,4320,139075,1,282494
28582,0.002133,172.31.36.0-255,66,139141,1,282494
28583,0.002138,74.125.68.0-255,2902,142043,1,282494
28584,0.00214,172.31.36.0-255,66,142109,1,282494
28585,0.002145,74.125.68.0-255,4320,146429,1,282494
28586,0.002147,172.31.36.0-255,66,146495,1,282494
28587,0.002185,74.125.68.0-255,5020,151515,1,282494
28588,0.002189,172.31.36.0-255,66,151581,1,282494
28589,0.004432,74.125.68.0-255,5738,157319,1,282494
28590,0.004435,172.31.36.0-255,66,157385,1,282494
28591,0.006691,74.125.68.0-255,5738,163123,1,282494
28592,0.006699,172.31.36.0-255,66,163189,1,282494
28593,0.008954,74.125.68.0-255,5738,168927,1,282494
28594,0.008961,172.31.36.0-255,66,168993,1,282494
28595,0.011221,74.125.68.0-255,5738,174731,1,282494
28596,0.011229,172.31.36.0-255,66,174797,1,282494
28597,0.013484,74.125.68.0-255,5738,180535,1,282494
28598,0.013491,172.31.36.0-255,66,180601,1,282494
28599,0.015765,74.125.68.0-255,5738,186339,1,282494
28600,0.015775,172.31.36.0-255,66,186405,1,282494
28601,0.018026,74.125.68.0-255,5738,192143,1,282494
28602,0.018034,172.31.36.0-255,66,192209,1,282494
28603,0.02029,74.125.68.0-255,5738,197947,1,282494
28604,0.020297,172.31.36.0-255,66,198013,1,282494
28605,0.022564,74.125.68.0-255,5738,203751,1,282494
28606,0.022571,172.31.36.0-255,66,203817,1,282494
28607,0.024827,74.125.68.0-255,5738,209555,1,282494
28608,0.024835,172.31.36.0-255,66,209621,1,282494
28609,0.027109,74.125.68.0-255,5738,215359,1,282494
28610,0.027118,172.31.36.0-255,66,215425,1,282494
28611,0.029381,74.125.68.0-255,5738,221163,1,282494
28612,0.029388,172.31.36.0-255,66,221229,1,282494
28613,0.031656,74.125.68.0-255,5738,226967,1,282494
28614,0.031663,172.31.36.0-255,66,227033,1,282494
28615,0.031782,172.31.36.0-255,172,227205,1,282494
28616,0.031808,172.31.36.0-255,1113,228318,1,282494
28617,0.031915,172.31.36.0-255,1514,229832,1,282494
28618,0.031917,172.31.36.0-255,1514,231346,1,282494
28619,0.031923,172.31.36.0-255,1514,232860,1,282494
28620,0.031924,172.31.36.0-255,1514,234374,1,282494
28621,0.031952,172.31.36.0-255,1490,235864,1,282494
28622,0.03332,104.244.42.0-255,66,235930,1,282494
28623,0.033368,104.244.42.0-255,66,235996,1,282494
28624,0.033611,104.244.42.0-255,66,236062,1,282494
28625,0.033907,74.125.68.0-255,5738,241800,1,282494
28626,0.033913,172.31.36.0-255,66,241866,1,282494
28627,0.036174,74.125.68.0-255,5738,247604,1,282494
28628,0.036181,172.31.36.0-255,66,247670,1,282494
28629,0.038429,74.125.68.0-255,5738,253408,1,282494
28630,0.038435,172.31.36.0-255,66,253474,1,282494
28631,0.040683,74.125.68.0-255,5738,259212,1,282494
28632,0.040689,172.31.36.0-255,66,259278,1,282494
28633,0.042943,74.125.68.0-255,5738,265016,1,282494
28634,0.042951,172.31.36.0-255,66,265082,1,282494
28635,0.045198,74.125.68.0-255,5738,270820,1,282494
28636,0.045204,172.31.36.0-255,66,270886,1,282494
28637,0.04746,74.125.68.0-255,5738,276624,1,282494
28638,0.047466,172.31.36.0-255,66,276690,1,282494
28639,0.049747,74.125.68.0-255,5738,282428,1,282494
28640,0.049752,172.31.36.0-255,66,282494,1,282494
28641,0.0,74.125.130.0-255,152,152,1,325578
28642,3e-05,172.31.36.0-255,66,218,1,325578
28643,3.7e-05,74.125.130.0-255,1484,1702,1,325578
28644,4.2e-05,172.31.36.0-255,66,1768,1,325578
28645,4.7e-05,74.125.130.0-255,2902,4670,1,325578
28646,5e-05,172.31.36.0-255,66,4736,1,325578
28647,7.4e-05,74.125.130.0-255,5738,10474,1,325578
28648,7.6e-05,172.31.36.0-255,66,10540,1,325578
28649,0.000103,74.125.130.0-255,3508,14048,1,325578
28650,0.000105,172.31.36.0-255,66,14114,1,325578
28651,0.000108,74.125.130.0-255,1484,15598,1,325578
28652,0.000111,172.31.36.0-255,66,15664,1,325578
28653,0.000127,74.125.130.0-255,2902,18566,1,325578
28654,0.000129,172.31.36.0-255,66,18632,1,325578
28655,0.000145,74.125.130.0-255,5738,24370,1,325578
28656,0.000148,172.31.36.0-255,66,24436,1,325578
28657,0.000167,74.125.130.0-255,1484,25920,1,325578
28658,0.000169,172.31.36.0-255,66,25986,1,325578
28659,0.000203,74.125.130.0-255,5379,31365,1,325578
28660,0.000206,172.31.36.0-255,66,31431,1,325578
28661,0.00036,74.125.130.0-255,1484,32915,1,325578
28662,0.000364,172.31.36.0-255,66,32981,1,325578
28663,0.00037,74.125.130.0-255,2902,35883,1,325578
28664,0.000372,172.31.36.0-255,66,35949,1,325578
28665,0.000387,74.125.130.0-255,1484,37433,1,325578
28666,0.000391,172.31.36.0-255,66,37499,1,325578
28667,0.000417,74.125.130.0-255,4320,41819,1,325578
28668,0.000421,172.31.36.0-255,66,41885,1,325578
28669,0.000427,74.125.130.0-255,6797,48682,1,325578
28670,0.00043,172.31.36.0-255,66,48748,1,325578
28671,0.000451,74.125.130.0-255,2902,51650,1,325578
28672,0.000453,172.31.36.0-255,66,51716,1,325578
28673,0.000475,74.125.130.0-255,4320,56036,1,325578
28674,0.000478,172.31.36.0-255,66,56102,1,325578
28675,0.000488,172.31.36.0-255,66,56168,1,325578
28676,0.000508,74.125.130.0-255,1381,57549,1,325578
28677,0.000511,74.125.130.0-255,121,57670,1,325578
28678,0.000646,74.125.130.0-255,1484,59154,1,325578
28679,0.000649,172.31.36.0-255,66,59220,1,325578
28680,0.000667,74.125.130.0-255,1484,60704,1,325578
28681,0.000684,74.125.130.0-255,1484,62188,1,325578
28682,0.000687,172.31.36.0-255,66,62254,1,325578
28683,0.000694,74.125.130.0-255,5738,67992,1,325578
28684,0.000696,172.31.36.0-255,66,68058,1,325578
28685,0.0007,74.125.130.0-255,2902,70960,1,325578
28686,0.000702,172.31.36.0-255,66,71026,1,325578
28687,0.000705,74.125.130.0-255,1484,72510,1,325578
28688,0.000727,74.125.130.0-255,2543,75053,1,325578
28689,0.000729,172.31.36.0-255,66,75119,1,325578
28690,0.000748,74.125.130.0-255,2902,78021,1,325578
28691,0.00075,172.31.36.0-255,66,78087,1,325578
28692,0.000777,74.125.130.0-255,5738,83825,1,325578
28693,0.000779,172.31.36.0-255,66,83891,1,325578
28694,0.000785,74.125.130.0-255,4320,88211,1,325578
28695,0.000792,172.31.36.0-255,66,88277,1,325578
28696,0.000797,74.125.130.0-255,1484,89761,1,325578
28697,0.000816,74.125.130.0-255,2543,92304,1,325578
28698,0.000819,172.31.36.0-255,66,92370,1,325578
28699,0.000983,74.125.130.0-255,1484,93854,1,325578
28700,0.000989,74.125.130.0-255,2902,96756,1,325578
28701,0.000992,172.31.36.0-255,66,96822,1,325578
28702,0.001015,74.125.130.0-255,1484,98306,1,325578
28703,0.001022,74.125.130.0-255,5738,104044,1,325578
28704,0.001026,172.31.36.0-255,66,104110,1,325578
28705,0.001056,74.125.130.0-255,4320,108430,1,325578
28706,0.001059,172.31.36.0-255,66,108496,1,325578
28707,0.001089,172.31.36.0-255,66,108562,1,325578
28708,0.00111,74.125.130.0-255,4320,112882,1,325578
28709,0.001113,172.31.36.0-255,66,112948,1,325578
28710,0.001128,74.125.130.0-255,5020,117968,1,325578
28711,0.001131,172.31.36.0-255,66,118034,1,325578
28712,0.001278,74.125.130.0-255,1484,119518,1,325578
28713,0.001294,74.125.130.0-255,2902,122420,1,325578
28714,0.001298,172.31.36.0-255,66,122486,1,325578
28715,0.001303,74.125.130.0-255,2902,125388,1,325578
28716,0.001305,172.31.36.0-255,66,125454,1,325578
28717,0.00133,74.125.130.0-255,1484,126938,1,325578
28718,0.001349,74.125.130.0-255,2902,129840,1,325578
28719,0.001352,172.31.36.0-255,66,129906,1,325578
28720,0.001379,172.31.36.0-255,66,129972,1,325578
28721,0.001383,74.125.130.0-255,1484,131456,1,325578
28722,0.001399,74.125.130.0-255,4320,135776,1,325578
28723,0.001402,172.31.36.0-255,66,135842,1,325578
28724,0.001426,74.125.130.0-255,7156,142998,1,325578
28725,0.001429,172.31.36.0-255,66,143064,1,325578
28726,0.001432,74.125.130.0-255,766,143830,1,325578
28727,0.001538,74.125.130.0-255,1484,145314,1,325578
28728,0.001541,172.31.36.0-255,66,145380,1,325578
28729,0.00155,74.125.130.0-255,2902,148282,1,325578
28730,0.001553,172.31.36.0-255,66,148348,1,325578
28731,0.001556,74.125.130.0-255,1484,149832,1,325578
28732,0.001577,74.125.130.0-255,2902,152734,1,325578
28733,0.00158,172.31.36.0-255,66,152800,1,325578
28734,0.001596,74.125.130.0-255,2902,155702,1,325578
28735,0.001599,172.31.36.0-255,66,155768,1,325578
28736,0.00161,74.125.130.0-255,2902,158670,1,325578
28737,0.001612,172.31.36.0-255,66,158736,1,325578
28738,0.001633,172.31.36.0-255,66,158802,1,325578
28739,0.001637,74.125.130.0-255,1484,160286,1,325578
28740,0.001664,172.31.36.0-255,66,160352,1,325578
28741,0.001669,74.125.130.0-255,2184,162536,1,325578
28742,0.001671,172.31.36.0-255,66,162602,1,325578
28743,0.001675,74.125.130.0-255,2902,165504,1,325578
28744,0.001676,172.31.36.0-255,66,165570,1,325578
28745,0.001699,74.125.130.0-255,1484,167054,1,325578
28746,0.001719,74.125.130.0-255,5738,172792,1,325578
28747,0.001723,172.31.36.0-255,66,172858,1,325578
28748,0.001764,74.125.130.0-255,1484,174342,1,325578
28749,0.001786,74.125.130.0-255,1484,175826,1,325578
28750,0.001789,172.31.36.0-255,66,175892,1,325578
28751,0.001794,74.125.130.0-255,4320,180212,1,325578
28752,0.001812,172.31.36.0-255,66,180278,1,325578
28753,0.001823,172.31.36.0-255,66,180344,1,325578
28754,0.001826,74.125.130.0-255,1484,181828,1,325578
28755,0.00183,74.125.130.0-255,2902,184730,1,325578
28756,0.001833,172.31.36.0-255,66,184796,1,325578
28757,0.001837,74.125.130.0-255,2184,186980,1,325578
28758,0.001839,172.31.36.0-255,66,187046,1,325578
28759,0.003897,74.125.130.0-255,4320,191366,1,325578
28760,0.003904,172.31.36.0-255,66,191432,1,325578
28761,0.003923,74.125.130.0-255,1484,192916,1,325578
28762,0.00596,74.125.130.0-255,4320,197236,1,325578
28763,0.005963,172.31.36.0-255,66,197302,1,325578
28764,0.008039,74.125.130.0-255,5738,203040,1,325578
28765,0.008045,172.31.36.0-255,66,203106,1,325578
28766,0.01012,74.125.130.0-255,5738,208844,1,325578
28767,0.010127,172.31.36.0-255,66,208910,1,325578
28768,0.012225,74.125.130.0-255,5738,214648,1,325578
28769,0.012233,172.31.36.0-255,66,214714,1,325578
28770,0.014297,74.125.130.0-255,5738,220452,1,325578
28771,0.014304,172.31.36.0-255,66,220518,1,325578
28772,0.01637,74.125.130.0-255,5738,226256,1,325578
28773,0.01638,172.31.36.0-255,66,226322,1,325578
28774,0.018454,74.125.130.0-255,5738,232060,1,325578
28775,0.018461,172.31.36.0-255,66,232126,1,325578
28776,0.020522,74.125.130.0-255,5738,237864,1,325578
28777,0.02053,172.31.36.0-255,66,237930,1,325578
28778,0.022604,74.125.130.0-255,5738,243668,1,325578
28779,0.02261,172.31.36.0-255,66,243734,1,325578
28780,0.024689,74.125.130.0-255,5738,249472,1,325578
28781,0.024695,172.31.36.0-255,66,249538,1,325578
28782,0.026779,74.125.130.0-255,5738,255276,1,325578
28783,0.026788,172.31.36.0-255,66,255342,1,325578
28784,0.028862,74.125.130.0-255,4320,259662,1,325578
28785,0.028869,172.31.36.0-255,66,259728,1,325578
28786,0.028901,74.125.130.0-255,1484,261212,1,325578
28787,0.030936,74.125.130.0-255,4320,265532,1,325578
28788,0.030943,172.31.36.0-255,66,265598,1,325578
28789,0.033006,74.125.130.0-255,4320,269918,1,325578
28790,0.033013,172.31.36.0-255,66,269984,1,325578
28791,0.033031,74.125.130.0-255,1484,271468,1,325578
28792,0.035077,74.125.130.0-255,4320,275788,1,325578
28793,0.035083,172.31.36.0-255,66,275854,1,325578
28794,0.037158,74.125.130.0-255,5738,281592,1,325578
28795,0.037165,172.31.36.0-255,66,281658,1,325578
28796,0.039233,74.125.130.0-255,5738,287396,1,325578
28797,0.03924,172.31.36.0-255,66,287462,1,325578
28798,0.041312,74.125.130.0-255,5738,293200,1,325578
28799,0.041319,172.31.36.0-255,66,293266,1,325578
28800,0.042273,172.31.36.0-255,172,293438,1,325578
28801,0.042304,172.31.36.0-255,1115,294553,1,325578
28802,0.042351,172.31.36.0-255,1514,296067,1,325578
28803,0.042352,172.31.36.0-255,1514,297581,1,325578
28804,0.042354,172.31.36.0-255,1514,299095,1,325578
28805,0.042358,172.31.36.0-255,1514,300609,1,325578
28806,0.042359,172.31.36.0-255,1489,302098,1,325578
28807,0.043419,74.125.130.0-255,5738,307836,1,325578
28808,0.043426,172.31.36.0-255,66,307902,1,325578
28809,0.043829,104.244.42.0-255,66,307968,1,325578
28810,0.043837,104.244.42.0-255,66,308034,1,325578
28811,0.043942,104.244.42.0-255,66,308100,1,325578
28812,0.045497,74.125.130.0-255,5738,313838,1,325578
28813,0.045504,172.31.36.0-255,66,313904,1,325578
28814,0.047578,74.125.130.0-255,5738,319642,1,325578
28815,0.047584,172.31.36.0-255,66,319708,1,325578
28816,0.049654,74.125.130.0-255,4320,324028,1,325578
28817,0.049659,172.31.36.0-255,66,324094,1,325578
28818,0.049694,74.125.130.0-255,1484,325578,1,325578
28819,0.0,74.125.24.0-255,143,143,1,299093
28820,2.6e-05,172.31.36.0-255,66,209,1,299093
28821,3.3e-05,74.125.24.0-255,1484,1693,1,299093
28822,3.7e-05,172.31.36.0-255,66,1759,1,299093
28823,4.1e-05,74.125.24.0-255,2902,4661,1,299093
28824,4.4e-05,172.31.36.0-255,66,4727,1,299093
28825,5.2e-05,74.125.24.0-255,7156,11883,1,299093
28826,5.4e-05,172.31.36.0-255,66,11949,1,299093
28827,5.8e-05,74.125.24.0-255,2100,14049,1,299093
28828,6e-05,172.31.36.0-255,66,14115,1,299093
28829,8.1e-05,74.125.24.0-255,2902,17017,1,299093
28830,8.4e-05,172.31.36.0-255,66,17083,1,299093
28831,8.9e-05,74.125.24.0-255,4320,21403,1,299093
28832,9.2e-05,172.31.36.0-255,66,21469,1,299093
28833,0.000104,74.125.24.0-255,1484,22953,1,299093
28834,0.000106,172.31.36.0-255,66,23019,1,299093
28835,0.000129,74.125.24.0-255,7156,30175,1,299093
28836,0.000132,172.31.36.0-255,66,30241,1,299093
28837,0.000135,74.125.24.0-255,1125,31366,1,299093
28838,0.000137,172.31.36.0-255,66,31432,1,299093
28839,0.0003,74.125.24.0-255,1484,32916,1,299093
28840,0.000304,172.31.36.0-255,66,32982,1,299093
28841,0.000308,74.125.24.0-255,1484,34466,1,299093
28842,0.00031,172.31.36.0-255,66,34532,1,299093
28843,0.000328,74.125.24.0-255,1484,36016,1,299093
28844,0.000331,172.31.36.0-255,66,36082,1,299093
28845,0.000337,74.125.24.0-255,5738,41820,1,299093
28846,0.000339,172.31.36.0-255,66,41886,1,299093
28847,0.000346,74.125.24.0-255,6797,48683,1,299093
28848,0.000348,172.31.36.0-255,66,48749,1,299093
28849,0.00038,172.31.36.0-255,66,48815,1,299093
28850,0.000384,74.125.24.0-255,2543,51358,1,299093
28851,0.000396,172.31.36.0-255,66,51424,1,299093
28852,0.000414,74.125.24.0-255,400,51824,1,299093
28853,0.000688,74.125.24.0-255,344,52168,1,299093
28854,0.000749,172.31.36.0-255,66,52234,1,299093
28855,0.000779,74.125.24.0-255,1484,53718,1,299093
28856,0.000794,74.125.24.0-255,2902,56620,1,299093
28857,0.0008,74.125.24.0-255,5738,62358,1,299093
28858,0.000807,172.31.36.0-255,66,62424,1,299093
28859,0.000841,74.125.24.0-255,1484,63908,1,299093
28860,0.000862,74.125.24.0-255,5379,69287,1,299093
28861,0.000873,172.31.36.0-255,66,69353,1,299093
28862,0.000884,74.125.24.0-255,4320,73673,1,299093
28863,0.00089,172.31.36.0-255,66,73739,1,299093
28864,0.000896,74.125.24.0-255,2902,76641,1,299093
28865,0.0009,74.125.24.0-255,2902,79543,1,299093
28866,0.000906,172.31.36.0-255,66,79609,1,299093
28867,0.000914,74.125.24.0-255,2902,82511,1,299093
28868,0.000917,172.31.36.0-255,66,82577,1,299093
28869,0.000937,74.125.24.0-255,3961,86538,1,299093
28870,0.000941,172.31.36.0-255,66,86604,1,299093
28871,0.001285,74.125.24.0-255,1484,88088,1,299093
28872,0.001295,74.125.24.0-255,2902,90990,1,299093
28873,0.001299,172.31.36.0-255,66,91056,1,299093
28874,0.001304,74.125.24.0-255,2902,93958,1,299093
28875,0.00132,74.125.24.0-255,2902,96860,1,299093
28876,0.001339,74.125.24.0-255,2902,99762,1,299093
28877,0.001446,74.125.24.0-255,1484,101246,1,299093
28878,0.001462,74.125.24.0-255,2902,104148,1,299093
28879,0.001465,74.125.24.0-255,1484,105632,1,299093
28880,0.001485,74.125.24.0-255,4320,109952,1,299093
28881,0.001489,74.125.24.0-255,2902,112854,1,299093
28882,0.001517,74.125.24.0-255,7156,120010,1,299093
28883,0.001529,74.125.24.0-255,1484,121494,1,299093
28884,0.001544,74.125.24.0-255,2184,123678,1,299093
28885,0.001623,74.125.24.0-255,1484,125162,1,299093
28886,0.001641,74.125.24.0-255,2902,128064,1,299093
28887,0.001681,74.125.24.0-255,4320,132384,1,299093
28888,0.001695,74.125.24.0-255,1484,133868,1,299093
28889,0.001699,74.125.24.0-255,4320,138188,1,299093
28890,0.001712,74.125.24.0-255,5738,143926,1,299093
28891,0.001724,74.125.24.0-255,2184,146110,1,299093
28892,0.00176,74.125.24.0-255,1484,147594,1,299093
28893,0.001776,74.125.24.0-255,1484,149078,1,299093
28894,0.00178,74.125.24.0-255,4320,153398,1,299093
28895,0.001784,74.125.24.0-255,4320,157718,1,299093
28896,0.001802,74.125.24.0-255,4320,162038,1,299093
28897,0.001854,74.125.24.0-255,1484,163522,1,299093
28898,0.001878,74.125.24.0-255,2902,166424,1,299093
28899,0.001896,74.125.24.0-255,5020,171444,1,299093
28900,0.00197,74.125.24.0-255,5020,176464,1,299093
28901,0.001973,74.125.24.0-255,1484,177948,1,299093
28902,0.001986,74.125.24.0-255,4320,182268,1,299093
28903,0.002426,172.31.36.0-255,66,182334,1,299093
28904,0.004479,74.125.24.0-255,5738,188072,1,299093
28905,0.004485,172.31.36.0-255,66,188138,1,299093
28906,0.006502,74.125.24.0-255,4320,192458,1,299093
28907,0.006516,74.125.24.0-255,1484,193942,1,299093
28908,0.007818,172.31.36.0-255,66,194008,1,299093
28909,0.00986,74.125.24.0-255,5738,199746,1,299093
28910,0.009867,172.31.36.0-255,66,199812,1,299093
28911,0.01189,74.125.24.0-255,4320,204132,1,299093
28912,0.01191,74.125.24.0-255,1484,205616,1,299093
28913,0.012745,172.31.36.0-255,66,205682,1,299093
28914,0.014763,74.125.24.0-255,5738,211420,1,299093
28915,0.014772,172.31.36.0-255,66,211486,1,299093
28916,0.016819,74.125.24.0-255,5738,217224,1,299093
28917,0.016827,172.31.36.0-255,66,217290,1,299093
28918,0.018848,74.125.24.0-255,5738,223028,1,299093
28919,0.018855,172.31.36.0-255,66,223094,1,299093
28920,0.020894,74.125.24.0-255,5738,228832,1,299093
28921,0.020902,172.31.36.0-255,66,228898,1,299093
28922,0.022932,74.125.24.0-255,5738,234636,1,299093
28923,0.022936,172.31.36.0-255,66,234702,1,299093
28924,0.023688,172.31.36.0-255,172,234874,1,299093
28925,0.023715,172.31.36.0-255,1114,235988,1,299093
28926,0.023744,172.31.36.0-255,1514,237502,1,299093
28927,0.023746,172.31.36.0-255,328,237830,1,299093
28928,0.025013,74.125.24.0-255,5738,243568,1,299093
28929,0.025018,172.31.36.0-255,66,243634,1,299093
28930,0.025276,104.244.42.0-255,66,243700,1,299093
28931,0.025303,104.244.42.0-255,66,243766,1,299093
28932,0.025307,104.244.42.0-255,66,243832,1,299093
28933,0.027046,74.125.24.0-255,2902,246734,1,299093
28934,0.027051,172.31.36.0-255,66,246800,1,299093
28935,0.027083,74.125.24.0-255,2902,249702,1,299093
28936,0.0271,172.31.36.0-255,66,249768,1,299093
28937,0.029081,74.125.24.0-255,2902,252670,1,299093
28938,0.029087,172.31.36.0-255,66,252736,1,299093
28939,0.029131,74.125.24.0-255,2902,255638,1,299093
28940,0.029139,172.31.36.0-255,66,255704,1,299093
28941,0.031124,74.125.24.0-255,2902,258606,1,299093
28942,0.031129,172.31.36.0-255,66,258672,1,299093
28943,0.031157,74.125.24.0-255,2902,261574,1,299093
28944,0.031176,172.31.36.0-255,66,261640,1,299093
28945,0.033156,74.125.24.0-255,2902,264542,1,299093
28946,0.033161,172.31.36.0-255,66,264608,1,299093
28947,0.033192,74.125.24.0-255,2902,267510,1,299093
28948,0.033211,172.31.36.0-255,66,267576,1,299093
28949,0.0352,74.125.24.0-255,2902,270478,1,299093
28950,0.035205,172.31.36.0-255,66,270544,1,299093
28951,0.035241,74.125.24.0-255,2902,273446,1,299093
28952,0.035253,172.31.36.0-255,66,273512,1,299093
28953,0.037231,74.125.24.0-255,2902,276414,1,299093
28954,0.037236,172.31.36.0-255,66,276480,1,299093
28955,0.037274,74.125.24.0-255,2902,279382,1,299093
28956,0.037289,172.31.36.0-255,66,279448,1,299093
28957,0.039293,74.125.24.0-255,2902,282350,1,299093
28958,0.039298,172.31.36.0-255,66,282416,1,299093
28959,0.039332,74.125.24.0-255,2902,285318,1,299093
28960,0.039348,172.31.36.0-255,66,285384,1,299093
28961,0.041315,74.125.24.0-255,2902,288286,1,299093
28962,0.04132,172.31.36.0-255,66,288352,1,299093
28963,0.041349,74.125.24.0-255,2902,291254,1,299093
28964,0.04137,172.31.36.0-255,66,291320,1,299093
28965,0.043343,74.125.24.0-255,2902,294222,1,299093
28966,0.043348,172.31.36.0-255,66,294288,1,299093
28967,0.043387,74.125.24.0-255,2902,297190,1,299093
28968,0.043397,172.31.36.0-255,66,297256,1,299093
28969,0.045375,74.125.24.0-255,1600,298856,1,299093
28970,0.045381,172.31.36.0-255,66,298922,1,299093
28971,0.045548,172.31.36.0-255,105,299027,1,299093
28972,0.047538,74.125.24.0-255,66,299093,1,299093
28973,0.0,74.125.24.0-255,154,154,1,257587
28974,2.8e-05,172.31.36.0-255,66,220,1,257587
28975,3.6e-05,74.125.24.0-255,1484,1704,1,257587
28976,4.1e-05,172.31.36.0-255,66,1770,1,257587
28977,4.5e-05,74.125.24.0-255,2902,4672,1,257587
28978,5.7e-05,172.31.36.0-255,66,4738,1,257587
28979,6.3e-05,74.125.24.0-255,5738,10476,1,257587
28980,6.6e-05,172.31.36.0-255,66,10542,1,257587
28981,0.000102,74.125.24.0-255,3459,14001,1,257587
28982,0.000105,172.31.36.0-255,66,14067,1,257587
28983,0.000111,74.125.24.0-255,4320,18387,1,257587
28984,0.000114,172.31.36.0-255,66,18453,1,257587
28985,0.000165,172.31.36.0-255,66,18519,1,257587
28986,0.000208,172.31.36.0-255,66,18585,1,257587
28987,0.000234,74.125.24.0-255,2543,21128,1,257587
28988,0.000237,172.31.36.0-255,66,21194,1,257587
28989,0.000259,74.125.24.0-255,2902,24096,1,257587
28990,0.000262,172.31.36.0-255,66,24162,1,257587
28991,0.000296,74.125.24.0-255,7156,31318,1,257587
28992,0.0003,172.31.36.0-255,66,31384,1,257587
28993,0.000331,74.125.24.0-255,6797,38181,1,257587
28994,0.000335,172.31.36.0-255,66,38247,1,257587
28995,0.00053,74.125.24.0-255,396,38643,1,257587
28996,0.000534,172.31.36.0-255,66,38709,1,257587
28997,0.000556,74.125.24.0-255,110,38819,1,257587
28998,0.000559,172.31.36.0-255,66,38885,1,257587
28999,0.000645,74.125.24.0-255,1484,40369,1,257587
29000,0.000649,172.31.36.0-255,66,40435,1,257587
29001,0.000654,74.125.24.0-255,2902,43337,1,257587
29002,0.000656,172.31.36.0-255,66,43403,1,257587
29003,0.000686,74.125.24.0-255,5738,49141,1,257587
29004,0.000692,74.125.24.0-255,5738,54879,1,257587
29005,0.000693,172.31.36.0-255,66,54945,1,257587
29006,0.000697,172.31.36.0-255,66,55011,1,257587
29007,0.000734,172.31.36.0-255,66,55077,1,257587
29008,0.00074,74.125.24.0-255,3961,59038,1,257587
29009,0.000742,172.31.36.0-255,66,59104,1,257587
29010,0.001589,74.125.24.0-255,1484,60588,1,257587
29011,0.001602,74.125.24.0-255,2902,63490,1,257587
29012,0.001606,172.31.36.0-255,66,63556,1,257587
29013,0.001614,74.125.24.0-255,5738,69294,1,257587
29014,0.001615,172.31.36.0-255,66,69360,1,257587
29015,0.001651,172.31.36.0-255,66,69426,1,257587
29016,0.001658,74.125.24.0-255,4320,73746,1,257587
29017,0.00166,172.31.36.0-255,66,73812,1,257587
29018,0.001716,74.125.24.0-255,6438,80250,1,257587
29019,0.001718,172.31.36.0-255,66,80316,1,257587
29020,0.001845,74.125.24.0-255,1484,81800,1,257587
29021,0.001859,74.125.24.0-255,2902,84702,1,257587
29022,0.001861,172.31.36.0-255,66,84768,1,257587
29023,0.001867,74.125.24.0-255,4320,89088,1,257587
29024,0.001869,172.31.36.0-255,66,89154,1,257587
29025,0.001898,74.125.24.0-255,1484,90638,1,257587
29026,0.00191,172.31.36.0-255,66,90704,1,257587
29027,0.001917,74.125.24.0-255,7156,97860,1,257587
29028,0.001919,172.31.36.0-255,66,97926,1,257587
29029,0.001955,74.125.24.0-255,3602,101528,1,257587
29030,0.001957,172.31.36.0-255,66,101594,1,257587
29031,0.00198,74.125.24.0-255,4320,105914,1,257587
29032,0.001983,172.31.36.0-255,66,105980,1,257587
29033,0.002016,172.31.36.0-255,66,106046,1,257587
29034,0.002021,74.125.24.0-255,4320,110366,1,257587
29035,0.002023,172.31.36.0-255,66,110432,1,257587
29036,0.002046,172.31.36.0-255,66,110498,1,257587
29037,0.00205,74.125.24.0-255,3602,114100,1,257587
29038,0.002053,172.31.36.0-255,66,114166,1,257587
29039,0.002096,74.125.24.0-255,1484,115650,1,257587
29040,0.0021,74.125.24.0-255,1484,117134,1,257587
29041,0.002102,172.31.36.0-255,66,117200,1,257587
29042,0.002124,74.125.24.0-255,1484,118684,1,257587
29043,0.00213,74.125.24.0-255,5738,124422,1,257587
29044,0.002135,74.125.24.0-255,4320,128742,1,257587
29045,0.002157,74.125.24.0-255,5738,134480,1,257587
29046,0.002176,74.125.24.0-255,5020,139500,1,257587
29047,0.006614,172.31.36.0-255,66,139566,1,257587
29048,0.008843,74.125.24.0-255,5738,145304,1,257587
29049,0.00885,172.31.36.0-255,66,145370,1,257587
29050,0.011088,74.125.24.0-255,5738,151108,1,257587
29051,0.011094,172.31.36.0-255,66,151174,1,257587
29052,0.013364,74.125.24.0-255,5738,156912,1,257587
29053,0.013372,172.31.36.0-255,66,156978,1,257587
29054,0.015627,74.125.24.0-255,5738,162716,1,257587
29055,0.015635,172.31.36.0-255,66,162782,1,257587
29056,0.017855,74.125.24.0-255,5738,168520,1,257587
29057,0.017864,172.31.36.0-255,66,168586,1,257587
29058,0.020092,74.125.24.0-255,5738,174324,1,257587
29059,0.0201,172.31.36.0-255,66,174390,1,257587
29060,0.02232,74.125.24.0-255,5738,180128,1,257587
29061,0.022326,172.31.36.0-255,66,180194,1,257587
29062,0.024582,74.125.24.0-255,5738,185932,1,257587
29063,0.024588,172.31.36.0-255,66,185998,1,257587
29064,0.026824,74.125.24.0-255,5738,191736,1,257587
29065,0.026832,172.31.36.0-255,66,191802,1,257587
29066,0.02904,74.125.24.0-255,5738,197540,1,257587
29067,0.029048,172.31.36.0-255,66,197606,1,257587
29068,0.031262,74.125.24.0-255,5738,203344,1,257587
29069,0.03127,172.31.36.0-255,66,203410,1,257587
29070,0.033302,172.31.36.0-255,172,203582,1,257587
29071,0.033328,172.31.36.0-255,1113,204695,1,257587
29072,0.033382,172.31.36.0-255,1514,206209,1,257587
29073,0.033384,172.31.36.0-255,1514,207723,1,257587
29074,0.033389,172.31.36.0-255,1514,209237,1,257587
29075,0.033391,172.31.36.0-255,1514,210751,1,257587
29076,0.033408,172.31.36.0-255,1492,212243,1,257587
29077,0.033482,74.125.24.0-255,5738,217981,1,257587
29078,0.033487,172.31.36.0-255,66,218047,1,257587
29079,0.034819,104.244.42.0-255,66,218113,1,257587
29080,0.034879,104.244.42.0-255,66,218179,1,257587
29081,0.034928,104.244.42.0-255,66,218245,1,257587
29082,0.03498,104.244.42.0-255,66,218311,1,257587
29083,0.035721,74.125.24.0-255,5738,224049,1,257587
29084,0.035726,172.31.36.0-255,66,224115,1,257587
29085,0.037942,74.125.24.0-255,5738,229853,1,257587
29086,0.037948,172.31.36.0-255,66,229919,1,257587
29087,0.040186,74.125.24.0-255,5738,235657,1,257587
29088,0.040196,172.31.36.0-255,66,235723,1,257587
29089,0.042411,74.125.24.0-255,4320,240043,1,257587
29090,0.042416,172.31.36.0-255,66,240109,1,257587
29091,0.04245,74.125.24.0-255,1484,241593,1,257587
29092,0.044634,74.125.24.0-255,4320,245913,1,257587
29093,0.044639,172.31.36.0-255,66,245979,1,257587
29094,0.046883,74.125.24.0-255,5738,251717,1,257587
29095,0.046888,172.31.36.0-255,66,251783,1,257587
29096,0.049108,74.125.24.0-255,5738,257521,1,257587
29097,0.049113,172.31.36.0-255,66,257587,1,257587
29098,0.0,74.125.24.0-255,153,153,1,211921
29099,2.9e-05,172.31.36.0-255,66,219,1,211921
29100,3.6e-05,74.125.24.0-255,1484,1703,1,211921
29101,4e-05,172.31.36.0-255,66,1769,1,211921
29102,4.6e-05,74.125.24.0-255,2902,4671,1,211921
29103,5.6e-05,172.31.36.0-255,66,4737,1,211921
29104,6.2e-05,74.125.24.0-255,5738,10475,1,211921
29105,6.5e-05,172.31.36.0-255,66,10541,1,211921
29106,0.000113,74.125.24.0-255,3420,13961,1,211921
29107,0.000116,172.31.36.0-255,66,14027,1,211921
29108,0.000179,74.125.24.0-255,1484,15511,1,211921
29109,0.000183,172.31.36.0-255,66,15577,1,211921
29110,0.000188,74.125.24.0-255,2902,18479,1,211921
29111,0.00019,172.31.36.0-255,66,18545,1,211921
29112,0.000195,74.125.24.0-255,2902,21447,1,211921
29113,0.000203,172.31.36.0-255,66,21513,1,211921
29114,0.000234,74.125.24.0-255,2902,24415,1,211921
29115,0.000237,172.31.36.0-255,66,24481,1,211921
29116,0.000245,74.125.24.0-255,6797,31278,1,211921
29117,0.000248,172.31.36.0-255,66,31344,1,211921
29118,0.000382,74.125.24.0-255,1484,32828,1,211921
29119,0.000386,172.31.36.0-255,66,32894,1,211921
29120,0.000391,74.125.24.0-255,2902,35796,1,211921
29121,0.000394,172.31.36.0-255,66,35862,1,211921
29122,0.000397,74.125.24.0-255,1484,37346,1,211921
29123,0.000398,172.31.36.0-255,66,37412,1,211921
29124,0.000417,74.125.24.0-255,2902,40314,1,211921
29125,0.00042,172.31.36.0-255,66,40380,1,211921
29126,0.000432,74.125.24.0-255,5738,46118,1,211921
29127,0.000435,172.31.36.0-255,66,46184,1,211921
29128,0.000439,74.125.24.0-255,2902,49086,1,211921
29129,0.000443,172.31.36.0-255,66,49152,1,211921
29130,0.000486,172.31.36.0-255,66,49218,1,211921
29131,0.000494,74.125.24.0-255,6797,56015,1,211921
29132,0.000496,172.31.36.0-255,66,56081,1,211921
29133,0.000499,74.125.24.0-255,401,56482,1,211921
29134,0.000531,74.125.24.0-255,110,56592,1,211921
29135,0.000845,172.31.36.0-255,66,56658,1,211921
29136,0.000942,74.125.24.0-255,331,56989,1,211921
29137,0.001382,74.125.24.0-255,1484,58473,1,211921
29138,0.001388,172.31.36.0-255,66,58539,1,211921
29139,0.001395,74.125.24.0-255,2902,61441,1,211921
29140,0.001397,172.31.36.0-255,66,61507,1,211921
29141,0.0014,74.125.24.0-255,1484,62991,1,211921
29142,0.001431,74.125.24.0-255,4320,67311,1,211921
29143,0.001433,172.31.36.0-255,66,67377,1,211921
29144,0.001436,74.125.24.0-255,1484,68861,1,211921
29145,0.001444,172.31.36.0-255,66,68927,1,211921
29146,0.001472,74.125.24.0-255,2902,71829,1,211921
29147,0.001477,172.31.36.0-255,66,71895,1,211921
29148,0.001509,172.31.36.0-255,66,71961,1,211921
29149,0.00175,74.125.24.0-255,1484,73445,1,211921
29150,0.001763,74.125.24.0-255,2902,76347,1,211921
29151,0.001765,172.31.36.0-255,66,76413,1,211921
29152,0.001768,74.125.24.0-255,1484,77897,1,211921
29153,0.001791,74.125.24.0-255,4320,82217,1,211921
29154,0.001792,172.31.36.0-255,66,82283,1,211921
29155,0.001797,74.125.24.0-255,4320,86603,1,211921
29156,0.001798,172.31.36.0-255,66,86669,1,211921
29157,0.001832,172.31.36.0-255,66,86735,1,211921
29158,0.001841,172.31.36.0-255,66,86801,1,211921
29159,0.004185,74.125.24.0-255,5738,92539,1,211921
29160,0.004191,172.31.36.0-255,66,92605,1,211921
29161,0.006495,74.125.24.0-255,5738,98343,1,211921
29162,0.006501,172.31.36.0-255,66,98409,1,211921
29163,0.00886,74.125.24.0-255,5738,104147,1,211921
29164,0.008871,172.31.36.0-255,66,104213,1,211921
29165,0.011197,74.125.24.0-255,5738,109951,1,211921
29166,0.011209,172.31.36.0-255,66,110017,1,211921
29167,0.01356,74.125.24.0-255,5738,115755,1,211921
29168,0.013571,172.31.36.0-255,66,115821,1,211921
29169,0.015918,74.125.24.0-255,5738,121559,1,211921
29170,0.015926,172.31.36.0-255,66,121625,1,211921
29171,0.018233,74.125.24.0-255,5738,127363,1,211921
29172,0.01824,172.31.36.0-255,66,127429,1,211921
29173,0.020593,74.125.24.0-255,5738,133167,1,211921
29174,0.020601,172.31.36.0-255,66,133233,1,211921
29175,0.022958,74.125.24.0-255,5738,138971,1,211921
29176,0.022966,172.31.36.0-255,66,139037,1,211921
29177,0.025363,74.125.24.0-255,5738,144775,1,211921
29178,0.02537,172.31.36.0-255,66,144841,1,211921
29179,0.027124,172.31.36.0-255,182,145023,1,211921
29180,0.027154,172.31.36.0-255,1113,146136,1,211921
29181,0.027224,172.31.36.0-255,1514,147650,1,211921
29182,0.027226,172.31.36.0-255,1514,149164,1,211921
29183,0.027227,172.31.36.0-255,1514,150678,1,211921
29184,0.027232,172.31.36.0-255,1514,152192,1,211921
29185,0.027234,172.31.36.0-255,1491,153683,1,211921
29186,0.027695,74.125.24.0-255,5738,159421,1,211921
29187,0.027702,172.31.36.0-255,66,159487,1,211921
29188,0.028634,104.244.42.0-255,66,159553,1,211921
29189,0.028755,104.244.42.0-255,66,159619,1,211921
29190,0.028771,104.244.42.0-255,66,159685,1,211921
29191,0.030065,74.125.24.0-255,5738,165423,1,211921
29192,0.030072,172.31.36.0-255,66,165489,1,211921
29193,0.032413,74.125.24.0-255,5738,171227,1,211921
29194,0.032423,172.31.36.0-255,66,171293,1,211921
29195,0.034755,74.125.24.0-255,5738,177031,1,211921
29196,0.034761,172.31.36.0-255,66,177097,1,211921
29197,0.037121,74.125.24.0-255,5738,182835,1,211921
29198,0.037128,172.31.36.0-255,66,182901,1,211921
29199,0.039479,74.125.24.0-255,5738,188639,1,211921
29200,0.039485,172.31.36.0-255,66,188705,1,211921
29201,0.041839,74.125.24.0-255,5738,194443,1,211921
29202,0.041848,172.31.36.0-255,66,194509,1,211921
29203,0.044212,74.125.24.0-255,5738,200247,1,211921
29204,0.044218,172.31.36.0-255,66,200313,1,211921
29205,0.046616,74.125.24.0-255,5738,206051,1,211921
29206,0.046623,172.31.36.0-255,66,206117,1,211921
29207,0.048948,74.125.24.0-255,5738,211855,1,211921
29208,0.048955,172.31.36.0-255,66,211921,1,211921
29209,0.0,172.31.36.0-255,174,174,1,240
29210,0.006613,74.125.24.0-255,66,240,1,240
29211,0.0,172.217.194.0-255,147,147,1,247103
29212,1.5e-05,172.31.36.0-255,66,213,1,247103
29213,2.2e-05,172.217.194.0-255,1484,1697,1,247103
29214,2.7e-05,172.31.36.0-255,66,1763,1,247103
29215,3.3e-05,172.217.194.0-255,2902,4665,1,247103
29216,4.5e-05,172.31.36.0-255,66,4731,1,247103
29217,5.3e-05,172.217.194.0-255,7156,11887,1,247103
29218,5.7e-05,172.31.36.0-255,66,11953,1,247103
29219,6.1e-05,172.217.194.0-255,2058,14011,1,247103
29220,6.4e-05,172.31.36.0-255,66,14077,1,247103
29221,8.1e-05,172.217.194.0-255,2902,16979,1,247103
29222,9.1e-05,172.31.36.0-255,66,17045,1,247103
29223,9.9e-05,172.217.194.0-255,7156,24201,1,247103
29224,0.000101,172.31.36.0-255,66,24267,1,247103
29225,0.00013,172.217.194.0-255,6797,31064,1,247103
29226,0.000133,172.31.36.0-255,66,31130,1,247103
29227,0.000247,172.217.194.0-255,1484,32614,1,247103
29228,0.000251,172.31.36.0-255,66,32680,1,247103
29229,0.000257,172.217.194.0-255,2902,35582,1,247103
29230,0.000259,172.31.36.0-255,66,35648,1,247103
29231,0.000291,172.217.194.0-255,1484,37132,1,247103
29232,0.000293,172.31.36.0-255,66,37198,1,247103
29233,0.000298,172.217.194.0-255,2902,40100,1,247103
29234,0.000301,172.31.36.0-255,66,40166,1,247103
29235,0.000307,172.217.194.0-255,5738,45904,1,247103
29236,0.000309,172.31.36.0-255,66,45970,1,247103
29237,0.000341,172.217.194.0-255,2543,48513,1,247103
29238,0.000344,172.31.36.0-255,66,48579,1,247103
29239,0.00037,172.217.194.0-255,2902,51481,1,247103
29240,0.000372,172.31.36.0-255,66,51547,1,247103
29241,0.000403,172.217.194.0-255,4320,55867,1,247103
29242,0.000406,172.31.36.0-255,66,55933,1,247103
29243,0.000418,172.31.36.0-255,66,55999,1,247103
29244,0.000425,172.217.194.0-255,1417,57416,1,247103
29245,0.000508,172.217.194.0-255,386,57802,1,247103
29246,0.000511,172.31.36.0-255,66,57868,1,247103
29247,0.000894,172.217.194.0-255,1484,59352,1,247103
29248,0.0009,172.217.194.0-255,2902,62254,1,247103
29249,0.000904,172.31.36.0-255,66,62320,1,247103
29250,0.000909,172.217.194.0-255,2902,65222,1,247103
29251,0.000911,172.31.36.0-255,66,65288,1,247103
29252,0.000935,172.217.194.0-255,2902,68190,1,247103
29253,0.000937,172.31.36.0-255,66,68256,1,247103
29254,0.000952,172.31.36.0-255,66,68322,1,247103
29255,0.001002,172.31.36.0-255,66,68388,1,247103
29256,0.001191,172.217.194.0-255,1484,69872,1,247103
29257,0.001197,172.217.194.0-255,2902,72774,1,247103
29258,0.0012,172.31.36.0-255,66,72840,1,247103
29259,0.001206,172.217.194.0-255,2902,75742,1,247103
29260,0.001208,172.31.36.0-255,66,75808,1,247103
29261,0.001233,172.217.194.0-255,2902,78710,1,247103
29262,0.001236,172.31.36.0-255,66,78776,1,247103
29263,0.001255,172.31.36.0-255,66,78842,1,247103
29264,0.001258,172.217.194.0-255,1484,80326,1,247103
29265,0.001323,172.31.36.0-255,66,80392,1,247103
29266,0.001869,172.217.194.0-255,1484,81876,1,247103
29267,0.001875,172.217.194.0-255,2902,84778,1,247103
29268,0.001879,172.31.36.0-255,66,84844,1,247103
29269,0.001885,172.217.194.0-255,2902,87746,1,247103
29270,0.001887,172.31.36.0-255,66,87812,1,247103
29271,0.001911,172.217.194.0-255,2902,90714,1,247103
29272,0.001913,172.31.36.0-255,66,90780,1,247103
29273,0.001924,172.31.36.0-255,66,90846,1,247103
29274,0.00198,172.31.36.0-255,66,90912,1,247103
29275,0.001997,172.217.194.0-255,3602,94514,1,247103
29276,0.002,172.31.36.0-255,66,94580,1,247103
29277,0.002028,172.217.194.0-255,1484,96064,1,247103
29278,0.002033,172.217.194.0-255,2902,98966,1,247103
29279,0.002036,172.31.36.0-255,66,99032,1,247103
29280,0.002072,172.217.194.0-255,5738,104770,1,247103
29281,0.002087,172.31.36.0-255,66,104836,1,247103
29282,0.002095,172.31.36.0-255,66,104902,1,247103
29283,0.002099,172.217.194.0-255,1484,106386,1,247103
29284,0.002104,172.217.194.0-255,4320,110706,1,247103
29285,0.002107,172.31.36.0-255,66,110772,1,247103
29286,0.002141,172.217.194.0-255,6438,117210,1,247103
29287,0.002143,172.31.36.0-255,66,117276,1,247103
29288,0.002187,172.31.36.0-255,66,117342,1,247103
29289,0.002198,172.31.36.0-255,66,117408,1,247103
29290,0.00225,172.31.36.0-255,66,117474,1,247103
29291,0.002279,172.217.194.0-255,1484,118958,1,247103
29292,0.002284,172.217.194.0-255,2902,121860,1,247103
29293,0.002287,172.31.36.0-255,66,121926,1,247103
29294,0.00229,172.217.194.0-255,1484,123410,1,247103
29295,0.004577,172.217.194.0-255,4320,127730,1,247103
29296,0.004584,172.31.36.0-255,66,127796,1,247103
29297,0.006839,172.217.194.0-255,5738,133534,1,247103
29298,0.006843,172.31.36.0-255,66,133600,1,247103
29299,0.009103,172.217.194.0-255,5738,139338,1,247103
29300,0.009111,172.31.36.0-255,66,139404,1,247103
29301,0.011387,172.217.194.0-255,5738,145142,1,247103
29302,0.011395,172.31.36.0-255,66,145208,1,247103
29303,0.013674,172.217.194.0-255,5738,150946,1,247103
29304,0.013681,172.31.36.0-255,66,151012,1,247103
29305,0.015969,172.217.194.0-255,5738,156750,1,247103
29306,0.015977,172.31.36.0-255,66,156816,1,247103
29307,0.018286,172.217.194.0-255,5738,162554,1,247103
29308,0.018296,172.31.36.0-255,66,162620,1,247103
29309,0.020561,172.217.194.0-255,5738,168358,1,247103
29310,0.02057,172.31.36.0-255,66,168424,1,247103
29311,0.022849,172.217.194.0-255,5738,174162,1,247103
29312,0.022856,172.31.36.0-255,66,174228,1,247103
29313,0.025131,172.217.194.0-255,5738,179966,1,247103
29314,0.025141,172.31.36.0-255,66,180032,1,247103
29315,0.027442,172.217.194.0-255,5738,185770,1,247103
29316,0.027451,172.31.36.0-255,66,185836,1,247103
29317,0.029769,172.217.194.0-255,5738,191574,1,247103
29318,0.029778,172.31.36.0-255,66,191640,1,247103
29319,0.032046,172.217.194.0-255,5738,197378,1,247103
29320,0.032053,172.31.36.0-255,66,197444,1,247103
29321,0.034324,172.217.194.0-255,5738,203182,1,247103
29322,0.034332,172.31.36.0-255,66,203248,1,247103
29323,0.036602,172.217.194.0-255,5738,208986,1,247103
29324,0.036608,172.31.36.0-255,66,209052,1,247103
29325,0.036861,172.31.36.0-255,172,209224,1,247103
29326,0.036894,172.31.36.0-255,1115,210339,1,247103
29327,0.036967,172.31.36.0-255,1514,211853,1,247103
29328,0.036969,172.31.36.0-255,1514,213367,1,247103
29329,0.036974,172.31.36.0-255,1514,214881,1,247103
29330,0.036975,172.31.36.0-255,1514,216395,1,247103
29331,0.036994,172.31.36.0-255,1490,217885,1,247103
29332,0.038407,104.244.42.0-255,66,217951,1,247103
29333,0.038416,104.244.42.0-255,66,218017,1,247103
29334,0.038511,104.244.42.0-255,66,218083,1,247103
29335,0.038906,172.217.194.0-255,5738,223821,1,247103
29336,0.038912,172.31.36.0-255,66,223887,1,247103
29337,0.041211,172.217.194.0-255,5738,229625,1,247103
29338,0.041215,172.31.36.0-255,66,229691,1,247103
29339,0.043497,172.217.194.0-255,5738,235429,1,247103
29340,0.043504,172.31.36.0-255,66,235495,1,247103
29341,0.045778,172.217.194.0-255,5738,241233,1,247103
29342,0.045785,172.31.36.0-255,66,241299,1,247103
29343,0.048044,172.217.194.0-255,5738,247037,1,247103
29344,0.048049,172.31.36.0-255,66,247103,1,247103
29345,0.0,172.217.194.0-255,153,153,1,219395
29346,2.9e-05,172.31.36.0-255,66,219,1,219395
29347,3.5e-05,172.217.194.0-255,1484,1703,1,219395
29348,3.9e-05,172.31.36.0-255,66,1769,1,219395
29349,4.4e-05,172.217.194.0-255,2902,4671,1,219395
29350,4.7e-05,172.31.36.0-255,66,4737,1,219395
29351,5.4e-05,172.217.194.0-255,7156,11893,1,219395
29352,5.6e-05,172.31.36.0-255,66,11959,1,219395
29353,6.8e-05,172.31.36.0-255,66,12025,1,219395
29354,0.000101,172.217.194.0-255,2902,14927,1,219395
29355,0.000103,172.31.36.0-255,66,14993,1,219395
29356,0.00013,172.31.36.0-255,66,15059,1,219395
29357,0.000143,172.31.36.0-255,66,15125,1,219395
29358,0.000149,172.217.194.0-255,5379,20504,1,219395
29359,0.000151,172.31.36.0-255,66,20570,1,219395
29360,0.000171,172.217.194.0-255,5738,26308,1,219395
29361,0.000174,172.31.36.0-255,66,26374,1,219395
29362,0.000206,172.217.194.0-255,5738,32112,1,219395
29363,0.000209,172.31.36.0-255,66,32178,1,219395
29364,0.000226,172.217.194.0-255,5379,37557,1,219395
29365,0.000228,172.31.36.0-255,66,37623,1,219395
29366,0.000511,172.217.194.0-255,646,38269,1,219395
29367,0.000515,172.31.36.0-255,66,38335,1,219395
29368,0.000998,172.217.194.0-255,1484,39819,1,219395
29369,0.001004,172.31.36.0-255,66,39885,1,219395
29370,0.001014,172.217.194.0-255,2902,42787,1,219395
29371,0.001016,172.31.36.0-255,66,42853,1,219395
29372,0.001023,172.217.194.0-255,5738,48591,1,219395
29373,0.001025,172.31.36.0-255,66,48657,1,219395
29374,0.001056,172.31.36.0-255,66,48723,1,219395
29375,0.001081,172.217.194.0-255,4320,53043,1,219395
29376,0.001085,172.31.36.0-255,66,53109,1,219395
29377,0.001097,172.31.36.0-255,66,53175,1,219395
29378,0.001739,172.217.194.0-255,1484,54659,1,219395
29379,0.001747,172.217.194.0-255,2902,57561,1,219395
29380,0.001751,172.31.36.0-255,66,57627,1,219395
29381,0.001758,172.217.194.0-255,5738,63365,1,219395
29382,0.00176,172.31.36.0-255,66,63431,1,219395
29383,0.001765,172.217.194.0-255,4320,67751,1,219395
29384,0.001767,172.31.36.0-255,66,67817,1,219395
29385,0.001799,172.31.36.0-255,66,67883,1,219395
29386,0.001809,172.31.36.0-255,66,67949,1,219395
29387,0.001812,172.217.194.0-255,766,68715,1,219395
29388,0.001884,172.217.194.0-255,1484,70199,1,219395
29389,0.001886,172.31.36.0-255,66,70265,1,219395
29390,0.001898,172.217.194.0-255,2902,73167,1,219395
29391,0.0019,172.31.36.0-255,66,73233,1,219395
29392,0.001906,172.217.194.0-255,5738,78971,1,219395
29393,0.001908,172.31.36.0-255,66,79037,1,219395
29394,0.001925,172.217.194.0-255,2902,81939,1,219395
29395,0.001928,172.31.36.0-255,66,82005,1,219395
29396,0.001951,172.31.36.0-255,66,82071,1,219395
29397,0.001962,172.31.36.0-255,66,82137,1,219395
29398,0.002084,172.217.194.0-255,1484,83621,1,219395
29399,0.002088,172.217.194.0-255,2902,86523,1,219395
29400,0.00209,172.31.36.0-255,66,86589,1,219395
29401,0.002111,172.217.194.0-255,5738,92327,1,219395
29402,0.002113,172.31.36.0-255,66,92393,1,219395
29403,0.002118,172.217.194.0-255,4320,96713,1,219395
29404,0.00212,172.31.36.0-255,66,96779,1,219395
29405,0.00214,172.31.36.0-255,66,96845,1,219395
29406,0.002149,172.31.36.0-255,66,96911,1,219395
29407,0.002164,172.217.194.0-255,2184,99095,1,219395
29408,0.002166,172.31.36.0-255,66,99161,1,219395
29409,0.002214,172.31.36.0-255,66,99227,1,219395
29410,0.002251,172.31.36.0-255,66,99293,1,219395
29411,0.002253,172.217.194.0-255,1484,100777,1,219395
29412,0.00226,172.217.194.0-255,6438,107215,1,219395
29413,0.002262,172.31.36.0-255,66,107281,1,219395
29414,0.002268,172.217.194.0-255,5738,113019,1,219395
29415,0.002271,172.31.36.0-255,66,113085,1,219395
29416,0.002299,172.217.194.0-255,1484,114569,1,219395
29417,0.002319,172.31.36.0-255,66,114635,1,219395
29418,0.002331,172.31.36.0-255,66,114701,1,219395
29419,0.002405,172.217.194.0-255,4320,119021,1,219395
29420,0.00246,172.217.194.0-255,1484,120505,1,219395
29421,0.002476,172.217.194.0-255,2902,123407,1,219395
29422,0.002482,172.217.194.0-255,4320,127727,1,219395
29423,0.002494,172.217.194.0-255,1484,129211,1,219395
29424,0.002498,172.217.194.0-255,2902,132113,1,219395
29425,0.002527,172.217.194.0-255,4320,136433,1,219395
29426,0.002552,172.217.194.0-255,2902,139335,1,219395
29427,0.002568,172.217.194.0-255,5020,144355,1,219395
29428,0.002593,172.217.194.0-255,2902,147257,1,219395
29429,0.002618,172.217.194.0-255,5738,152995,1,219395
29430,0.005321,172.31.36.0-255,66,153061,1,219395
29431,0.007906,172.217.194.0-255,5738,158799,1,219395
29432,0.007912,172.31.36.0-255,66,158865,1,219395
29433,0.010514,172.217.194.0-255,5738,164603,1,219395
29434,0.010525,172.31.36.0-255,66,164669,1,219395
29435,0.013134,172.217.194.0-255,5738,170407,1,219395
29436,0.013147,172.31.36.0-255,66,170473,1,219395
29437,0.015723,172.217.194.0-255,5738,176211,1,219395
29438,0.015734,172.31.36.0-255,66,176277,1,219395
29439,0.018321,172.217.194.0-255,5738,182015,1,219395
29440,0.01833,172.31.36.0-255,66,182081,1,219395
29441,0.020931,172.217.194.0-255,5738,187819,1,219395
29442,0.020943,172.31.36.0-255,66,187885,1,219395
29443,0.023516,172.217.194.0-255,5738,193623,1,219395
29444,0.023522,172.31.36.0-255,66,193689,1,219395
29445,0.026115,172.217.194.0-255,5738,199427,1,219395
29446,0.026123,172.31.36.0-255,66,199493,1,219395
29447,0.028714,172.217.194.0-255,5738,205231,1,219395
29448,0.028722,172.31.36.0-255,66,205297,1,219395
29449,0.031323,172.217.194.0-255,5738,211035,1,219395
29450,0.031333,172.31.36.0-255,66,211101,1,219395
29451,0.033913,172.217.194.0-255,5738,216839,1,219395
29452,0.033926,172.31.36.0-255,66,216905,1,219395
29453,0.036476,172.217.194.0-255,200,217105,1,219395
29454,0.036589,172.31.36.0-255,176,217281,1,219395
29455,0.036615,172.31.36.0-255,1114,218395,1,219395
29456,0.036648,172.31.36.0-255,565,218960,1,219395
29457,0.036736,172.31.36.0-255,66,219026,1,219395
29458,0.036759,172.31.36.0-255,105,219131,1,219395
29459,0.038129,104.244.42.0-255,66,219197,1,219395
29460,0.038151,104.244.42.0-255,66,219263,1,219395
29461,0.038155,104.244.42.0-255,66,219329,1,219395
29462,0.039309,172.217.194.0-255,66,219395,1,219395
29463,0.0,74.125.130.0-255,299,299,1,210117
29464,3.3e-05,172.31.36.0-255,66,365,1,210117
29465,4e-05,74.125.130.0-255,1484,1849,1,210117
29466,4.4e-05,172.31.36.0-255,66,1915,1,210117
29467,4.9e-05,74.125.130.0-255,4320,6235,1,210117
29468,5.3e-05,172.31.36.0-255,66,6301,1,210117
29469,6.4e-05,172.31.36.0-255,66,6367,1,210117
29470,6.7e-05,74.125.130.0-255,1484,7851,1,210117
29471,7e-05,172.31.36.0-255,66,7917,1,210117
29472,0.000104,74.125.130.0-255,7156,15073,1,210117
29473,0.000107,172.31.36.0-255,66,15139,1,210117
29474,0.000114,74.125.130.0-255,7156,22295,1,210117
29475,0.000116,172.31.36.0-255,66,22361,1,210117
29476,0.000133,74.125.130.0-255,7156,29517,1,210117
29477,0.000136,172.31.36.0-255,66,29583,1,210117
29478,0.000167,172.31.36.0-255,66,29649,1,210117
29479,0.000183,74.125.130.0-255,2184,31833,1,210117
29480,0.000186,172.31.36.0-255,66,31899,1,210117
29481,0.000542,74.125.130.0-255,1484,33383,1,210117
29482,0.000549,172.31.36.0-255,66,33449,1,210117
29483,0.000555,74.125.130.0-255,2902,36351,1,210117
29484,0.000557,172.31.36.0-255,66,36417,1,210117
29485,0.000562,74.125.130.0-255,2902,39319,1,210117
29486,0.000564,172.31.36.0-255,66,39385,1,210117
29487,0.000582,74.125.130.0-255,1484,40869,1,210117
29488,0.000585,172.31.36.0-255,66,40935,1,210117
29489,0.000593,74.125.130.0-255,7156,48091,1,210117
29490,0.000595,172.31.36.0-255,66,48157,1,210117
29491,0.000617,74.125.130.0-255,2543,50700,1,210117
29492,0.000622,172.31.36.0-255,66,50766,1,210117
29493,0.000626,172.31.36.0-255,66,50832,1,210117
29494,0.000638,172.31.36.0-255,66,50898,1,210117
29495,0.000658,74.125.130.0-255,1484,52382,1,210117
29496,0.00069,172.31.36.0-255,66,52448,1,210117
29497,0.000739,74.125.130.0-255,646,53094,1,210117
29498,0.001082,172.31.36.0-255,66,53160,1,210117
29499,0.001723,74.125.130.0-255,1484,54644,1,210117
29500,0.001733,74.125.130.0-255,2902,57546,1,210117
29501,0.001737,172.31.36.0-255,66,57612,1,210117
29502,0.00176,74.125.130.0-255,5738,63350,1,210117
29503,0.001763,172.31.36.0-255,66,63416,1,210117
29504,0.001767,74.125.130.0-255,1484,64900,1,210117
29505,0.001784,74.125.130.0-255,2902,67802,1,210117
29506,0.001786,172.31.36.0-255,66,67868,1,210117
29507,0.001793,74.125.130.0-255,5738,73606,1,210117
29508,0.001795,172.31.36.0-255,66,73672,1,210117
29509,0.001807,74.125.130.0-255,1484,75156,1,210117
29510,0.001827,172.31.36.0-255,66,75222,1,210117
29511,0.001846,74.125.130.0-255,2902,78124,1,210117
29512,0.00185,172.31.36.0-255,66,78190,1,210117
29513,0.001853,74.125.130.0-255,766,78956,1,210117
29514,0.004047,74.125.130.0-255,1484,80440,1,210117
29515,0.004052,172.31.36.0-255,66,80506,1,210117
29516,0.00408,74.125.130.0-255,2902,83408,1,210117
29517,0.004083,172.31.36.0-255,66,83474,1,210117
29518,0.006292,74.125.130.0-255,2902,86376,1,210117
29519,0.006297,172.31.36.0-255,66,86442,1,210117
29520,0.006328,74.125.130.0-255,2902,89344,1,210117
29521,0.006331,172.31.36.0-255,66,89410,1,210117
29522,0.008535,74.125.130.0-255,2902,92312,1,210117
29523,0.008541,172.31.36.0-255,66,92378,1,210117
29524,0.008563,74.125.130.0-255,2902,95280,1,210117
29525,0.008566,172.31.36.0-255,66,95346,1,210117
29526,0.010786,74.125.130.0-255,2902,98248,1,210117
29527,0.010795,172.31.36.0-255,66,98314,1,210117
29528,0.010818,74.125.130.0-255,2902,101216,1,210117
29529,0.01082,172.31.36.0-255,66,101282,1,210117
29530,0.013057,74.125.130.0-255,5738,107020,1,210117
29531,0.013064,172.31.36.0-255,66,107086,1,210117
29532,0.015342,74.125.130.0-255,5738,112824,1,210117
29533,0.01535,172.31.36.0-255,66,112890,1,210117
29534,0.017608,74.125.130.0-255,5738,118628,1,210117
29535,0.017621,172.31.36.0-255,66,118694,1,210117
29536,0.019878,74.125.130.0-255,5738,124432,1,210117
29537,0.019888,172.31.36.0-255,66,124498,1,210117
29538,0.022153,74.125.130.0-255,5738,130236,1,210117
29539,0.022165,172.31.36.0-255,66,130302,1,210117
29540,0.024429,74.125.130.0-255,5738,136040,1,210117
29541,0.024443,172.31.36.0-255,66,136106,1,210117
29542,0.026695,74.125.130.0-255,5738,141844,1,210117
29543,0.026705,172.31.36.0-255,66,141910,1,210117
29544,0.028961,74.125.130.0-255,5738,147648,1,210117
29545,0.028975,172.31.36.0-255,66,147714,1,210117
29546,0.031261,74.125.130.0-255,5738,153452,1,210117
29547,0.031275,172.31.36.0-255,66,153518,1,210117
29548,0.033405,172.31.36.0-255,188,153706,1,210117
29549,0.033435,172.31.36.0-255,958,154664,1,210117
29550,0.033493,172.31.36.0-255,1514,156178,1,210117
29551,0.033495,172.31.36.0-255,1514,157692,1,210117
29552,0.033499,172.31.36.0-255,1514,159206,1,210117
29553,0.0335,172.31.36.0-255,1514,160720,1,210117
29554,0.033523,74.125.130.0-255,5738,166458,1,210117
29555,0.033529,172.31.36.0-255,66,166524,1,210117
29556,0.033558,172.31.36.0-255,1514,168038,1,210117
29557,0.03356,172.31.36.0-255,197,168235,1,210117
29558,0.034948,104.244.42.0-255,66,168301,1,210117
29559,0.035004,104.244.42.0-255,66,168367,1,210117
29560,0.035107,104.244.42.0-255,66,168433,1,210117
29561,0.035113,104.244.42.0-255,66,168499,1,210117
29562,0.035761,74.125.130.0-255,2902,171401,1,210117
29563,0.035766,172.31.36.0-255,66,171467,1,210117
29564,0.035798,74.125.130.0-255,2902,174369,1,210117
29565,0.035801,172.31.36.0-255,66,174435,1,210117
29566,0.038011,74.125.130.0-255,2902,177337,1,210117
29567,0.038016,172.31.36.0-255,66,177403,1,210117
29568,0.038052,74.125.130.0-255,2902,180305,1,210117
29569,0.038055,172.31.36.0-255,66,180371,1,210117
29570,0.040248,74.125.130.0-255,2902,183273,1,210117
29571,0.040267,172.31.36.0-255,66,183339,1,210117
29572,0.040289,74.125.130.0-255,2902,186241,1,210117
29573,0.040293,172.31.36.0-255,66,186307,1,210117
29574,0.042511,74.125.130.0-255,2902,189209,1,210117
29575,0.042517,172.31.36.0-255,66,189275,1,210117
29576,0.042544,74.125.130.0-255,2902,192177,1,210117
29577,0.042547,172.31.36.0-255,66,192243,1,210117
29578,0.044753,74.125.130.0-255,2902,195145,1,210117
29579,0.044759,172.31.36.0-255,66,195211,1,210117
29580,0.044779,74.125.130.0-255,1484,196695,1,210117
29581,0.044796,74.125.130.0-255,1484,198179,1,210117
29582,0.044799,172.31.36.0-255,66,198245,1,210117
29583,0.04699,74.125.130.0-255,2902,201147,1,210117
29584,0.046996,172.31.36.0-255,66,201213,1,210117
29585,0.047027,74.125.130.0-255,2902,204115,1,210117
29586,0.047029,172.31.36.0-255,66,204181,1,210117
29587,0.04924,74.125.130.0-255,2902,207083,1,210117
29588,0.049246,172.31.36.0-255,66,207149,1,210117
29589,0.049281,74.125.130.0-255,2902,210051,1,210117
29590,0.049285,172.31.36.0-255,66,210117,1,210117
29591,0.0,172.31.36.0-255,66,66,1,66
29592,0.0,74.125.24.0-255,153,153,1,219890
29593,2.3e-05,172.31.36.0-255,66,219,1,219890
29594,3e-05,74.125.24.0-255,1484,1703,1,219890
29595,3.4e-05,172.31.36.0-255,66,1769,1,219890
29596,4e-05,74.125.24.0-255,2902,4671,1,219890
29597,4.3e-05,172.31.36.0-255,66,4737,1,219890
29598,4.9e-05,74.125.24.0-255,4320,9057,1,219890
29599,5.2e-05,172.31.36.0-255,66,9123,1,219890
29600,7e-05,74.125.24.0-255,4863,13986,1,219890
29601,7.3e-05,172.31.36.0-255,66,14052,1,219890
29602,0.000138,74.125.24.0-255,1484,15536,1,219890
29603,0.00014,172.31.36.0-255,66,15602,1,219890
29604,0.000146,74.125.24.0-255,2902,18504,1,219890
29605,0.000148,172.31.36.0-255,66,18570,1,219890
29606,0.000181,74.125.24.0-255,5738,24308,1,219890
29607,0.000184,172.31.36.0-255,66,24374,1,219890
29608,0.00019,74.125.24.0-255,6797,31171,1,219890
29609,0.000193,172.31.36.0-255,66,31237,1,219890
29610,0.000211,74.125.24.0-255,5738,36975,1,219890
29611,0.000214,172.31.36.0-255,66,37041,1,219890
29612,0.000247,172.31.36.0-255,66,37107,1,219890
29613,0.000254,74.125.24.0-255,5738,42845,1,219890
29614,0.000257,172.31.36.0-255,66,42911,1,219890
29615,0.000278,74.125.24.0-255,5738,48649,1,219890
29616,0.000282,172.31.36.0-255,66,48715,1,219890
29617,0.000303,172.31.36.0-255,66,48781,1,219890
29618,0.000318,74.125.24.0-255,108,48889,1,219890
29619,0.00032,172.31.36.0-255,66,48955,1,219890
29620,0.000497,74.125.24.0-255,1484,50439,1,219890
29621,0.000501,172.31.36.0-255,66,50505,1,219890
29622,0.000507,74.125.24.0-255,2902,53407,1,219890
29623,0.000509,172.31.36.0-255,66,53473,1,219890
29624,0.00053,74.125.24.0-255,5738,59211,1,219890
29625,0.000533,172.31.36.0-255,66,59277,1,219890
29626,0.00054,74.125.24.0-255,7156,66433,1,219890
29627,0.000543,172.31.36.0-255,66,66499,1,219890
29628,0.000575,172.31.36.0-255,66,66565,1,219890
29629,0.000593,74.125.24.0-255,2902,69467,1,219890
29630,0.000596,172.31.36.0-255,66,69533,1,219890
29631,0.0006,74.125.24.0-255,2184,71717,1,219890
29632,0.000602,172.31.36.0-255,66,71783,1,219890
29633,0.000605,74.125.24.0-255,331,72114,1,219890
29634,0.000921,74.125.24.0-255,1484,73598,1,219890
29635,0.000926,172.31.36.0-255,66,73664,1,219890
29636,0.000931,74.125.24.0-255,2902,76566,1,219890
29637,0.000934,172.31.36.0-255,66,76632,1,219890
29638,0.000968,74.125.24.0-255,2902,79534,1,219890
29639,0.000971,172.31.36.0-255,66,79600,1,219890
29640,0.001001,74.125.24.0-255,2902,82502,1,219890
29641,0.001004,172.31.36.0-255,66,82568,1,219890
29642,0.001019,172.31.36.0-255,66,82634,1,219890
29643,0.001031,172.31.36.0-255,66,82700,1,219890
29644,0.001092,74.125.24.0-255,1484,84184,1,219890
29645,0.001098,74.125.24.0-255,2902,87086,1,219890
29646,0.001101,172.31.36.0-255,66,87152,1,219890
29647,0.001126,74.125.24.0-255,5738,92890,1,219890
29648,0.001128,172.31.36.0-255,66,92956,1,219890
29649,0.001133,74.125.24.0-255,2902,95858,1,219890
29650,0.001135,172.31.36.0-255,66,95924,1,219890
29651,0.001162,172.31.36.0-255,66,95990,1,219890
29652,0.00119,74.125.24.0-255,2902,98892,1,219890
29653,0.001192,172.31.36.0-255,66,98958,1,219890
29654,0.00122,172.31.36.0-255,66,99024,1,219890
29655,0.001236,74.125.24.0-255,5738,104762,1,219890
29656,0.001238,172.31.36.0-255,66,104828,1,219890
29657,0.001257,74.125.24.0-255,5738,110566,1,219890
29658,0.00126,172.31.36.0-255,66,110632,1,219890
29659,0.001333,74.125.24.0-255,1484,112116,1,219890
29660,0.001336,74.125.24.0-255,1484,113600,1,219890
29661,0.001358,74.125.24.0-255,1484,115084,1,219890
29662,0.001364,74.125.24.0-255,5738,120822,1,219890
29663,0.001368,74.125.24.0-255,2902,123724,1,219890
29664,0.001407,74.125.24.0-255,7156,130880,1,219890
29665,0.001422,172.31.36.0-255,66,130946,1,219890
29666,0.001442,74.125.24.0-255,3602,134548,1,219890
29667,0.001469,172.31.36.0-255,66,134614,1,219890
29668,0.001481,74.125.24.0-255,1484,136098,1,219890
29669,0.001503,74.125.24.0-255,2902,139000,1,219890
29670,0.00151,74.125.24.0-255,5738,144738,1,219890
29671,0.001556,74.125.24.0-255,7156,151894,1,219890
29672,0.001571,172.31.36.0-255,66,151960,1,219890
29673,0.001585,74.125.24.0-255,3602,155562,1,219890
29674,0.001605,172.31.36.0-255,66,155628,1,219890
29675,0.001727,74.125.24.0-255,1484,157112,1,219890
29676,0.001753,74.125.24.0-255,2902,160014,1,219890
29677,0.00176,74.125.24.0-255,5738,165752,1,219890
29678,0.001827,172.31.36.0-255,66,165818,1,219890
29679,0.001836,74.125.24.0-255,1484,167302,1,219890
29680,0.001852,172.31.36.0-255,66,167368,1,219890
29681,0.001944,74.125.24.0-255,1484,168852,1,219890
29682,0.001948,74.125.24.0-255,1484,170336,1,219890
29683,0.001961,74.125.24.0-255,1484,171820,1,219890
29684,0.001969,74.125.24.0-255,5738,177558,1,219890
29685,0.001994,172.31.36.0-255,66,177624,1,219890
29686,0.001999,172.31.36.0-255,66,177690,1,219890
29687,0.002019,74.125.24.0-255,4320,182010,1,219890
29688,0.002027,74.125.24.0-255,7156,189166,1,219890
29689,0.002044,172.31.36.0-255,66,189232,1,219890
29690,0.002094,172.31.36.0-255,66,189298,1,219890
29691,0.002105,74.125.24.0-255,5020,194318,1,219890
29692,0.002115,172.31.36.0-255,66,194384,1,219890
29693,0.00215,74.125.24.0-255,5738,200122,1,219890
29694,0.002156,74.125.24.0-255,4320,204442,1,219890
29695,0.002169,74.125.24.0-255,1484,205926,1,219890
29696,0.00218,172.31.36.0-255,66,205992,1,219890
29697,0.002226,74.125.24.0-255,1484,207476,1,219890
29698,0.002234,172.31.36.0-255,66,207542,1,219890
29699,0.002253,172.31.36.0-255,66,207608,1,219890
29700,0.002272,74.125.24.0-255,2842,210450,1,219890
29701,0.002279,172.31.36.0-255,66,210516,1,219890
29702,0.002301,74.125.24.0-255,105,210621,1,219890
29703,0.00519,172.31.36.0-255,66,210687,1,219890
29704,0.005227,172.31.36.0-255,105,210792,1,219890
29705,0.007508,74.125.24.0-255,66,210858,1,219890
29706,0.038298,172.31.36.0-255,172,211030,1,219890
29707,0.038357,172.31.36.0-255,1115,212145,1,219890
29708,0.038433,172.31.36.0-255,1514,213659,1,219890
29709,0.038435,172.31.36.0-255,1514,215173,1,219890
29710,0.038436,172.31.36.0-255,1514,216687,1,219890
29711,0.038437,172.31.36.0-255,1514,218201,1,219890
29712,0.038438,172.31.36.0-255,1491,219692,1,219890
29713,0.039799,104.244.42.0-255,66,219758,1,219890
29714,0.039838,104.244.42.0-255,66,219824,1,219890
29715,0.039975,104.244.42.0-255,66,219890,1,219890
29716,0.0,74.125.200.0-255,153,153,1,280265
29717,2.5e-05,172.31.36.0-255,66,219,1,280265
29718,3.2e-05,74.125.200.0-255,1484,1703,1,280265
29719,3.7e-05,172.31.36.0-255,66,1769,1,280265
29720,5e-05,74.125.200.0-255,2902,4671,1,280265
29721,5.4e-05,172.31.36.0-255,66,4737,1,280265
29722,6e-05,74.125.200.0-255,4320,9057,1,280265
29723,6.3e-05,172.31.36.0-255,66,9123,1,280265
29724,7e-05,74.125.200.0-255,4884,14007,1,280265
29725,7.3e-05,172.31.36.0-255,66,14073,1,280265
29726,0.000103,74.125.200.0-255,7156,21229,1,280265
29727,0.000106,172.31.36.0-255,66,21295,1,280265
29728,0.000141,172.31.36.0-255,66,21361,1,280265
29729,0.000145,74.125.200.0-255,1125,22486,1,280265
29730,0.000147,172.31.36.0-255,66,22552,1,280265
29731,0.000238,74.125.200.0-255,1484,24036,1,280265
29732,0.000241,172.31.36.0-255,66,24102,1,280265
29733,0.000258,74.125.200.0-255,1484,25586,1,280265
29734,0.00026,172.31.36.0-255,66,25652,1,280265
29735,0.000265,74.125.200.0-255,2902,28554,1,280265
29736,0.000267,172.31.36.0-255,66,28620,1,280265
29737,0.000293,74.125.200.0-255,4320,32940,1,280265
29738,0.000297,172.31.36.0-255,66,33006,1,280265
29739,0.000334,74.125.200.0-255,1484,34490,1,280265
29740,0.000336,172.31.36.0-255,66,34556,1,280265
29741,0.00034,74.125.200.0-255,1484,36040,1,280265
29742,0.000342,172.31.36.0-255,66,36106,1,280265
29743,0.00037,172.31.36.0-255,66,36172,1,280265
29744,0.000377,74.125.200.0-255,7156,43328,1,280265
29745,0.00038,172.31.36.0-255,66,43394,1,280265
29746,0.000411,74.125.200.0-255,4316,47710,1,280265
29747,0.000545,74.125.200.0-255,1484,49194,1,280265
29748,0.000562,74.125.200.0-255,1484,50678,1,280265
29749,0.000572,74.125.200.0-255,1484,52162,1,280265
29750,0.000577,74.125.200.0-255,4320,56482,1,280265
29751,0.00059,74.125.200.0-255,1484,57966,1,280265
29752,0.000604,74.125.200.0-255,4320,62286,1,280265
29753,0.00062,74.125.200.0-255,2543,64829,1,280265
29754,0.000624,74.125.200.0-255,2902,67731,1,280265
29755,0.000643,74.125.200.0-255,4320,72051,1,280265
29756,0.000678,74.125.200.0-255,332,72383,1,280265
29757,0.000682,172.31.36.0-255,66,72449,1,280265
29758,0.001388,74.125.200.0-255,1484,73933,1,280265
29759,0.001394,172.31.36.0-255,66,73999,1,280265
29760,0.0014,74.125.200.0-255,2902,76901,1,280265
29761,0.001423,74.125.200.0-255,2902,79803,1,280265
29762,0.00143,172.31.36.0-255,66,79869,1,280265
29763,0.001445,74.125.200.0-255,2902,82771,1,280265
29764,0.001457,74.125.200.0-255,7156,89927,1,280265
29765,0.001461,74.125.200.0-255,2902,92829,1,280265
29766,0.001479,74.125.200.0-255,4320,97149,1,280265
29767,0.001483,74.125.200.0-255,2902,100051,1,280265
29768,0.001489,172.31.36.0-255,66,100117,1,280265
29769,0.0015,74.125.200.0-255,5738,105855,1,280265
29770,0.001503,74.125.200.0-255,766,106621,1,280265
29771,0.001522,172.31.36.0-255,66,106687,1,280265
29772,0.001802,74.125.200.0-255,1484,108171,1,280265
29773,0.001807,74.125.200.0-255,1484,109655,1,280265
29774,0.001811,172.31.36.0-255,66,109721,1,280265
29775,0.001839,74.125.200.0-255,1484,111205,1,280265
29776,0.001846,74.125.200.0-255,5738,116943,1,280265
29777,0.001889,172.31.36.0-255,66,117009,1,280265
29778,0.001897,74.125.200.0-255,7156,124165,1,280265
29779,0.00192,172.31.36.0-255,66,124231,1,280265
29780,0.001929,74.125.200.0-255,2184,126415,1,280265
29781,0.001962,172.31.36.0-255,66,126481,1,280265
29782,0.00202,74.125.200.0-255,1484,127965,1,280265
29783,0.002035,74.125.200.0-255,1484,129449,1,280265
29784,0.002038,172.31.36.0-255,66,129515,1,280265
29785,0.002043,74.125.200.0-255,2902,132417,1,280265
29786,0.002065,172.31.36.0-255,66,132483,1,280265
29787,0.002072,74.125.200.0-255,5738,138221,1,280265
29788,0.002089,74.125.200.0-255,2902,141123,1,280265
29789,0.002094,172.31.36.0-255,66,141189,1,280265
29790,0.002121,74.125.200.0-255,7156,148345,1,280265
29791,0.002129,74.125.200.0-255,7156,155501,1,280265
29792,0.002138,172.31.36.0-255,66,155567,1,280265
29793,0.002148,74.125.200.0-255,4320,159887,1,280265
29794,0.00215,74.125.200.0-255,766,160653,1,280265
29795,0.002161,172.31.36.0-255,66,160719,1,280265
29796,0.004441,74.125.200.0-255,5738,166457,1,280265
29797,0.004449,172.31.36.0-255,66,166523,1,280265
29798,0.006715,74.125.200.0-255,2902,169425,1,280265
29799,0.006734,74.125.200.0-255,2902,172327,1,280265
29800,0.008203,172.31.36.0-255,66,172393,1,280265
29801,0.010495,74.125.200.0-255,5738,178131,1,280265
29802,0.010504,172.31.36.0-255,66,178197,1,280265
29803,0.012787,74.125.200.0-255,5738,183935,1,280265
29804,0.014355,172.31.36.0-255,66,184001,1,280265
29805,0.016663,74.125.200.0-255,5738,189739,1,280265
29806,0.016678,172.31.36.0-255,66,189805,1,280265
29807,0.01898,74.125.200.0-255,5738,195543,1,280265
29808,0.018989,172.31.36.0-255,66,195609,1,280265
29809,0.021272,74.125.200.0-255,5738,201347,1,280265
29810,0.02128,172.31.36.0-255,66,201413,1,280265
29811,0.023573,74.125.200.0-255,5738,207151,1,280265
29812,0.023581,172.31.36.0-255,66,207217,1,280265
29813,0.025882,74.125.200.0-255,5738,212955,1,280265
29814,0.025892,172.31.36.0-255,66,213021,1,280265
29815,0.028175,74.125.200.0-255,5738,218759,1,280265
29816,0.028183,172.31.36.0-255,66,218825,1,280265
29817,0.030459,74.125.200.0-255,5738,224563,1,280265
29818,0.030468,172.31.36.0-255,66,224629,1,280265
29819,0.032765,74.125.200.0-255,5738,230367,1,280265
29820,0.032777,172.31.36.0-255,66,230433,1,280265
29821,0.034997,172.31.36.0-255,172,230605,1,280265
29822,0.035028,172.31.36.0-255,1115,231720,1,280265
29823,0.035062,74.125.200.0-255,5738,237458,1,280265
29824,0.035068,172.31.36.0-255,66,237524,1,280265
29825,0.035196,172.31.36.0-255,1514,239038,1,280265
29826,0.035199,172.31.36.0-255,1514,240552,1,280265
29827,0.0352,172.31.36.0-255,1514,242066,1,280265
29828,0.035201,172.31.36.0-255,1514,243580,1,280265
29829,0.035229,172.31.36.0-255,1489,245069,1,280265
29830,0.036574,104.244.42.0-255,66,245135,1,280265
29831,0.036583,104.244.42.0-255,66,245201,1,280265
29832,0.036807,104.244.42.0-255,66,245267,1,280265
29833,0.037359,74.125.200.0-255,5738,251005,1,280265
29834,0.037367,172.31.36.0-255,66,251071,1,280265
29835,0.037525,104.244.42.0-255,108,251179,1,280265
29836,0.037531,172.31.36.0-255,66,251245,1,280265
29837,0.039676,74.125.200.0-255,5738,256983,1,280265
29838,0.039691,172.31.36.0-255,66,257049,1,280265
29839,0.041995,74.125.200.0-255,5738,262787,1,280265
29840,0.042008,172.31.36.0-255,66,262853,1,280265
29841,0.044356,74.125.200.0-255,5738,268591,1,280265
29842,0.044364,172.31.36.0-255,66,268657,1,280265
29843,0.046671,74.125.200.0-255,5738,274395,1,280265
29844,0.046682,172.31.36.0-255,66,274461,1,280265
29845,0.048967,74.125.200.0-255,5738,280199,1,280265
29846,0.048976,172.31.36.0-255,66,280265,1,280265
29847,0.0,74.125.24.0-255,153,153,1,257203
29848,1.6e-05,172.31.36.0-255,66,219,1,257203
29849,2.2e-05,74.125.24.0-255,1484,1703,1,257203
29850,2.6e-05,172.31.36.0-255,66,1769,1,257203
29851,5.2e-05,74.125.24.0-255,2902,4671,1,257203
29852,5.6e-05,172.31.36.0-255,66,4737,1,257203
29853,6.9e-05,74.125.24.0-255,7156,11893,1,257203
29854,7.2e-05,172.31.36.0-255,66,11959,1,257203
29855,7.7e-05,74.125.24.0-255,2015,13974,1,257203
29856,8.1e-05,172.31.36.0-255,66,14040,1,257203
29857,0.000134,172.31.36.0-255,66,14106,1,257203
29858,0.000141,74.125.24.0-255,5379,19485,1,257203
29859,0.000144,172.31.36.0-255,66,19551,1,257203
29860,0.000341,74.125.24.0-255,1484,21035,1,257203
29861,0.000346,172.31.36.0-255,66,21101,1,257203
29862,0.000353,74.125.24.0-255,2902,24003,1,257203
29863,0.000355,172.31.36.0-255,66,24069,1,257203
29864,0.000391,74.125.24.0-255,5738,29807,1,257203
29865,0.000394,172.31.36.0-255,66,29873,1,257203
29866,0.000432,74.125.24.0-255,7156,37029,1,257203
29867,0.000435,172.31.36.0-255,66,37095,1,257203
29868,0.000457,74.125.24.0-255,2543,39638,1,257203
29869,0.00046,172.31.36.0-255,66,39704,1,257203
29870,0.000468,74.125.24.0-255,7156,46860,1,257203
29871,0.000471,172.31.36.0-255,66,46926,1,257203
29872,0.0005,74.125.24.0-255,2902,49828,1,257203
29873,0.000503,172.31.36.0-255,66,49894,1,257203
29874,0.000508,74.125.24.0-255,4227,54121,1,257203
29875,0.000511,172.31.36.0-255,66,54187,1,257203
29876,0.000931,74.125.24.0-255,130,54317,1,257203
29877,0.000937,172.31.36.0-255,66,54383,1,257203
29878,0.001478,74.125.24.0-255,1484,55867,1,257203
29879,0.001489,74.125.24.0-255,2902,58769,1,257203
29880,0.001493,172.31.36.0-255,66,58835,1,257203
29881,0.001501,74.125.24.0-255,4320,63155,1,257203
29882,0.001525,74.125.24.0-255,1484,64639,1,257203
29883,0.001551,74.125.24.0-255,1484,66123,1,257203
29884,0.0016,74.125.24.0-255,2902,69025,1,257203
29885,0.001617,74.125.24.0-255,2184,71209,1,257203
29886,0.001824,74.125.24.0-255,1484,72693,1,257203
29887,0.001832,74.125.24.0-255,2902,75595,1,257203
29888,0.001858,74.125.24.0-255,5738,81333,1,257203
29889,0.001882,74.125.24.0-255,4320,85653,1,257203
29890,0.001955,74.125.24.0-255,4320,89973,1,257203
29891,0.002002,74.125.24.0-255,5738,95711,1,257203
29892,0.002005,74.125.24.0-255,1484,97195,1,257203
29893,0.002022,74.125.24.0-255,6438,103633,1,257203
29894,0.002074,74.125.24.0-255,1484,105117,1,257203
29895,0.002097,74.125.24.0-255,2902,108019,1,257203
29896,0.002117,74.125.24.0-255,5738,113757,1,257203
29897,0.00214,74.125.24.0-255,4320,118077,1,257203
29898,0.002162,74.125.24.0-255,1484,119561,1,257203
29899,0.002243,74.125.24.0-255,5738,125299,1,257203
29900,0.00226,74.125.24.0-255,3602,128901,1,257203
29901,0.003011,74.125.24.0-255,1484,130385,1,257203
29902,0.003015,74.125.24.0-255,1484,131869,1,257203
29903,0.003033,74.125.24.0-255,1484,133353,1,257203
29904,0.00304,74.125.24.0-255,5738,139091,1,257203
29905,0.003069,74.125.24.0-255,5738,144829,1,257203
29906,0.003099,74.125.24.0-255,7156,151985,1,257203
29907,0.003104,74.125.24.0-255,2902,154887,1,257203
29908,0.003128,74.125.24.0-255,2902,157789,1,257203
29909,0.003145,74.125.24.0-255,2902,160691,1,257203
29910,0.003166,74.125.24.0-255,7156,167847,1,257203
29911,0.003205,74.125.24.0-255,3602,171449,1,257203
29912,0.003261,74.125.24.0-255,1484,172933,1,257203
29913,0.003282,74.125.24.0-255,2902,175835,1,257203
29914,0.003288,74.125.24.0-255,5738,181573,1,257203
29915,0.003301,74.125.24.0-255,1484,183057,1,257203
29916,0.003315,74.125.24.0-255,5738,188795,1,257203
29917,0.003332,74.125.24.0-255,5738,194533,1,257203
29918,0.003339,74.125.24.0-255,7156,201689,1,257203
29919,0.003367,74.125.24.0-255,3602,205291,1,257203
29920,0.003401,74.125.24.0-255,4320,209611,1,257203
29921,0.003414,74.125.24.0-255,1484,211095,1,257203
29922,0.003433,74.125.24.0-255,7156,218251,1,257203
29923,0.003444,74.125.24.0-255,1484,219735,1,257203
29924,0.003477,74.125.24.0-255,6438,226173,1,257203
29925,0.003524,74.125.24.0-255,5738,231911,1,257203
29926,0.003569,74.125.24.0-255,5738,237649,1,257203
29927,0.00389,172.31.36.0-255,66,237715,1,257203
29928,0.00396,74.125.24.0-255,1484,239199,1,257203
29929,0.003968,74.125.24.0-255,2902,242101,1,257203
29930,0.003991,172.31.36.0-255,66,242167,1,257203
29931,0.00403,74.125.24.0-255,5599,247766,1,257203
29932,0.004042,172.31.36.0-255,66,247832,1,257203
29933,0.004078,74.125.24.0-255,105,247937,1,257203
29934,0.006527,172.31.36.0-255,66,248003,1,257203
29935,0.006568,172.31.36.0-255,105,248108,1,257203
29936,0.00856,74.125.24.0-255,66,248174,1,257203
29937,0.034909,172.31.36.0-255,172,248346,1,257203
29938,0.034947,172.31.36.0-255,1116,249462,1,257203
29939,0.035028,172.31.36.0-255,1514,250976,1,257203
29940,0.03503,172.31.36.0-255,1514,252490,1,257203
29941,0.035031,172.31.36.0-255,1514,254004,1,257203
29942,0.035036,172.31.36.0-255,1514,255518,1,257203
29943,0.035038,172.31.36.0-255,1487,257005,1,257203
29944,0.036461,104.244.42.0-255,66,257071,1,257203
29945,0.036508,104.244.42.0-255,66,257137,1,257203
29946,0.036611,104.244.42.0-255,66,257203,1,257203
29947,0.0,104.244.42.0-255,66,66,1,66
29948,0.0,74.125.68.0-255,153,153,1,264310
29949,2.4e-05,172.31.36.0-255,66,219,1,264310
29950,3.1e-05,74.125.68.0-255,1484,1703,1,264310
29951,3.5e-05,172.31.36.0-255,66,1769,1,264310
29952,3.9e-05,74.125.68.0-255,1484,3253,1,264310
29953,4.9e-05,172.31.36.0-255,66,3319,1,264310
29954,5.6e-05,74.125.68.0-255,2902,6221,1,264310
29955,5.9e-05,172.31.36.0-255,66,6287,1,264310
29956,9.7e-05,74.125.68.0-255,5738,12025,1,264310
29957,0.0001,172.31.36.0-255,66,12091,1,264310
29958,0.000104,74.125.68.0-255,1484,13575,1,264310
29959,0.000106,172.31.36.0-255,66,13641,1,264310
29960,0.000109,74.125.68.0-255,585,14226,1,264310
29961,0.000111,172.31.36.0-255,66,14292,1,264310
29962,0.000301,74.125.68.0-255,1484,15776,1,264310
29963,0.000307,172.31.36.0-255,66,15842,1,264310
29964,0.000311,74.125.68.0-255,1484,17326,1,264310
29965,0.000313,172.31.36.0-255,66,17392,1,264310
29966,0.000353,74.125.68.0-255,2902,20294,1,264310
29967,0.000356,172.31.36.0-255,66,20360,1,264310
29968,0.000415,74.125.68.0-255,2902,23262,1,264310
29969,0.000419,172.31.36.0-255,66,23328,1,264310
29970,0.000445,74.125.68.0-255,2902,26230,1,264310
29971,0.000448,172.31.36.0-255,66,26296,1,264310
29972,0.000487,74.125.68.0-255,2902,29198,1,264310
29973,0.000489,172.31.36.0-255,66,29264,1,264310
29974,0.000521,74.125.68.0-255,3961,33225,1,264310
29975,0.000524,172.31.36.0-255,66,33291,1,264310
29976,0.000531,74.125.68.0-255,7156,40447,1,264310
29977,0.000533,172.31.36.0-255,66,40513,1,264310
29978,0.000543,74.125.68.0-255,2902,43415,1,264310
29979,0.000545,172.31.36.0-255,66,43481,1,264310
29980,0.00055,74.125.68.0-255,4320,47801,1,264310
29981,0.000552,172.31.36.0-255,66,47867,1,264310
29982,0.000585,74.125.68.0-255,5738,53605,1,264310
29983,0.000588,172.31.36.0-255,66,53671,1,264310
29984,0.000594,74.125.68.0-255,4320,57991,1,264310
29985,0.000596,172.31.36.0-255,66,58057,1,264310
29986,0.000603,74.125.68.0-255,5738,63795,1,264310
29987,0.000605,172.31.36.0-255,66,63861,1,264310
29988,0.000629,74.125.68.0-255,1484,65345,1,264310
29989,0.000633,74.125.68.0-255,766,66111,1,264310
29990,0.000635,172.31.36.0-255,66,66177,1,264310
29991,0.000677,74.125.68.0-255,423,66600,1,264310
29992,0.000777,74.125.68.0-255,1484,68084,1,264310
29993,0.000782,172.31.36.0-255,66,68150,1,264310
29994,0.000803,74.125.68.0-255,2902,71052,1,264310
29995,0.000805,172.31.36.0-255,66,71118,1,264310
29996,0.000834,74.125.68.0-255,5738,76856,1,264310
29997,0.000837,172.31.36.0-255,66,76922,1,264310
29998,0.000843,74.125.68.0-255,4320,81242,1,264310
29999,0.000845,172.31.36.0-255,66,81308,1,264310
30000,0.000876,74.125.68.0-255,5738,87046,1,264310
30001,0.00088,172.31.36.0-255,66,87112,1,264310
30002,0.000909,172.31.36.0-255,66,87178,1,264310
30003,0.000948,74.125.68.0-255,5020,92198,1,264310
30004,0.000951,172.31.36.0-255,66,92264,1,264310
30005,0.000976,74.125.68.0-255,351,92615,1,264310
30006,0.001003,74.125.68.0-255,1484,94099,1,264310
30007,0.001007,172.31.36.0-255,66,94165,1,264310
30008,0.001025,74.125.68.0-255,4320,98485,1,264310
30009,0.001028,172.31.36.0-255,66,98551,1,264310
30010,0.001063,74.125.68.0-255,5738,104289,1,264310
30011,0.001067,172.31.36.0-255,66,104355,1,264310
30012,0.001073,74.125.68.0-255,5738,110093,1,264310
30013,0.001075,172.31.36.0-255,66,110159,1,264310
30014,0.001101,74.125.68.0-255,1484,111643,1,264310
30015,0.001108,74.125.68.0-255,5738,117381,1,264310
30016,0.001111,172.31.36.0-255,66,117447,1,264310
30017,0.001119,74.125.68.0-255,7156,124603,1,264310
30018,0.001121,172.31.36.0-255,66,124669,1,264310
30019,0.001155,74.125.68.0-255,2184,126853,1,264310
30020,0.001158,172.31.36.0-255,66,126919,1,264310
30021,0.001374,74.125.68.0-255,1484,128403,1,264310
30022,0.001379,74.125.68.0-255,1484,129887,1,264310
30023,0.001382,172.31.36.0-255,66,129953,1,264310
30024,0.001394,74.125.68.0-255,1484,131437,1,264310
30025,0.001408,74.125.68.0-255,1484,132921,1,264310
30026,0.00141,172.31.36.0-255,66,132987,1,264310
30027,0.001416,74.125.68.0-255,2902,135889,1,264310
30028,0.001418,172.31.36.0-255,66,135955,1,264310
30029,0.001424,74.125.68.0-255,5738,141693,1,264310
30030,0.001426,172.31.36.0-255,66,141759,1,264310
30031,0.001459,172.31.36.0-255,66,141825,1,264310
30032,0.001508,172.31.36.0-255,66,141891,1,264310
30033,0.001511,74.125.68.0-255,766,142657,1,264310
30034,0.002365,172.31.36.0-255,66,142723,1,264310
30035,0.002473,74.125.68.0-255,1484,144207,1,264310
30036,0.002496,74.125.68.0-255,2902,147109,1,264310
30037,0.002499,172.31.36.0-255,66,147175,1,264310
30038,0.002504,74.125.68.0-255,1484,148659,1,264310
30039,0.002509,74.125.68.0-255,2902,151561,1,264310
30040,0.002511,172.31.36.0-255,66,151627,1,264310
30041,0.002533,74.125.68.0-255,1484,153111,1,264310
30042,0.005018,74.125.68.0-255,4320,157431,1,264310
30043,0.005025,172.31.36.0-255,66,157497,1,264310
30044,0.007537,74.125.68.0-255,5738,163235,1,264310
30045,0.007543,172.31.36.0-255,66,163301,1,264310
30046,0.010061,74.125.68.0-255,5738,169039,1,264310
30047,0.010071,172.31.36.0-255,66,169105,1,264310
30048,0.012612,74.125.68.0-255,5738,174843,1,264310
30049,0.012622,172.31.36.0-255,66,174909,1,264310
30050,0.015159,74.125.68.0-255,5738,180647,1,264310
30051,0.015169,172.31.36.0-255,66,180713,1,264310
30052,0.017675,74.125.68.0-255,5738,186451,1,264310
30053,0.017686,172.31.36.0-255,66,186517,1,264310
30054,0.020197,74.125.68.0-255,5738,192255,1,264310
30055,0.020205,172.31.36.0-255,66,192321,1,264310
30056,0.022713,74.125.68.0-255,5738,198059,1,264310
30057,0.02272,172.31.36.0-255,66,198125,1,264310
30058,0.025222,74.125.68.0-255,5738,203863,1,264310
30059,0.02523,172.31.36.0-255,66,203929,1,264310
30060,0.027732,74.125.68.0-255,5738,209667,1,264310
30061,0.027741,172.31.36.0-255,66,209733,1,264310
30062,0.030252,74.125.68.0-255,5738,215471,1,264310
30063,0.03026,172.31.36.0-255,66,215537,1,264310
30064,0.032763,74.125.68.0-255,5738,221275,1,264310
30065,0.03277,172.31.36.0-255,66,221341,1,264310
30066,0.035279,74.125.68.0-255,5738,227079,1,264310
30067,0.035287,172.31.36.0-255,66,227145,1,264310
30068,0.037361,172.31.36.0-255,187,227332,1,264310
30069,0.037392,172.31.36.0-255,982,228314,1,264310
30070,0.037457,172.31.36.0-255,1514,229828,1,264310
30071,0.037459,172.31.36.0-255,1514,231342,1,264310
30072,0.03746,172.31.36.0-255,1514,232856,1,264310
30073,0.037461,172.31.36.0-255,1514,234370,1,264310
30074,0.037488,172.31.36.0-255,482,234852,1,264310
30075,0.037806,74.125.68.0-255,5738,240590,1,264310
30076,0.037813,172.31.36.0-255,66,240656,1,264310
30077,0.038944,104.244.42.0-255,66,240722,1,264310
30078,0.039005,104.244.42.0-255,66,240788,1,264310
30079,0.039048,104.244.42.0-255,66,240854,1,264310
30080,0.039053,104.244.42.0-255,66,240920,1,264310
30081,0.040326,74.125.68.0-255,5738,246658,1,264310
30082,0.040335,172.31.36.0-255,66,246724,1,264310
30083,0.040478,104.244.42.0-255,108,246832,1,264310
30084,0.040484,172.31.36.0-255,66,246898,1,264310
30085,0.042846,74.125.68.0-255,5738,252636,1,264310
30086,0.04285,172.31.36.0-255,66,252702,1,264310
30087,0.045426,74.125.68.0-255,5738,258440,1,264310
30088,0.045432,172.31.36.0-255,66,258506,1,264310
30089,0.047941,74.125.68.0-255,5738,264244,1,264310
30090,0.047946,172.31.36.0-255,66,264310,1,264310
30091,0.0,172.253.118.0-255,150,150,1,291502
30092,1.6e-05,172.31.36.0-255,66,216,1,291502
30093,3.6e-05,172.253.118.0-255,1484,1700,1,291502
30094,4e-05,172.31.36.0-255,66,1766,1,291502
30095,5.5e-05,172.253.118.0-255,2902,4668,1,291502
30096,5.9e-05,172.31.36.0-255,66,4734,1,291502
30097,7.7e-05,172.253.118.0-255,5738,10472,1,291502
30098,8e-05,172.31.36.0-255,66,10538,1,291502
30099,0.000103,172.253.118.0-255,1484,12022,1,291502
30100,0.000106,172.31.36.0-255,66,12088,1,291502
30101,0.000111,172.253.118.0-255,2104,14192,1,291502
30102,0.000113,172.31.36.0-255,66,14258,1,291502
30103,0.000302,172.253.118.0-255,1484,15742,1,291502
30104,0.000309,172.31.36.0-255,66,15808,1,291502
30105,0.000315,172.253.118.0-255,2902,18710,1,291502
30106,0.000318,172.31.36.0-255,66,18776,1,291502
30107,0.000325,172.253.118.0-255,5738,24514,1,291502
30108,0.000327,172.31.36.0-255,66,24580,1,291502
30109,0.000354,172.253.118.0-255,4320,28900,1,291502
30110,0.000357,172.31.36.0-255,66,28966,1,291502
30111,0.000399,172.31.36.0-255,66,29032,1,291502
30112,0.000424,172.253.118.0-255,3961,32993,1,291502
30113,0.000429,172.31.36.0-255,66,33059,1,291502
30114,0.000439,172.31.36.0-255,66,33125,1,291502
30115,0.000488,172.31.36.0-255,66,33191,1,291502
30116,0.000491,172.253.118.0-255,427,33618,1,291502
30117,0.000493,172.31.36.0-255,66,33684,1,291502
30118,0.000598,172.253.118.0-255,1484,35168,1,291502
30119,0.000603,172.31.36.0-255,66,35234,1,291502
30120,0.000608,172.253.118.0-255,2902,38136,1,291502
30121,0.000611,172.31.36.0-255,66,38202,1,291502
30122,0.000616,172.253.118.0-255,5738,43940,1,291502
30123,0.000619,172.31.36.0-255,66,44006,1,291502
30124,0.000653,172.31.36.0-255,66,44072,1,291502
30125,0.000679,172.253.118.0-255,2902,46974,1,291502
30126,0.000683,172.31.36.0-255,66,47040,1,291502
30127,0.000693,172.31.36.0-255,66,47106,1,291502
30128,0.000697,172.253.118.0-255,2184,49290,1,291502
30129,0.000701,172.31.36.0-255,66,49356,1,291502
30130,0.000793,172.253.118.0-255,1484,50840,1,291502
30131,0.0008,172.253.118.0-255,2902,53742,1,291502
30132,0.000803,172.31.36.0-255,66,53808,1,291502
30133,0.000807,172.253.118.0-255,1484,55292,1,291502
30134,0.000823,172.253.118.0-255,4320,59612,1,291502
30135,0.000826,172.31.36.0-255,66,59678,1,291502
30136,0.000829,172.253.118.0-255,1484,61162,1,291502
30137,0.000852,172.31.36.0-255,66,61228,1,291502
30138,0.00086,172.253.118.0-255,7156,68384,1,291502
30139,0.000863,172.31.36.0-255,66,68450,1,291502
30140,0.000879,172.253.118.0-255,2902,71352,1,291502
30141,0.000881,172.31.36.0-255,66,71418,1,291502
30142,0.000884,172.253.118.0-255,766,72184,1,291502
30143,0.000913,172.253.118.0-255,1484,73668,1,291502
30144,0.000916,172.31.36.0-255,66,73734,1,291502
30145,0.000938,172.253.118.0-255,4320,78054,1,291502
30146,0.000941,172.31.36.0-255,66,78120,1,291502
30147,0.000944,172.253.118.0-255,1484,79604,1,291502
30148,0.00097,172.31.36.0-255,66,79670,1,291502
30149,0.000975,172.253.118.0-255,4320,83990,1,291502
30150,0.000977,172.31.36.0-255,66,84056,1,291502
30151,0.001019,172.253.118.0-255,7156,91212,1,291502
30152,0.001023,172.31.36.0-255,66,91278,1,291502
30153,0.001038,172.31.36.0-255,66,91344,1,291502
30154,0.001053,172.31.36.0-255,66,91410,1,291502
30155,0.001099,172.253.118.0-255,4320,95730,1,291502
30156,0.001102,172.31.36.0-255,66,95796,1,291502
30157,0.00113,172.31.36.0-255,66,95862,1,291502
30158,0.001133,172.253.118.0-255,1484,97346,1,291502
30159,0.001137,172.253.118.0-255,2902,100248,1,291502
30160,0.00114,172.31.36.0-255,66,100314,1,291502
30161,0.001146,172.253.118.0-255,5738,106052,1,291502
30162,0.001148,172.31.36.0-255,66,106118,1,291502
30163,0.001154,172.253.118.0-255,4320,110438,1,291502
30164,0.001156,172.31.36.0-255,66,110504,1,291502
30165,0.001189,172.31.36.0-255,66,110570,1,291502
30166,0.001196,172.253.118.0-255,7156,117726,1,291502
30167,0.001199,172.31.36.0-255,66,117792,1,291502
30168,0.001219,172.253.118.0-255,3602,121394,1,291502
30169,0.001222,172.31.36.0-255,66,121460,1,291502
30170,0.001774,172.253.118.0-255,1484,122944,1,291502
30171,0.00178,172.253.118.0-255,2902,125846,1,291502
30172,0.001784,172.31.36.0-255,66,125912,1,291502
30173,0.00179,172.253.118.0-255,5738,131650,1,291502
30174,0.001793,172.31.36.0-255,66,131716,1,291502
30175,0.001808,172.253.118.0-255,1484,133200,1,291502
30176,0.001838,172.31.36.0-255,66,133266,1,291502
30177,0.001856,172.253.118.0-255,1484,134750,1,291502
30178,0.001864,172.253.118.0-255,7156,141906,1,291502
30179,0.001867,172.31.36.0-255,66,141972,1,291502
30180,0.00187,172.253.118.0-255,1484,143456,1,291502
30181,0.001886,172.253.118.0-255,2184,145640,1,291502
30182,0.001889,172.31.36.0-255,66,145706,1,291502
30183,0.001994,172.253.118.0-255,1484,147190,1,291502
30184,0.002009,172.253.118.0-255,2902,150092,1,291502
30185,0.002012,172.31.36.0-255,66,150158,1,291502
30186,0.002036,172.253.118.0-255,5738,155896,1,291502
30187,0.002039,172.31.36.0-255,66,155962,1,291502
30188,0.004061,172.253.118.0-255,5738,161700,1,291502
30189,0.004068,172.31.36.0-255,66,161766,1,291502
30190,0.006082,172.253.118.0-255,5738,167504,1,291502
30191,0.006086,172.31.36.0-255,66,167570,1,291502
30192,0.008087,172.253.118.0-255,5738,173308,1,291502
30193,0.008091,172.31.36.0-255,66,173374,1,291502
30194,0.010109,172.253.118.0-255,5738,179112,1,291502
30195,0.010116,172.31.36.0-255,66,179178,1,291502
30196,0.012133,172.253.118.0-255,5738,184916,1,291502
30197,0.012141,172.31.36.0-255,66,184982,1,291502
30198,0.01415,172.253.118.0-255,5738,190720,1,291502
30199,0.014159,172.31.36.0-255,66,190786,1,291502
30200,0.016164,172.253.118.0-255,5738,196524,1,291502
30201,0.016172,172.31.36.0-255,66,196590,1,291502
30202,0.018185,172.253.118.0-255,5738,202328,1,291502
30203,0.018192,172.31.36.0-255,66,202394,1,291502
30204,0.020195,172.253.118.0-255,5738,208132,1,291502
30205,0.020202,172.31.36.0-255,66,208198,1,291502
30206,0.022213,172.253.118.0-255,5738,213936,1,291502
30207,0.022222,172.31.36.0-255,66,214002,1,291502
30208,0.024209,172.253.118.0-255,5738,219740,1,291502
30209,0.024216,172.31.36.0-255,66,219806,1,291502
30210,0.026227,172.253.118.0-255,5738,225544,1,291502
30211,0.026236,172.31.36.0-255,66,225610,1,291502
30212,0.028256,172.253.118.0-255,5738,231348,1,291502
30213,0.028267,172.31.36.0-255,66,231414,1,291502
30214,0.030269,172.253.118.0-255,5738,237152,1,291502
30215,0.030278,172.31.36.0-255,66,237218,1,291502
30216,0.032282,172.253.118.0-255,5738,242956,1,291502
30217,0.03229,172.31.36.0-255,66,243022,1,291502
30218,0.034282,172.253.118.0-255,5738,248760,1,291502
30219,0.034289,172.31.36.0-255,66,248826,1,291502
30220,0.036342,172.253.118.0-255,5738,254564,1,291502
30221,0.036353,172.31.36.0-255,66,254630,1,291502
30222,0.038366,172.253.118.0-255,5738,260368,1,291502
30223,0.038372,172.31.36.0-255,66,260434,1,291502
30224,0.0384,172.31.36.0-255,172,260606,1,291502
30225,0.038423,172.31.36.0-255,1114,261720,1,291502
30226,0.038474,172.31.36.0-255,564,262284,1,291502
30227,0.03989,104.244.42.0-255,66,262350,1,291502
30228,0.039921,104.244.42.0-255,66,262416,1,291502
30229,0.03995,104.244.42.0-255,66,262482,1,291502
30230,0.040361,172.253.118.0-255,5738,268220,1,291502
30231,0.040366,172.31.36.0-255,66,268286,1,291502
30232,0.042382,172.253.118.0-255,5738,274024,1,291502
30233,0.042403,172.31.36.0-255,66,274090,1,291502
30234,0.044399,172.253.118.0-255,5738,279828,1,291502
30235,0.044404,172.31.36.0-255,66,279894,1,291502
30236,0.046405,172.253.118.0-255,5738,285632,1,291502
30237,0.046412,172.31.36.0-255,66,285698,1,291502
30238,0.048421,172.253.118.0-255,5738,291436,1,291502
30239,0.048428,172.31.36.0-255,66,291502,1,291502
30240,0.0,74.125.24.0-255,298,298,1,198000
30241,1.6e-05,172.31.36.0-255,66,364,1,198000
30242,2.3e-05,74.125.24.0-255,1484,1848,1,198000
30243,2.8e-05,172.31.36.0-255,66,1914,1,198000
30244,4.2e-05,74.125.24.0-255,4320,6234,1,198000
30245,4.6e-05,172.31.36.0-255,66,6300,1,198000
30246,8.1e-05,74.125.24.0-255,4320,10620,1,198000
30247,8.4e-05,172.31.36.0-255,66,10686,1,198000
30248,0.000111,74.125.24.0-255,3201,13887,1,198000
30249,0.000113,172.31.36.0-255,66,13953,1,198000
30250,0.000118,74.125.24.0-255,2902,16855,1,198000
30251,0.000121,172.31.36.0-255,66,16921,1,198000
30252,0.000138,74.125.24.0-255,2902,19823,1,198000
30253,0.000141,172.31.36.0-255,66,19889,1,198000
30254,0.000173,74.125.24.0-255,1484,21373,1,198000
30255,0.000175,172.31.36.0-255,66,21439,1,198000
30256,0.000187,172.31.36.0-255,66,21505,1,198000
30257,0.00019,74.125.24.0-255,1125,22630,1,198000
30258,0.000193,172.31.36.0-255,66,22696,1,198000
30259,0.000237,172.31.36.0-255,66,22762,1,198000
30260,0.000265,74.125.24.0-255,2902,25664,1,198000
30261,0.000267,172.31.36.0-255,66,25730,1,198000
30262,0.000287,74.125.24.0-255,3961,29691,1,198000
30263,0.000289,172.31.36.0-255,66,29757,1,198000
30264,0.000318,74.125.24.0-255,7156,36913,1,198000
30265,0.000321,172.31.36.0-255,66,36979,1,198000
30266,0.000327,74.125.24.0-255,4320,41299,1,198000
30267,0.000329,172.31.36.0-255,66,41365,1,198000
30268,0.000369,74.125.24.0-255,5712,47077,1,198000
30269,0.000371,172.31.36.0-255,66,47143,1,198000
30270,0.000526,74.125.24.0-255,112,47255,1,198000
30271,0.00069,74.125.24.0-255,1484,48739,1,198000
30272,0.000695,172.31.36.0-255,66,48805,1,198000
30273,0.000702,74.125.24.0-255,2902,51707,1,198000
30274,0.000704,172.31.36.0-255,66,51773,1,198000
30275,0.000716,74.125.24.0-255,5738,57511,1,198000
30276,0.000718,172.31.36.0-255,66,57577,1,198000
30277,0.000724,74.125.24.0-255,4320,61897,1,198000
30278,0.000726,172.31.36.0-255,66,61963,1,198000
30279,0.000767,74.125.24.0-255,3961,65924,1,198000
30280,0.00077,172.31.36.0-255,66,65990,1,198000
30281,0.000785,172.31.36.0-255,66,66056,1,198000
30282,0.001598,74.125.24.0-255,1484,67540,1,198000
30283,0.001606,74.125.24.0-255,2902,70442,1,198000
30284,0.00161,172.31.36.0-255,66,70508,1,198000
30285,0.001618,74.125.24.0-255,5738,76246,1,198000
30286,0.00162,172.31.36.0-255,66,76312,1,198000
30287,0.001624,74.125.24.0-255,1484,77796,1,198000
30288,0.001664,172.31.36.0-255,66,77862,1,198000
30289,0.001671,74.125.24.0-255,5738,83600,1,198000
30290,0.001673,172.31.36.0-255,66,83666,1,198000
30291,0.001718,74.125.24.0-255,5020,88686,1,198000
30292,0.001721,172.31.36.0-255,66,88752,1,198000
30293,0.001879,74.125.24.0-255,1484,90236,1,198000
30294,0.001886,74.125.24.0-255,2902,93138,1,198000
30295,0.00189,172.31.36.0-255,66,93204,1,198000
30296,0.001898,74.125.24.0-255,5738,98942,1,198000
30297,0.0019,172.31.36.0-255,66,99008,1,198000
30298,0.001932,172.31.36.0-255,66,99074,1,198000
30299,0.001936,74.125.24.0-255,1484,100558,1,198000
30300,0.001975,172.31.36.0-255,66,100624,1,198000
30301,0.002119,74.125.24.0-255,1484,102108,1,198000
30302,0.002126,74.125.24.0-255,2902,105010,1,198000
30303,0.002129,172.31.36.0-255,66,105076,1,198000
30304,0.002133,74.125.24.0-255,1484,106560,1,198000
30305,0.002164,74.125.24.0-255,4320,110880,1,198000
30306,0.002167,172.31.36.0-255,66,110946,1,198000
30307,0.002174,74.125.24.0-255,4320,115266,1,198000
30308,0.002176,172.31.36.0-255,66,115332,1,198000
30309,0.002189,172.31.36.0-255,66,115398,1,198000
30310,0.002222,172.31.36.0-255,66,115464,1,198000
30311,0.002256,74.125.24.0-255,1484,116948,1,198000
30312,0.002261,74.125.24.0-255,2902,119850,1,198000
30313,0.002263,172.31.36.0-255,66,119916,1,198000
30314,0.00227,74.125.24.0-255,5738,125654,1,198000
30315,0.002273,172.31.36.0-255,66,125720,1,198000
30316,0.002277,74.125.24.0-255,2902,128622,1,198000
30317,0.00228,172.31.36.0-255,66,128688,1,198000
30318,0.002283,74.125.24.0-255,1484,130172,1,198000
30319,0.002311,74.125.24.0-255,5738,135910,1,198000
30320,0.002314,172.31.36.0-255,66,135976,1,198000
30321,0.002321,74.125.24.0-255,7156,143132,1,198000
30322,0.002324,172.31.36.0-255,66,143198,1,198000
30323,0.002355,74.125.24.0-255,6438,149636,1,198000
30324,0.002358,172.31.36.0-255,66,149702,1,198000
30325,0.003088,74.125.24.0-255,1484,151186,1,198000
30326,0.003097,74.125.24.0-255,2902,154088,1,198000
30327,0.003101,172.31.36.0-255,66,154154,1,198000
30328,0.003106,74.125.24.0-255,1484,155638,1,198000
30329,0.003133,74.125.24.0-255,4320,159958,1,198000
30330,0.003136,172.31.36.0-255,66,160024,1,198000
30331,0.003156,172.31.36.0-255,66,160090,1,198000
30332,0.00318,172.31.36.0-255,66,160156,1,198000
30333,0.003228,74.125.24.0-255,1484,161640,1,198000
30334,0.003252,74.125.24.0-255,2902,164542,1,198000
30335,0.003255,172.31.36.0-255,66,164608,1,198000
30336,0.003261,74.125.24.0-255,5738,170346,1,198000
30337,0.003264,172.31.36.0-255,66,170412,1,198000
30338,0.003272,74.125.24.0-255,7156,177568,1,198000
30339,0.003275,172.31.36.0-255,66,177634,1,198000
30340,0.003292,172.31.36.0-255,66,177700,1,198000
30341,0.00333,172.31.36.0-255,66,177766,1,198000
30342,0.003342,172.31.36.0-255,66,177832,1,198000
30343,0.003414,172.31.36.0-255,66,177898,1,198000
30344,0.003429,172.31.36.0-255,66,177964,1,198000
30345,0.003444,172.31.36.0-255,66,178030,1,198000
30346,0.003474,74.125.24.0-255,5020,183050,1,198000
30347,0.003476,172.31.36.0-255,66,183116,1,198000
30348,0.003482,74.125.24.0-255,2902,186018,1,198000
30349,0.003484,172.31.36.0-255,66,186084,1,198000
30350,0.003521,172.31.36.0-255,66,186150,1,198000
30351,0.003538,172.31.36.0-255,66,186216,1,198000
30352,0.003583,172.31.36.0-255,66,186282,1,198000
30353,0.003591,74.125.24.0-255,2127,188409,1,198000
30354,0.003594,172.31.36.0-255,66,188475,1,198000
30355,0.003621,74.125.24.0-255,105,188580,1,198000
30356,0.007326,172.31.36.0-255,66,188646,1,198000
30357,0.007368,172.31.36.0-255,105,188751,1,198000
30358,0.009594,74.125.24.0-255,66,188817,1,198000
30359,0.041998,172.31.36.0-255,192,189009,1,198000
30360,0.04203,172.31.36.0-255,958,189967,1,198000
30361,0.042104,172.31.36.0-255,1514,191481,1,198000
30362,0.042106,172.31.36.0-255,1514,192995,1,198000
30363,0.042107,172.31.36.0-255,1514,194509,1,198000
30364,0.042114,172.31.36.0-255,1514,196023,1,198000
30365,0.042116,172.31.36.0-255,1514,197537,1,198000
30366,0.042117,172.31.36.0-255,199,197736,1,198000
30367,0.043635,104.244.42.0-255,66,197802,1,198000
30368,0.043645,104.244.42.0-255,66,197868,1,198000
30369,0.043675,104.244.42.0-255,66,197934,1,198000
30370,0.043707,104.244.42.0-255,66,198000,1,198000
30371,0.0,74.125.130.0-255,153,153,1,266576
30372,1.5e-05,172.31.36.0-255,66,219,1,266576
30373,2.2e-05,74.125.130.0-255,1484,1703,1,266576
30374,2.6e-05,172.31.36.0-255,66,1769,1,266576
30375,3.1e-05,74.125.130.0-255,2902,4671,1,266576
30376,3.5e-05,172.31.36.0-255,66,4737,1,266576
30377,4.2e-05,74.125.130.0-255,5738,10475,1,266576
30378,4.5e-05,172.31.36.0-255,66,10541,1,266576
30379,8.8e-05,74.125.130.0-255,6274,16815,1,266576
30380,9.1e-05,172.31.36.0-255,66,16881,1,266576
30381,9.8e-05,74.125.130.0-255,7156,24037,1,266576
30382,0.000101,172.31.36.0-255,66,24103,1,266576
30383,0.000106,74.125.130.0-255,2902,27005,1,266576
30384,0.000108,172.31.36.0-255,66,27071,1,266576
30385,0.000135,74.125.130.0-255,3961,31032,1,266576
30386,0.000137,172.31.36.0-255,66,31098,1,266576
30387,0.000249,74.125.130.0-255,1484,32582,1,266576
30388,0.000253,172.31.36.0-255,66,32648,1,266576
30389,0.000259,74.125.130.0-255,2902,35550,1,266576
30390,0.000261,172.31.36.0-255,66,35616,1,266576
30391,0.000265,74.125.130.0-255,1484,37100,1,266576
30392,0.000267,172.31.36.0-255,66,37166,1,266576
30393,0.00029,74.125.130.0-255,2902,40068,1,266576
30394,0.000293,172.31.36.0-255,66,40134,1,266576
30395,0.000313,74.125.130.0-255,4320,44454,1,266576
30396,0.000316,172.31.36.0-255,66,44520,1,266576
30397,0.000335,74.125.130.0-255,5379,49899,1,266576
30398,0.000338,172.31.36.0-255,66,49965,1,266576
30399,0.000345,74.125.130.0-255,5738,55703,1,266576
30400,0.000347,172.31.36.0-255,66,55769,1,266576
30401,0.000369,74.125.130.0-255,4320,60089,1,266576
30402,0.000372,172.31.36.0-255,66,60155,1,266576
30403,0.000376,74.125.130.0-255,2902,63057,1,266576
30404,0.000378,172.31.36.0-255,66,63123,1,266576
30405,0.000428,74.125.130.0-255,2832,65955,1,266576
30406,0.000431,172.31.36.0-255,66,66021,1,266576
30407,0.000449,74.125.130.0-255,366,66387,1,266576
30408,0.000748,74.125.130.0-255,1484,67871,1,266576
30409,0.000752,172.31.36.0-255,66,67937,1,266576
30410,0.000758,74.125.130.0-255,2902,70839,1,266576
30411,0.00076,172.31.36.0-255,66,70905,1,266576
30412,0.000783,74.125.130.0-255,2902,73807,1,266576
30413,0.000786,172.31.36.0-255,66,73873,1,266576
30414,0.000805,74.125.130.0-255,2902,76775,1,266576
30415,0.000808,172.31.36.0-255,66,76841,1,266576
30416,0.000815,74.125.130.0-255,5738,82579,1,266576
30417,0.000817,172.31.36.0-255,66,82645,1,266576
30418,0.000839,74.125.130.0-255,1484,84129,1,266576
30419,0.000853,74.125.130.0-255,4320,88449,1,266576
30420,0.000856,172.31.36.0-255,66,88515,1,266576
30421,0.000874,74.125.130.0-255,1484,89999,1,266576
30422,0.00088,74.125.130.0-255,4320,94319,1,266576
30423,0.000883,172.31.36.0-255,66,94385,1,266576
30424,0.00089,74.125.130.0-255,5738,100123,1,266576
30425,0.000892,172.31.36.0-255,66,100189,1,266576
30426,0.000895,74.125.130.0-255,766,100955,1,266576
30427,0.001567,74.125.130.0-255,1484,102439,1,266576
30428,0.001574,172.31.36.0-255,66,102505,1,266576
30429,0.001581,74.125.130.0-255,2902,105407,1,266576
30430,0.001584,172.31.36.0-255,66,105473,1,266576
30431,0.001621,74.125.130.0-255,4320,109793,1,266576
30432,0.001624,172.31.36.0-255,66,109859,1,266576
30433,0.001649,74.125.130.0-255,1484,111343,1,266576
30434,0.001663,172.31.36.0-255,66,111409,1,266576
30435,0.001695,172.31.36.0-255,66,111475,1,266576
30436,0.001723,74.125.130.0-255,1484,112959,1,266576
30437,0.001747,172.31.36.0-255,66,113025,1,266576
30438,0.001751,74.125.130.0-255,2902,115927,1,266576
30439,0.001753,172.31.36.0-255,66,115993,1,266576
30440,0.001775,172.31.36.0-255,66,116059,1,266576
30441,0.001785,172.31.36.0-255,66,116125,1,266576
30442,0.001839,74.125.130.0-255,3602,119727,1,266576
30443,0.001842,172.31.36.0-255,66,119793,1,266576
30444,0.001918,74.125.130.0-255,1484,121277,1,266576
30445,0.001934,74.125.130.0-255,2902,124179,1,266576
30446,0.001937,172.31.36.0-255,66,124245,1,266576
30447,0.001942,74.125.130.0-255,2902,127147,1,266576
30448,0.001944,172.31.36.0-255,66,127213,1,266576
30449,0.001958,74.125.130.0-255,2902,130115,1,266576
30450,0.00196,172.31.36.0-255,66,130181,1,266576
30451,0.001977,74.125.130.0-255,4320,134501,1,266576
30452,0.001979,172.31.36.0-255,66,134567,1,266576
30453,0.002002,74.125.130.0-255,5738,140305,1,266576
30454,0.002005,172.31.36.0-255,66,140371,1,266576
30455,0.002018,172.31.36.0-255,66,140437,1,266576
30456,0.002022,74.125.130.0-255,2184,142621,1,266576
30457,0.002024,172.31.36.0-255,66,142687,1,266576
30458,0.004318,74.125.130.0-255,1484,144171,1,266576
30459,0.00434,74.125.130.0-255,4320,148491,1,266576
30460,0.004344,172.31.36.0-255,66,148557,1,266576
30461,0.006657,74.125.130.0-255,5738,154295,1,266576
30462,0.006662,172.31.36.0-255,66,154361,1,266576
30463,0.008992,74.125.130.0-255,5738,160099,1,266576
30464,0.008999,172.31.36.0-255,66,160165,1,266576
30465,0.011318,74.125.130.0-255,5738,165903,1,266576
30466,0.011325,172.31.36.0-255,66,165969,1,266576
30467,0.013662,74.125.130.0-255,5738,171707,1,266576
30468,0.013671,172.31.36.0-255,66,171773,1,266576
30469,0.016013,74.125.130.0-255,5738,177511,1,266576
30470,0.016026,172.31.36.0-255,66,177577,1,266576
30471,0.018355,74.125.130.0-255,5738,183315,1,266576
30472,0.018364,172.31.36.0-255,66,183381,1,266576
30473,0.020681,74.125.130.0-255,5738,189119,1,266576
30474,0.020688,172.31.36.0-255,66,189185,1,266576
30475,0.023016,74.125.130.0-255,5738,194923,1,266576
30476,0.023023,172.31.36.0-255,66,194989,1,266576
30477,0.025353,74.125.130.0-255,5738,200727,1,266576
30478,0.025364,172.31.36.0-255,66,200793,1,266576
30479,0.027724,74.125.130.0-255,5738,206531,1,266576
30480,0.027732,172.31.36.0-255,66,206597,1,266576
30481,0.030052,74.125.130.0-255,5738,212335,1,266576
30482,0.03006,172.31.36.0-255,66,212401,1,266576
30483,0.032376,74.125.130.0-255,4320,216721,1,266576
30484,0.032383,172.31.36.0-255,66,216787,1,266576
30485,0.032403,74.125.130.0-255,1484,218271,1,266576
30486,0.034718,74.125.130.0-255,4320,222591,1,266576
30487,0.034725,172.31.36.0-255,66,222657,1,266576
30488,0.035923,172.31.36.0-255,172,222829,1,266576
30489,0.035955,172.31.36.0-255,1113,223942,1,266576
30490,0.036021,172.31.36.0-255,1514,225456,1,266576
30491,0.036022,172.31.36.0-255,1514,226970,1,266576
30492,0.036028,172.31.36.0-255,1514,228484,1,266576
30493,0.036029,172.31.36.0-255,1514,229998,1,266576
30494,0.036048,172.31.36.0-255,1490,231488,1,266576
30495,0.037048,74.125.130.0-255,5738,237226,1,266576
30496,0.037055,172.31.36.0-255,66,237292,1,266576
30497,0.037473,104.244.42.0-255,66,237358,1,266576
30498,0.037514,104.244.42.0-255,66,237424,1,266576
30499,0.037573,104.244.42.0-255,66,237490,1,266576
30500,0.037625,104.244.42.0-255,66,237556,1,266576
30501,0.039423,74.125.130.0-255,5738,243294,1,266576
30502,0.03943,172.31.36.0-255,66,243360,1,266576
30503,0.041763,74.125.130.0-255,5738,249098,1,266576
30504,0.041769,172.31.36.0-255,66,249164,1,266576
30505,0.044094,74.125.130.0-255,5738,254902,1,266576
30506,0.044099,172.31.36.0-255,66,254968,1,266576
30507,0.046457,74.125.130.0-255,5738,260706,1,266576
30508,0.046464,172.31.36.0-255,66,260772,1,266576
30509,0.048796,74.125.130.0-255,5738,266510,1,266576
30510,0.048803,172.31.36.0-255,66,266576,1,266576
30511,0.0,172.217.24.0-255,220,220,1,277269
30512,2.4e-05,172.31.36.0-255,66,286,1,277269
30513,3.1e-05,172.217.24.0-255,1484,1770,1,277269
30514,3.7e-05,172.31.36.0-255,66,1836,1,277269
30515,5.1e-05,172.217.24.0-255,2902,4738,1,277269
30516,5.5e-05,172.31.36.0-255,66,4804,1,277269
30517,6.3e-05,172.217.24.0-255,5738,10542,1,277269
30518,6.6e-05,172.31.36.0-255,66,10608,1,277269
30519,7.2e-05,172.217.24.0-255,3221,13829,1,277269
30520,7.5e-05,172.31.36.0-255,66,13895,1,277269
30521,0.000119,172.217.24.0-255,1484,15379,1,277269
30522,0.000122,172.31.36.0-255,66,15445,1,277269
30523,0.000128,172.217.24.0-255,2902,18347,1,277269
30524,0.00013,172.31.36.0-255,66,18413,1,277269
30525,0.000143,172.217.24.0-255,5738,24151,1,277269
30526,0.000146,172.31.36.0-255,66,24217,1,277269
30527,0.000178,172.217.24.0-255,6797,31014,1,277269
30528,0.000181,172.31.36.0-255,66,31080,1,277269
30529,0.000189,172.217.24.0-255,7156,38236,1,277269
30530,0.000191,172.31.36.0-255,66,38302,1,277269
30531,0.000241,172.31.36.0-255,66,38368,1,277269
30532,0.000371,172.217.24.0-255,1484,39852,1,277269
30533,0.000376,172.31.36.0-255,66,39918,1,277269
30534,0.000382,172.217.24.0-255,2902,42820,1,277269
30535,0.000384,172.31.36.0-255,66,42886,1,277269
30536,0.00039,172.217.24.0-255,5738,48624,1,277269
30537,0.000397,172.31.36.0-255,66,48690,1,277269
30538,0.000444,172.217.24.0-255,7130,55820,1,277269
30539,0.000447,172.31.36.0-255,66,55886,1,277269
30540,0.000853,172.217.24.0-255,112,55998,1,277269
30541,0.000858,172.31.36.0-255,66,56064,1,277269
30542,0.001017,172.217.24.0-255,1484,57548,1,277269
30543,0.00104,172.217.24.0-255,2902,60450,1,277269
30544,0.001044,172.31.36.0-255,66,60516,1,277269
30545,0.00105,172.217.24.0-255,2902,63418,1,277269
30546,0.001052,172.31.36.0-255,66,63484,1,277269
30547,0.001071,172.217.24.0-255,1484,64968,1,277269
30548,0.001077,172.217.24.0-255,4320,69288,1,277269
30549,0.001083,172.31.36.0-255,66,69354,1,277269
30550,0.00109,172.217.24.0-255,5379,74733,1,277269
30551,0.001126,172.217.24.0-255,1484,76217,1,277269
30552,0.001159,172.217.24.0-255,7156,83373,1,277269
30553,0.001167,172.217.24.0-255,7062,90435,1,277269
30554,0.001563,172.217.24.0-255,1484,91919,1,277269
30555,0.001581,172.217.24.0-255,2902,94821,1,277269
30556,0.001587,172.217.24.0-255,4320,99141,1,277269
30557,0.001589,172.217.24.0-255,1484,100625,1,277269
30558,0.001606,172.217.24.0-255,4320,104945,1,277269
30559,0.001608,172.217.24.0-255,1484,106429,1,277269
30560,0.001626,172.217.24.0-255,5738,112167,1,277269
30561,0.001644,172.217.24.0-255,4320,116487,1,277269
30562,0.001648,172.217.24.0-255,2902,119389,1,277269
30563,0.001666,172.217.24.0-255,5020,124409,1,277269
30564,0.001899,172.217.24.0-255,1484,125893,1,277269
30565,0.001914,172.217.24.0-255,2902,128795,1,277269
30566,0.001921,172.217.24.0-255,4320,133115,1,277269
30567,0.001938,172.217.24.0-255,1484,134599,1,277269
30568,0.001944,172.217.24.0-255,5738,140337,1,277269
30569,0.00609,172.31.36.0-255,66,140403,1,277269
30570,0.008024,172.217.24.0-255,5738,146141,1,277269
30571,0.00803,172.31.36.0-255,66,146207,1,277269
30572,0.009954,172.217.24.0-255,5738,151945,1,277269
30573,0.009959,172.31.36.0-255,66,152011,1,277269
30574,0.011887,172.217.24.0-255,5738,157749,1,277269
30575,0.011894,172.31.36.0-255,66,157815,1,277269
30576,0.013824,172.217.24.0-255,5738,163553,1,277269
30577,0.013832,172.31.36.0-255,66,163619,1,277269
30578,0.015769,172.217.24.0-255,5738,169357,1,277269
30579,0.015777,172.31.36.0-255,66,169423,1,277269
30580,0.017706,172.217.24.0-255,5738,175161,1,277269
30581,0.017713,172.31.36.0-255,66,175227,1,277269
30582,0.019651,172.217.24.0-255,5738,180965,1,277269
30583,0.019659,172.31.36.0-255,66,181031,1,277269
30584,0.021603,172.217.24.0-255,5738,186769,1,277269
30585,0.021611,172.31.36.0-255,66,186835,1,277269
30586,0.023547,172.217.24.0-255,5738,192573,1,277269
30587,0.023557,172.31.36.0-255,66,192639,1,277269
30588,0.025487,172.217.24.0-255,5738,198377,1,277269
30589,0.025495,172.31.36.0-255,66,198443,1,277269
30590,0.027428,172.217.24.0-255,5738,204181,1,277269
30591,0.027435,172.31.36.0-255,66,204247,1,277269
30592,0.029365,172.217.24.0-255,5738,209985,1,277269
30593,0.029373,172.31.36.0-255,66,210051,1,277269
30594,0.03133,172.217.24.0-255,5738,215789,1,277269
30595,0.031337,172.31.36.0-255,66,215855,1,277269
30596,0.033271,172.217.24.0-255,5738,221593,1,277269
30597,0.033278,172.31.36.0-255,66,221659,1,277269
30598,0.035244,172.217.24.0-255,5738,227397,1,277269
30599,0.035252,172.31.36.0-255,66,227463,1,277269
30600,0.037179,172.217.24.0-255,5738,233201,1,277269
30601,0.03719,172.31.36.0-255,66,233267,1,277269
30602,0.03912,172.217.24.0-255,5738,239005,1,277269
30603,0.039127,172.31.36.0-255,66,239071,1,277269
30604,0.041064,172.217.24.0-255,5738,244809,1,277269
30605,0.041072,172.31.36.0-255,66,244875,1,277269
30606,0.043006,172.217.24.0-255,5738,250613,1,277269
30607,0.043014,172.31.36.0-255,66,250679,1,277269
30608,0.044946,172.217.24.0-255,5738,256417,1,277269
30609,0.044954,172.31.36.0-255,66,256483,1,277269
30610,0.045604,172.31.36.0-255,188,256671,1,277269
30611,0.045634,172.31.36.0-255,958,257629,1,277269
30612,0.045704,172.31.36.0-255,1514,259143,1,277269
30613,0.045706,172.31.36.0-255,1514,260657,1,277269
30614,0.045711,172.31.36.0-255,1514,262171,1,277269
30615,0.045712,172.31.36.0-255,1514,263685,1,277269
30616,0.04573,172.31.36.0-255,1514,265199,1,277269
30617,0.045731,172.31.36.0-255,198,265397,1,277269
30618,0.046921,172.217.24.0-255,5738,271135,1,277269
30619,0.046928,172.31.36.0-255,66,271201,1,277269
30620,0.047171,104.244.42.0-255,66,271267,1,277269
30621,0.047179,104.244.42.0-255,66,271333,1,277269
30622,0.047279,104.244.42.0-255,66,271399,1,277269
30623,0.047323,104.244.42.0-255,66,271465,1,277269
30624,0.048864,172.217.24.0-255,5738,277203,1,277269
30625,0.048871,172.31.36.0-255,66,277269,1,277269
30626,0.0,74.125.24.0-255,153,153,1,297528
30627,2.9e-05,172.31.36.0-255,66,219,1,297528
30628,3.6e-05,74.125.24.0-255,1484,1703,1,297528
30629,4e-05,172.31.36.0-255,66,1769,1,297528
30630,4.5e-05,74.125.24.0-255,2902,4671,1,297528
30631,4.7e-05,172.31.36.0-255,66,4737,1,297528
30632,5.4e-05,74.125.24.0-255,7156,11893,1,297528
30633,5.7e-05,172.31.36.0-255,66,11959,1,297528
30634,8.6e-05,74.125.24.0-255,1966,13925,1,297528
30635,8.9e-05,172.31.36.0-255,66,13991,1,297528
30636,0.000118,74.125.24.0-255,2902,16893,1,297528
30637,0.000121,172.31.36.0-255,66,16959,1,297528
30638,0.000125,74.125.24.0-255,1484,18443,1,297528
30639,0.000127,172.31.36.0-255,66,18509,1,297528
30640,0.000147,74.125.24.0-255,5738,24247,1,297528
30641,0.00015,172.31.36.0-255,66,24313,1,297528
30642,0.000209,74.125.24.0-255,4320,28633,1,297528
30643,0.000212,172.31.36.0-255,66,28699,1,297528
30644,0.000228,74.125.24.0-255,2543,31242,1,297528
30645,0.00023,172.31.36.0-255,66,31308,1,297528
30646,0.000322,74.125.24.0-255,1484,32792,1,297528
30647,0.000326,172.31.36.0-255,66,32858,1,297528
30648,0.000333,74.125.24.0-255,2902,35760,1,297528
30649,0.000336,172.31.36.0-255,66,35826,1,297528
30650,0.000339,74.125.24.0-255,1484,37310,1,297528
30651,0.00034,172.31.36.0-255,66,37376,1,297528
30652,0.000371,74.125.24.0-255,5738,43114,1,297528
30653,0.000375,172.31.36.0-255,66,43180,1,297528
30654,0.000393,74.125.24.0-255,4320,47500,1,297528
30655,0.000396,172.31.36.0-255,66,47566,1,297528
30656,0.000415,74.125.24.0-255,1125,48691,1,297528
30657,0.00042,172.31.36.0-255,66,48757,1,297528
30658,0.000438,74.125.24.0-255,1484,50241,1,297528
30659,0.000452,74.125.24.0-255,2902,53143,1,297528
30660,0.000456,172.31.36.0-255,66,53209,1,297528
30661,0.000462,74.125.24.0-255,5738,58947,1,297528
30662,0.000465,172.31.36.0-255,66,59013,1,297528
30663,0.00049,74.125.24.0-255,5738,64751,1,297528
30664,0.000495,172.31.36.0-255,66,64817,1,297528
30665,0.000512,74.125.24.0-255,1471,66288,1,297528
30666,0.000835,172.31.36.0-255,66,66354,1,297528
30667,0.001114,74.125.24.0-255,333,66687,1,297528
30668,0.001147,74.125.24.0-255,1484,68171,1,297528
30669,0.001152,172.31.36.0-255,66,68237,1,297528
30670,0.001174,74.125.24.0-255,4320,72557,1,297528
30671,0.001177,172.31.36.0-255,66,72623,1,297528
30672,0.001195,74.125.24.0-255,4320,76943,1,297528
30673,0.001198,172.31.36.0-255,66,77009,1,297528
30674,0.00122,74.125.24.0-255,5738,82747,1,297528
30675,0.001223,172.31.36.0-255,66,82813,1,297528
30676,0.001227,74.125.24.0-255,1484,84297,1,297528
30677,0.001242,74.125.24.0-255,4320,88617,1,297528
30678,0.001245,172.31.36.0-255,66,88683,1,297528
30679,0.001273,74.125.24.0-255,5738,94421,1,297528
30680,0.001277,172.31.36.0-255,66,94487,1,297528
30681,0.001282,74.125.24.0-255,4320,98807,1,297528
30682,0.001284,172.31.36.0-255,66,98873,1,297528
30683,0.001329,74.125.24.0-255,2184,101057,1,297528
30684,0.001332,172.31.36.0-255,66,101123,1,297528
30685,0.001663,74.125.24.0-255,1484,102607,1,297528
30686,0.001669,74.125.24.0-255,1484,104091,1,297528
30687,0.001676,172.31.36.0-255,66,104157,1,297528
30688,0.001696,74.125.24.0-255,1484,105641,1,297528
30689,0.001702,74.125.24.0-255,5738,111379,1,297528
30690,0.001704,172.31.36.0-255,66,111445,1,297528
30691,0.001708,74.125.24.0-255,2902,114347,1,297528
30692,0.00171,172.31.36.0-255,66,114413,1,297528
30693,0.001739,172.31.36.0-255,66,114479,1,297528
30694,0.001755,74.125.24.0-255,1484,115963,1,297528
30695,0.001767,172.31.36.0-255,66,116029,1,297528
30696,0.00184,74.125.24.0-255,1484,117513,1,297528
30697,0.00185,74.125.24.0-255,2902,120415,1,297528
30698,0.001852,172.31.36.0-255,66,120481,1,297528
30699,0.00187,74.125.24.0-255,2902,123383,1,297528
30700,0.001872,172.31.36.0-255,66,123449,1,297528
30701,0.001884,74.125.24.0-255,2902,126351,1,297528
30702,0.001886,172.31.36.0-255,66,126417,1,297528
30703,0.001889,74.125.24.0-255,1484,127901,1,297528
30704,0.001923,172.31.36.0-255,66,127967,1,297528
30705,0.001928,74.125.24.0-255,4320,132287,1,297528
30706,0.00193,172.31.36.0-255,66,132353,1,297528
30707,0.001941,74.125.24.0-255,1484,133837,1,297528
30708,0.001969,74.125.24.0-255,5020,138857,1,297528
30709,0.001972,172.31.36.0-255,66,138923,1,297528
30710,0.002117,74.125.24.0-255,1484,140407,1,297528
30711,0.00213,74.125.24.0-255,2902,143309,1,297528
30712,0.002132,172.31.36.0-255,66,143375,1,297528
30713,0.002153,74.125.24.0-255,5738,149113,1,297528
30714,0.002155,172.31.36.0-255,66,149179,1,297528
30715,0.002159,74.125.24.0-255,2902,152081,1,297528
30716,0.002161,172.31.36.0-255,66,152147,1,297528
30717,0.002185,74.125.24.0-255,4320,156467,1,297528
30718,0.002187,172.31.36.0-255,66,156533,1,297528
30719,0.002206,74.125.24.0-255,5738,162271,1,297528
30720,0.002209,172.31.36.0-255,66,162337,1,297528
30721,0.002214,74.125.24.0-255,5738,168075,1,297528
30722,0.002217,172.31.36.0-255,66,168141,1,297528
30723,0.002231,74.125.24.0-255,4320,172461,1,297528
30724,0.002233,172.31.36.0-255,66,172527,1,297528
30725,0.002256,74.125.24.0-255,766,173293,1,297528
30726,0.004583,74.125.24.0-255,4320,177613,1,297528
30727,0.004588,172.31.36.0-255,66,177679,1,297528
30728,0.006928,74.125.24.0-255,5738,183417,1,297528
30729,0.006936,172.31.36.0-255,66,183483,1,297528
30730,0.009292,74.125.24.0-255,5738,189221,1,297528
30731,0.009301,172.31.36.0-255,66,189287,1,297528
30732,0.011689,74.125.24.0-255,5738,195025,1,297528
30733,0.011701,172.31.36.0-255,66,195091,1,297528
30734,0.014042,74.125.24.0-255,5738,200829,1,297528
30735,0.014051,172.31.36.0-255,66,200895,1,297528
30736,0.016381,74.125.24.0-255,5738,206633,1,297528
30737,0.01639,172.31.36.0-255,66,206699,1,297528
30738,0.018753,74.125.24.0-255,5738,212437,1,297528
30739,0.018762,172.31.36.0-255,66,212503,1,297528
30740,0.021122,74.125.24.0-255,5738,218241,1,297528
30741,0.021136,172.31.36.0-255,66,218307,1,297528
30742,0.023583,74.125.24.0-255,5738,224045,1,297528
30743,0.023601,172.31.36.0-255,66,224111,1,297528
30744,0.025958,74.125.24.0-255,5738,229849,1,297528
30745,0.02597,172.31.36.0-255,66,229915,1,297528
30746,0.028317,74.125.24.0-255,5738,235653,1,297528
30747,0.028325,172.31.36.0-255,66,235719,1,297528
30748,0.030672,74.125.24.0-255,5738,241457,1,297528
30749,0.03068,172.31.36.0-255,66,241523,1,297528
30750,0.033022,74.125.24.0-255,5738,247261,1,297528
30751,0.033028,172.31.36.0-255,66,247327,1,297528
30752,0.03539,74.125.24.0-255,5738,253065,1,297528
30753,0.035399,172.31.36.0-255,66,253131,1,297528
30754,0.037756,74.125.24.0-255,5738,258869,1,297528
30755,0.037763,172.31.36.0-255,66,258935,1,297528
30756,0.038381,172.31.36.0-255,188,259123,1,297528
30757,0.038409,172.31.36.0-255,958,260081,1,297528
30758,0.038879,172.31.36.0-255,1514,261595,1,297528
30759,0.038882,172.31.36.0-255,1514,263109,1,297528
30760,0.038888,172.31.36.0-255,1514,264623,1,297528
30761,0.038889,172.31.36.0-255,1514,266137,1,297528
30762,0.038918,172.31.36.0-255,1514,267651,1,297528
30763,0.03892,172.31.36.0-255,197,267848,1,297528
30764,0.039904,104.244.42.0-255,66,267914,1,297528
30765,0.039943,104.244.42.0-255,66,267980,1,297528
30766,0.040089,74.125.24.0-255,2902,270882,1,297528
30767,0.040093,172.31.36.0-255,66,270948,1,297528
30768,0.040126,74.125.24.0-255,2902,273850,1,297528
30769,0.040129,172.31.36.0-255,66,273916,1,297528
30770,0.040433,104.244.42.0-255,66,273982,1,297528
30771,0.040474,104.244.42.0-255,66,274048,1,297528
30772,0.042409,74.125.24.0-255,1484,275532,1,297528
30773,0.042436,74.125.24.0-255,1484,277016,1,297528
30774,0.04244,172.31.36.0-255,66,277082,1,297528
30775,0.042473,74.125.24.0-255,2902,279984,1,297528
30776,0.042478,172.31.36.0-255,66,280050,1,297528
30777,0.044799,74.125.24.0-255,5738,285788,1,297528
30778,0.044803,172.31.36.0-255,66,285854,1,297528
30779,0.04718,74.125.24.0-255,1484,287338,1,297528
30780,0.047212,74.125.24.0-255,4320,291658,1,297528
30781,0.047217,172.31.36.0-255,66,291724,1,297528
30782,0.049563,74.125.24.0-255,5738,297462,1,297528
30783,0.049568,172.31.36.0-255,66,297528,1,297528
30784,0.0,74.125.24.0-255,145,145,1,227827
30785,3.8e-05,172.31.36.0-255,66,211,1,227827
30786,4.5e-05,74.125.24.0-255,1484,1695,1,227827
30787,5.1e-05,172.31.36.0-255,66,1761,1,227827
30788,5.6e-05,74.125.24.0-255,2902,4663,1,227827
30789,6e-05,172.31.36.0-255,66,4729,1,227827
30790,6.7e-05,74.125.24.0-255,7156,11885,1,227827
30791,6.9e-05,172.31.36.0-255,66,11951,1,227827
30792,7.3e-05,74.125.24.0-255,1964,13915,1,227827
30793,7.6e-05,172.31.36.0-255,66,13981,1,227827
30794,0.000317,74.125.24.0-255,1484,15465,1,227827
30795,0.000322,172.31.36.0-255,66,15531,1,227827
30796,0.000328,74.125.24.0-255,2902,18433,1,227827
30797,0.000331,172.31.36.0-255,66,18499,1,227827
30798,0.000339,74.125.24.0-255,5738,24237,1,227827
30799,0.000341,172.31.36.0-255,66,24303,1,227827
30800,0.00037,74.125.24.0-255,4320,28623,1,227827
30801,0.000374,172.31.36.0-255,66,28689,1,227827
30802,0.000391,74.125.24.0-255,2543,31232,1,227827
30803,0.000396,172.31.36.0-255,66,31298,1,227827
30804,0.000515,74.125.24.0-255,1484,32782,1,227827
30805,0.000519,74.125.24.0-255,2902,35684,1,227827
30806,0.000522,74.125.24.0-255,1484,37168,1,227827
30807,0.000523,172.31.36.0-255,66,37234,1,227827
30808,0.000526,172.31.36.0-255,66,37300,1,227827
30809,0.000529,172.31.36.0-255,66,37366,1,227827
30810,0.000539,74.125.24.0-255,2902,40268,1,227827
30811,0.000541,172.31.36.0-255,66,40334,1,227827
30812,0.000576,74.125.24.0-255,5738,46072,1,227827
30813,0.00058,172.31.36.0-255,66,46138,1,227827
30814,0.000598,74.125.24.0-255,2543,48681,1,227827
30815,0.000602,172.31.36.0-255,66,48747,1,227827
30816,0.000982,74.125.24.0-255,1484,50231,1,227827
30817,0.000994,74.125.24.0-255,2902,53133,1,227827
30818,0.000998,172.31.36.0-255,66,53199,1,227827
30819,0.001005,74.125.24.0-255,5738,58937,1,227827
30820,0.001038,74.125.24.0-255,6797,65734,1,227827
30821,0.001253,74.125.24.0-255,1484,67218,1,227827
30822,0.001271,74.125.24.0-255,2902,70120,1,227827
30823,0.001292,74.125.24.0-255,5738,75858,1,227827
30824,0.001295,74.125.24.0-255,1484,77342,1,227827
30825,0.001325,74.125.24.0-255,1484,78826,1,227827
30826,0.001339,74.125.24.0-255,4542,83368,1,227827
30827,0.002016,74.125.24.0-255,1484,84852,1,227827
30828,0.002023,74.125.24.0-255,2902,87754,1,227827
30829,0.002026,74.125.24.0-255,1484,89238,1,227827
30830,0.00204,74.125.24.0-255,2902,92140,1,227827
30831,0.002042,74.125.24.0-255,1484,93624,1,227827
30832,0.002059,74.125.24.0-255,4320,97944,1,227827
30833,0.002073,74.125.24.0-255,4320,102264,1,227827
30834,0.002084,74.125.24.0-255,2902,105166,1,227827
30835,0.002101,74.125.24.0-255,4320,109486,1,227827
30836,0.00588,172.31.36.0-255,66,109552,1,227827
30837,0.007981,74.125.24.0-255,5738,115290,1,227827
30838,0.007987,172.31.36.0-255,66,115356,1,227827
30839,0.010241,74.125.24.0-255,5738,121094,1,227827
30840,0.014396,172.31.36.0-255,66,121160,1,227827
30841,0.016502,74.125.24.0-255,5738,126898,1,227827
30842,0.016516,172.31.36.0-255,66,126964,1,227827
30843,0.018578,74.125.24.0-255,5738,132702,1,227827
30844,0.018588,172.31.36.0-255,66,132768,1,227827
30845,0.020637,74.125.24.0-255,5738,138506,1,227827
30846,0.020643,172.31.36.0-255,66,138572,1,227827
30847,0.022693,74.125.24.0-255,5738,144310,1,227827
30848,0.022701,172.31.36.0-255,66,144376,1,227827
30849,0.024785,74.125.24.0-255,5738,150114,1,227827
30850,0.024793,172.31.36.0-255,66,150180,1,227827
30851,0.026877,74.125.24.0-255,5738,155918,1,227827
30852,0.026887,172.31.36.0-255,66,155984,1,227827
30853,0.028927,74.125.24.0-255,5738,161722,1,227827
30854,0.028935,172.31.36.0-255,66,161788,1,227827
30855,0.030995,74.125.24.0-255,5738,167526,1,227827
30856,0.031004,172.31.36.0-255,66,167592,1,227827
30857,0.033034,74.125.24.0-255,5738,173330,1,227827
30858,0.033042,172.31.36.0-255,66,173396,1,227827
30859,0.034803,172.31.36.0-255,188,173584,1,227827
30860,0.034831,172.31.36.0-255,958,174542,1,227827
30861,0.034884,172.31.36.0-255,1514,176056,1,227827
30862,0.034886,172.31.36.0-255,1514,177570,1,227827
30863,0.034887,172.31.36.0-255,1514,179084,1,227827
30864,0.034888,172.31.36.0-255,1514,180598,1,227827
30865,0.034919,172.31.36.0-255,1514,182112,1,227827
30866,0.034926,172.31.36.0-255,197,182309,1,227827
30867,0.035094,74.125.24.0-255,4320,186629,1,227827
30868,0.0351,172.31.36.0-255,66,186695,1,227827
30869,0.035122,74.125.24.0-255,1484,188179,1,227827
30870,0.036338,104.244.42.0-255,66,188245,1,227827
30871,0.036399,104.244.42.0-255,66,188311,1,227827
30872,0.036439,104.244.42.0-255,66,188377,1,227827
30873,0.036486,104.244.42.0-255,66,188443,1,227827
30874,0.037157,74.125.24.0-255,4320,192763,1,227827
30875,0.037165,172.31.36.0-255,66,192829,1,227827
30876,0.037203,104.244.42.0-255,108,192937,1,227827
30877,0.037207,172.31.36.0-255,66,193003,1,227827
30878,0.039218,74.125.24.0-255,5738,198741,1,227827
30879,0.039297,172.31.36.0-255,66,198807,1,227827
30880,0.041376,74.125.24.0-255,5738,204545,1,227827
30881,0.041389,172.31.36.0-255,66,204611,1,227827
30882,0.043428,74.125.24.0-255,5738,210349,1,227827
30883,0.043435,172.31.36.0-255,66,210415,1,227827
30884,0.045491,74.125.24.0-255,5738,216153,1,227827
30885,0.045498,172.31.36.0-255,66,216219,1,227827
30886,0.047556,74.125.24.0-255,5738,221957,1,227827
30887,0.047562,172.31.36.0-255,66,222023,1,227827
30888,0.049609,74.125.24.0-255,5738,227761,1,227827
30889,0.049615,172.31.36.0-255,66,227827,1,227827
30890,0.0,74.125.68.0-255,297,297,1,236842
30891,2.4e-05,172.31.36.0-255,66,363,1,236842
30892,3e-05,74.125.68.0-255,1484,1847,1,236842
30893,3.5e-05,172.31.36.0-255,66,1913,1,236842
30894,4.2e-05,74.125.68.0-255,4320,6233,1,236842
30895,4.6e-05,172.31.36.0-255,66,6299,1,236842
30896,5.2e-05,74.125.68.0-255,5738,12037,1,236842
30897,5.5e-05,172.31.36.0-255,66,12103,1,236842
30898,7.4e-05,74.125.68.0-255,1906,14009,1,236842
30899,7.7e-05,172.31.36.0-255,66,14075,1,236842
30900,8.8e-05,172.31.36.0-255,66,14141,1,236842
30901,9.2e-05,74.125.68.0-255,1484,15625,1,236842
30902,9.4e-05,172.31.36.0-255,66,15691,1,236842
30903,0.000125,74.125.68.0-255,6797,22488,1,236842
30904,0.000127,172.31.36.0-255,66,22554,1,236842
30905,0.000178,74.125.68.0-255,1484,24038,1,236842
30906,0.000181,172.31.36.0-255,66,24104,1,236842
30907,0.000186,74.125.68.0-255,1484,25588,1,236842
30908,0.000188,172.31.36.0-255,66,25654,1,236842
30909,0.000204,74.125.68.0-255,1484,27138,1,236842
30910,0.000207,172.31.36.0-255,66,27204,1,236842
30911,0.000213,74.125.68.0-255,4320,31524,1,236842
30912,0.000215,172.31.36.0-255,66,31590,1,236842
30913,0.000265,172.31.36.0-255,66,31656,1,236842
30914,0.000273,74.125.68.0-255,7156,38812,1,236842
30915,0.000275,172.31.36.0-255,66,38878,1,236842
30916,0.000285,172.31.36.0-255,66,38944,1,236842
30917,0.000288,74.125.68.0-255,1060,40004,1,236842
30918,0.00029,172.31.36.0-255,66,40070,1,236842
30919,0.000457,74.125.68.0-255,128,40198,1,236842
30920,0.000644,74.125.68.0-255,1484,41682,1,236842
30921,0.000649,172.31.36.0-255,66,41748,1,236842
30922,0.000655,74.125.68.0-255,2902,44650,1,236842
30923,0.000657,172.31.36.0-255,66,44716,1,236842
30924,0.000683,74.125.68.0-255,4320,49036,1,236842
30925,0.000688,172.31.36.0-255,66,49102,1,236842
30926,0.000694,74.125.68.0-255,5738,54840,1,236842
30927,0.000696,172.31.36.0-255,66,54906,1,236842
30928,0.000719,74.125.68.0-255,5738,60644,1,236842
30929,0.000722,172.31.36.0-255,66,60710,1,236842
30930,0.000748,74.125.68.0-255,5738,66448,1,236842
30931,0.000751,172.31.36.0-255,66,66514,1,236842
30932,0.000756,74.125.68.0-255,4320,70834,1,236842
30933,0.000758,172.31.36.0-255,66,70900,1,236842
30934,0.000786,74.125.68.0-255,3602,74502,1,236842
30935,0.000791,172.31.36.0-255,66,74568,1,236842
30936,0.000839,74.125.68.0-255,1484,76052,1,236842
30937,0.000857,74.125.68.0-255,2902,78954,1,236842
30938,0.00086,172.31.36.0-255,66,79020,1,236842
30939,0.000866,74.125.68.0-255,2902,81922,1,236842
30940,0.000868,172.31.36.0-255,66,81988,1,236842
30941,0.000884,74.125.68.0-255,2902,84890,1,236842
30942,0.000886,172.31.36.0-255,66,84956,1,236842
30943,0.000891,74.125.68.0-255,2902,87858,1,236842
30944,0.000893,172.31.36.0-255,66,87924,1,236842
30945,0.00092,172.31.36.0-255,66,87990,1,236842
30946,0.000928,74.125.68.0-255,1484,89474,1,236842
30947,0.000954,172.31.36.0-255,66,89540,1,236842
30948,0.001068,74.125.68.0-255,1484,91024,1,236842
30949,0.001083,74.125.68.0-255,2902,93926,1,236842
30950,0.001087,172.31.36.0-255,66,93992,1,236842
30951,0.001102,74.125.68.0-255,5738,99730,1,236842
30952,0.001105,172.31.36.0-255,66,99796,1,236842
30953,0.001134,74.125.68.0-255,2902,102698,1,236842
30954,0.001138,172.31.36.0-255,66,102764,1,236842
30955,0.001163,172.31.36.0-255,66,102830,1,236842
30956,0.001167,74.125.68.0-255,2902,105732,1,236842
30957,0.001169,172.31.36.0-255,66,105798,1,236842
30958,0.001204,172.31.36.0-255,66,105864,1,236842
30959,0.001429,74.125.68.0-255,1484,107348,1,236842
30960,0.001435,74.125.68.0-255,2902,110250,1,236842
30961,0.001439,172.31.36.0-255,66,110316,1,236842
30962,0.001446,74.125.68.0-255,5738,116054,1,236842
30963,0.001448,172.31.36.0-255,66,116120,1,236842
30964,0.001474,74.125.68.0-255,7156,123276,1,236842
30965,0.001477,172.31.36.0-255,66,123342,1,236842
30966,0.00151,172.31.36.0-255,66,123408,1,236842
30967,0.001526,74.125.68.0-255,1484,124892,1,236842
30968,0.001551,172.31.36.0-255,66,124958,1,236842
30969,0.00157,74.125.68.0-255,2184,127142,1,236842
30970,0.001573,172.31.36.0-255,66,127208,1,236842
30971,0.001585,172.31.36.0-255,66,127274,1,236842
30972,0.001622,74.125.68.0-255,2902,130176,1,236842
30973,0.001625,172.31.36.0-255,66,130242,1,236842
30974,0.001659,74.125.68.0-255,4320,134562,1,236842
30975,0.001663,172.31.36.0-255,66,134628,1,236842
30976,0.001673,172.31.36.0-255,66,134694,1,236842
30977,0.001695,74.125.68.0-255,1484,136178,1,236842
30978,0.0017,74.125.68.0-255,2902,139080,1,236842
30979,0.001702,172.31.36.0-255,66,139146,1,236842
30980,0.001707,74.125.68.0-255,2902,142048,1,236842
30981,0.001709,172.31.36.0-255,66,142114,1,236842
30982,0.001723,74.125.68.0-255,2902,145016,1,236842
30983,0.001726,172.31.36.0-255,66,145082,1,236842
30984,0.001741,74.125.68.0-255,1484,146566,1,236842
30985,0.001768,172.31.36.0-255,66,146632,1,236842
30986,0.001773,74.125.68.0-255,4320,150952,1,236842
30987,0.001776,172.31.36.0-255,66,151018,1,236842
30988,0.0018,172.31.36.0-255,66,151084,1,236842
30989,0.001803,74.125.68.0-255,1484,152568,1,236842
30990,0.001807,74.125.68.0-255,2902,155470,1,236842
30991,0.001809,172.31.36.0-255,66,155536,1,236842
30992,0.001838,74.125.68.0-255,5738,161274,1,236842
30993,0.001841,172.31.36.0-255,66,161340,1,236842
30994,0.001847,74.125.68.0-255,5738,167078,1,236842
30995,0.001849,172.31.36.0-255,66,167144,1,236842
30996,0.001879,74.125.68.0-255,7156,174300,1,236842
30997,0.001882,172.31.36.0-255,66,174366,1,236842
30998,0.001895,74.125.68.0-255,4320,178686,1,236842
30999,0.001898,172.31.36.0-255,66,178752,1,236842
31000,0.001924,74.125.68.0-255,6438,185190,1,236842
31001,0.001927,172.31.36.0-255,66,185256,1,236842
31002,0.001931,74.125.68.0-255,2902,188158,1,236842
31003,0.001934,172.31.36.0-255,66,188224,1,236842
31004,0.001955,172.31.36.0-255,66,188290,1,236842
31005,0.00196,74.125.68.0-255,2902,191192,1,236842
31006,0.001962,172.31.36.0-255,66,191258,1,236842
31007,0.002005,172.31.36.0-255,66,191324,1,236842
31008,0.00201,74.125.68.0-255,3602,194926,1,236842
31009,0.002012,172.31.36.0-255,66,194992,1,236842
31010,0.002055,74.125.68.0-255,5738,200730,1,236842
31011,0.002059,172.31.36.0-255,66,200796,1,236842
31012,0.002086,172.31.36.0-255,66,200862,1,236842
31013,0.002089,74.125.68.0-255,1484,202346,1,236842
31014,0.002128,172.31.36.0-255,66,202412,1,236842
31015,0.002134,74.125.68.0-255,3602,206014,1,236842
31016,0.002136,172.31.36.0-255,66,206080,1,236842
31017,0.002163,74.125.68.0-255,4320,210400,1,236842
31018,0.002166,172.31.36.0-255,66,210466,1,236842
31019,0.002186,74.125.68.0-255,5738,216204,1,236842
31020,0.002189,172.31.36.0-255,66,216270,1,236842
31021,0.002222,172.31.36.0-255,66,216336,1,236842
31022,0.002248,74.125.68.0-255,2902,219238,1,236842
31023,0.002251,172.31.36.0-255,66,219304,1,236842
31024,0.002277,172.31.36.0-255,66,219370,1,236842
31025,0.004535,74.125.68.0-255,5738,225108,1,236842
31026,0.004544,172.31.36.0-255,66,225174,1,236842
31027,0.00678,74.125.68.0-255,5738,230912,1,236842
31028,0.006787,172.31.36.0-255,66,230978,1,236842
31029,0.009021,74.125.68.0-255,2879,233857,1,236842
31030,0.009028,172.31.36.0-255,66,233923,1,236842
31031,0.00959,172.31.36.0-255,105,234028,1,236842
31032,0.011774,74.125.68.0-255,66,234094,1,236842
31033,0.011954,172.31.36.0-255,105,234199,1,236842
31034,0.012229,172.31.36.0-255,90,234289,1,236842
31035,0.012239,172.31.36.0-255,66,234355,1,236842
31036,0.014128,74.125.68.0-255,66,234421,1,236842
31037,0.014404,74.125.68.0-255,66,234487,1,236842
31038,0.014448,74.125.68.0-255,66,234553,1,236842
31039,0.014455,172.31.36.0-255,66,234619,1,236842
31040,0.040772,172.31.36.0-255,172,234791,1,236842
31041,0.04081,172.31.36.0-255,1114,235905,1,236842
31042,0.040865,172.31.36.0-255,565,236470,1,236842
31043,0.042267,104.244.42.0-255,66,236536,1,236842
31044,0.04229,104.244.42.0-255,66,236602,1,236842
31045,0.042331,104.244.42.0-255,66,236668,1,236842
31046,0.042863,104.244.42.0-255,108,236776,1,236842
31047,0.042872,172.31.36.0-255,66,236842,1,236842
31048,0.0,172.217.194.0-255,153,153,1,274379
31049,3.5e-05,172.31.36.0-255,66,219,1,274379
31050,4.1e-05,172.217.194.0-255,1484,1703,1,274379
31051,4.5e-05,172.31.36.0-255,66,1769,1,274379
31052,5.1e-05,172.217.194.0-255,2902,4671,1,274379
31053,5.4e-05,172.31.36.0-255,66,4737,1,274379
31054,6.1e-05,172.217.194.0-255,7156,11893,1,274379
31055,6.4e-05,172.31.36.0-255,66,11959,1,274379
31056,8.4e-05,172.217.194.0-255,2082,14041,1,274379
31057,8.6e-05,172.31.36.0-255,66,14107,1,274379
31058,0.000176,172.217.194.0-255,1484,15591,1,274379
31059,0.00018,172.31.36.0-255,66,15657,1,274379
31060,0.000199,172.217.194.0-255,2902,18559,1,274379
31061,0.000203,172.31.36.0-255,66,18625,1,274379
31062,0.000209,172.217.194.0-255,5738,24363,1,274379
31063,0.000212,172.31.36.0-255,66,24429,1,274379
31064,0.000242,172.217.194.0-255,6797,31226,1,274379
31065,0.000245,172.31.36.0-255,66,31292,1,274379
31066,0.000291,172.217.194.0-255,1484,32776,1,274379
31067,0.000295,172.31.36.0-255,66,32842,1,274379
31068,0.0003,172.217.194.0-255,2902,35744,1,274379
31069,0.000302,172.31.36.0-255,66,35810,1,274379
31070,0.000324,172.217.194.0-255,2902,38712,1,274379
31071,0.000328,172.31.36.0-255,66,38778,1,274379
31072,0.000349,172.217.194.0-255,4320,43098,1,274379
31073,0.000352,172.31.36.0-255,66,43164,1,274379
31074,0.000371,172.217.194.0-255,5379,48543,1,274379
31075,0.000375,172.31.36.0-255,66,48609,1,274379
31076,0.001026,172.217.194.0-255,1484,50093,1,274379
31077,0.001033,172.31.36.0-255,66,50159,1,274379
31078,0.001051,172.217.194.0-255,2902,53061,1,274379
31079,0.001054,172.31.36.0-255,66,53127,1,274379
31080,0.001061,172.217.194.0-255,5738,58865,1,274379
31081,0.001107,172.217.194.0-255,2902,61767,1,274379
31082,0.001127,172.217.194.0-255,3961,65728,1,274379
31083,0.001138,172.31.36.0-255,66,65794,1,274379
31084,0.001157,172.217.194.0-255,1484,67278,1,274379
31085,0.00118,172.217.194.0-255,1484,68762,1,274379
31086,0.001185,172.217.194.0-255,2902,71664,1,274379
31087,0.001209,172.217.194.0-255,5738,77402,1,274379
31088,0.001223,172.31.36.0-255,66,77468,1,274379
31089,0.001249,172.217.194.0-255,2902,80370,1,274379
31090,0.001262,172.217.194.0-255,4320,84690,1,274379
31091,0.001273,172.217.194.0-255,2902,87592,1,274379
31092,0.001277,172.31.36.0-255,66,87658,1,274379
31093,0.001298,172.217.194.0-255,3961,91619,1,274379
31094,0.001315,172.31.36.0-255,66,91685,1,274379
31095,0.001352,172.217.194.0-255,5738,97423,1,274379
31096,0.001359,172.31.36.0-255,66,97489,1,274379
31097,0.001367,172.217.194.0-255,3123,100612,1,274379
31098,0.001372,172.31.36.0-255,66,100678,1,274379
31099,0.00145,172.217.194.0-255,1484,102162,1,274379
31100,0.001454,172.217.194.0-255,1484,103646,1,274379
31101,0.001462,172.31.36.0-255,66,103712,1,274379
31102,0.001473,172.217.194.0-255,1484,105196,1,274379
31103,0.001478,172.217.194.0-255,5738,110934,1,274379
31104,0.0015,172.31.36.0-255,66,111000,1,274379
31105,0.001565,172.31.36.0-255,66,111066,1,274379
31106,0.001577,172.217.194.0-255,2902,113968,1,274379
31107,0.001608,172.217.194.0-255,2184,116152,1,274379
31108,0.001615,172.31.36.0-255,66,116218,1,274379
31109,0.001697,172.217.194.0-255,1484,117702,1,274379
31110,0.001716,172.217.194.0-255,2902,120604,1,274379
31111,0.001727,172.217.194.0-255,2902,123506,1,274379
31112,0.00174,172.31.36.0-255,66,123572,1,274379
31113,0.001749,172.217.194.0-255,2902,126474,1,274379
31114,0.001753,172.31.36.0-255,66,126540,1,274379
31115,0.00177,172.217.194.0-255,2902,129442,1,274379
31116,0.001795,172.31.36.0-255,66,129508,1,274379
31117,0.001805,172.217.194.0-255,1484,130992,1,274379
31118,0.001871,172.217.194.0-255,5738,136730,1,274379
31119,0.001891,172.217.194.0-255,5020,141750,1,274379
31120,0.001898,172.31.36.0-255,66,141816,1,274379
31121,0.002017,172.217.194.0-255,1484,143300,1,274379
31122,0.002021,172.217.194.0-255,1484,144784,1,274379
31123,0.002034,172.31.36.0-255,66,144850,1,274379
31124,0.002037,172.217.194.0-255,1484,146334,1,274379
31125,0.00204,172.217.194.0-255,1484,147818,1,274379
31126,0.002044,172.31.36.0-255,66,147884,1,274379
31127,0.002058,172.217.194.0-255,4320,152204,1,274379
31128,0.002071,172.217.194.0-255,1484,153688,1,274379
31129,0.002094,172.217.194.0-255,5738,159426,1,274379
31130,0.002098,172.31.36.0-255,66,159492,1,274379
31131,0.002135,172.217.194.0-255,2902,162394,1,274379
31132,0.002148,172.31.36.0-255,66,162460,1,274379
31133,0.002168,172.31.36.0-255,66,162526,1,274379
31134,0.002244,172.217.194.0-255,2184,164710,1,274379
31135,0.002248,172.31.36.0-255,66,164776,1,274379
31136,0.004464,172.217.194.0-255,2902,167678,1,274379
31137,0.00447,172.31.36.0-255,66,167744,1,274379
31138,0.004547,172.217.194.0-255,2902,170646,1,274379
31139,0.00455,172.31.36.0-255,66,170712,1,274379
31140,0.006775,172.217.194.0-255,2902,173614,1,274379
31141,0.006782,172.31.36.0-255,66,173680,1,274379
31142,0.006915,172.217.194.0-255,2902,176582,1,274379
31143,0.009072,172.217.194.0-255,2902,179484,1,274379
31144,0.011051,172.31.36.0-255,66,179550,1,274379
31145,0.013362,172.217.194.0-255,5738,185288,1,274379
31146,0.01337,172.31.36.0-255,66,185354,1,274379
31147,0.015671,172.217.194.0-255,5738,191092,1,274379
31148,0.015679,172.31.36.0-255,66,191158,1,274379
31149,0.017979,172.217.194.0-255,5738,196896,1,274379
31150,0.017985,172.31.36.0-255,66,196962,1,274379
31151,0.020025,172.31.36.0-255,164,197126,1,274379
31152,0.020053,172.31.36.0-255,1122,198248,1,274379
31153,0.020085,172.31.36.0-255,1514,199762,1,274379
31154,0.020087,172.31.36.0-255,319,200081,1,274379
31155,0.020292,172.217.194.0-255,5738,205819,1,274379
31156,0.020297,172.31.36.0-255,66,205885,1,274379
31157,0.02153,104.244.42.0-255,66,205951,1,274379
31158,0.021622,104.244.42.0-255,66,206017,1,274379
31159,0.021665,104.244.42.0-255,66,206083,1,274379
31160,0.022559,172.217.194.0-255,5738,211821,1,274379
31161,0.022563,172.31.36.0-255,66,211887,1,274379
31162,0.024882,172.217.194.0-255,4320,216207,1,274379
31163,0.024888,172.31.36.0-255,66,216273,1,274379
31164,0.024906,172.217.194.0-255,1484,217757,1,274379
31165,0.027154,172.217.194.0-255,4320,222077,1,274379
31166,0.027161,172.31.36.0-255,66,222143,1,274379
31167,0.029442,172.217.194.0-255,5738,227881,1,274379
31168,0.029495,172.31.36.0-255,66,227947,1,274379
31169,0.031784,172.217.194.0-255,5738,233685,1,274379
31170,0.03179,172.31.36.0-255,66,233751,1,274379
31171,0.034067,172.217.194.0-255,5738,239489,1,274379
31172,0.034073,172.31.36.0-255,66,239555,1,274379
31173,0.036365,172.217.194.0-255,5738,245293,1,274379
31174,0.036371,172.31.36.0-255,66,245359,1,274379
31175,0.038636,172.217.194.0-255,5738,251097,1,274379
31176,0.038641,172.31.36.0-255,66,251163,1,274379
31177,0.040924,172.217.194.0-255,5738,256901,1,274379
31178,0.04093,172.31.36.0-255,66,256967,1,274379
31179,0.043209,172.217.194.0-255,5738,262705,1,274379
31180,0.043214,172.31.36.0-255,66,262771,1,274379
31181,0.045563,172.217.194.0-255,5738,268509,1,274379
31182,0.045568,172.31.36.0-255,66,268575,1,274379
31183,0.047859,172.217.194.0-255,5738,274313,1,274379
31184,0.047865,172.31.36.0-255,66,274379,1,274379
31185,0.0,74.125.68.0-255,150,150,1,328295
31186,3.1e-05,172.31.36.0-255,66,216,1,328295
31187,3.7e-05,74.125.68.0-255,1484,1700,1,328295
31188,4.3e-05,172.31.36.0-255,66,1766,1,328295
31189,4.8e-05,74.125.68.0-255,2902,4668,1,328295
31190,5.1e-05,172.31.36.0-255,66,4734,1,328295
31191,7.6e-05,74.125.68.0-255,7156,11890,1,328295
31192,7.9e-05,172.31.36.0-255,66,11956,1,328295
31193,0.000121,74.125.68.0-255,1987,13943,1,328295
31194,0.000125,172.31.36.0-255,66,14009,1,328295
31195,0.002623,74.125.68.0-255,1484,15493,1,328295
31196,0.00263,172.31.36.0-255,66,15559,1,328295
31197,0.00264,74.125.68.0-255,2902,18461,1,328295
31198,0.002643,172.31.36.0-255,66,18527,1,328295
31199,0.00265,74.125.68.0-255,5738,24265,1,328295
31200,0.002652,172.31.36.0-255,66,24331,1,328295
31201,0.002655,74.125.68.0-255,1484,25815,1,328295
31202,0.002657,172.31.36.0-255,66,25881,1,328295
31203,0.002682,74.125.68.0-255,2902,28783,1,328295
31204,0.002684,172.31.36.0-255,66,28849,1,328295
31205,0.002713,74.125.68.0-255,6797,35646,1,328295
31206,0.002716,172.31.36.0-255,66,35712,1,328295
31207,0.002721,74.125.68.0-255,4320,40032,1,328295
31208,0.002723,172.31.36.0-255,66,40098,1,328295
31209,0.00275,74.125.68.0-255,7156,47254,1,328295
31210,0.002753,172.31.36.0-255,66,47320,1,328295
31211,0.00277,74.125.68.0-255,5738,53058,1,328295
31212,0.002773,172.31.36.0-255,66,53124,1,328295
31213,0.002779,74.125.68.0-255,5738,58862,1,328295
31214,0.002781,172.31.36.0-255,66,58928,1,328295
31215,0.002788,74.125.68.0-255,6438,65366,1,328295
31216,0.002791,172.31.36.0-255,66,65432,1,328295
31217,0.003051,74.125.68.0-255,357,65789,1,328295
31218,0.003094,74.125.68.0-255,134,65923,1,328295
31219,0.00331,172.31.36.0-255,66,65989,1,328295
31220,0.00383,74.125.68.0-255,1484,67473,1,328295
31221,0.003854,74.125.68.0-255,2902,70375,1,328295
31222,0.003859,172.31.36.0-255,66,70441,1,328295
31223,0.003882,74.125.68.0-255,4320,74761,1,328295
31224,0.003885,172.31.36.0-255,66,74827,1,328295
31225,0.003888,74.125.68.0-255,1484,76311,1,328295
31226,0.003913,74.125.68.0-255,4320,80631,1,328295
31227,0.003916,172.31.36.0-255,66,80697,1,328295
31228,0.003946,172.31.36.0-255,66,80763,1,328295
31229,0.003962,74.125.68.0-255,1484,82247,1,328295
31230,0.003986,172.31.36.0-255,66,82313,1,328295
31231,0.004008,74.125.68.0-255,766,83079,1,328295
31232,0.004034,74.125.68.0-255,1484,84563,1,328295
31233,0.004037,172.31.36.0-255,66,84629,1,328295
31234,0.004054,74.125.68.0-255,2902,87531,1,328295
31235,0.004057,172.31.36.0-255,66,87597,1,328295
31236,0.004064,74.125.68.0-255,4320,91917,1,328295
31237,0.004066,172.31.36.0-255,66,91983,1,328295
31238,0.004094,74.125.68.0-255,1484,93467,1,328295
31239,0.004101,74.125.68.0-255,5738,99205,1,328295
31240,0.004104,172.31.36.0-255,66,99271,1,328295
31241,0.004124,74.125.68.0-255,2902,102173,1,328295
31242,0.004126,172.31.36.0-255,66,102239,1,328295
31243,0.00416,74.125.68.0-255,4320,106559,1,328295
31244,0.004165,172.31.36.0-255,66,106625,1,328295
31245,0.004188,74.125.68.0-255,5738,112363,1,328295
31246,0.004192,172.31.36.0-255,66,112429,1,328295
31247,0.004246,74.125.68.0-255,4320,116749,1,328295
31248,0.004251,172.31.36.0-255,66,116815,1,328295
31249,0.004274,74.125.68.0-255,2184,118999,1,328295
31250,0.004278,172.31.36.0-255,66,119065,1,328295
31251,0.004283,74.125.68.0-255,4320,123385,1,328295
31252,0.004286,172.31.36.0-255,66,123451,1,328295
31253,0.004293,74.125.68.0-255,5738,129189,1,328295
31254,0.004295,172.31.36.0-255,66,129255,1,328295
31255,0.004306,172.31.36.0-255,66,129321,1,328295
31256,0.004332,74.125.68.0-255,5738,135059,1,328295
31257,0.004336,172.31.36.0-255,66,135125,1,328295
31258,0.004365,74.125.68.0-255,4320,139445,1,328295
31259,0.004368,172.31.36.0-255,66,139511,1,328295
31260,0.004373,74.125.68.0-255,3602,143113,1,328295
31261,0.004376,172.31.36.0-255,66,143179,1,328295
31262,0.004394,74.125.68.0-255,5738,148917,1,328295
31263,0.004398,172.31.36.0-255,66,148983,1,328295
31264,0.004423,74.125.68.0-255,4320,153303,1,328295
31265,0.004427,172.31.36.0-255,66,153369,1,328295
31266,0.004442,172.31.36.0-255,66,153435,1,328295
31267,0.004447,74.125.68.0-255,4320,157755,1,328295
31268,0.004449,172.31.36.0-255,66,157821,1,328295
31269,0.00447,74.125.68.0-255,1484,159305,1,328295
31270,0.004477,74.125.68.0-255,6438,165743,1,328295
31271,0.00448,172.31.36.0-255,66,165809,1,328295
31272,0.004501,74.125.68.0-255,1484,167293,1,328295
31273,0.004506,74.125.68.0-255,2902,170195,1,328295
31274,0.004508,172.31.36.0-255,66,170261,1,328295
31275,0.004532,74.125.68.0-255,5738,175999,1,328295
31276,0.004535,172.31.36.0-255,66,176065,1,328295
31277,0.004563,74.125.68.0-255,1484,177549,1,328295
31278,0.004585,74.125.68.0-255,7156,184705,1,328295
31279,0.004589,172.31.36.0-255,66,184771,1,328295
31280,0.004601,172.31.36.0-255,66,184837,1,328295
31281,0.004604,74.125.68.0-255,1484,186321,1,328295
31282,0.004626,74.125.68.0-255,1484,187805,1,328295
31283,0.004629,172.31.36.0-255,66,187871,1,328295
31284,0.004634,74.125.68.0-255,3602,191473,1,328295
31285,0.004637,172.31.36.0-255,66,191539,1,328295
31286,0.00466,74.125.68.0-255,2902,194441,1,328295
31287,0.004664,172.31.36.0-255,66,194507,1,328295
31288,0.00467,74.125.68.0-255,4320,198827,1,328295
31289,0.004672,172.31.36.0-255,66,198893,1,328295
31290,0.004692,74.125.68.0-255,1484,200377,1,328295
31291,0.004718,74.125.68.0-255,5738,206115,1,328295
31292,0.004724,172.31.36.0-255,66,206181,1,328295
31293,0.004744,74.125.68.0-255,1484,207665,1,328295
31294,0.004752,74.125.68.0-255,7156,214821,1,328295
31295,0.004755,172.31.36.0-255,66,214887,1,328295
31296,0.004779,172.31.36.0-255,66,214953,1,328295
31297,0.004803,74.125.68.0-255,766,215719,1,328295
31298,0.004817,172.31.36.0-255,66,215785,1,328295
31299,0.004827,172.31.36.0-255,66,215851,1,328295
31300,0.004874,74.125.68.0-255,5020,220871,1,328295
31301,0.004907,172.31.36.0-255,66,220937,1,328295
31302,0.004921,74.125.68.0-255,1484,222421,1,328295
31303,0.004937,74.125.68.0-255,1484,223905,1,328295
31304,0.004956,172.31.36.0-255,66,223971,1,328295
31305,0.004959,74.125.68.0-255,1484,225455,1,328295
31306,0.004977,74.125.68.0-255,1484,226939,1,328295
31307,0.004995,74.125.68.0-255,2902,229841,1,328295
31308,0.005003,172.31.36.0-255,66,229907,1,328295
31309,0.005015,74.125.68.0-255,4320,234227,1,328295
31310,0.005067,74.125.68.0-255,2902,237129,1,328295
31311,0.00507,74.125.68.0-255,2902,240031,1,328295
31312,0.005072,74.125.68.0-255,1484,241515,1,328295
31313,0.005074,74.125.68.0-255,1484,242999,1,328295
31314,0.005076,74.125.68.0-255,1484,244483,1,328295
31315,0.005079,172.31.36.0-255,66,244549,1,328295
31316,0.005105,74.125.68.0-255,2902,247451,1,328295
31317,0.005112,74.125.68.0-255,4320,251771,1,328295
31318,0.005137,74.125.68.0-255,3602,255373,1,328295
31319,0.005141,74.125.68.0-255,2902,258275,1,328295
31320,0.005169,74.125.68.0-255,4320,262595,1,328295
31321,0.005182,172.31.36.0-255,66,262661,1,328295
31322,0.005196,74.125.68.0-255,5738,268399,1,328295
31323,0.005201,172.31.36.0-255,66,268465,1,328295
31324,0.00521,74.125.68.0-255,1484,269949,1,328295
31325,0.005248,74.125.68.0-255,4320,274269,1,328295
31326,0.005254,74.125.68.0-255,5738,280007,1,328295
31327,0.005266,172.31.36.0-255,66,280073,1,328295
31328,0.00528,74.125.68.0-255,7156,287229,1,328295
31329,0.005299,74.125.68.0-255,5020,292249,1,328295
31330,0.005303,74.125.68.0-255,2902,295151,1,328295
31331,0.005305,172.31.36.0-255,66,295217,1,328295
31332,0.005335,74.125.68.0-255,5738,300955,1,328295
31333,0.005364,74.125.68.0-255,6438,307393,1,328295
31334,0.005368,172.31.36.0-255,66,307459,1,328295
31335,0.005374,172.31.36.0-255,66,307525,1,328295
31336,0.005395,74.125.68.0-255,4320,311845,1,328295
31337,0.005401,74.125.68.0-255,5738,317583,1,328295
31338,0.005453,74.125.68.0-255,1108,318691,1,328295
31339,0.005458,74.125.68.0-255,97,318788,1,328295
31340,0.005479,172.31.36.0-255,66,318854,1,328295
31341,0.005545,74.125.68.0-255,105,318959,1,328295
31342,0.011365,172.31.36.0-255,66,319025,1,328295
31343,0.011414,172.31.36.0-255,105,319130,1,328295
31344,0.013629,74.125.68.0-255,66,319196,1,328295
31345,0.035615,172.31.36.0-255,176,319372,1,328295
31346,0.035676,172.31.36.0-255,1114,320486,1,328295
31347,0.035781,172.31.36.0-255,1514,322000,1,328295
31348,0.035784,172.31.36.0-255,1514,323514,1,328295
31349,0.035789,172.31.36.0-255,1514,325028,1,328295
31350,0.03579,172.31.36.0-255,1514,326542,1,328295
31351,0.035842,172.31.36.0-255,1489,328031,1,328295
31352,0.037163,104.244.42.0-255,66,328097,1,328295
31353,0.037209,104.244.42.0-255,66,328163,1,328295
31354,0.037352,104.244.42.0-255,66,328229,1,328295
31355,0.03742,104.244.42.0-255,66,328295,1,328295
31356,0.0,74.125.24.0-255,150,150,1,255872
31357,2.6e-05,172.31.36.0-255,66,216,1,255872
31358,3.3e-05,74.125.24.0-255,1484,1700,1,255872
31359,3.7e-05,172.31.36.0-255,66,1766,1,255872
31360,4.2e-05,74.125.24.0-255,2902,4668,1,255872
31361,4.5e-05,172.31.36.0-255,66,4734,1,255872
31362,6e-05,74.125.24.0-255,7156,11890,1,255872
31363,6.3e-05,172.31.36.0-255,66,11956,1,255872
31364,6.7e-05,74.125.24.0-255,2013,13969,1,255872
31365,6.9e-05,172.31.36.0-255,66,14035,1,255872
31366,0.000523,74.125.24.0-255,1484,15519,1,255872
31367,0.000529,172.31.36.0-255,66,15585,1,255872
31368,0.00054,74.125.24.0-255,2902,18487,1,255872
31369,0.000543,172.31.36.0-255,66,18553,1,255872
31370,0.000557,74.125.24.0-255,5738,24291,1,255872
31371,0.00056,172.31.36.0-255,66,24357,1,255872
31372,0.000601,172.31.36.0-255,66,24423,1,255872
31373,0.000611,172.31.36.0-255,66,24489,1,255872
31374,0.000656,172.31.36.0-255,66,24555,1,255872
31375,0.000661,74.125.24.0-255,2902,27457,1,255872
31376,0.000663,172.31.36.0-255,66,27523,1,255872
31377,0.000701,172.31.36.0-255,66,27589,1,255872
31378,0.000813,74.125.24.0-255,394,27983,1,255872
31379,0.000818,172.31.36.0-255,66,28049,1,255872
31380,0.000844,74.125.24.0-255,114,28163,1,255872
31381,0.000847,172.31.36.0-255,66,28229,1,255872
31382,0.000932,74.125.24.0-255,1484,29713,1,255872
31383,0.000936,172.31.36.0-255,66,29779,1,255872
31384,0.000942,74.125.24.0-255,2902,32681,1,255872
31385,0.000944,172.31.36.0-255,66,32747,1,255872
31386,0.000947,74.125.24.0-255,1484,34231,1,255872
31387,0.000981,74.125.24.0-255,4320,38551,1,255872
31388,0.000984,172.31.36.0-255,66,38617,1,255872
31389,0.000994,172.31.36.0-255,66,38683,1,255872
31390,0.001022,74.125.24.0-255,4320,43003,1,255872
31391,0.001025,172.31.36.0-255,66,43069,1,255872
31392,0.00103,74.125.24.0-255,5738,48807,1,255872
31393,0.001033,172.31.36.0-255,66,48873,1,255872
31394,0.001038,74.125.24.0-255,4320,53193,1,255872
31395,0.001041,172.31.36.0-255,66,53259,1,255872
31396,0.001064,74.125.24.0-255,766,54025,1,255872
31397,0.001102,74.125.24.0-255,1484,55509,1,255872
31398,0.001105,172.31.36.0-255,66,55575,1,255872
31399,0.001109,74.125.24.0-255,2902,58477,1,255872
31400,0.001111,172.31.36.0-255,66,58543,1,255872
31401,0.001132,74.125.24.0-255,2902,61445,1,255872
31402,0.001134,172.31.36.0-255,66,61511,1,255872
31403,0.001137,74.125.24.0-255,1484,62995,1,255872
31404,0.00116,74.125.24.0-255,2902,65897,1,255872
31405,0.001162,172.31.36.0-255,66,65963,1,255872
31406,0.001176,172.31.36.0-255,66,66029,1,255872
31407,0.001186,74.125.24.0-255,1484,67513,1,255872
31408,0.001221,172.31.36.0-255,66,67579,1,255872
31409,0.001251,74.125.24.0-255,2184,69763,1,255872
31410,0.001253,172.31.36.0-255,66,69829,1,255872
31411,0.001257,74.125.24.0-255,2902,72731,1,255872
31412,0.001259,172.31.36.0-255,66,72797,1,255872
31413,0.001265,74.125.24.0-255,5738,78535,1,255872
31414,0.001273,172.31.36.0-255,66,78601,1,255872
31415,0.001303,74.125.24.0-255,1484,80085,1,255872
31416,0.001318,172.31.36.0-255,66,80151,1,255872
31417,0.001327,172.31.36.0-255,66,80217,1,255872
31418,0.001564,74.125.24.0-255,1484,81701,1,255872
31419,0.00158,74.125.24.0-255,2902,84603,1,255872
31420,0.001582,172.31.36.0-255,66,84669,1,255872
31421,0.001588,74.125.24.0-255,5738,90407,1,255872
31422,0.001591,172.31.36.0-255,66,90473,1,255872
31423,0.001596,74.125.24.0-255,2902,93375,1,255872
31424,0.001598,172.31.36.0-255,66,93441,1,255872
31425,0.001622,74.125.24.0-255,4320,97761,1,255872
31426,0.001625,172.31.36.0-255,66,97827,1,255872
31427,0.001635,74.125.24.0-255,5738,103565,1,255872
31428,0.001637,172.31.36.0-255,66,103631,1,255872
31429,0.001667,172.31.36.0-255,66,103697,1,255872
31430,0.001671,74.125.24.0-255,2184,105881,1,255872
31431,0.001673,172.31.36.0-255,66,105947,1,255872
31432,0.0017,172.31.36.0-255,66,106013,1,255872
31433,0.001725,74.125.24.0-255,7156,113169,1,255872
31434,0.001727,172.31.36.0-255,66,113235,1,255872
31435,0.00174,172.31.36.0-255,66,113301,1,255872
31436,0.00177,74.125.24.0-255,3602,116903,1,255872
31437,0.001772,172.31.36.0-255,66,116969,1,255872
31438,0.001786,74.125.24.0-255,4320,121289,1,255872
31439,0.001792,172.31.36.0-255,66,121355,1,255872
31440,0.001804,172.31.36.0-255,66,121421,1,255872
31441,0.001819,172.31.36.0-255,66,121487,1,255872
31442,0.001893,172.31.36.0-255,66,121553,1,255872
31443,0.002233,74.125.24.0-255,1484,123037,1,255872
31444,0.002248,74.125.24.0-255,2902,125939,1,255872
31445,0.00225,172.31.36.0-255,66,126005,1,255872
31446,0.002253,74.125.24.0-255,1484,127489,1,255872
31447,0.004529,74.125.24.0-255,4320,131809,1,255872
31448,0.004536,172.31.36.0-255,66,131875,1,255872
31449,0.006809,74.125.24.0-255,5738,137613,1,255872
31450,0.006816,172.31.36.0-255,66,137679,1,255872
31451,0.009059,74.125.24.0-255,5738,143417,1,255872
31452,0.009066,172.31.36.0-255,66,143483,1,255872
31453,0.011309,74.125.24.0-255,5738,149221,1,255872
31454,0.011318,172.31.36.0-255,66,149287,1,255872
31455,0.013606,74.125.24.0-255,5738,155025,1,255872
31456,0.013613,172.31.36.0-255,66,155091,1,255872
31457,0.015883,74.125.24.0-255,5738,160829,1,255872
31458,0.015892,172.31.36.0-255,66,160895,1,255872
31459,0.018153,74.125.24.0-255,5738,166633,1,255872
31460,0.018162,172.31.36.0-255,66,166699,1,255872
31461,0.020426,74.125.24.0-255,5738,172437,1,255872
31462,0.020433,172.31.36.0-255,66,172503,1,255872
31463,0.022665,74.125.24.0-255,5738,178241,1,255872
31464,0.022673,172.31.36.0-255,66,178307,1,255872
31465,0.024925,74.125.24.0-255,5738,184045,1,255872
31466,0.024932,172.31.36.0-255,66,184111,1,255872
31467,0.027218,74.125.24.0-255,5738,189849,1,255872
31468,0.027232,172.31.36.0-255,66,189915,1,255872
31469,0.029515,74.125.24.0-255,5738,195653,1,255872
31470,0.029528,172.31.36.0-255,66,195719,1,255872
31471,0.031801,74.125.24.0-255,5738,201457,1,255872
31472,0.031816,172.31.36.0-255,66,201523,1,255872
31473,0.034079,74.125.24.0-255,5738,207261,1,255872
31474,0.034086,172.31.36.0-255,66,207327,1,255872
31475,0.034101,172.31.36.0-255,172,207499,1,255872
31476,0.034125,172.31.36.0-255,1116,208615,1,255872
31477,0.034246,172.31.36.0-255,1514,210129,1,255872
31478,0.034249,172.31.36.0-255,1514,211643,1,255872
31479,0.034273,172.31.36.0-255,1514,213157,1,255872
31480,0.034274,172.31.36.0-255,1514,214671,1,255872
31481,0.034282,172.31.36.0-255,1487,216158,1,255872
31482,0.035624,104.244.42.0-255,66,216224,1,255872
31483,0.03566,104.244.42.0-255,66,216290,1,255872
31484,0.035818,104.244.42.0-255,66,216356,1,255872
31485,0.035918,104.244.42.0-255,66,216422,1,255872
31486,0.036351,74.125.24.0-255,4320,220742,1,255872
31487,0.036356,172.31.36.0-255,66,220808,1,255872
31488,0.03639,74.125.24.0-255,1484,222292,1,255872
31489,0.036651,104.244.42.0-255,108,222400,1,255872
31490,0.03666,172.31.36.0-255,66,222466,1,255872
31491,0.038603,74.125.24.0-255,4320,226786,1,255872
31492,0.038607,172.31.36.0-255,66,226852,1,255872
31493,0.040903,74.125.24.0-255,5738,232590,1,255872
31494,0.04091,172.31.36.0-255,66,232656,1,255872
31495,0.043151,74.125.24.0-255,5738,238394,1,255872
31496,0.04316,172.31.36.0-255,66,238460,1,255872
31497,0.045438,74.125.24.0-255,5738,244198,1,255872
31498,0.045442,172.31.36.0-255,66,244264,1,255872
31499,0.047674,74.125.24.0-255,5738,250002,1,255872
31500,0.04768,172.31.36.0-255,66,250068,1,255872
31501,0.049923,74.125.24.0-255,5738,255806,1,255872
31502,0.049927,172.31.36.0-255,66,255872,1,255872
31503,0.0,172.217.194.0-255,153,153,1,215747
31504,2.4e-05,172.31.36.0-255,66,219,1,215747
31505,3.2e-05,172.217.194.0-255,1484,1703,1,215747
31506,3.7e-05,172.31.36.0-255,66,1769,1,215747
31507,5e-05,172.217.194.0-255,2902,4671,1,215747
31508,5.4e-05,172.31.36.0-255,66,4737,1,215747
31509,6.2e-05,172.217.194.0-255,7156,11893,1,215747
31510,6.5e-05,172.31.36.0-255,66,11959,1,215747
31511,6.9e-05,172.217.194.0-255,2067,14026,1,215747
31512,7.1e-05,172.31.36.0-255,66,14092,1,215747
31513,9.5e-05,172.217.194.0-255,2902,16994,1,215747
31514,9.8e-05,172.31.36.0-255,66,17060,1,215747
31515,0.00011,172.217.194.0-255,4320,21380,1,215747
31516,0.000112,172.31.36.0-255,66,21446,1,215747
31517,0.000149,172.31.36.0-255,66,21512,1,215747
31518,0.000153,172.217.194.0-255,1125,22637,1,215747
31519,0.000155,172.31.36.0-255,66,22703,1,215747
31520,0.000239,172.217.194.0-255,1484,24187,1,215747
31521,0.000241,172.31.36.0-255,66,24253,1,215747
31522,0.000245,172.217.194.0-255,1484,25737,1,215747
31523,0.000247,172.31.36.0-255,66,25803,1,215747
31524,0.000278,172.217.194.0-255,1484,27287,1,215747
31525,0.000281,172.31.36.0-255,66,27353,1,215747
31526,0.000288,172.217.194.0-255,5738,33091,1,215747
31527,0.00029,172.31.36.0-255,66,33157,1,215747
31528,0.000298,172.217.194.0-255,1484,34641,1,215747
31529,0.0003,172.31.36.0-255,66,34707,1,215747
31530,0.000342,172.31.36.0-255,66,34773,1,215747
31531,0.000358,172.31.36.0-255,66,34839,1,215747
31532,0.000361,172.217.194.0-255,378,35217,1,215747
31533,0.000458,172.217.194.0-255,365,35582,1,215747
31534,0.000547,172.217.194.0-255,1484,37066,1,215747
31535,0.000552,172.31.36.0-255,66,37132,1,215747
31536,0.000557,172.217.194.0-255,2902,40034,1,215747
31537,0.000559,172.31.36.0-255,66,40100,1,215747
31538,0.000579,172.217.194.0-255,2902,43002,1,215747
31539,0.000586,172.31.36.0-255,66,43068,1,215747
31540,0.000613,172.217.194.0-255,2902,45970,1,215747
31541,0.000615,172.31.36.0-255,66,46036,1,215747
31542,0.000618,172.217.194.0-255,1484,47520,1,215747
31543,0.000625,172.217.194.0-255,5738,53258,1,215747
31544,0.000627,172.31.36.0-255,66,53324,1,215747
31545,0.00066,172.217.194.0-255,3961,57285,1,215747
31546,0.000664,172.31.36.0-255,66,57351,1,215747
31547,0.00068,172.31.36.0-255,66,57417,1,215747
31548,0.000688,172.217.194.0-255,6248,63665,1,215747
31549,0.000691,172.31.36.0-255,66,63731,1,215747
31550,0.000698,172.217.194.0-255,7156,70887,1,215747
31551,0.000701,172.31.36.0-255,66,70953,1,215747
31552,0.000729,172.217.194.0-255,2902,73855,1,215747
31553,0.000731,172.31.36.0-255,66,73921,1,215747
31554,0.000758,172.217.194.0-255,2543,76464,1,215747
31555,0.000761,172.31.36.0-255,66,76530,1,215747
31556,0.00078,172.217.194.0-255,1484,78014,1,215747
31557,0.000798,172.217.194.0-255,2902,80916,1,215747
31558,0.000801,172.31.36.0-255,66,80982,1,215747
31559,0.000807,172.217.194.0-255,5738,86720,1,215747
31560,0.000809,172.31.36.0-255,66,86786,1,215747
31561,0.000854,172.31.36.0-255,66,86852,1,215747
31562,0.00087,172.31.36.0-255,66,86918,1,215747
31563,0.000903,172.31.36.0-255,66,86984,1,215747
31564,0.00091,172.217.194.0-255,5738,92722,1,215747
31565,0.000912,172.31.36.0-255,66,92788,1,215747
31566,0.000935,172.217.194.0-255,5738,98526,1,215747
31567,0.000937,172.31.36.0-255,66,98592,1,215747
31568,0.000977,172.31.36.0-255,66,98658,1,215747
31569,0.000995,172.31.36.0-255,66,98724,1,215747
31570,0.001019,172.217.194.0-255,1484,100208,1,215747
31571,0.001024,172.217.194.0-255,3961,104169,1,215747
31572,0.001027,172.31.36.0-255,66,104235,1,215747
31573,0.001127,172.217.194.0-255,1484,105719,1,215747
31574,0.001134,172.217.194.0-255,2902,108621,1,215747
31575,0.001137,172.31.36.0-255,66,108687,1,215747
31576,0.001162,172.217.194.0-255,5738,114425,1,215747
31577,0.001166,172.31.36.0-255,66,114491,1,215747
31578,0.001253,172.31.36.0-255,66,114557,1,215747
31579,0.001256,172.217.194.0-255,1484,116041,1,215747
31580,0.00126,172.217.194.0-255,2902,118943,1,215747
31581,0.001262,172.31.36.0-255,66,119009,1,215747
31582,0.001279,172.217.194.0-255,4320,123329,1,215747
31583,0.001281,172.31.36.0-255,66,123395,1,215747
31584,0.001307,172.217.194.0-255,2184,125579,1,215747
31585,0.001314,172.31.36.0-255,66,125645,1,215747
31586,0.001386,172.217.194.0-255,1484,127129,1,215747
31587,0.001405,172.217.194.0-255,1484,128613,1,215747
31588,0.001409,172.31.36.0-255,66,128679,1,215747
31589,0.001436,172.217.194.0-255,1484,130163,1,215747
31590,0.001443,172.217.194.0-255,5738,135901,1,215747
31591,0.001446,172.31.36.0-255,66,135967,1,215747
31592,0.001453,172.217.194.0-255,5738,141705,1,215747
31593,0.001455,172.31.36.0-255,66,141771,1,215747
31594,0.001496,172.217.194.0-255,7156,148927,1,215747
31595,0.001503,172.217.194.0-255,7156,156083,1,215747
31596,0.001508,172.31.36.0-255,66,156149,1,215747
31597,0.001511,172.31.36.0-255,66,156215,1,215747
31598,0.001528,172.217.194.0-255,3602,159817,1,215747
31599,0.001531,172.31.36.0-255,66,159883,1,215747
31600,0.001607,172.217.194.0-255,1484,161367,1,215747
31601,0.001611,172.217.194.0-255,1484,162851,1,215747
31602,0.001615,172.31.36.0-255,66,162917,1,215747
31603,0.001639,172.217.194.0-255,1484,164401,1,215747
31604,0.001647,172.217.194.0-255,5738,170139,1,215747
31605,0.00165,172.31.36.0-255,66,170205,1,215747
31606,0.00168,172.217.194.0-255,7156,177361,1,215747
31607,0.001683,172.31.36.0-255,66,177427,1,215747
31608,0.001705,172.217.194.0-255,4320,181747,1,215747
31609,0.001708,172.31.36.0-255,66,181813,1,215747
31610,0.001721,172.31.36.0-255,66,181879,1,215747
31611,0.001781,172.217.194.0-255,1484,183363,1,215747
31612,0.001801,172.217.194.0-255,1484,184847,1,215747
31613,0.001804,172.31.36.0-255,66,184913,1,215747
31614,0.001811,172.217.194.0-255,4320,189233,1,215747
31615,0.001813,172.31.36.0-255,66,189299,1,215747
31616,0.001828,172.31.36.0-255,66,189365,1,215747
31617,0.00184,172.31.36.0-255,66,189431,1,215747
31618,0.001888,172.217.194.0-255,5738,195169,1,215747
31619,0.001891,172.31.36.0-255,66,195235,1,215747
31620,0.001938,172.31.36.0-255,66,195301,1,215747
31621,0.001958,172.31.36.0-255,66,195367,1,215747
31622,0.001986,172.217.194.0-255,5020,200387,1,215747
31623,0.001989,172.31.36.0-255,66,200453,1,215747
31624,0.00201,172.31.36.0-255,66,200519,1,215747
31625,0.002059,172.31.36.0-255,66,200585,1,215747
31626,0.002092,172.217.194.0-255,5379,205964,1,215747
31627,0.002094,172.31.36.0-255,66,206030,1,215747
31628,0.002116,172.31.36.0-255,66,206096,1,215747
31629,0.002119,172.217.194.0-255,97,206193,1,215747
31630,0.002121,172.217.194.0-255,105,206298,1,215747
31631,0.011879,172.31.36.0-255,66,206364,1,215747
31632,0.011921,172.31.36.0-255,105,206469,1,215747
31633,0.012565,172.217.194.0-255,105,206574,1,215747
31634,0.012575,172.31.36.0-255,78,206652,1,215747
31635,0.014368,172.217.194.0-255,66,206718,1,215747
31636,0.046825,172.31.36.0-255,172,206890,1,215747
31637,0.046856,172.31.36.0-255,1114,208004,1,215747
31638,0.046925,172.31.36.0-255,1514,209518,1,215747
31639,0.046927,172.31.36.0-255,1514,211032,1,215747
31640,0.046929,172.31.36.0-255,1514,212546,1,215747
31641,0.04693,172.31.36.0-255,1514,214060,1,215747
31642,0.046957,172.31.36.0-255,1489,215549,1,215747
31643,0.048404,104.244.42.0-255,66,215615,1,215747
31644,0.048431,104.244.42.0-255,66,215681,1,215747
31645,0.048558,104.244.42.0-255,66,215747,1,215747
31646,0.0,74.125.200.0-255,296,296,1,240567
31647,2.7e-05,172.31.36.0-255,66,362,1,240567
31648,3.4e-05,74.125.200.0-255,1484,1846,1,240567
31649,3.8e-05,172.31.36.0-255,66,1912,1,240567
31650,4.4e-05,74.125.200.0-255,4320,6232,1,240567
31651,4.8e-05,172.31.36.0-255,66,6298,1,240567
31652,6.7e-05,172.31.36.0-255,66,6364,1,240567
31653,0.000102,172.31.36.0-255,66,6430,1,240567
31654,0.000107,74.125.200.0-255,5738,12168,1,240567
31655,0.000109,172.31.36.0-255,66,12234,1,240567
31656,0.000162,74.125.200.0-255,2543,14777,1,240567
31657,0.000166,172.31.36.0-255,66,14843,1,240567
31658,0.000246,74.125.200.0-255,1484,16327,1,240567
31659,0.00025,172.31.36.0-255,66,16393,1,240567
31660,0.000254,74.125.200.0-255,1484,17877,1,240567
31661,0.000257,172.31.36.0-255,66,17943,1,240567
31662,0.000261,74.125.200.0-255,2902,20845,1,240567
31663,0.000269,172.31.36.0-255,66,20911,1,240567
31664,0.000307,74.125.200.0-255,5738,26649,1,240567
31665,0.000311,172.31.36.0-255,66,26715,1,240567
31666,0.000317,74.125.200.0-255,5379,32094,1,240567
31667,0.00032,172.31.36.0-255,66,32160,1,240567
31668,0.000348,74.125.200.0-255,4320,36480,1,240567
31669,0.000351,172.31.36.0-255,66,36546,1,240567
31670,0.000364,74.125.200.0-255,1484,38030,1,240567
31671,0.000367,172.31.36.0-255,66,38096,1,240567
31672,0.000385,172.31.36.0-255,66,38162,1,240567
31673,0.000388,74.125.200.0-255,133,38295,1,240567
31674,0.00039,172.31.36.0-255,66,38361,1,240567
31675,0.000462,74.125.200.0-255,344,38705,1,240567
31676,0.000673,74.125.200.0-255,1484,40189,1,240567
31677,0.000677,172.31.36.0-255,66,40255,1,240567
31678,0.000683,74.125.200.0-255,2902,43157,1,240567
31679,0.000686,172.31.36.0-255,66,43223,1,240567
31680,0.000704,74.125.200.0-255,1484,44707,1,240567
31681,0.000729,74.125.200.0-255,4320,49027,1,240567
31682,0.000732,172.31.36.0-255,66,49093,1,240567
31683,0.00074,74.125.200.0-255,7156,56249,1,240567
31684,0.000742,172.31.36.0-255,66,56315,1,240567
31685,0.000787,172.31.36.0-255,66,56381,1,240567
31686,0.000792,74.125.200.0-255,2184,58565,1,240567
31687,0.000794,172.31.36.0-255,66,58631,1,240567
31688,0.00096,74.125.200.0-255,1484,60115,1,240567
31689,0.000966,74.125.200.0-255,1484,61599,1,240567
31690,0.000969,172.31.36.0-255,66,61665,1,240567
31691,0.000993,74.125.200.0-255,1484,63149,1,240567
31692,0.001,74.125.200.0-255,5738,68887,1,240567
31693,0.001005,172.31.36.0-255,66,68953,1,240567
31694,0.001041,172.31.36.0-255,66,69019,1,240567
31695,0.001046,74.125.200.0-255,4320,73339,1,240567
31696,0.001048,172.31.36.0-255,66,73405,1,240567
31697,0.001086,74.125.200.0-255,4320,77725,1,240567
31698,0.001089,172.31.36.0-255,66,77791,1,240567
31699,0.001113,74.125.200.0-255,2184,79975,1,240567
31700,0.001116,172.31.36.0-255,66,80041,1,240567
31701,0.001508,74.125.200.0-255,1484,81525,1,240567
31702,0.001531,74.125.200.0-255,2902,84427,1,240567
31703,0.001536,172.31.36.0-255,66,84493,1,240567
31704,0.001543,74.125.200.0-255,2902,87395,1,240567
31705,0.001545,172.31.36.0-255,66,87461,1,240567
31706,0.001549,74.125.200.0-255,2902,90363,1,240567
31707,0.001558,172.31.36.0-255,66,90429,1,240567
31708,0.001595,74.125.200.0-255,1484,91913,1,240567
31709,0.001609,172.31.36.0-255,66,91979,1,240567
31710,0.001617,74.125.200.0-255,7156,99135,1,240567
31711,0.001619,172.31.36.0-255,66,99201,1,240567
31712,0.001646,74.125.200.0-255,6438,105639,1,240567
31713,0.00165,172.31.36.0-255,66,105705,1,240567
31714,0.00185,74.125.200.0-255,1484,107189,1,240567
31715,0.001857,74.125.200.0-255,2902,110091,1,240567
31716,0.001862,172.31.36.0-255,66,110157,1,240567
31717,0.001896,74.125.200.0-255,5738,115895,1,240567
31718,0.001899,172.31.36.0-255,66,115961,1,240567
31719,0.001904,74.125.200.0-255,4320,120281,1,240567
31720,0.001906,172.31.36.0-255,66,120347,1,240567
31721,0.001911,74.125.200.0-255,2902,123249,1,240567
31722,0.001913,172.31.36.0-255,66,123315,1,240567
31723,0.001946,74.125.200.0-255,2902,126217,1,240567
31724,0.001948,172.31.36.0-255,66,126283,1,240567
31725,0.00196,172.31.36.0-255,66,126349,1,240567
31726,0.001964,74.125.200.0-255,2184,128533,1,240567
31727,0.001966,172.31.36.0-255,66,128599,1,240567
31728,0.001996,74.125.200.0-255,4320,132919,1,240567
31729,0.002,172.31.36.0-255,66,132985,1,240567
31730,0.002029,172.31.36.0-255,66,133051,1,240567
31731,0.002035,74.125.200.0-255,4320,137371,1,240567
31732,0.002037,172.31.36.0-255,66,137437,1,240567
31733,0.002077,172.31.36.0-255,66,137503,1,240567
31734,0.00208,74.125.200.0-255,766,138269,1,240567
31735,0.002166,172.31.36.0-255,66,138335,1,240567
31736,0.002182,172.31.36.0-255,66,138401,1,240567
31737,0.002193,172.31.36.0-255,66,138467,1,240567
31738,0.002199,74.125.200.0-255,5020,143487,1,240567
31739,0.002204,172.31.36.0-255,66,143553,1,240567
31740,0.002244,74.125.200.0-255,5738,149291,1,240567
31741,0.002249,172.31.36.0-255,66,149357,1,240567
31742,0.002268,74.125.200.0-255,5738,155095,1,240567
31743,0.002274,172.31.36.0-255,66,155161,1,240567
31744,0.002275,172.31.36.0-255,66,155227,1,240567
31745,0.002313,74.125.200.0-255,2902,158129,1,240567
31746,0.002317,172.31.36.0-255,66,158195,1,240567
31747,0.002353,172.31.36.0-255,66,158261,1,240567
31748,0.002356,74.125.200.0-255,1484,159745,1,240567
31749,0.002402,172.31.36.0-255,66,159811,1,240567
31750,0.002409,74.125.200.0-255,4320,164131,1,240567
31751,0.002411,172.31.36.0-255,66,164197,1,240567
31752,0.002431,74.125.200.0-255,766,164963,1,240567
31753,0.002438,74.125.200.0-255,5738,170701,1,240567
31754,0.00244,172.31.36.0-255,66,170767,1,240567
31755,0.002505,74.125.200.0-255,7156,177923,1,240567
31756,0.002519,74.125.200.0-255,5738,183661,1,240567
31757,0.002523,74.125.200.0-255,2184,185845,1,240567
31758,0.002546,74.125.200.0-255,1484,187329,1,240567
31759,0.003652,172.31.36.0-255,66,187395,1,240567
31760,0.006176,74.125.200.0-255,5738,193133,1,240567
31761,0.006183,172.31.36.0-255,66,193199,1,240567
31762,0.008707,74.125.200.0-255,5738,198937,1,240567
31763,0.00871,172.31.36.0-255,66,199003,1,240567
31764,0.011242,74.125.200.0-255,5738,204741,1,240567
31765,0.011249,172.31.36.0-255,66,204807,1,240567
31766,0.013776,74.125.200.0-255,5738,210545,1,240567
31767,0.013783,172.31.36.0-255,66,210611,1,240567
31768,0.016317,74.125.200.0-255,5738,216349,1,240567
31769,0.016327,172.31.36.0-255,66,216415,1,240567
31770,0.018867,74.125.200.0-255,5738,222153,1,240567
31771,0.018874,172.31.36.0-255,66,222219,1,240567
31772,0.021402,74.125.200.0-255,5738,227957,1,240567
31773,0.021416,172.31.36.0-255,66,228023,1,240567
31774,0.023956,74.125.200.0-255,3277,231300,1,240567
31775,0.023962,172.31.36.0-255,66,231366,1,240567
31776,0.024124,172.31.36.0-255,105,231471,1,240567
31777,0.026598,74.125.200.0-255,66,231537,1,240567
31778,0.036585,172.31.36.0-255,172,231709,1,240567
31779,0.036617,172.31.36.0-255,1113,232822,1,240567
31780,0.036667,172.31.36.0-255,1514,234336,1,240567
31781,0.036668,172.31.36.0-255,1514,235850,1,240567
31782,0.036669,172.31.36.0-255,1514,237364,1,240567
31783,0.036671,172.31.36.0-255,1514,238878,1,240567
31784,0.036696,172.31.36.0-255,1491,240369,1,240567
31785,0.038169,104.244.42.0-255,66,240435,1,240567
31786,0.03818,104.244.42.0-255,66,240501,1,240567
31787,0.038297,104.244.42.0-255,66,240567,1,240567
31788,0.0,74.125.24.0-255,153,153,1,242470
31789,3.5e-05,172.31.36.0-255,66,219,1,242470
31790,4.3e-05,74.125.24.0-255,1484,1703,1,242470
31791,4.7e-05,172.31.36.0-255,66,1769,1,242470
31792,6.1e-05,74.125.24.0-255,2902,4671,1,242470
31793,6.3e-05,172.31.36.0-255,66,4737,1,242470
31794,7e-05,74.125.24.0-255,7156,11893,1,242470
31795,7.3e-05,172.31.36.0-255,66,11959,1,242470
31796,7.7e-05,74.125.24.0-255,2076,14035,1,242470
31797,8e-05,172.31.36.0-255,66,14101,1,242470
31798,0.000112,74.125.24.0-255,2902,17003,1,242470
31799,0.000115,172.31.36.0-255,66,17069,1,242470
31800,0.000122,74.125.24.0-255,7156,24225,1,242470
31801,0.000124,172.31.36.0-255,66,24291,1,242470
31802,0.000163,74.125.24.0-255,6797,31088,1,242470
31803,0.000167,172.31.36.0-255,66,31154,1,242470
31804,0.000378,74.125.24.0-255,1484,32638,1,242470
31805,0.000383,172.31.36.0-255,66,32704,1,242470
31806,0.000389,74.125.24.0-255,2902,35606,1,242470
31807,0.000391,172.31.36.0-255,66,35672,1,242470
31808,0.000419,74.125.24.0-255,5738,41410,1,242470
31809,0.000424,172.31.36.0-255,66,41476,1,242470
31810,0.000427,74.125.24.0-255,1484,42960,1,242470
31811,0.000431,172.31.36.0-255,66,43026,1,242470
31812,0.000471,172.31.36.0-255,66,43092,1,242470
31813,0.000484,172.31.36.0-255,66,43158,1,242470
31814,0.000488,74.125.24.0-255,1424,44582,1,242470
31815,0.000491,172.31.36.0-255,66,44648,1,242470
31816,0.00076,74.125.24.0-255,381,45029,1,242470
31817,0.000765,172.31.36.0-255,66,45095,1,242470
31818,0.000864,74.125.24.0-255,1484,46579,1,242470
31819,0.00088,74.125.24.0-255,2902,49481,1,242470
31820,0.000884,172.31.36.0-255,66,49547,1,242470
31821,0.00089,74.125.24.0-255,4320,53867,1,242470
31822,0.000892,172.31.36.0-255,66,53933,1,242470
31823,0.000942,74.125.24.0-255,7156,61089,1,242470
31824,0.000946,172.31.36.0-255,66,61155,1,242470
31825,0.000977,74.125.24.0-255,1125,62280,1,242470
31826,0.000989,172.31.36.0-255,66,62346,1,242470
31827,0.000999,172.31.36.0-255,66,62412,1,242470
31828,0.001409,74.125.24.0-255,1484,63896,1,242470
31829,0.00142,74.125.24.0-255,2902,66798,1,242470
31830,0.001425,172.31.36.0-255,66,66864,1,242470
31831,0.001433,74.125.24.0-255,5738,72602,1,242470
31832,0.001435,172.31.36.0-255,66,72668,1,242470
31833,0.001485,172.31.36.0-255,66,72734,1,242470
31834,0.001497,172.31.36.0-255,66,72800,1,242470
31835,0.001924,74.125.24.0-255,1484,74284,1,242470
31836,0.001932,74.125.24.0-255,2902,77186,1,242470
31837,0.001936,172.31.36.0-255,66,77252,1,242470
31838,0.001943,74.125.24.0-255,5738,82990,1,242470
31839,0.001945,172.31.36.0-255,66,83056,1,242470
31840,0.00195,74.125.24.0-255,2902,85958,1,242470
31841,0.001958,172.31.36.0-255,66,86024,1,242470
31842,0.001981,74.125.24.0-255,2902,88926,1,242470
31843,0.001983,172.31.36.0-255,66,88992,1,242470
31844,0.001996,172.31.36.0-255,66,89058,1,242470
31845,0.002002,74.125.24.0-255,5020,94078,1,242470
31846,0.002004,172.31.36.0-255,66,94144,1,242470
31847,0.003942,74.125.24.0-255,5738,99882,1,242470
31848,0.003946,172.31.36.0-255,66,99948,1,242470
31849,0.005886,74.125.24.0-255,5738,105686,1,242470
31850,0.005891,172.31.36.0-255,66,105752,1,242470
31851,0.007835,74.125.24.0-255,5738,111490,1,242470
31852,0.007842,172.31.36.0-255,66,111556,1,242470
31853,0.009791,74.125.24.0-255,5738,117294,1,242470
31854,0.0098,172.31.36.0-255,66,117360,1,242470
31855,0.011763,74.125.24.0-255,5738,123098,1,242470
31856,0.01177,172.31.36.0-255,66,123164,1,242470
31857,0.013731,74.125.24.0-255,5738,128902,1,242470
31858,0.013739,172.31.36.0-255,66,128968,1,242470
31859,0.015695,74.125.24.0-255,5738,134706,1,242470
31860,0.015706,172.31.36.0-255,66,134772,1,242470
31861,0.017661,74.125.24.0-255,5738,140510,1,242470
31862,0.017668,172.31.36.0-255,66,140576,1,242470
31863,0.019601,74.125.24.0-255,5738,146314,1,242470
31864,0.019608,172.31.36.0-255,66,146380,1,242470
31865,0.021564,74.125.24.0-255,5738,152118,1,242470
31866,0.021573,172.31.36.0-255,66,152184,1,242470
31867,0.023519,74.125.24.0-255,5738,157922,1,242470
31868,0.023526,172.31.36.0-255,66,157988,1,242470
31869,0.025469,74.125.24.0-255,5738,163726,1,242470
31870,0.025476,172.31.36.0-255,66,163792,1,242470
31871,0.027455,74.125.24.0-255,5738,169530,1,242470
31872,0.02748,172.31.36.0-255,66,169596,1,242470
31873,0.029432,74.125.24.0-255,5738,175334,1,242470
31874,0.029439,172.31.36.0-255,66,175400,1,242470
31875,0.031398,74.125.24.0-255,5738,181138,1,242470
31876,0.031406,172.31.36.0-255,66,181204,1,242470
31877,0.03337,74.125.24.0-255,5738,186942,1,242470
31878,0.033383,172.31.36.0-255,66,187008,1,242470
31879,0.035335,74.125.24.0-255,5738,192746,1,242470
31880,0.035342,172.31.36.0-255,66,192812,1,242470
31881,0.037307,74.125.24.0-255,5738,198550,1,242470
31882,0.037314,172.31.36.0-255,66,198616,1,242470
31883,0.037658,172.31.36.0-255,172,198788,1,242470
31884,0.037688,172.31.36.0-255,1115,199903,1,242470
31885,0.037736,172.31.36.0-255,1514,201417,1,242470
31886,0.037737,172.31.36.0-255,1514,202931,1,242470
31887,0.037743,172.31.36.0-255,1514,204445,1,242470
31888,0.037744,172.31.36.0-255,1514,205959,1,242470
31889,0.037773,172.31.36.0-255,1489,207448,1,242470
31890,0.039217,104.244.42.0-255,66,207514,1,242470
31891,0.039257,74.125.24.0-255,5738,213252,1,242470
31892,0.039262,172.31.36.0-255,66,213318,1,242470
31893,0.039289,104.244.42.0-255,66,213384,1,242470
31894,0.039311,104.244.42.0-255,66,213450,1,242470
31895,0.041194,74.125.24.0-255,5738,219188,1,242470
31896,0.041221,172.31.36.0-255,66,219254,1,242470
31897,0.043175,74.125.24.0-255,5738,224992,1,242470
31898,0.043181,172.31.36.0-255,66,225058,1,242470
31899,0.045116,74.125.24.0-255,5738,230796,1,242470
31900,0.045124,172.31.36.0-255,66,230862,1,242470
31901,0.047077,74.125.24.0-255,5738,236600,1,242470
31902,0.047083,172.31.36.0-255,66,236666,1,242470
31903,0.049047,74.125.24.0-255,5738,242404,1,242470
31904,0.049054,172.31.36.0-255,66,242470,1,242470
31905,0.0,74.125.200.0-255,153,153,1,183436
31906,3.2e-05,172.31.36.0-255,66,219,1,183436
31907,3.9e-05,74.125.200.0-255,1484,1703,1,183436
31908,4.3e-05,172.31.36.0-255,66,1769,1,183436
31909,4.9e-05,74.125.200.0-255,2902,4671,1,183436
31910,5.1e-05,172.31.36.0-255,66,4737,1,183436
31911,5.6e-05,74.125.200.0-255,5738,10475,1,183436
31912,5.9e-05,172.31.36.0-255,66,10541,1,183436
31913,7.9e-05,74.125.200.0-255,1484,12025,1,183436
31914,8.2e-05,172.31.36.0-255,66,12091,1,183436
31915,8.6e-05,74.125.200.0-255,2047,14138,1,183436
31916,8.7e-05,172.31.36.0-255,66,14204,1,183436
31917,0.000126,74.125.200.0-255,1484,15688,1,183436
31918,0.000129,172.31.36.0-255,66,15754,1,183436
31919,0.000133,74.125.200.0-255,2902,18656,1,183436
31920,0.000136,172.31.36.0-255,66,18722,1,183436
31921,0.000154,74.125.200.0-255,5738,24460,1,183436
31922,0.000157,172.31.36.0-255,66,24526,1,183436
31923,0.00016,74.125.200.0-255,2902,27428,1,183436
31924,0.000162,172.31.36.0-255,66,27494,1,183436
31925,0.000211,74.125.200.0-255,3961,31455,1,183436
31926,0.000215,172.31.36.0-255,66,31521,1,183436
31927,0.000343,74.125.200.0-255,1484,33005,1,183436
31928,0.000348,172.31.36.0-255,66,33071,1,183436
31929,0.000352,74.125.200.0-255,2902,35973,1,183436
31930,0.000357,172.31.36.0-255,66,36039,1,183436
31931,0.000368,74.125.200.0-255,2902,38941,1,183436
31932,0.00037,172.31.36.0-255,66,39007,1,183436
31933,0.000375,74.125.200.0-255,2902,41909,1,183436
31934,0.000377,172.31.36.0-255,66,41975,1,183436
31935,0.000398,74.125.200.0-255,1484,43459,1,183436
31936,0.000401,172.31.36.0-255,66,43525,1,183436
31937,0.000404,74.125.200.0-255,1484,45009,1,183436
31938,0.000432,172.31.36.0-255,66,45075,1,183436
31939,0.000437,74.125.200.0-255,4320,49395,1,183436
31940,0.00044,172.31.36.0-255,66,49461,1,183436
31941,0.000499,172.31.36.0-255,66,49527,1,183436
31942,0.000567,74.125.200.0-255,109,49636,1,183436
31943,0.000606,74.125.200.0-255,333,49969,1,183436
31944,0.00081,172.31.36.0-255,66,50035,1,183436
31945,0.001249,74.125.200.0-255,1484,51519,1,183436
31946,0.001259,74.125.200.0-255,2902,54421,1,183436
31947,0.001264,172.31.36.0-255,66,54487,1,183436
31948,0.001268,74.125.200.0-255,1484,55971,1,183436
31949,0.001287,74.125.200.0-255,2902,58873,1,183436
31950,0.001289,172.31.36.0-255,66,58939,1,183436
31951,0.001296,74.125.200.0-255,5738,64677,1,183436
31952,0.001298,172.31.36.0-255,66,64743,1,183436
31953,0.001323,74.125.200.0-255,5738,70481,1,183436
31954,0.001326,172.31.36.0-255,66,70547,1,183436
31955,0.001351,74.125.200.0-255,2902,73449,1,183436
31956,0.001354,172.31.36.0-255,66,73515,1,183436
31957,0.001365,172.31.36.0-255,66,73581,1,183436
31958,0.001367,74.125.200.0-255,766,74347,1,183436
31959,0.00389,74.125.200.0-255,2902,77249,1,183436
31960,0.003894,172.31.36.0-255,66,77315,1,183436
31961,0.00391,74.125.200.0-255,1484,78799,1,183436
31962,0.006419,74.125.200.0-255,4320,83119,1,183436
31963,0.006425,172.31.36.0-255,66,83185,1,183436
31964,0.008962,74.125.200.0-255,5738,88923,1,183436
31965,0.008969,172.31.36.0-255,66,88989,1,183436
31966,0.011518,74.125.200.0-255,5738,94727,1,183436
31967,0.011527,172.31.36.0-255,66,94793,1,183436
31968,0.014073,74.125.200.0-255,5738,100531,1,183436
31969,0.014081,172.31.36.0-255,66,100597,1,183436
31970,0.016634,74.125.200.0-255,5738,106335,1,183436
31971,0.016642,172.31.36.0-255,66,106401,1,183436
31972,0.019185,74.125.200.0-255,5738,112139,1,183436
31973,0.019192,172.31.36.0-255,66,112205,1,183436
31974,0.021726,74.125.200.0-255,5738,117943,1,183436
31975,0.021733,172.31.36.0-255,66,118009,1,183436
31976,0.022967,172.31.36.0-255,172,118181,1,183436
31977,0.022998,172.31.36.0-255,1112,119293,1,183436
31978,0.023042,172.31.36.0-255,1514,120807,1,183436
31979,0.023044,172.31.36.0-255,1291,122098,1,183436
31980,0.024274,74.125.200.0-255,4320,126418,1,183436
31981,0.02428,172.31.36.0-255,66,126484,1,183436
31982,0.024306,74.125.200.0-255,1484,127968,1,183436
31983,0.024481,104.244.42.0-255,66,128034,1,183436
31984,0.02455,104.244.42.0-255,66,128100,1,183436
31985,0.024554,104.244.42.0-255,66,128166,1,183436
31986,0.026808,74.125.200.0-255,4320,132486,1,183436
31987,0.026814,172.31.36.0-255,66,132552,1,183436
31988,0.029349,74.125.200.0-255,4320,136872,1,183436
31989,0.029354,172.31.36.0-255,66,136938,1,183436
31990,0.029381,74.125.200.0-255,1484,138422,1,183436
31991,0.031869,74.125.200.0-255,4320,142742,1,183436
31992,0.031874,172.31.36.0-255,66,142808,1,183436
31993,0.034414,74.125.200.0-255,5738,148546,1,183436
31994,0.034418,172.31.36.0-255,66,148612,1,183436
31995,0.036947,74.125.200.0-255,5738,154350,1,183436
31996,0.036953,172.31.36.0-255,66,154416,1,183436
31997,0.039484,74.125.200.0-255,5738,160154,1,183436
31998,0.039489,172.31.36.0-255,66,160220,1,183436
31999,0.042293,74.125.200.0-255,5738,165958,1,183436
32000,0.042299,172.31.36.0-255,66,166024,1,183436
32001,0.044824,74.125.200.0-255,5738,171762,1,183436
32002,0.04483,172.31.36.0-255,66,171828,1,183436
32003,0.04736,74.125.200.0-255,5738,177566,1,183436
32004,0.047366,172.31.36.0-255,66,177632,1,183436
32005,0.049886,74.125.200.0-255,5738,183370,1,183436
32006,0.04989,172.31.36.0-255,66,183436,1,183436
32007,0.0,74.125.24.0-255,152,152,1,278066
32008,2.6e-05,172.31.36.0-255,66,218,1,278066
32009,3.3e-05,74.125.24.0-255,1484,1702,1,278066
32010,3.7e-05,172.31.36.0-255,66,1768,1,278066
32011,4.2e-05,74.125.24.0-255,2902,4670,1,278066
32012,5.2e-05,172.31.36.0-255,66,4736,1,278066
32013,5.8e-05,74.125.24.0-255,5738,10474,1,278066
32014,6.1e-05,172.31.36.0-255,66,10540,1,278066
32015,6.5e-05,74.125.24.0-255,2902,13442,1,278066
32016,6.8e-05,172.31.36.0-255,66,13508,1,278066
32017,0.000104,172.31.36.0-255,66,13574,1,278066
32018,0.000122,172.31.36.0-255,66,13640,1,278066
32019,0.000135,172.31.36.0-255,66,13706,1,278066
32020,0.00016,74.125.24.0-255,3602,17308,1,278066
32021,0.000168,172.31.36.0-255,66,17374,1,278066
32022,0.000173,74.125.24.0-255,1484,18858,1,278066
32023,0.000176,172.31.36.0-255,66,18924,1,278066
32024,0.000181,74.125.24.0-255,2902,21826,1,278066
32025,0.000183,172.31.36.0-255,66,21892,1,278066
32026,0.000218,74.125.24.0-255,5738,27630,1,278066
32027,0.000221,172.31.36.0-255,66,27696,1,278066
32028,0.000228,74.125.24.0-255,6797,34493,1,278066
32029,0.00023,172.31.36.0-255,66,34559,1,278066
32030,0.000342,74.125.24.0-255,1484,36043,1,278066
32031,0.000347,172.31.36.0-255,66,36109,1,278066
32032,0.000351,74.125.24.0-255,1484,37593,1,278066
32033,0.000353,172.31.36.0-255,66,37659,1,278066
32034,0.000372,74.125.24.0-255,1484,39143,1,278066
32035,0.000375,172.31.36.0-255,66,39209,1,278066
32036,0.000382,74.125.24.0-255,5738,44947,1,278066
32037,0.000384,172.31.36.0-255,66,45013,1,278066
32038,0.000396,74.125.24.0-255,7075,52088,1,278066
32039,0.000399,172.31.36.0-255,66,52154,1,278066
32040,0.000443,172.31.36.0-255,66,52220,1,278066
32041,0.000448,74.125.24.0-255,2834,55054,1,278066
32042,0.000451,172.31.36.0-255,66,55120,1,278066
32043,0.000531,74.125.24.0-255,1484,56604,1,278066
32044,0.00054,74.125.24.0-255,2902,59506,1,278066
32045,0.000544,172.31.36.0-255,66,59572,1,278066
32046,0.00055,74.125.24.0-255,4320,63892,1,278066
32047,0.000554,172.31.36.0-255,66,63958,1,278066
32048,0.000572,74.125.24.0-255,1484,65442,1,278066
32049,0.000584,74.125.24.0-255,6232,71674,1,278066
32050,0.000587,172.31.36.0-255,66,71740,1,278066
32051,0.000628,74.125.24.0-255,1484,73224,1,278066
32052,0.000632,74.125.24.0-255,2902,76126,1,278066
32053,0.000635,172.31.36.0-255,66,76192,1,278066
32054,0.00067,74.125.24.0-255,5738,81930,1,278066
32055,0.000675,172.31.36.0-255,66,81996,1,278066
32056,0.000682,74.125.24.0-255,5738,87734,1,278066
32057,0.000685,172.31.36.0-255,66,87800,1,278066
32058,0.00071,74.125.24.0-255,7156,94956,1,278066
32059,0.000713,172.31.36.0-255,66,95022,1,278066
32060,0.000752,172.31.36.0-255,66,95088,1,278066
32061,0.001205,74.125.24.0-255,1484,96572,1,278066
32062,0.001242,74.125.24.0-255,1484,98056,1,278066
32063,0.001246,172.31.36.0-255,66,98122,1,278066
32064,0.001271,74.125.24.0-255,1484,99606,1,278066
32065,0.001278,74.125.24.0-255,5738,105344,1,278066
32066,0.001281,172.31.36.0-255,66,105410,1,278066
32067,0.001288,74.125.24.0-255,7156,112566,1,278066
32068,0.00129,172.31.36.0-255,66,112632,1,278066
32069,0.001304,172.31.36.0-255,66,112698,1,278066
32070,0.001308,74.125.24.0-255,2184,114882,1,278066
32071,0.00131,172.31.36.0-255,66,114948,1,278066
32072,0.001925,74.125.24.0-255,1484,116432,1,278066
32073,0.001943,74.125.24.0-255,2902,119334,1,278066
32074,0.001947,172.31.36.0-255,66,119400,1,278066
32075,0.001977,74.125.24.0-255,5738,125138,1,278066
32076,0.00198,172.31.36.0-255,66,125204,1,278066
32077,0.002005,172.31.36.0-255,66,125270,1,278066
32078,0.002009,74.125.24.0-255,1484,126754,1,278066
32079,0.002039,74.125.24.0-255,4320,131074,1,278066
32080,0.002042,172.31.36.0-255,66,131140,1,278066
32081,0.00207,74.125.24.0-255,5020,136160,1,278066
32082,0.002073,172.31.36.0-255,66,136226,1,278066
32083,0.002102,74.125.24.0-255,4320,140546,1,278066
32084,0.002105,172.31.36.0-255,66,140612,1,278066
32085,0.002134,74.125.24.0-255,5738,146350,1,278066
32086,0.002138,74.125.24.0-255,2902,149252,1,278066
32087,0.002139,172.31.36.0-255,66,149318,1,278066
32088,0.002143,172.31.36.0-255,66,149384,1,278066
32089,0.002168,74.125.24.0-255,2902,152286,1,278066
32090,0.002172,172.31.36.0-255,66,152352,1,278066
32091,0.00218,74.125.24.0-255,2902,155254,1,278066
32092,0.002182,172.31.36.0-255,66,155320,1,278066
32093,0.002185,74.125.24.0-255,1484,156804,1,278066
32094,0.002188,74.125.24.0-255,1484,158288,1,278066
32095,0.00219,74.125.24.0-255,1484,159772,1,278066
32096,0.002191,172.31.36.0-255,66,159838,1,278066
32097,0.002225,74.125.24.0-255,5738,165576,1,278066
32098,0.002229,172.31.36.0-255,66,165642,1,278066
32099,0.002239,74.125.24.0-255,1484,167126,1,278066
32100,0.002273,74.125.24.0-255,3602,170728,1,278066
32101,0.002278,172.31.36.0-255,66,170794,1,278066
32102,0.002357,74.125.24.0-255,1484,172278,1,278066
32103,0.002361,74.125.24.0-255,1484,173762,1,278066
32104,0.002363,172.31.36.0-255,66,173828,1,278066
32105,0.002383,74.125.24.0-255,1484,175312,1,278066
32106,0.002388,74.125.24.0-255,2902,178214,1,278066
32107,0.00239,172.31.36.0-255,66,178280,1,278066
32108,0.002423,74.125.24.0-255,2902,181182,1,278066
32109,0.002426,172.31.36.0-255,66,181248,1,278066
32110,0.002431,74.125.24.0-255,2902,184150,1,278066
32111,0.002433,172.31.36.0-255,66,184216,1,278066
32112,0.002436,74.125.24.0-255,1484,185700,1,278066
32113,0.002449,74.125.24.0-255,7156,192856,1,278066
32114,0.002451,172.31.36.0-255,66,192922,1,278066
32115,0.002486,74.125.24.0-255,5738,198660,1,278066
32116,0.002491,172.31.36.0-255,66,198726,1,278066
32117,0.002496,74.125.24.0-255,4320,203046,1,278066
32118,0.002498,172.31.36.0-255,66,203112,1,278066
32119,0.002502,74.125.24.0-255,2184,205296,1,278066
32120,0.002511,172.31.36.0-255,66,205362,1,278066
32121,0.002721,74.125.24.0-255,1484,206846,1,278066
32122,0.002728,74.125.24.0-255,2902,209748,1,278066
32123,0.002731,172.31.36.0-255,66,209814,1,278066
32124,0.002736,74.125.24.0-255,2902,212716,1,278066
32125,0.002738,172.31.36.0-255,66,212782,1,278066
32126,0.002765,74.125.24.0-255,2902,215684,1,278066
32127,0.002768,172.31.36.0-255,66,215750,1,278066
32128,0.002774,74.125.24.0-255,5738,221488,1,278066
32129,0.002776,172.31.36.0-255,66,221554,1,278066
32130,0.00279,172.31.36.0-255,66,221620,1,278066
32131,0.002826,74.125.24.0-255,5020,226640,1,278066
32132,0.002829,172.31.36.0-255,66,226706,1,278066
32133,0.002857,74.125.24.0-255,1484,228190,1,278066
32134,0.002861,74.125.24.0-255,2902,231092,1,278066
32135,0.002863,172.31.36.0-255,66,231158,1,278066
32136,0.002867,74.125.24.0-255,2902,234060,1,278066
32137,0.002869,172.31.36.0-255,66,234126,1,278066
32138,0.002891,74.125.24.0-255,2902,237028,1,278066
32139,0.002893,172.31.36.0-255,66,237094,1,278066
32140,0.002898,74.125.24.0-255,4320,241414,1,278066
32141,0.0029,172.31.36.0-255,66,241480,1,278066
32142,0.002943,172.31.36.0-255,66,241546,1,278066
32143,0.002948,74.125.24.0-255,4320,245866,1,278066
32144,0.00295,172.31.36.0-255,66,245932,1,278066
32145,0.003024,74.125.24.0-255,6438,252370,1,278066
32146,0.003029,172.31.36.0-255,66,252436,1,278066
32147,0.003036,74.125.24.0-255,7156,259592,1,278066
32148,0.003038,172.31.36.0-255,66,259658,1,278066
32149,0.003055,172.31.36.0-255,66,259724,1,278066
32150,0.003065,172.31.36.0-255,66,259790,1,278066
32151,0.003075,172.31.36.0-255,66,259856,1,278066
32152,0.003107,74.125.24.0-255,2902,262758,1,278066
32153,0.00311,172.31.36.0-255,66,262824,1,278066
32154,0.003156,172.31.36.0-255,66,262890,1,278066
32155,0.003162,74.125.24.0-255,5468,268358,1,278066
32156,0.003165,172.31.36.0-255,66,268424,1,278066
32157,0.003174,74.125.24.0-255,97,268521,1,278066
32158,0.003196,74.125.24.0-255,105,268626,1,278066
32159,0.007246,172.31.36.0-255,66,268692,1,278066
32160,0.007274,172.31.36.0-255,105,268797,1,278066
32161,0.009214,74.125.24.0-255,66,268863,1,278066
32162,0.038671,172.31.36.0-255,172,269035,1,278066
32163,0.038707,172.31.36.0-255,1113,270148,1,278066
32164,0.03875,172.31.36.0-255,1514,271662,1,278066
32165,0.038752,172.31.36.0-255,1514,273176,1,278066
32166,0.038753,172.31.36.0-255,1514,274690,1,278066
32167,0.038754,172.31.36.0-255,1514,276204,1,278066
32168,0.038781,172.31.36.0-255,1490,277694,1,278066
32169,0.040253,104.244.42.0-255,66,277760,1,278066
32170,0.040263,104.244.42.0-255,66,277826,1,278066
32171,0.040358,104.244.42.0-255,66,277892,1,278066
32172,0.04109,104.244.42.0-255,108,278000,1,278066
32173,0.041115,172.31.36.0-255,66,278066,1,278066
32174,0.0,172.31.36.0-255,244,244,1,310
32175,0.006404,172.217.194.0-255,66,310,1,310
32176,0.0,74.125.68.0-255,146,146,1,165271
32177,3.5e-05,172.31.36.0-255,66,212,1,165271
32178,4.2e-05,74.125.68.0-255,1484,1696,1,165271
32179,4.6e-05,172.31.36.0-255,66,1762,1,165271
32180,7.4e-05,74.125.68.0-255,2902,4664,1,165271
32181,7.8e-05,172.31.36.0-255,66,4730,1,165271
32182,8.1e-05,74.125.68.0-255,1484,6214,1,165271
32183,8.3e-05,172.31.36.0-255,66,6280,1,165271
32184,9.9e-05,74.125.68.0-255,2902,9182,1,165271
32185,0.000102,172.31.36.0-255,66,9248,1,165271
32186,0.000188,74.125.68.0-255,5738,14986,1,165271
32187,0.000193,172.31.36.0-255,66,15052,1,165271
32188,0.000212,74.125.68.0-255,665,15717,1,165271
32189,0.000216,172.31.36.0-255,66,15783,1,165271
32190,0.000282,74.125.68.0-255,7156,22939,1,165271
32191,0.000289,172.31.36.0-255,66,23005,1,165271
32192,0.000404,74.125.68.0-255,4320,27325,1,165271
32193,0.000408,172.31.36.0-255,66,27391,1,165271
32194,0.000421,74.125.68.0-255,3961,31352,1,165271
32195,0.000425,172.31.36.0-255,66,31418,1,165271
32196,0.000558,74.125.68.0-255,1484,32902,1,165271
32197,0.000561,172.31.36.0-255,66,32968,1,165271
32198,0.000583,74.125.68.0-255,2902,35870,1,165271
32199,0.000586,172.31.36.0-255,66,35936,1,165271
32200,0.00063,74.125.68.0-255,4320,40256,1,165271
32201,0.000633,172.31.36.0-255,66,40322,1,165271
32202,0.000646,74.125.68.0-255,1484,41806,1,165271
32203,0.00065,172.31.36.0-255,66,41872,1,165271
32204,0.000731,74.125.68.0-255,4320,46192,1,165271
32205,0.000735,172.31.36.0-255,66,46258,1,165271
32206,0.000811,74.125.68.0-255,4320,50578,1,165271
32207,0.000815,172.31.36.0-255,66,50644,1,165271
32208,0.000847,172.31.36.0-255,66,50710,1,165271
32209,0.001092,74.125.68.0-255,3602,54312,1,165271
32210,0.001098,172.31.36.0-255,66,54378,1,165271
32211,0.001187,172.31.36.0-255,66,54444,1,165271
32212,0.001457,172.31.36.0-255,66,54510,1,165271
32213,0.001487,172.31.36.0-255,66,54576,1,165271
32214,0.001832,74.125.68.0-255,1484,56060,1,165271
32215,0.001867,172.31.36.0-255,66,56126,1,165271
32216,0.00191,172.31.36.0-255,66,56192,1,165271
32217,0.002653,74.125.68.0-255,4320,60512,1,165271
32218,0.002656,172.31.36.0-255,66,60578,1,165271
32219,0.002702,172.31.36.0-255,66,60644,1,165271
32220,0.003565,74.125.68.0-255,2902,63546,1,165271
32221,0.004503,74.125.68.0-255,7156,70702,1,165271
32222,0.006389,172.31.36.0-255,66,70768,1,165271
32223,0.009019,74.125.68.0-255,5738,76506,1,165271
32224,0.009025,172.31.36.0-255,66,76572,1,165271
32225,0.01165,74.125.68.0-255,5738,82310,1,165271
32226,0.011658,172.31.36.0-255,66,82376,1,165271
32227,0.014292,74.125.68.0-255,5738,88114,1,165271
32228,0.0143,172.31.36.0-255,66,88180,1,165271
32229,0.016939,74.125.68.0-255,5738,93918,1,165271
32230,0.016951,172.31.36.0-255,66,93984,1,165271
32231,0.019586,74.125.68.0-255,5738,99722,1,165271
32232,0.019594,172.31.36.0-255,66,99788,1,165271
32233,0.022235,74.125.68.0-255,5738,105526,1,165271
32234,0.022244,172.31.36.0-255,66,105592,1,165271
32235,0.024866,74.125.68.0-255,4320,109912,1,165271
32236,0.024873,172.31.36.0-255,66,109978,1,165271
32237,0.024905,74.125.68.0-255,1484,111462,1,165271
32238,0.027509,74.125.68.0-255,4320,115782,1,165271
32239,0.027516,172.31.36.0-255,66,115848,1,165271
32240,0.030142,74.125.68.0-255,5738,121586,1,165271
32241,0.030149,172.31.36.0-255,66,121652,1,165271
32242,0.032772,74.125.68.0-255,5738,127390,1,165271
32243,0.03278,172.31.36.0-255,66,127456,1,165271
32244,0.0354,74.125.68.0-255,5738,133194,1,165271
32245,0.035406,172.31.36.0-255,66,133260,1,165271
32246,0.037228,172.31.36.0-255,164,133424,1,165271
32247,0.037266,172.31.36.0-255,1121,134545,1,165271
32248,0.037302,172.31.36.0-255,1514,136059,1,165271
32249,0.037303,172.31.36.0-255,1280,137339,1,165271
32250,0.038038,74.125.68.0-255,5738,143077,1,165271
32251,0.038047,172.31.36.0-255,66,143143,1,165271
32252,0.038757,104.244.42.0-255,66,143209,1,165271
32253,0.038773,104.244.42.0-255,66,143275,1,165271
32254,0.038797,104.244.42.0-255,66,143341,1,165271
32255,0.040694,74.125.68.0-255,4320,147661,1,165271
32256,0.040699,172.31.36.0-255,66,147727,1,165271
32257,0.040728,74.125.68.0-255,1484,149211,1,165271
32258,0.043308,74.125.68.0-255,4320,153531,1,165271
32259,0.043313,172.31.36.0-255,66,153597,1,165271
32260,0.045925,74.125.68.0-255,5738,159335,1,165271
32261,0.045931,172.31.36.0-255,66,159401,1,165271
32262,0.048546,74.125.68.0-255,4320,163721,1,165271
32263,0.048552,172.31.36.0-255,66,163787,1,165271
32264,0.048582,74.125.68.0-255,1484,165271,1,165271
32265,0.0,74.125.24.0-255,153,153,1,267643
32266,3e-05,172.31.36.0-255,66,219,1,267643
32267,3.7e-05,74.125.24.0-255,1484,1703,1,267643
32268,4.1e-05,172.31.36.0-255,66,1769,1,267643
32269,4.5e-05,74.125.24.0-255,2902,4671,1,267643
32270,4.8e-05,172.31.36.0-255,66,4737,1,267643
32271,6.2e-05,74.125.24.0-255,7156,11893,1,267643
32272,6.5e-05,172.31.36.0-255,66,11959,1,267643
32273,6.9e-05,74.125.24.0-255,2067,14026,1,267643
32274,7.2e-05,172.31.36.0-255,66,14092,1,267643
32275,0.00012,74.125.24.0-255,1484,15576,1,267643
32276,0.000124,172.31.36.0-255,66,15642,1,267643
32277,0.00013,74.125.24.0-255,2902,18544,1,267643
32278,0.000132,172.31.36.0-255,66,18610,1,267643
32279,0.000169,74.125.24.0-255,5738,24348,1,267643
32280,0.000173,172.31.36.0-255,66,24414,1,267643
32281,0.000176,74.125.24.0-255,1484,25898,1,267643
32282,0.000178,172.31.36.0-255,66,25964,1,267643
32283,0.000231,74.125.24.0-255,5379,31343,1,267643
32284,0.000236,172.31.36.0-255,66,31409,1,267643
32285,0.000354,74.125.24.0-255,1484,32893,1,267643
32286,0.000358,172.31.36.0-255,66,32959,1,267643
32287,0.000384,74.125.24.0-255,2902,35861,1,267643
32288,0.00039,172.31.36.0-255,66,35927,1,267643
32289,0.000401,74.125.24.0-255,4320,40247,1,267643
32290,0.000408,172.31.36.0-255,66,40313,1,267643
32291,0.000437,74.125.24.0-255,1484,41797,1,267643
32292,0.00044,172.31.36.0-255,66,41863,1,267643
32293,0.000446,74.125.24.0-255,5738,47601,1,267643
32294,0.000449,172.31.36.0-255,66,47667,1,267643
32295,0.000457,74.125.24.0-255,1125,48792,1,267643
32296,0.00046,172.31.36.0-255,66,48858,1,267643
32297,0.000488,74.125.24.0-255,1484,50342,1,267643
32298,0.000509,74.125.24.0-255,4320,54662,1,267643
32299,0.000512,172.31.36.0-255,66,54728,1,267643
32300,0.000523,172.31.36.0-255,66,54794,1,267643
32301,0.000553,74.125.24.0-255,1484,56278,1,267643
32302,0.000568,74.125.24.0-255,1735,58013,1,267643
32303,0.000571,172.31.36.0-255,66,58079,1,267643
32304,0.00071,74.125.24.0-255,1484,59563,1,267643
32305,0.000715,74.125.24.0-255,2902,62465,1,267643
32306,0.000718,172.31.36.0-255,66,62531,1,267643
32307,0.000721,74.125.24.0-255,1484,64015,1,267643
32308,0.000746,74.125.24.0-255,4320,68335,1,267643
32309,0.000749,172.31.36.0-255,66,68401,1,267643
32310,0.000778,74.125.24.0-255,6797,75198,1,267643
32311,0.000782,172.31.36.0-255,66,75264,1,267643
32312,0.000802,74.125.24.0-255,4320,79584,1,267643
32313,0.000805,172.31.36.0-255,66,79650,1,267643
32314,0.000832,74.125.24.0-255,2902,82552,1,267643
32315,0.000835,172.31.36.0-255,66,82618,1,267643
32316,0.000842,74.125.24.0-255,7156,89774,1,267643
32317,0.000844,172.31.36.0-255,66,89840,1,267643
32318,0.000872,74.125.24.0-255,2543,92383,1,267643
32319,0.000875,172.31.36.0-255,66,92449,1,267643
32320,0.00125,74.125.24.0-255,1484,93933,1,267643
32321,0.001261,74.125.24.0-255,2902,96835,1,267643
32322,0.001265,172.31.36.0-255,66,96901,1,267643
32323,0.001273,74.125.24.0-255,5738,102639,1,267643
32324,0.001275,172.31.36.0-255,66,102705,1,267643
32325,0.001278,74.125.24.0-255,1484,104189,1,267643
32326,0.001312,74.125.24.0-255,5738,109927,1,267643
32327,0.001316,172.31.36.0-255,66,109993,1,267643
32328,0.001323,74.125.24.0-255,5738,115731,1,267643
32329,0.001326,172.31.36.0-255,66,115797,1,267643
32330,0.001368,172.31.36.0-255,66,115863,1,267643
32331,0.001372,74.125.24.0-255,2184,118047,1,267643
32332,0.001373,172.31.36.0-255,66,118113,1,267643
32333,0.002127,74.125.24.0-255,1484,119597,1,267643
32334,0.002136,74.125.24.0-255,1484,121081,1,267643
32335,0.00214,172.31.36.0-255,66,121147,1,267643
32336,0.002167,74.125.24.0-255,1484,122631,1,267643
32337,0.002174,74.125.24.0-255,5738,128369,1,267643
32338,0.002176,172.31.36.0-255,66,128435,1,267643
32339,0.002186,172.31.36.0-255,66,128501,1,267643
32340,0.002218,74.125.24.0-255,2902,131403,1,267643
32341,0.00222,172.31.36.0-255,66,131469,1,267643
32342,0.002227,74.125.24.0-255,5738,137207,1,267643
32343,0.002228,172.31.36.0-255,66,137273,1,267643
32344,0.002249,74.125.24.0-255,5020,142293,1,267643
32345,0.002251,172.31.36.0-255,66,142359,1,267643
32346,0.004521,74.125.24.0-255,5738,148097,1,267643
32347,0.004527,172.31.36.0-255,66,148163,1,267643
32348,0.00681,74.125.24.0-255,5738,153901,1,267643
32349,0.006816,172.31.36.0-255,66,153967,1,267643
32350,0.009323,74.125.24.0-255,5738,159705,1,267643
32351,0.009385,172.31.36.0-255,66,159771,1,267643
32352,0.011712,74.125.24.0-255,5738,165509,1,267643
32353,0.011729,172.31.36.0-255,66,165575,1,267643
32354,0.014052,74.125.24.0-255,5738,171313,1,267643
32355,0.014068,172.31.36.0-255,66,171379,1,267643
32356,0.016355,74.125.24.0-255,5738,177117,1,267643
32357,0.01637,172.31.36.0-255,66,177183,1,267643
32358,0.018666,74.125.24.0-255,5738,182921,1,267643
32359,0.018671,172.31.36.0-255,66,182987,1,267643
32360,0.020961,74.125.24.0-255,5738,188725,1,267643
32361,0.020972,172.31.36.0-255,66,188791,1,267643
32362,0.023272,74.125.24.0-255,5738,194529,1,267643
32363,0.023287,172.31.36.0-255,66,194595,1,267643
32364,0.025578,74.125.24.0-255,5738,200333,1,267643
32365,0.025595,172.31.36.0-255,66,200399,1,267643
32366,0.027866,74.125.24.0-255,5738,206137,1,267643
32367,0.027876,172.31.36.0-255,66,206203,1,267643
32368,0.030143,74.125.24.0-255,5738,211941,1,267643
32369,0.030151,172.31.36.0-255,66,212007,1,267643
32370,0.032438,74.125.24.0-255,5738,217745,1,267643
32371,0.032449,172.31.36.0-255,66,217811,1,267643
32372,0.034743,74.125.24.0-255,5738,223549,1,267643
32373,0.034753,172.31.36.0-255,66,223615,1,267643
32374,0.037044,74.125.24.0-255,5738,229353,1,267643
32375,0.037052,172.31.36.0-255,66,229419,1,267643
32376,0.039103,172.31.36.0-255,172,229591,1,267643
32377,0.039192,172.31.36.0-255,1114,230705,1,267643
32378,0.039329,74.125.24.0-255,5738,236443,1,267643
32379,0.039336,172.31.36.0-255,66,236509,1,267643
32380,0.039508,172.31.36.0-255,1514,238023,1,267643
32381,0.039511,172.31.36.0-255,1514,239537,1,267643
32382,0.039512,172.31.36.0-255,1514,241051,1,267643
32383,0.039517,172.31.36.0-255,1514,242565,1,267643
32384,0.039518,172.31.36.0-255,1490,244055,1,267643
32385,0.04067,104.244.42.0-255,66,244121,1,267643
32386,0.040803,104.244.42.0-255,66,244187,1,267643
32387,0.041079,104.244.42.0-255,66,244253,1,267643
32388,0.041617,104.244.42.0-255,108,244361,1,267643
32389,0.041639,172.31.36.0-255,66,244427,1,267643
32390,0.041644,74.125.24.0-255,5738,250165,1,267643
32391,0.041647,172.31.36.0-255,66,250231,1,267643
32392,0.043926,74.125.24.0-255,5738,255969,1,267643
32393,0.043932,172.31.36.0-255,66,256035,1,267643
32394,0.046215,74.125.24.0-255,5738,261773,1,267643
32395,0.046221,172.31.36.0-255,66,261839,1,267643
32396,0.048524,74.125.24.0-255,5738,267577,1,267643
32397,0.04853,172.31.36.0-255,66,267643,1,267643
32398,0.0,74.125.68.0-255,153,153,1,279827
32399,1.9e-05,172.31.36.0-255,66,219,1,279827
32400,2.7e-05,74.125.68.0-255,1484,1703,1,279827
32401,3.1e-05,172.31.36.0-255,66,1769,1,279827
32402,4.5e-05,74.125.68.0-255,2902,4671,1,279827
32403,4.8e-05,172.31.36.0-255,66,4737,1,279827
32404,5.6e-05,74.125.68.0-255,7156,11893,1,279827
32405,6e-05,172.31.36.0-255,66,11959,1,279827
32406,6.4e-05,74.125.68.0-255,1992,13951,1,279827
32407,6.7e-05,172.31.36.0-255,66,14017,1,279827
32408,8.8e-05,74.125.68.0-255,2902,16919,1,279827
32409,9.5e-05,172.31.36.0-255,66,16985,1,279827
32410,0.000123,74.125.68.0-255,2902,19887,1,279827
32411,0.000125,172.31.36.0-255,66,19953,1,279827
32412,0.000153,74.125.68.0-255,4320,24273,1,279827
32413,0.000156,172.31.36.0-255,66,24339,1,279827
32414,0.000217,74.125.68.0-255,2902,27241,1,279827
32415,0.00022,172.31.36.0-255,66,27307,1,279827
32416,0.00024,74.125.68.0-255,3961,31268,1,279827
32417,0.000243,172.31.36.0-255,66,31334,1,279827
32418,0.000285,74.125.68.0-255,1484,32818,1,279827
32419,0.000287,172.31.36.0-255,66,32884,1,279827
32420,0.000292,74.125.68.0-255,2902,35786,1,279827
32421,0.000295,172.31.36.0-255,66,35852,1,279827
32422,0.000324,74.125.68.0-255,1484,37336,1,279827
32423,0.000326,172.31.36.0-255,66,37402,1,279827
32424,0.000354,74.125.68.0-255,4320,41722,1,279827
32425,0.000357,172.31.36.0-255,66,41788,1,279827
32426,0.000364,74.125.68.0-255,5738,47526,1,279827
32427,0.000366,172.31.36.0-255,66,47592,1,279827
32428,0.000386,74.125.68.0-255,1125,48717,1,279827
32429,0.000389,172.31.36.0-255,66,48783,1,279827
32430,0.000447,74.125.68.0-255,1484,50267,1,279827
32431,0.000471,74.125.68.0-255,6797,57064,1,279827
32432,0.000482,74.125.68.0-255,678,57742,1,279827
32433,0.000573,172.31.36.0-255,66,57808,1,279827
32434,0.000929,74.125.68.0-255,1484,59292,1,279827
32435,0.000934,74.125.68.0-255,1484,60776,1,279827
32436,0.000943,172.31.36.0-255,66,60842,1,279827
32437,0.000952,74.125.68.0-255,1484,62326,1,279827
32438,0.000975,74.125.68.0-255,5738,68064,1,279827
32439,0.000996,74.125.68.0-255,2902,70966,1,279827
32440,0.00101,74.125.68.0-255,2902,73868,1,279827
32441,0.001012,172.31.36.0-255,66,73934,1,279827
32442,0.00102,74.125.68.0-255,1484,75418,1,279827
32443,0.001035,74.125.68.0-255,1484,76902,1,279827
32444,0.001038,172.31.36.0-255,66,76968,1,279827
32445,0.001049,74.125.68.0-255,2902,79870,1,279827
32446,0.001068,74.125.68.0-255,4320,84190,1,279827
32447,0.001087,172.31.36.0-255,66,84256,1,279827
32448,0.001094,74.125.68.0-255,1484,85740,1,279827
32449,0.001113,74.125.68.0-255,2902,88642,1,279827
32450,0.00114,172.31.36.0-255,66,88708,1,279827
32451,0.001153,74.125.68.0-255,3602,92310,1,279827
32452,0.001163,172.31.36.0-255,66,92376,1,279827
32453,0.001712,74.125.68.0-255,1484,93860,1,279827
32454,0.001721,74.125.68.0-255,2902,96762,1,279827
32455,0.001725,172.31.36.0-255,66,96828,1,279827
32456,0.00173,74.125.68.0-255,1484,98312,1,279827
32457,0.001756,74.125.68.0-255,2902,101214,1,279827
32458,0.00177,74.125.68.0-255,2902,104116,1,279827
32459,0.001791,74.125.68.0-255,2902,107018,1,279827
32460,0.001799,74.125.68.0-255,7156,114174,1,279827
32461,0.001811,74.125.68.0-255,1484,115658,1,279827
32462,0.001857,74.125.68.0-255,5738,121396,1,279827
32463,0.001875,74.125.68.0-255,4320,125716,1,279827
32464,0.001878,74.125.68.0-255,766,126482,1,279827
32465,0.001952,74.125.68.0-255,1484,127966,1,279827
32466,0.001973,74.125.68.0-255,2902,130868,1,279827
32467,0.00198,74.125.68.0-255,5738,136606,1,279827
32468,0.001984,74.125.68.0-255,2902,139508,1,279827
32469,0.002007,74.125.68.0-255,4320,143828,1,279827
32470,0.002035,74.125.68.0-255,2902,146730,1,279827
32471,0.002059,74.125.68.0-255,5738,152468,1,279827
32472,0.002065,74.125.68.0-255,5738,158206,1,279827
32473,0.002104,74.125.68.0-255,2184,160390,1,279827
32474,0.005364,172.31.36.0-255,66,160456,1,279827
32475,0.007577,74.125.68.0-255,1484,161940,1,279827
32476,0.007599,74.125.68.0-255,4320,166260,1,279827
32477,0.007603,172.31.36.0-255,66,166326,1,279827
32478,0.009814,74.125.68.0-255,5738,172064,1,279827
32479,0.009822,172.31.36.0-255,66,172130,1,279827
32480,0.012039,74.125.68.0-255,5738,177868,1,279827
32481,0.012047,172.31.36.0-255,66,177934,1,279827
32482,0.014253,74.125.68.0-255,5738,183672,1,279827
32483,0.014261,172.31.36.0-255,66,183738,1,279827
32484,0.016481,74.125.68.0-255,5738,189476,1,279827
32485,0.016491,172.31.36.0-255,66,189542,1,279827
32486,0.018701,74.125.68.0-255,5738,195280,1,279827
32487,0.018829,172.31.36.0-255,66,195346,1,279827
32488,0.021056,74.125.68.0-255,5738,201084,1,279827
32489,0.021064,172.31.36.0-255,66,201150,1,279827
32490,0.023276,74.125.68.0-255,5738,206888,1,279827
32491,0.023283,172.31.36.0-255,66,206954,1,279827
32492,0.02549,74.125.68.0-255,5738,212692,1,279827
32493,0.025497,172.31.36.0-255,66,212758,1,279827
32494,0.027713,74.125.68.0-255,5738,218496,1,279827
32495,0.02772,172.31.36.0-255,66,218562,1,279827
32496,0.029944,74.125.68.0-255,5738,224300,1,279827
32497,0.029951,172.31.36.0-255,66,224366,1,279827
32498,0.032166,74.125.68.0-255,5738,230104,1,279827
32499,0.032174,172.31.36.0-255,66,230170,1,279827
32500,0.03438,74.125.68.0-255,5738,235908,1,279827
32501,0.034388,172.31.36.0-255,66,235974,1,279827
32502,0.036598,74.125.68.0-255,5738,241712,1,279827
32503,0.036606,172.31.36.0-255,66,241778,1,279827
32504,0.038837,74.125.68.0-255,5738,247516,1,279827
32505,0.038844,172.31.36.0-255,66,247582,1,279827
32506,0.039839,172.31.36.0-255,172,247754,1,279827
32507,0.039871,172.31.36.0-255,1113,248867,1,279827
32508,0.039937,172.31.36.0-255,1514,250381,1,279827
32509,0.039939,172.31.36.0-255,1514,251895,1,279827
32510,0.03994,172.31.36.0-255,1514,253409,1,279827
32511,0.039941,172.31.36.0-255,1514,254923,1,279827
32512,0.039968,172.31.36.0-255,1490,256413,1,279827
32513,0.041078,74.125.68.0-255,5738,262151,1,279827
32514,0.041086,172.31.36.0-255,66,262217,1,279827
32515,0.041429,104.244.42.0-255,66,262283,1,279827
32516,0.041438,104.244.42.0-255,66,262349,1,279827
32517,0.041513,104.244.42.0-255,66,262415,1,279827
32518,0.043311,74.125.68.0-255,5738,268153,1,279827
32519,0.043319,172.31.36.0-255,66,268219,1,279827
32520,0.045541,74.125.68.0-255,5738,273957,1,279827
32521,0.045548,172.31.36.0-255,66,274023,1,279827
32522,0.047779,74.125.68.0-255,5738,279761,1,279827
32523,0.047786,172.31.36.0-255,66,279827,1,279827
32524,0.0,172.217.194.0-255,153,153,1,218240
32525,3.2e-05,172.31.36.0-255,66,219,1,218240
32526,3.9e-05,172.217.194.0-255,1484,1703,1,218240
32527,4.4e-05,172.31.36.0-255,66,1769,1,218240
32528,4.9e-05,172.217.194.0-255,2902,4671,1,218240
32529,5.2e-05,172.31.36.0-255,66,4737,1,218240
32530,5.8e-05,172.217.194.0-255,5738,10475,1,218240
32531,6e-05,172.31.36.0-255,66,10541,1,218240
32532,9.4e-05,172.31.36.0-255,66,10607,1,218240
32533,0.000101,172.217.194.0-255,6797,17404,1,218240
32534,0.000103,172.31.36.0-255,66,17470,1,218240
32535,0.000173,172.217.194.0-255,1484,18954,1,218240
32536,0.000178,172.31.36.0-255,66,19020,1,218240
32537,0.00019,172.217.194.0-255,2902,21922,1,218240
32538,0.000193,172.31.36.0-255,66,21988,1,218240
32539,0.000222,172.217.194.0-255,5738,27726,1,218240
32540,0.000226,172.31.36.0-255,66,27792,1,218240
32541,0.000257,172.31.36.0-255,66,27858,1,218240
32542,0.00029,172.217.194.0-255,5738,33596,1,218240
32543,0.000293,172.31.36.0-255,66,33662,1,218240
32544,0.000309,172.217.194.0-255,5667,39329,1,218240
32545,0.000313,172.31.36.0-255,66,39395,1,218240
32546,0.000316,172.217.194.0-255,99,39494,1,218240
32547,0.000318,172.31.36.0-255,66,39560,1,218240
32548,0.000378,172.217.194.0-255,1484,41044,1,218240
32549,0.000381,172.31.36.0-255,66,41110,1,218240
32550,0.000385,172.217.194.0-255,1484,42594,1,218240
32551,0.000387,172.31.36.0-255,66,42660,1,218240
32552,0.000407,172.217.194.0-255,1484,44144,1,218240
32553,0.000412,172.217.194.0-255,5738,49882,1,218240
32554,0.000413,172.31.36.0-255,66,49948,1,218240
32555,0.000417,172.31.36.0-255,66,50014,1,218240
32556,0.000456,172.217.194.0-255,6797,56811,1,218240
32557,0.000459,172.31.36.0-255,66,56877,1,218240
32558,0.000467,172.217.194.0-255,7156,64033,1,218240
32559,0.00047,172.31.36.0-255,66,64099,1,218240
32560,0.000492,172.217.194.0-255,1484,65583,1,218240
32561,0.000523,172.31.36.0-255,66,65649,1,218240
32562,0.00056,172.217.194.0-255,1484,67133,1,218240
32563,0.000572,172.217.194.0-255,2902,70035,1,218240
32564,0.000576,172.31.36.0-255,66,70101,1,218240
32565,0.000579,172.217.194.0-255,1484,71585,1,218240
32566,0.000597,172.217.194.0-255,2902,74487,1,218240
32567,0.000601,172.31.36.0-255,66,74553,1,218240
32568,0.000609,172.217.194.0-255,1484,76037,1,218240
32569,0.000628,172.217.194.0-255,7156,83193,1,218240
32570,0.000632,172.31.36.0-255,66,83259,1,218240
32571,0.000662,172.217.194.0-255,7156,90415,1,218240
32572,0.000666,172.31.36.0-255,66,90481,1,218240
32573,0.000687,172.31.36.0-255,66,90547,1,218240
32574,0.000757,172.217.194.0-255,1484,92031,1,218240
32575,0.000777,172.217.194.0-255,2902,94933,1,218240
32576,0.000781,172.31.36.0-255,66,94999,1,218240
32577,0.000784,172.217.194.0-255,1484,96483,1,218240
32578,0.000804,172.217.194.0-255,4320,100803,1,218240
32579,0.000807,172.31.36.0-255,66,100869,1,218240
32580,0.000814,172.217.194.0-255,7156,108025,1,218240
32581,0.000816,172.31.36.0-255,66,108091,1,218240
32582,0.00083,172.217.194.0-255,2902,110993,1,218240
32583,0.000832,172.31.36.0-255,66,111059,1,218240
32584,0.000865,172.31.36.0-255,66,111125,1,218240
32585,0.000869,172.217.194.0-255,2184,113309,1,218240
32586,0.000872,172.31.36.0-255,66,113375,1,218240
32587,0.001028,172.217.194.0-255,1484,114859,1,218240
32588,0.001033,172.217.194.0-255,2902,117761,1,218240
32589,0.001036,172.31.36.0-255,66,117827,1,218240
32590,0.00104,172.217.194.0-255,1484,119311,1,218240
32591,0.001061,172.217.194.0-255,4320,123631,1,218240
32592,0.001064,172.31.36.0-255,66,123697,1,218240
32593,0.001069,172.217.194.0-255,4320,128017,1,218240
32594,0.001071,172.31.36.0-255,66,128083,1,218240
32595,0.001087,172.217.194.0-255,4320,132403,1,218240
32596,0.00109,172.31.36.0-255,66,132469,1,218240
32597,0.001115,172.217.194.0-255,7156,139625,1,218240
32598,0.001119,172.31.36.0-255,66,139691,1,218240
32599,0.001131,172.31.36.0-255,66,139757,1,218240
32600,0.001134,172.217.194.0-255,1484,141241,1,218240
32601,0.001159,172.217.194.0-255,7156,148397,1,218240
32602,0.001163,172.31.36.0-255,66,148463,1,218240
32603,0.001167,172.217.194.0-255,2902,151365,1,218240
32604,0.00117,172.31.36.0-255,66,151431,1,218240
32605,0.001195,172.31.36.0-255,66,151497,1,218240
32606,0.001217,172.217.194.0-255,1484,152981,1,218240
32607,0.001232,172.217.194.0-255,5738,158719,1,218240
32608,0.001236,172.31.36.0-255,66,158785,1,218240
32609,0.001247,172.217.194.0-255,5020,163805,1,218240
32610,0.00125,172.31.36.0-255,66,163871,1,218240
32611,0.001293,172.217.194.0-255,1484,165355,1,218240
32612,0.001315,172.217.194.0-255,2902,168257,1,218240
32613,0.001318,172.31.36.0-255,66,168323,1,218240
32614,0.001323,172.217.194.0-255,2902,171225,1,218240
32615,0.001326,172.31.36.0-255,66,171291,1,218240
32616,0.001331,172.217.194.0-255,4320,175611,1,218240
32617,0.001334,172.31.36.0-255,66,175677,1,218240
32618,0.001348,172.217.194.0-255,2902,178579,1,218240
32619,0.001351,172.31.36.0-255,66,178645,1,218240
32620,0.001373,172.217.194.0-255,4320,182965,1,218240
32621,0.001376,172.31.36.0-255,66,183031,1,218240
32622,0.001408,172.217.194.0-255,3602,186633,1,218240
32623,0.001409,172.31.36.0-255,66,186699,1,218240
32624,0.001412,172.31.36.0-255,66,186765,1,218240
32625,0.001474,172.217.194.0-255,1484,188249,1,218240
32626,0.001495,172.217.194.0-255,2902,191151,1,218240
32627,0.001499,172.31.36.0-255,66,191217,1,218240
32628,0.001502,172.217.194.0-255,1484,192701,1,218240
32629,0.001518,172.217.194.0-255,4320,197021,1,218240
32630,0.001521,172.31.36.0-255,66,197087,1,218240
32631,0.001525,172.217.194.0-255,1484,198571,1,218240
32632,0.001553,172.31.36.0-255,66,198637,1,218240
32633,0.001571,172.217.194.0-255,1484,200121,1,218240
32634,0.001579,172.217.194.0-255,7156,207277,1,218240
32635,0.001582,172.31.36.0-255,66,207343,1,218240
32636,0.001605,172.217.194.0-255,6438,213781,1,218240
32637,0.001608,172.31.36.0-255,66,213847,1,218240
32638,0.001619,172.31.36.0-255,66,213913,1,218240
32639,0.0017,172.31.36.0-255,66,213979,1,218240
32640,0.001722,172.31.36.0-255,66,214045,1,218240
32641,0.001738,172.31.36.0-255,66,214111,1,218240
32642,0.001756,172.31.36.0-255,66,214177,1,218240
32643,0.001795,172.31.36.0-255,66,214243,1,218240
32644,0.001811,172.31.36.0-255,66,214309,1,218240
32645,0.001852,172.31.36.0-255,66,214375,1,218240
32646,0.001856,172.217.194.0-255,97,214472,1,218240
32647,0.001858,172.217.194.0-255,105,214577,1,218240
32648,0.002889,172.31.36.0-255,101,214678,1,218240
32649,0.003713,172.31.36.0-255,105,214783,1,218240
32650,0.004909,172.217.194.0-255,66,214849,1,218240
32651,0.005706,172.217.194.0-255,66,214915,1,218240
32652,0.027507,172.31.36.0-255,172,215087,1,218240
32653,0.027539,172.31.36.0-255,1114,216201,1,218240
32654,0.027582,172.31.36.0-255,1514,217715,1,218240
32655,0.027583,172.31.36.0-255,327,218042,1,218240
32656,0.029056,104.244.42.0-255,66,218108,1,218240
32657,0.029093,104.244.42.0-255,66,218174,1,218240
32658,0.029142,104.244.42.0-255,66,218240,1,218240
32659,0.0,172.253.118.0-255,146,146,1,319456
32660,2.4e-05,172.31.36.0-255,66,212,1,319456
32661,3.1e-05,172.253.118.0-255,1484,1696,1,319456
32662,3.5e-05,172.31.36.0-255,66,1762,1,319456
32663,4.2e-05,172.253.118.0-255,2902,4664,1,319456
32664,4.6e-05,172.31.36.0-255,66,4730,1,319456
32665,6.2e-05,172.253.118.0-255,7156,11886,1,319456
32666,6.5e-05,172.31.36.0-255,66,11952,1,319456
32667,6.9e-05,172.253.118.0-255,2104,14056,1,319456
32668,7.1e-05,172.31.36.0-255,66,14122,1,319456
32669,0.000128,172.31.36.0-255,66,14188,1,319456
32670,0.000135,172.253.118.0-255,5379,19567,1,319456
32671,0.000138,172.31.36.0-255,66,19633,1,319456
32672,0.000195,172.253.118.0-255,1484,21117,1,319456
32673,0.000198,172.31.36.0-255,66,21183,1,319456
32674,0.000203,172.253.118.0-255,2902,24085,1,319456
32675,0.000205,172.31.36.0-255,66,24151,1,319456
32676,0.000212,172.253.118.0-255,5738,29889,1,319456
32677,0.000215,172.31.36.0-255,66,29955,1,319456
32678,0.000222,172.253.118.0-255,6797,36752,1,319456
32679,0.000224,172.31.36.0-255,66,36818,1,319456
32680,0.000391,172.253.118.0-255,1484,38302,1,319456
32681,0.000397,172.31.36.0-255,66,38368,1,319456
32682,0.000402,172.253.118.0-255,2902,41270,1,319456
32683,0.000405,172.31.36.0-255,66,41336,1,319456
32684,0.00041,172.253.118.0-255,2902,44238,1,319456
32685,0.000412,172.31.36.0-255,66,44304,1,319456
32686,0.000425,172.253.118.0-255,7156,51460,1,319456
32687,0.000427,172.31.36.0-255,66,51526,1,319456
32688,0.000454,172.253.118.0-255,2543,54069,1,319456
32689,0.000457,172.31.36.0-255,66,54135,1,319456
32690,0.000553,172.253.118.0-255,1484,55619,1,319456
32691,0.000558,172.253.118.0-255,1484,57103,1,319456
32692,0.000561,172.31.36.0-255,66,57169,1,319456
32693,0.000591,172.253.118.0-255,1484,58653,1,319456
32694,0.000598,172.253.118.0-255,5738,64391,1,319456
32695,0.000601,172.31.36.0-255,66,64457,1,319456
32696,0.000613,172.31.36.0-255,66,64523,1,319456
32697,0.000628,172.253.118.0-255,3961,68484,1,319456
32698,0.000631,172.31.36.0-255,66,68550,1,319456
32699,0.00067,172.31.36.0-255,66,68616,1,319456
32700,0.000674,172.253.118.0-255,1705,70321,1,319456
32701,0.00068,172.31.36.0-255,66,70387,1,319456
32702,0.000747,172.253.118.0-255,1484,71871,1,319456
32703,0.000764,172.253.118.0-255,2902,74773,1,319456
32704,0.000771,172.253.118.0-255,4320,79093,1,319456
32705,0.000782,172.253.118.0-255,1484,80577,1,319456
32706,0.000798,172.31.36.0-255,66,80643,1,319456
32707,0.000832,172.253.118.0-255,6234,86877,1,319456
32708,0.000848,172.31.36.0-255,66,86943,1,319456
32709,0.001005,172.253.118.0-255,1484,88427,1,319456
32710,0.001011,172.253.118.0-255,2902,91329,1,319456
32711,0.001014,172.31.36.0-255,66,91395,1,319456
32712,0.001043,172.253.118.0-255,5738,97133,1,319456
32713,0.00105,172.253.118.0-255,5738,102871,1,319456
32714,0.001059,172.31.36.0-255,66,102937,1,319456
32715,0.001118,172.253.118.0-255,5020,107957,1,319456
32716,0.001138,172.31.36.0-255,66,108023,1,319456
32717,0.001469,172.253.118.0-255,1484,109507,1,319456
32718,0.001476,172.253.118.0-255,2902,112409,1,319456
32719,0.00148,172.31.36.0-255,66,112475,1,319456
32720,0.001513,172.253.118.0-255,5738,118213,1,319456
32721,0.001519,172.253.118.0-255,2902,121115,1,319456
32722,0.001532,172.253.118.0-255,4320,125435,1,319456
32723,0.001548,172.253.118.0-255,5738,131173,1,319456
32724,0.001575,172.31.36.0-255,66,131239,1,319456
32725,0.001684,172.253.118.0-255,1484,132723,1,319456
32726,0.001701,172.253.118.0-255,2902,135625,1,319456
32727,0.001704,172.31.36.0-255,66,135691,1,319456
32728,0.001711,172.253.118.0-255,5738,141429,1,319456
32729,0.001732,172.253.118.0-255,2902,144331,1,319456
32730,0.001749,172.31.36.0-255,66,144397,1,319456
32731,0.00177,172.253.118.0-255,7156,151553,1,319456
32732,0.001812,172.31.36.0-255,66,151619,1,319456
32733,0.001822,172.253.118.0-255,3602,155221,1,319456
32734,0.001847,172.31.36.0-255,66,155287,1,319456
32735,0.001859,172.253.118.0-255,4320,159607,1,319456
32736,0.001882,172.253.118.0-255,5738,165345,1,319456
32737,0.001908,172.253.118.0-255,2902,168247,1,319456
32738,0.001916,172.253.118.0-255,7156,175403,1,319456
32739,0.00192,172.31.36.0-255,66,175469,1,319456
32740,0.001949,172.253.118.0-255,4320,179789,1,319456
32741,0.001959,172.31.36.0-255,66,179855,1,319456
32742,0.001979,172.253.118.0-255,766,180621,1,319456
32743,0.002195,172.253.118.0-255,1484,182105,1,319456
32744,0.002201,172.253.118.0-255,2902,185007,1,319456
32745,0.002204,172.253.118.0-255,1484,186491,1,319456
32746,0.002224,172.253.118.0-255,4320,190811,1,319456
32747,0.00223,172.253.118.0-255,4320,195131,1,319456
32748,0.002256,172.253.118.0-255,4320,199451,1,319456
32749,0.00228,172.253.118.0-255,6438,205889,1,319456
32750,0.007939,172.31.36.0-255,66,205955,1,319456
32751,0.010256,172.253.118.0-255,5738,211693,1,319456
32752,0.010265,172.31.36.0-255,66,211759,1,319456
32753,0.012568,172.253.118.0-255,5738,217497,1,319456
32754,0.012576,172.31.36.0-255,66,217563,1,319456
32755,0.014871,172.253.118.0-255,5738,223301,1,319456
32756,0.01488,172.31.36.0-255,66,223367,1,319456
32757,0.017175,172.253.118.0-255,5738,229105,1,319456
32758,0.017182,172.31.36.0-255,66,229171,1,319456
32759,0.01947,172.253.118.0-255,5738,234909,1,319456
32760,0.019478,172.31.36.0-255,66,234975,1,319456
32761,0.021775,172.253.118.0-255,5738,240713,1,319456
32762,0.021786,172.31.36.0-255,66,240779,1,319456
32763,0.024083,172.253.118.0-255,5738,246517,1,319456
32764,0.024097,172.31.36.0-255,66,246583,1,319456
32765,0.026389,172.253.118.0-255,5738,252321,1,319456
32766,0.026399,172.31.36.0-255,66,252387,1,319456
32767,0.028698,172.253.118.0-255,5738,258125,1,319456
32768,0.028709,172.31.36.0-255,66,258191,1,319456
32769,0.031012,172.253.118.0-255,5738,263929,1,319456
32770,0.031022,172.31.36.0-255,66,263995,1,319456
32771,0.033321,172.253.118.0-255,5738,269733,1,319456
32772,0.033329,172.31.36.0-255,66,269799,1,319456
32773,0.035618,172.253.118.0-255,5738,275537,1,319456
32774,0.035625,172.31.36.0-255,66,275603,1,319456
32775,0.037935,172.253.118.0-255,5738,281341,1,319456
32776,0.037944,172.31.36.0-255,66,281407,1,319456
32777,0.040242,172.253.118.0-255,5738,287145,1,319456
32778,0.040256,172.31.36.0-255,66,287211,1,319456
32779,0.042553,172.253.118.0-255,5738,292949,1,319456
32780,0.042559,172.31.36.0-255,66,293015,1,319456
32781,0.04327,172.31.36.0-255,172,293187,1,319456
32782,0.043303,172.31.36.0-255,1114,294301,1,319456
32783,0.043365,172.31.36.0-255,1514,295815,1,319456
32784,0.043367,172.31.36.0-255,1514,297329,1,319456
32785,0.043372,172.31.36.0-255,1514,298843,1,319456
32786,0.043373,172.31.36.0-255,1514,300357,1,319456
32787,0.043393,172.31.36.0-255,1489,301846,1,319456
32788,0.044847,172.253.118.0-255,5738,307584,1,319456
32789,0.044854,172.31.36.0-255,66,307650,1,319456
32790,0.044862,104.244.42.0-255,66,307716,1,319456
32791,0.044888,104.244.42.0-255,66,307782,1,319456
32792,0.04494,104.244.42.0-255,66,307848,1,319456
32793,0.047153,172.253.118.0-255,5738,313586,1,319456
32794,0.047159,172.31.36.0-255,66,313652,1,319456
32795,0.049465,172.253.118.0-255,5738,319390,1,319456
32796,0.049471,172.31.36.0-255,66,319456,1,319456
32797,0.0,172.217.194.0-255,153,153,1,199865
32798,1.5e-05,172.31.36.0-255,66,219,1,199865
32799,2.2e-05,172.217.194.0-255,1484,1703,1,199865
32800,2.5e-05,172.31.36.0-255,66,1769,1,199865
32801,3.1e-05,172.217.194.0-255,2902,4671,1,199865
32802,3.5e-05,172.31.36.0-255,66,4737,1,199865
32803,4.3e-05,172.217.194.0-255,7156,11893,1,199865
32804,4.6e-05,172.31.36.0-255,66,11959,1,199865
32805,6.8e-05,172.217.194.0-255,2077,14036,1,199865
32806,7.1e-05,172.31.36.0-255,66,14102,1,199865
32807,9.9e-05,172.217.194.0-255,2902,17004,1,199865
32808,0.000102,172.31.36.0-255,66,17070,1,199865
32809,0.000106,172.217.194.0-255,2902,19972,1,199865
32810,0.000108,172.31.36.0-255,66,20038,1,199865
32811,0.000124,172.217.194.0-255,4320,24358,1,199865
32812,0.000127,172.31.36.0-255,66,24424,1,199865
32813,0.000161,172.217.194.0-255,2902,27326,1,199865
32814,0.000164,172.31.36.0-255,66,27392,1,199865
32815,0.000184,172.217.194.0-255,3961,31353,1,199865
32816,0.000186,172.31.36.0-255,66,31419,1,199865
32817,0.000194,172.217.194.0-255,7156,38575,1,199865
32818,0.000196,172.31.36.0-255,66,38641,1,199865
32819,0.000232,172.31.36.0-255,66,38707,1,199865
32820,0.000265,172.217.194.0-255,5738,44445,1,199865
32821,0.000268,172.31.36.0-255,66,44511,1,199865
32822,0.000274,172.217.194.0-255,4320,48831,1,199865
32823,0.000284,172.31.36.0-255,66,48897,1,199865
32824,0.000297,172.217.194.0-255,2902,51799,1,199865
32825,0.0003,172.31.36.0-255,66,51865,1,199865
32826,0.000328,172.217.194.0-255,4257,56122,1,199865
32827,0.000331,172.31.36.0-255,66,56188,1,199865
32828,0.000345,172.217.194.0-255,381,56569,1,199865
32829,0.000585,172.217.194.0-255,1484,58053,1,199865
32830,0.000591,172.31.36.0-255,66,58119,1,199865
32831,0.000597,172.217.194.0-255,2902,61021,1,199865
32832,0.000599,172.31.36.0-255,66,61087,1,199865
32833,0.000605,172.217.194.0-255,4320,65407,1,199865
32834,0.000607,172.31.36.0-255,66,65473,1,199865
32835,0.000633,172.217.194.0-255,1484,66957,1,199865
32836,0.000641,172.217.194.0-255,5738,72695,1,199865
32837,0.000644,172.31.36.0-255,66,72761,1,199865
32838,0.000658,172.31.36.0-255,66,72827,1,199865
32839,0.000661,172.217.194.0-255,1484,74311,1,199865
32840,0.000677,172.217.194.0-255,3602,77913,1,199865
32841,0.00068,172.31.36.0-255,66,77979,1,199865
32842,0.000784,172.217.194.0-255,1484,79463,1,199865
32843,0.00079,172.217.194.0-255,2902,82365,1,199865
32844,0.000792,172.217.194.0-255,1484,83849,1,199865
32845,0.000797,172.31.36.0-255,66,83915,1,199865
32846,0.000814,172.217.194.0-255,4320,88235,1,199865
32847,0.000817,172.31.36.0-255,66,88301,1,199865
32848,0.000825,172.217.194.0-255,7156,95457,1,199865
32849,0.000827,172.31.36.0-255,66,95523,1,199865
32850,0.000851,172.217.194.0-255,5738,101261,1,199865
32851,0.000853,172.31.36.0-255,66,101327,1,199865
32852,0.000867,172.217.194.0-255,4320,105647,1,199865
32853,0.00087,172.31.36.0-255,66,105713,1,199865
32854,0.000915,172.31.36.0-255,66,105779,1,199865
32855,0.00093,172.31.36.0-255,66,105845,1,199865
32856,0.000942,172.31.36.0-255,66,105911,1,199865
32857,0.000973,172.217.194.0-255,1484,107395,1,199865
32858,0.000987,172.217.194.0-255,2902,110297,1,199865
32859,0.00099,172.31.36.0-255,66,110363,1,199865
32860,0.001013,172.217.194.0-255,5738,116101,1,199865
32861,0.001017,172.31.36.0-255,66,116167,1,199865
32862,0.001061,172.217.194.0-255,7156,123323,1,199865
32863,0.001064,172.31.36.0-255,66,123389,1,199865
32864,0.001086,172.217.194.0-255,5738,129127,1,199865
32865,0.001089,172.31.36.0-255,66,129193,1,199865
32866,0.001102,172.31.36.0-255,66,129259,1,199865
32867,0.001114,172.31.36.0-255,66,129325,1,199865
32868,0.001126,172.31.36.0-255,66,129391,1,199865
32869,0.001143,172.217.194.0-255,5738,135129,1,199865
32870,0.001145,172.31.36.0-255,66,135195,1,199865
32871,0.001163,172.217.194.0-255,6438,141633,1,199865
32872,0.001165,172.31.36.0-255,66,141699,1,199865
32873,0.00124,172.217.194.0-255,1484,143183,1,199865
32874,0.001255,172.217.194.0-255,2902,146085,1,199865
32875,0.001258,172.31.36.0-255,66,146151,1,199865
32876,0.001266,172.217.194.0-255,5738,151889,1,199865
32877,0.001269,172.31.36.0-255,66,151955,1,199865
32878,0.00132,172.31.36.0-255,66,152021,1,199865
32879,0.001332,172.31.36.0-255,66,152087,1,199865
32880,0.001363,172.31.36.0-255,66,152153,1,199865
32881,0.001375,172.31.36.0-255,66,152219,1,199865
32882,0.0014,172.217.194.0-255,5738,157957,1,199865
32883,0.001404,172.31.36.0-255,66,158023,1,199865
32884,0.001433,172.31.36.0-255,66,158089,1,199865
32885,0.001548,172.217.194.0-255,1484,159573,1,199865
32886,0.001553,172.217.194.0-255,2902,162475,1,199865
32887,0.001556,172.31.36.0-255,66,162541,1,199865
32888,0.00156,172.217.194.0-255,1484,164025,1,199865
32889,0.001581,172.217.194.0-255,4320,168345,1,199865
32890,0.001584,172.31.36.0-255,66,168411,1,199865
32891,0.001591,172.217.194.0-255,7156,175567,1,199865
32892,0.001593,172.31.36.0-255,66,175633,1,199865
32893,0.00161,172.217.194.0-255,5738,181371,1,199865
32894,0.001612,172.31.36.0-255,66,181437,1,199865
32895,0.001624,172.31.36.0-255,66,181503,1,199865
32896,0.001627,172.217.194.0-255,766,182269,1,199865
32897,0.001745,172.31.36.0-255,101,182370,1,199865
32898,0.001791,172.217.194.0-255,1484,183854,1,199865
32899,0.001796,172.217.194.0-255,2902,186756,1,199865
32900,0.001801,172.31.36.0-255,66,186822,1,199865
32901,0.001807,172.217.194.0-255,5738,192560,1,199865
32902,0.001811,172.31.36.0-255,66,192626,1,199865
32903,0.001842,172.31.36.0-255,66,192692,1,199865
32904,0.00188,172.31.36.0-255,66,192758,1,199865
32905,0.001938,172.31.36.0-255,66,192824,1,199865
32906,0.00195,172.31.36.0-255,66,192890,1,199865
32907,0.001954,172.217.194.0-255,2902,195792,1,199865
32908,0.001957,172.31.36.0-255,66,195858,1,199865
32909,0.001996,172.31.36.0-255,66,195924,1,199865
32910,0.002,172.217.194.0-255,1484,197408,1,199865
32911,0.002032,172.31.36.0-255,66,197474,1,199865
32912,0.002035,172.217.194.0-255,105,197579,1,199865
32913,0.004004,172.217.194.0-255,66,197645,1,199865
32914,0.00451,172.31.36.0-255,105,197750,1,199865
32915,0.006769,172.217.194.0-255,66,197816,1,199865
32916,0.038056,172.31.36.0-255,172,197988,1,199865
32917,0.038105,172.31.36.0-255,1115,199103,1,199865
32918,0.038161,172.31.36.0-255,564,199667,1,199865
32919,0.039599,104.244.42.0-255,66,199733,1,199865
32920,0.039642,104.244.42.0-255,66,199799,1,199865
32921,0.039698,104.244.42.0-255,66,199865,1,199865
32922,0.0,74.125.130.0-255,152,152,1,293983
32923,2.4e-05,172.31.36.0-255,66,218,1,293983
32924,8.7e-05,74.125.130.0-255,1484,1702,1,293983
32925,9.1e-05,172.31.36.0-255,66,1768,1,293983
32926,0.00011,74.125.130.0-255,2902,4670,1,293983
32927,0.000113,172.31.36.0-255,66,4736,1,293983
32928,0.000133,74.125.130.0-255,1484,6220,1,293983
32929,0.000137,172.31.36.0-255,66,6286,1,293983
32930,0.000148,74.125.130.0-255,4320,10606,1,293983
32931,0.000151,172.31.36.0-255,66,10672,1,293983
32932,0.00017,74.125.130.0-255,1484,12156,1,293983
32933,0.000172,172.31.36.0-255,66,12222,1,293983
32934,0.000191,74.125.130.0-255,2017,14239,1,293983
32935,0.000193,172.31.36.0-255,66,14305,1,293983
32936,0.000475,74.125.130.0-255,1484,15789,1,293983
32937,0.000481,172.31.36.0-255,66,15855,1,293983
32938,0.000485,74.125.130.0-255,1484,17339,1,293983
32939,0.000487,172.31.36.0-255,66,17405,1,293983
32940,0.000492,74.125.130.0-255,2902,20307,1,293983
32941,0.000495,172.31.36.0-255,66,20373,1,293983
32942,0.000502,74.125.130.0-255,5738,26111,1,293983
32943,0.000506,172.31.36.0-255,66,26177,1,293983
32944,0.000558,172.31.36.0-255,66,26243,1,293983
32945,0.000569,172.31.36.0-255,66,26309,1,293983
32946,0.000586,74.125.130.0-255,2902,29211,1,293983
32947,0.000588,172.31.36.0-255,66,29277,1,293983
32948,0.0006,172.31.36.0-255,66,29343,1,293983
32949,0.000625,74.125.130.0-255,6438,35781,1,293983
32950,0.000628,74.125.130.0-255,379,36160,1,293983
32951,0.000632,172.31.36.0-255,66,36226,1,293983
32952,0.000962,74.125.130.0-255,364,36590,1,293983
32953,0.001017,172.31.36.0-255,66,36656,1,293983
32954,0.001154,74.125.130.0-255,1484,38140,1,293983
32955,0.001163,74.125.130.0-255,2902,41042,1,293983
32956,0.001167,172.31.36.0-255,66,41108,1,293983
32957,0.001192,74.125.130.0-255,2902,44010,1,293983
32958,0.001194,172.31.36.0-255,66,44076,1,293983
32959,0.001214,74.125.130.0-255,2902,46978,1,293983
32960,0.001217,172.31.36.0-255,66,47044,1,293983
32961,0.001223,74.125.130.0-255,5738,52782,1,293983
32962,0.001225,172.31.36.0-255,66,52848,1,293983
32963,0.001233,74.125.130.0-255,7156,60004,1,293983
32964,0.001235,172.31.36.0-255,66,60070,1,293983
32965,0.001271,172.31.36.0-255,66,60136,1,293983
32966,0.001423,74.125.130.0-255,1484,61620,1,293983
32967,0.001429,74.125.130.0-255,2902,64522,1,293983
32968,0.001433,172.31.36.0-255,66,64588,1,293983
32969,0.001439,74.125.130.0-255,2902,67490,1,293983
32970,0.001441,172.31.36.0-255,66,67556,1,293983
32971,0.001446,74.125.130.0-255,2902,70458,1,293983
32972,0.001448,172.31.36.0-255,66,70524,1,293983
32973,0.001473,74.125.130.0-255,4320,74844,1,293983
32974,0.001475,172.31.36.0-255,66,74910,1,293983
32975,0.00148,74.125.130.0-255,2902,77812,1,293983
32976,0.001482,172.31.36.0-255,66,77878,1,293983
32977,0.001513,172.31.36.0-255,66,77944,1,293983
32978,0.001518,74.125.130.0-255,3602,81546,1,293983
32979,0.001521,172.31.36.0-255,66,81612,1,293983
32980,0.001612,74.125.130.0-255,1484,83096,1,293983
32981,0.001618,74.125.130.0-255,2902,85998,1,293983
32982,0.001622,172.31.36.0-255,66,86064,1,293983
32983,0.001629,74.125.130.0-255,5738,91802,1,293983
32984,0.001632,172.31.36.0-255,66,91868,1,293983
32985,0.00167,172.31.36.0-255,66,91934,1,293983
32986,0.001678,74.125.130.0-255,7156,99090,1,293983
32987,0.00168,172.31.36.0-255,66,99156,1,293983
32988,0.001694,74.125.130.0-255,4320,103476,1,293983
32989,0.001697,172.31.36.0-255,66,103542,1,293983
32990,0.001704,74.125.130.0-255,7156,110698,1,293983
32991,0.001707,172.31.36.0-255,66,110764,1,293983
32992,0.001725,74.125.130.0-255,5020,115784,1,293983
32993,0.001728,172.31.36.0-255,66,115850,1,293983
32994,0.001742,172.31.36.0-255,66,115916,1,293983
32995,0.001756,74.125.130.0-255,4320,120236,1,293983
32996,0.001759,172.31.36.0-255,66,120302,1,293983
32997,0.001778,74.125.130.0-255,6438,126740,1,293983
32998,0.001781,172.31.36.0-255,66,126806,1,293983
32999,0.001922,74.125.130.0-255,1484,128290,1,293983
33000,0.001943,74.125.130.0-255,2902,131192,1,293983
33001,0.001948,172.31.36.0-255,66,131258,1,293983
33002,0.001954,74.125.130.0-255,4320,135578,1,293983
33003,0.001957,172.31.36.0-255,66,135644,1,293983
33004,0.001963,74.125.130.0-255,5738,141382,1,293983
33005,0.001966,172.31.36.0-255,66,141448,1,293983
33006,0.001996,172.31.36.0-255,66,141514,1,293983
33007,0.002002,74.125.130.0-255,4320,145834,1,293983
33008,0.002004,172.31.36.0-255,66,145900,1,293983
33009,0.002019,74.125.130.0-255,3602,149502,1,293983
33010,0.002022,172.31.36.0-255,66,149568,1,293983
33011,0.002113,74.125.130.0-255,1484,151052,1,293983
33012,0.002129,74.125.130.0-255,2902,153954,1,293983
33013,0.002133,172.31.36.0-255,66,154020,1,293983
33014,0.002137,74.125.130.0-255,1484,155504,1,293983
33015,0.00216,74.125.130.0-255,4320,159824,1,293983
33016,0.002163,172.31.36.0-255,66,159890,1,293983
33017,0.002167,74.125.130.0-255,2902,162792,1,293983
33018,0.002169,172.31.36.0-255,66,162858,1,293983
33019,0.00218,74.125.130.0-255,4320,167178,1,293983
33020,0.002184,172.31.36.0-255,66,167244,1,293983
33021,0.002194,172.31.36.0-255,66,167310,1,293983
33022,0.002236,74.125.130.0-255,1484,168794,1,293983
33023,0.002257,172.31.36.0-255,66,168860,1,293983
33024,0.002268,172.31.36.0-255,66,168926,1,293983
33025,0.002286,172.31.36.0-255,66,168992,1,293983
33026,0.004491,74.125.130.0-255,5738,174730,1,293983
33027,0.004495,172.31.36.0-255,66,174796,1,293983
33028,0.006689,74.125.130.0-255,5738,180534,1,293983
33029,0.006696,172.31.36.0-255,66,180600,1,293983
33030,0.008893,74.125.130.0-255,5738,186338,1,293983
33031,0.0089,172.31.36.0-255,66,186404,1,293983
33032,0.011099,74.125.130.0-255,5738,192142,1,293983
33033,0.011106,172.31.36.0-255,66,192208,1,293983
33034,0.013296,74.125.130.0-255,5738,197946,1,293983
33035,0.013303,172.31.36.0-255,66,198012,1,293983
33036,0.015494,74.125.130.0-255,5738,203750,1,293983
33037,0.0155,172.31.36.0-255,66,203816,1,293983
33038,0.0177,74.125.130.0-255,5738,209554,1,293983
33039,0.01771,172.31.36.0-255,66,209620,1,293983
33040,0.019921,74.125.130.0-255,5738,215358,1,293983
33041,0.019931,172.31.36.0-255,66,215424,1,293983
33042,0.022137,74.125.130.0-255,2902,218326,1,293983
33043,0.022144,172.31.36.0-255,66,218392,1,293983
33044,0.022166,74.125.130.0-255,2902,221294,1,293983
33045,0.022168,172.31.36.0-255,66,221360,1,293983
33046,0.024362,74.125.130.0-255,5738,227098,1,293983
33047,0.024367,172.31.36.0-255,66,227164,1,293983
33048,0.026568,74.125.130.0-255,5738,232902,1,293983
33049,0.026576,172.31.36.0-255,66,232968,1,293983
33050,0.028788,74.125.130.0-255,5738,238706,1,293983
33051,0.028795,172.31.36.0-255,66,238772,1,293983
33052,0.030993,74.125.130.0-255,5738,244510,1,293983
33053,0.031004,172.31.36.0-255,66,244576,1,293983
33054,0.033204,74.125.130.0-255,5738,250314,1,293983
33055,0.033214,172.31.36.0-255,66,250380,1,293983
33056,0.035416,74.125.130.0-255,5738,256118,1,293983
33057,0.035423,172.31.36.0-255,66,256184,1,293983
33058,0.037624,74.125.130.0-255,5738,261922,1,293983
33059,0.037631,172.31.36.0-255,66,261988,1,293983
33060,0.039752,172.31.36.0-255,200,262188,1,293983
33061,0.039796,172.31.36.0-255,1115,263303,1,293983
33062,0.039835,74.125.130.0-255,5738,269041,1,293983
33063,0.03984,172.31.36.0-255,66,269107,1,293983
33064,0.039929,172.31.36.0-255,1514,270621,1,293983
33065,0.039931,172.31.36.0-255,1514,272135,1,293983
33066,0.039935,172.31.36.0-255,1514,273649,1,293983
33067,0.039936,172.31.36.0-255,1514,275163,1,293983
33068,0.039954,172.31.36.0-255,1489,276652,1,293983
33069,0.041297,104.244.42.0-255,66,276718,1,293983
33070,0.041418,104.244.42.0-255,66,276784,1,293983
33071,0.041536,104.244.42.0-255,66,276850,1,293983
33072,0.042028,74.125.130.0-255,5738,282588,1,293983
33073,0.042035,172.31.36.0-255,66,282654,1,293983
33074,0.044261,74.125.130.0-255,5738,288392,1,293983
33075,0.044271,172.31.36.0-255,66,288458,1,293983
33076,0.046479,74.125.130.0-255,5288,293746,1,293983
33077,0.046485,172.31.36.0-255,66,293812,1,293983
33078,0.046678,172.31.36.0-255,105,293917,1,293983
33079,0.048834,74.125.130.0-255,66,293983,1,293983
33080,0.0,172.217.194.0-255,146,146,1,278556
33081,2.4e-05,172.31.36.0-255,66,212,1,278556
33082,3.2e-05,172.217.194.0-255,1484,1696,1,278556
33083,3.7e-05,172.31.36.0-255,66,1762,1,278556
33084,4.3e-05,172.217.194.0-255,2902,4664,1,278556
33085,4.6e-05,172.31.36.0-255,66,4730,1,278556
33086,5.4e-05,172.217.194.0-255,7156,11886,1,278556
33087,5.6e-05,172.31.36.0-255,66,11952,1,278556
33088,6.3e-05,172.217.194.0-255,5738,17690,1,278556
33089,6.6e-05,172.31.36.0-255,66,17756,1,278556
33090,8.5e-05,172.217.194.0-255,1941,19697,1,278556
33091,8.8e-05,172.31.36.0-255,66,19763,1,278556
33092,9.9e-05,172.31.36.0-255,66,19829,1,278556
33093,0.000123,172.217.194.0-255,2543,22372,1,278556
33094,0.000125,172.31.36.0-255,66,22438,1,278556
33095,0.000208,172.217.194.0-255,1484,23922,1,278556
33096,0.000211,172.31.36.0-255,66,23988,1,278556
33097,0.000216,172.217.194.0-255,2902,26890,1,278556
33098,0.000218,172.31.36.0-255,66,26956,1,278556
33099,0.000243,172.217.194.0-255,5738,32694,1,278556
33100,0.000246,172.31.36.0-255,66,32760,1,278556
33101,0.000254,172.217.194.0-255,6797,39557,1,278556
33102,0.000256,172.31.36.0-255,66,39623,1,278556
33103,0.000279,172.217.194.0-255,2902,42525,1,278556
33104,0.000282,172.31.36.0-255,66,42591,1,278556
33105,0.000314,172.31.36.0-255,66,42657,1,278556
33106,0.000318,172.217.194.0-255,2866,45523,1,278556
33107,0.00032,172.31.36.0-255,66,45589,1,278556
33108,0.000815,172.217.194.0-255,363,45952,1,278556
33109,0.00082,172.31.36.0-255,66,46018,1,278556
33110,0.001159,172.217.194.0-255,1484,47502,1,278556
33111,0.00117,172.217.194.0-255,2902,50404,1,278556
33112,0.001174,172.31.36.0-255,66,50470,1,278556
33113,0.001182,172.217.194.0-255,5738,56208,1,278556
33114,0.001184,172.31.36.0-255,66,56274,1,278556
33115,0.00119,172.217.194.0-255,4320,60594,1,278556
33116,0.001192,172.31.36.0-255,66,60660,1,278556
33117,0.001229,172.31.36.0-255,66,60726,1,278556
33118,0.001241,172.31.36.0-255,66,60792,1,278556
33119,0.001265,172.217.194.0-255,2184,62976,1,278556
33120,0.001268,172.31.36.0-255,66,63042,1,278556
33121,0.001323,172.217.194.0-255,1484,64526,1,278556
33122,0.001329,172.217.194.0-255,2902,67428,1,278556
33123,0.001331,172.31.36.0-255,66,67494,1,278556
33124,0.001335,172.217.194.0-255,1484,68978,1,278556
33125,0.001359,172.217.194.0-255,4320,73298,1,278556
33126,0.001361,172.31.36.0-255,66,73364,1,278556
33127,0.00137,172.217.194.0-255,6248,79612,1,278556
33128,0.001372,172.31.36.0-255,66,79678,1,278556
33129,0.00188,172.217.194.0-255,1484,81162,1,278556
33130,0.001889,172.217.194.0-255,2902,84064,1,278556
33131,0.001893,172.31.36.0-255,66,84130,1,278556
33132,0.0019,172.217.194.0-255,4320,88450,1,278556
33133,0.001903,172.31.36.0-255,66,88516,1,278556
33134,0.001915,172.217.194.0-255,1484,90000,1,278556
33135,0.001937,172.217.194.0-255,5738,95738,1,278556
33136,0.001941,172.31.36.0-255,66,95804,1,278556
33137,0.001947,172.217.194.0-255,5738,101542,1,278556
33138,0.001949,172.31.36.0-255,66,101608,1,278556
33139,0.00197,172.217.194.0-255,1484,103092,1,278556
33140,0.001998,172.217.194.0-255,5738,108830,1,278556
33141,0.002001,172.31.36.0-255,66,108896,1,278556
33142,0.002023,172.217.194.0-255,5020,113916,1,278556
33143,0.002026,172.31.36.0-255,66,113982,1,278556
33144,0.002077,172.217.194.0-255,1484,115466,1,278556
33145,0.00209,172.217.194.0-255,2902,118368,1,278556
33146,0.002092,172.31.36.0-255,66,118434,1,278556
33147,0.00211,172.217.194.0-255,2902,121336,1,278556
33148,0.002113,172.31.36.0-255,66,121402,1,278556
33149,0.002128,172.217.194.0-255,2902,124304,1,278556
33150,0.00213,172.31.36.0-255,66,124370,1,278556
33151,0.002133,172.217.194.0-255,1484,125854,1,278556
33152,0.002163,172.217.194.0-255,2902,128756,1,278556
33153,0.002166,172.31.36.0-255,66,128822,1,278556
33154,0.002172,172.217.194.0-255,5738,134560,1,278556
33155,0.002175,172.31.36.0-255,66,134626,1,278556
33156,0.00218,172.217.194.0-255,2902,137528,1,278556
33157,0.002182,172.31.36.0-255,66,137594,1,278556
33158,0.002201,172.217.194.0-255,7156,144750,1,278556
33159,0.002204,172.31.36.0-255,66,144816,1,278556
33160,0.002228,172.217.194.0-255,3602,148418,1,278556
33161,0.002231,172.31.36.0-255,66,148484,1,278556
33162,0.002373,172.217.194.0-255,1484,149968,1,278556
33163,0.002398,172.217.194.0-255,2902,152870,1,278556
33164,0.002401,172.31.36.0-255,66,152936,1,278556
33165,0.002407,172.217.194.0-255,5738,158674,1,278556
33166,0.002409,172.31.36.0-255,66,158740,1,278556
33167,0.002417,172.217.194.0-255,7156,165896,1,278556
33168,0.00242,172.31.36.0-255,66,165962,1,278556
33169,0.002446,172.217.194.0-255,5738,171700,1,278556
33170,0.002448,172.31.36.0-255,66,171766,1,278556
33171,0.002496,172.31.36.0-255,66,171832,1,278556
33172,0.002509,172.217.194.0-255,766,172598,1,278556
33173,0.002581,172.217.194.0-255,1484,174082,1,278556
33174,0.002584,172.31.36.0-255,66,174148,1,278556
33175,0.002604,172.217.194.0-255,2902,177050,1,278556
33176,0.002606,172.31.36.0-255,66,177116,1,278556
33177,0.002613,172.217.194.0-255,5738,182854,1,278556
33178,0.002615,172.31.36.0-255,66,182920,1,278556
33179,0.002651,172.31.36.0-255,66,182986,1,278556
33180,0.002662,172.31.36.0-255,66,183052,1,278556
33181,0.002671,172.217.194.0-255,2184,185236,1,278556
33182,0.005267,172.217.194.0-255,2902,188138,1,278556
33183,0.011981,172.31.36.0-255,66,188204,1,278556
33184,0.013487,172.217.194.0-255,1484,189688,1,278556
33185,0.014593,172.217.194.0-255,4320,194008,1,278556
33186,0.014602,172.31.36.0-255,66,194074,1,278556
33187,0.017198,172.217.194.0-255,5738,199812,1,278556
33188,0.017214,172.31.36.0-255,66,199878,1,278556
33189,0.019809,172.217.194.0-255,5738,205616,1,278556
33190,0.01982,172.31.36.0-255,66,205682,1,278556
33191,0.022444,172.217.194.0-255,5738,211420,1,278556
33192,0.022452,172.31.36.0-255,66,211486,1,278556
33193,0.025062,172.217.194.0-255,5738,217224,1,278556
33194,0.02507,172.31.36.0-255,66,217290,1,278556
33195,0.027656,172.217.194.0-255,5738,223028,1,278556
33196,0.027667,172.31.36.0-255,66,223094,1,278556
33197,0.03029,172.217.194.0-255,5738,228832,1,278556
33198,0.030299,172.31.36.0-255,66,228898,1,278556
33199,0.032902,172.217.194.0-255,5738,234636,1,278556
33200,0.032909,172.31.36.0-255,66,234702,1,278556
33201,0.035504,172.217.194.0-255,5738,240440,1,278556
33202,0.035512,172.31.36.0-255,66,240506,1,278556
33203,0.038133,172.217.194.0-255,5738,246244,1,278556
33204,0.038141,172.31.36.0-255,66,246310,1,278556
33205,0.040739,172.217.194.0-255,5738,252048,1,278556
33206,0.040747,172.31.36.0-255,66,252114,1,278556
33207,0.043399,172.217.194.0-255,5738,257852,1,278556
33208,0.043409,172.31.36.0-255,66,257918,1,278556
33209,0.04582,172.31.36.0-255,172,258090,1,278556
33210,0.04585,172.31.36.0-255,1114,259204,1,278556
33211,0.04592,172.31.36.0-255,1514,260718,1,278556
33212,0.045922,172.31.36.0-255,1514,262232,1,278556
33213,0.045923,172.31.36.0-255,1514,263746,1,278556
33214,0.045924,172.31.36.0-255,1514,265260,1,278556
33215,0.045955,172.31.36.0-255,1490,266750,1,278556
33216,0.046009,172.217.194.0-255,5738,272488,1,278556
33217,0.046014,172.31.36.0-255,66,272554,1,278556
33218,0.047393,104.244.42.0-255,66,272620,1,278556
33219,0.047402,104.244.42.0-255,66,272686,1,278556
33220,0.047485,104.244.42.0-255,66,272752,1,278556
33221,0.048596,172.217.194.0-255,5738,278490,1,278556
33222,0.048603,172.31.36.0-255,66,278556,1,278556
33223,0.0,74.125.68.0-255,146,146,1,200012
33224,2.3e-05,172.31.36.0-255,66,212,1,200012
33225,2.9e-05,74.125.68.0-255,1484,1696,1,200012
33226,3.4e-05,172.31.36.0-255,66,1762,1,200012
33227,4e-05,74.125.68.0-255,2902,4664,1,200012
33228,4.3e-05,172.31.36.0-255,66,4730,1,200012
33229,4.7e-05,74.125.68.0-255,1484,6214,1,200012
33230,4.9e-05,172.31.36.0-255,66,6280,1,200012
33231,8.4e-05,74.125.68.0-255,5738,12018,1,200012
33232,8.8e-05,172.31.36.0-255,66,12084,1,200012
33233,0.000153,74.125.68.0-255,2029,14113,1,200012
33234,0.000156,172.31.36.0-255,66,14179,1,200012
33235,0.00017,74.125.68.0-255,2902,17081,1,200012
33236,0.000173,172.31.36.0-255,66,17147,1,200012
33237,0.000218,74.125.68.0-255,5738,22885,1,200012
33238,0.000221,172.31.36.0-255,66,22951,1,200012
33239,0.000241,74.125.68.0-255,1484,24435,1,200012
33240,0.000258,172.31.36.0-255,66,24501,1,200012
33241,0.00031,74.125.68.0-255,6797,31298,1,200012
33242,0.000314,172.31.36.0-255,66,31364,1,200012
33243,0.000396,74.125.68.0-255,4320,35684,1,200012
33244,0.0004,172.31.36.0-255,66,35750,1,200012
33245,0.000434,172.31.36.0-255,66,35816,1,200012
33246,0.000603,74.125.68.0-255,1125,36941,1,200012
33247,0.000606,172.31.36.0-255,66,37007,1,200012
33248,0.000651,172.31.36.0-255,66,37073,1,200012
33249,0.000824,74.125.68.0-255,413,37486,1,200012
33250,0.000828,172.31.36.0-255,66,37552,1,200012
33251,0.000845,74.125.68.0-255,2902,40454,1,200012
33252,0.000847,172.31.36.0-255,66,40520,1,200012
33253,0.000863,74.125.68.0-255,1750,42270,1,200012
33254,0.000866,172.31.36.0-255,66,42336,1,200012
33255,0.000902,74.125.68.0-255,5738,48074,1,200012
33256,0.000904,172.31.36.0-255,66,48140,1,200012
33257,0.000922,74.125.68.0-255,1484,49624,1,200012
33258,0.001019,172.31.36.0-255,66,49690,1,200012
33259,0.001034,74.125.68.0-255,3961,53651,1,200012
33260,0.001038,172.31.36.0-255,66,53717,1,200012
33261,0.001209,74.125.68.0-255,2902,56619,1,200012
33262,0.001214,172.31.36.0-255,66,56685,1,200012
33263,0.001234,74.125.68.0-255,3961,60646,1,200012
33264,0.001237,172.31.36.0-255,66,60712,1,200012
33265,0.001304,74.125.68.0-255,7156,67868,1,200012
33266,0.001308,172.31.36.0-255,66,67934,1,200012
33267,0.001396,74.125.68.0-255,5738,73672,1,200012
33268,0.0014,172.31.36.0-255,66,73738,1,200012
33269,0.001432,172.31.36.0-255,66,73804,1,200012
33270,0.001605,74.125.68.0-255,5738,79542,1,200012
33271,0.001609,172.31.36.0-255,66,79608,1,200012
33272,0.001651,172.31.36.0-255,66,79674,1,200012
33273,0.001913,172.31.36.0-255,66,79740,1,200012
33274,0.001938,172.31.36.0-255,66,79806,1,200012
33275,0.002207,172.31.36.0-255,66,79872,1,200012
33276,0.00238,172.31.36.0-255,66,79938,1,200012
33277,0.002404,172.31.36.0-255,66,80004,1,200012
33278,0.002643,74.125.68.0-255,5738,85742,1,200012
33279,0.002648,172.31.36.0-255,66,85808,1,200012
33280,0.002684,172.31.36.0-255,66,85874,1,200012
33281,0.002717,172.31.36.0-255,66,85940,1,200012
33282,0.003097,74.125.68.0-255,1484,87424,1,200012
33283,0.003128,172.31.36.0-255,66,87490,1,200012
33284,0.00318,172.31.36.0-255,66,87556,1,200012
33285,0.003544,172.31.36.0-255,66,87622,1,200012
33286,0.003587,172.31.36.0-255,66,87688,1,200012
33287,0.00613,74.125.68.0-255,5738,93426,1,200012
33288,0.006137,172.31.36.0-255,66,93492,1,200012
33289,0.008688,74.125.68.0-255,5738,99230,1,200012
33290,0.008694,172.31.36.0-255,66,99296,1,200012
33291,0.011232,74.125.68.0-255,5738,105034,1,200012
33292,0.011239,172.31.36.0-255,66,105100,1,200012
33293,0.013777,74.125.68.0-255,5738,110838,1,200012
33294,0.013786,172.31.36.0-255,66,110904,1,200012
33295,0.016358,74.125.68.0-255,4320,115224,1,200012
33296,0.016366,172.31.36.0-255,66,115290,1,200012
33297,0.016385,74.125.68.0-255,1484,116774,1,200012
33298,0.01892,74.125.68.0-255,4320,121094,1,200012
33299,0.018931,172.31.36.0-255,66,121160,1,200012
33300,0.021483,74.125.68.0-255,5738,126898,1,200012
33301,0.021493,172.31.36.0-255,66,126964,1,200012
33302,0.024035,74.125.68.0-255,5738,132702,1,200012
33303,0.024046,172.31.36.0-255,66,132768,1,200012
33304,0.026584,74.125.68.0-255,5738,138506,1,200012
33305,0.026593,172.31.36.0-255,66,138572,1,200012
33306,0.029138,74.125.68.0-255,5738,144310,1,200012
33307,0.029145,172.31.36.0-255,66,144376,1,200012
33308,0.031685,74.125.68.0-255,5738,150114,1,200012
33309,0.031694,172.31.36.0-255,66,150180,1,200012
33310,0.034225,74.125.68.0-255,5738,155918,1,200012
33311,0.034233,172.31.36.0-255,66,155984,1,200012
33312,0.036765,74.125.68.0-255,5738,161722,1,200012
33313,0.036774,172.31.36.0-255,66,161788,1,200012
33314,0.039311,74.125.68.0-255,5738,167526,1,200012
33315,0.03932,172.31.36.0-255,66,167592,1,200012
33316,0.041874,74.125.68.0-255,5738,173330,1,200012
33317,0.041881,172.31.36.0-255,66,173396,1,200012
33318,0.043905,172.31.36.0-255,172,173568,1,200012
33319,0.043955,172.31.36.0-255,1115,174683,1,200012
33320,0.044025,172.31.36.0-255,1514,176197,1,200012
33321,0.044027,172.31.36.0-255,1514,177711,1,200012
33322,0.044028,172.31.36.0-255,1514,179225,1,200012
33323,0.044029,172.31.36.0-255,1514,180739,1,200012
33324,0.044057,172.31.36.0-255,1489,182228,1,200012
33325,0.044414,74.125.68.0-255,5738,187966,1,200012
33326,0.044421,172.31.36.0-255,66,188032,1,200012
33327,0.045475,104.244.42.0-255,66,188098,1,200012
33328,0.045528,104.244.42.0-255,66,188164,1,200012
33329,0.045626,104.244.42.0-255,66,188230,1,200012
33330,0.04696,74.125.68.0-255,5738,193968,1,200012
33331,0.046968,172.31.36.0-255,66,194034,1,200012
33332,0.049194,104.244.42.0-255,108,194142,1,200012
33333,0.049205,172.31.36.0-255,66,194208,1,200012
33334,0.0495,74.125.68.0-255,5738,199946,1,200012
33335,0.049505,172.31.36.0-255,66,200012,1,200012
33336,0.0,172.217.194.0-255,143,143,1,200193
33337,3.1e-05,172.31.36.0-255,66,209,1,200193
33338,3.9e-05,172.217.194.0-255,1484,1693,1,200193
33339,4.3e-05,172.31.36.0-255,66,1759,1,200193
33340,5.6e-05,172.217.194.0-255,2902,4661,1,200193
33341,6e-05,172.31.36.0-255,66,4727,1,200193
33342,6.8e-05,172.217.194.0-255,7156,11883,1,200193
33343,7e-05,172.31.36.0-255,66,11949,1,200193
33344,7.5e-05,172.217.194.0-255,2049,13998,1,200193
33345,7.7e-05,172.31.36.0-255,66,14064,1,200193
33346,0.000232,172.217.194.0-255,1484,15548,1,200193
33347,0.000237,172.31.36.0-255,66,15614,1,200193
33348,0.000243,172.217.194.0-255,2902,18516,1,200193
33349,0.000246,172.31.36.0-255,66,18582,1,200193
33350,0.000258,172.217.194.0-255,5738,24320,1,200193
33351,0.00026,172.31.36.0-255,66,24386,1,200193
33352,0.000301,172.217.194.0-255,6797,31183,1,200193
33353,0.000304,172.31.36.0-255,66,31249,1,200193
33354,0.000442,172.217.194.0-255,1484,32733,1,200193
33355,0.000446,172.31.36.0-255,66,32799,1,200193
33356,0.000451,172.217.194.0-255,2902,35701,1,200193
33357,0.000453,172.31.36.0-255,66,35767,1,200193
33358,0.000458,172.217.194.0-255,2902,38669,1,200193
33359,0.000467,172.31.36.0-255,66,38735,1,200193
33360,0.000505,172.217.194.0-255,2902,41637,1,200193
33361,0.000508,172.31.36.0-255,66,41703,1,200193
33362,0.000517,172.217.194.0-255,6797,48500,1,200193
33363,0.000519,172.31.36.0-255,66,48566,1,200193
33364,0.00054,172.31.36.0-255,66,48632,1,200193
33365,0.000544,172.217.194.0-255,2543,51175,1,200193
33366,0.000547,172.31.36.0-255,66,51241,1,200193
33367,0.001605,172.217.194.0-255,360,51601,1,200193
33368,0.001614,172.217.194.0-255,383,51984,1,200193
33369,0.001979,172.217.194.0-255,1484,53468,1,200193
33370,0.001983,172.31.36.0-255,66,53534,1,200193
33371,0.00199,172.217.194.0-255,2902,56436,1,200193
33372,0.001991,172.31.36.0-255,66,56502,1,200193
33373,0.001997,172.217.194.0-255,4320,60822,1,200193
33374,0.001998,172.31.36.0-255,66,60888,1,200193
33375,0.002026,172.217.194.0-255,1484,62372,1,200193
33376,0.002039,172.31.36.0-255,66,62438,1,200193
33377,0.002049,172.31.36.0-255,66,62504,1,200193
33378,0.002076,172.217.194.0-255,2184,64688,1,200193
33379,0.002078,172.31.36.0-255,66,64754,1,200193
33380,0.002391,172.217.194.0-255,1484,66238,1,200193
33381,0.002395,172.217.194.0-255,2902,69140,1,200193
33382,0.002397,172.31.36.0-255,66,69206,1,200193
33383,0.002423,172.217.194.0-255,5738,74944,1,200193
33384,0.002426,172.31.36.0-255,66,75010,1,200193
33385,0.002442,172.217.194.0-255,1484,76494,1,200193
33386,0.002464,172.31.36.0-255,66,76560,1,200193
33387,0.002477,172.31.36.0-255,66,76626,1,200193
33388,0.002497,172.217.194.0-255,766,77392,1,200193
33389,0.002526,172.217.194.0-255,1484,78876,1,200193
33390,0.002528,172.31.36.0-255,66,78942,1,200193
33391,0.002555,172.217.194.0-255,2902,81844,1,200193
33392,0.002557,172.31.36.0-255,66,81910,1,200193
33393,0.002562,172.217.194.0-255,4320,86230,1,200193
33394,0.002564,172.31.36.0-255,66,86296,1,200193
33395,0.005074,172.217.194.0-255,2902,89198,1,200193
33396,0.005078,172.31.36.0-255,66,89264,1,200193
33397,0.005103,172.217.194.0-255,2902,92166,1,200193
33398,0.005106,172.31.36.0-255,66,92232,1,200193
33399,0.007601,172.217.194.0-255,2902,95134,1,200193
33400,0.007607,172.31.36.0-255,66,95200,1,200193
33401,0.007638,172.217.194.0-255,2902,98102,1,200193
33402,0.00764,172.31.36.0-255,66,98168,1,200193
33403,0.010152,172.217.194.0-255,2902,101070,1,200193
33404,0.010157,172.31.36.0-255,66,101136,1,200193
33405,0.010174,172.217.194.0-255,2902,104038,1,200193
33406,0.010177,172.31.36.0-255,66,104104,1,200193
33407,0.012686,172.217.194.0-255,5738,109842,1,200193
33408,0.012692,172.31.36.0-255,66,109908,1,200193
33409,0.015235,172.217.194.0-255,5738,115646,1,200193
33410,0.015246,172.31.36.0-255,66,115712,1,200193
33411,0.017817,172.217.194.0-255,5738,121450,1,200193
33412,0.017826,172.31.36.0-255,66,121516,1,200193
33413,0.020348,172.217.194.0-255,5738,127254,1,200193
33414,0.020355,172.31.36.0-255,66,127320,1,200193
33415,0.022893,172.217.194.0-255,5738,133058,1,200193
33416,0.022899,172.31.36.0-255,66,133124,1,200193
33417,0.025437,172.217.194.0-255,5738,138862,1,200193
33418,0.025444,172.31.36.0-255,66,138928,1,200193
33419,0.027973,172.217.194.0-255,5738,144666,1,200193
33420,0.02798,172.31.36.0-255,66,144732,1,200193
33421,0.030105,172.31.36.0-255,172,144904,1,200193
33422,0.030137,172.31.36.0-255,1116,146020,1,200193
33423,0.030177,172.31.36.0-255,1514,147534,1,200193
33424,0.030179,172.31.36.0-255,1514,149048,1,200193
33425,0.030185,172.31.36.0-255,1514,150562,1,200193
33426,0.030201,172.31.36.0-255,1514,152076,1,200193
33427,0.030205,172.31.36.0-255,1487,153563,1,200193
33428,0.030483,172.217.194.0-255,5738,159301,1,200193
33429,0.03049,172.31.36.0-255,66,159367,1,200193
33430,0.031629,104.244.42.0-255,66,159433,1,200193
33431,0.031637,104.244.42.0-255,66,159499,1,200193
33432,0.031741,104.244.42.0-255,66,159565,1,200193
33433,0.033073,172.217.194.0-255,5738,165303,1,200193
33434,0.033078,172.31.36.0-255,66,165369,1,200193
33435,0.035631,172.217.194.0-255,5738,171107,1,200193
33436,0.035638,172.31.36.0-255,66,171173,1,200193
33437,0.038172,172.217.194.0-255,5738,176911,1,200193
33438,0.038179,172.31.36.0-255,66,176977,1,200193
33439,0.040695,172.217.194.0-255,5738,182715,1,200193
33440,0.040703,172.31.36.0-255,66,182781,1,200193
33441,0.043231,172.217.194.0-255,5738,188519,1,200193
33442,0.043252,172.31.36.0-255,66,188585,1,200193
33443,0.045772,172.217.194.0-255,5738,194323,1,200193
33444,0.045778,172.31.36.0-255,66,194389,1,200193
33445,0.048316,172.217.194.0-255,5738,200127,1,200193
33446,0.04832,172.31.36.0-255,66,200193,1,200193
33447,0.0,74.125.24.0-255,146,146,1,268575
33448,1.4e-05,172.31.36.0-255,66,212,1,268575
33449,2.2e-05,74.125.24.0-255,1484,1696,1,268575
33450,2.7e-05,172.31.36.0-255,66,1762,1,268575
33451,3.3e-05,74.125.24.0-255,2902,4664,1,268575
33452,3.6e-05,172.31.36.0-255,66,4730,1,268575
33453,4.2e-05,74.125.24.0-255,4320,9050,1,268575
33454,4.5e-05,172.31.36.0-255,66,9116,1,268575
33455,5.9e-05,74.125.24.0-255,1484,10600,1,268575
33456,6.2e-05,172.31.36.0-255,66,10666,1,268575
33457,9e-05,172.31.36.0-255,66,10732,1,268575
33458,0.000104,172.31.36.0-255,66,10798,1,268575
33459,0.000518,74.125.24.0-255,1484,12282,1,268575
33460,0.000524,172.31.36.0-255,66,12348,1,268575
33461,0.00053,74.125.24.0-255,2902,15250,1,268575
33462,0.000533,172.31.36.0-255,66,15316,1,268575
33463,0.000537,74.125.24.0-255,2902,18218,1,268575
33464,0.000539,172.31.36.0-255,66,18284,1,268575
33465,0.000545,74.125.24.0-255,4320,22604,1,268575
33466,0.000547,172.31.36.0-255,66,22670,1,268575
33467,0.000583,172.31.36.0-255,66,22736,1,268575
33468,0.000589,74.125.24.0-255,4320,27056,1,268575
33469,0.000592,172.31.36.0-255,66,27122,1,268575
33470,0.000621,172.31.36.0-255,66,27188,1,268575
33471,0.000909,74.125.24.0-255,131,27319,1,268575
33472,0.000915,172.31.36.0-255,66,27385,1,268575
33473,0.001068,74.125.24.0-255,1484,28869,1,268575
33474,0.001072,172.31.36.0-255,66,28935,1,268575
33475,0.001078,74.125.24.0-255,2902,31837,1,268575
33476,0.001081,172.31.36.0-255,66,31903,1,268575
33477,0.001085,74.125.24.0-255,1484,33387,1,268575
33478,0.001107,74.125.24.0-255,4320,37707,1,268575
33479,0.00111,172.31.36.0-255,66,37773,1,268575
33480,0.001119,74.125.24.0-255,6797,44570,1,268575
33481,0.001122,172.31.36.0-255,66,44636,1,268575
33482,0.001209,74.125.24.0-255,1484,46120,1,268575
33483,0.001214,74.125.24.0-255,2902,49022,1,268575
33484,0.001217,172.31.36.0-255,66,49088,1,268575
33485,0.001243,74.125.24.0-255,5738,54826,1,268575
33486,0.001246,172.31.36.0-255,66,54892,1,268575
33487,0.001251,74.125.24.0-255,2902,57794,1,268575
33488,0.001253,172.31.36.0-255,66,57860,1,268575
33489,0.00127,74.125.24.0-255,3961,61821,1,268575
33490,0.001273,172.31.36.0-255,66,61887,1,268575
33491,0.001757,74.125.24.0-255,1484,63371,1,268575
33492,0.001764,74.125.24.0-255,2902,66273,1,268575
33493,0.001768,172.31.36.0-255,66,66339,1,268575
33494,0.001775,74.125.24.0-255,5738,72077,1,268575
33495,0.001778,172.31.36.0-255,66,72143,1,268575
33496,0.00181,172.31.36.0-255,66,72209,1,268575
33497,0.001813,74.125.24.0-255,1484,73693,1,268575
33498,0.001854,74.125.24.0-255,5738,79431,1,268575
33499,0.001857,172.31.36.0-255,66,79497,1,268575
33500,0.001872,74.125.24.0-255,3602,83099,1,268575
33501,0.001875,172.31.36.0-255,66,83165,1,268575
33502,0.001881,74.125.24.0-255,5738,88903,1,268575
33503,0.001884,172.31.36.0-255,66,88969,1,268575
33504,0.001905,74.125.24.0-255,4320,93289,1,268575
33505,0.001907,172.31.36.0-255,66,93355,1,268575
33506,0.001915,74.125.24.0-255,7156,100511,1,268575
33507,0.001917,172.31.36.0-255,66,100577,1,268575
33508,0.001944,172.31.36.0-255,66,100643,1,268575
33509,0.001947,74.125.24.0-255,1484,102127,1,268575
33510,0.001974,74.125.24.0-255,6438,108565,1,268575
33511,0.001977,172.31.36.0-255,66,108631,1,268575
33512,0.002005,172.31.36.0-255,66,108697,1,268575
33513,0.00201,74.125.24.0-255,4320,113017,1,268575
33514,0.002012,172.31.36.0-255,66,113083,1,268575
33515,0.002043,172.31.36.0-255,66,113149,1,268575
33516,0.00205,74.125.24.0-255,6438,119587,1,268575
33517,0.002053,172.31.36.0-255,66,119653,1,268575
33518,0.002118,74.125.24.0-255,7156,126809,1,268575
33519,0.002121,172.31.36.0-255,66,126875,1,268575
33520,0.002132,172.31.36.0-255,66,126941,1,268575
33521,0.002148,172.31.36.0-255,66,127007,1,268575
33522,0.002151,74.125.24.0-255,766,127773,1,268575
33523,0.002187,172.31.36.0-255,66,127839,1,268575
33524,0.002204,74.125.24.0-255,2902,130741,1,268575
33525,0.002206,172.31.36.0-255,66,130807,1,268575
33526,0.002219,74.125.24.0-255,7156,137963,1,268575
33527,0.002221,172.31.36.0-255,66,138029,1,268575
33528,0.002245,172.31.36.0-255,66,138095,1,268575
33529,0.002248,74.125.24.0-255,766,138861,1,268575
33530,0.002251,74.125.24.0-255,1484,140345,1,268575
33531,0.002253,172.31.36.0-255,66,140411,1,268575
33532,0.002259,74.125.24.0-255,4320,144731,1,268575
33533,0.002262,172.31.36.0-255,66,144797,1,268575
33534,0.002274,172.31.36.0-255,66,144863,1,268575
33535,0.002317,172.31.36.0-255,66,144929,1,268575
33536,0.002321,74.125.24.0-255,2184,147113,1,268575
33537,0.002323,172.31.36.0-255,66,147179,1,268575
33538,0.002345,74.125.24.0-255,1484,148663,1,268575
33539,0.004645,74.125.24.0-255,2902,151565,1,268575
33540,0.004648,172.31.36.0-255,66,151631,1,268575
33541,0.004666,74.125.24.0-255,1484,153115,1,268575
33542,0.006972,74.125.24.0-255,4320,157435,1,268575
33543,0.006978,172.31.36.0-255,66,157501,1,268575
33544,0.009305,74.125.24.0-255,5738,163239,1,268575
33545,0.009311,172.31.36.0-255,66,163305,1,268575
33546,0.01164,74.125.24.0-255,5738,169043,1,268575
33547,0.011648,172.31.36.0-255,66,169109,1,268575
33548,0.013992,74.125.24.0-255,5738,174847,1,268575
33549,0.013999,172.31.36.0-255,66,174913,1,268575
33550,0.016336,74.125.24.0-255,5738,180651,1,268575
33551,0.016345,172.31.36.0-255,66,180717,1,268575
33552,0.018659,74.125.24.0-255,4320,185037,1,268575
33553,0.018666,172.31.36.0-255,66,185103,1,268575
33554,0.018687,74.125.24.0-255,1484,186587,1,268575
33555,0.021008,74.125.24.0-255,4320,190907,1,268575
33556,0.021016,172.31.36.0-255,66,190973,1,268575
33557,0.023369,74.125.24.0-255,5738,196711,1,268575
33558,0.023376,172.31.36.0-255,66,196777,1,268575
33559,0.025737,74.125.24.0-255,5738,202515,1,268575
33560,0.025744,172.31.36.0-255,66,202581,1,268575
33561,0.028092,74.125.24.0-255,5738,208319,1,268575
33562,0.028099,172.31.36.0-255,66,208385,1,268575
33563,0.030439,74.125.24.0-255,5738,214123,1,268575
33564,0.030447,172.31.36.0-255,66,214189,1,268575
33565,0.032788,74.125.24.0-255,5738,219927,1,268575
33566,0.032796,172.31.36.0-255,66,219993,1,268575
33567,0.035157,74.125.24.0-255,5738,225731,1,268575
33568,0.035164,172.31.36.0-255,66,225797,1,268575
33569,0.03754,74.125.24.0-255,5738,231535,1,268575
33570,0.037548,172.31.36.0-255,66,231601,1,268575
33571,0.038649,172.31.36.0-255,171,231772,1,268575
33572,0.038684,172.31.36.0-255,1137,232909,1,268575
33573,0.038754,172.31.36.0-255,1514,234423,1,268575
33574,0.038756,172.31.36.0-255,1514,235937,1,268575
33575,0.038757,172.31.36.0-255,1514,237451,1,268575
33576,0.038758,172.31.36.0-255,1514,238965,1,268575
33577,0.038785,172.31.36.0-255,326,239291,1,268575
33578,0.039888,74.125.24.0-255,5738,245029,1,268575
33579,0.039896,172.31.36.0-255,66,245095,1,268575
33580,0.040185,104.244.42.0-255,66,245161,1,268575
33581,0.04025,104.244.42.0-255,66,245227,1,268575
33582,0.040356,104.244.42.0-255,66,245293,1,268575
33583,0.040362,104.244.42.0-255,66,245359,1,268575
33584,0.042244,74.125.24.0-255,5738,251097,1,268575
33585,0.04225,172.31.36.0-255,66,251163,1,268575
33586,0.044582,74.125.24.0-255,5738,256901,1,268575
33587,0.044589,172.31.36.0-255,66,256967,1,268575
33588,0.046951,74.125.24.0-255,5738,262705,1,268575
33589,0.046961,172.31.36.0-255,66,262771,1,268575
33590,0.049298,74.125.24.0-255,5738,268509,1,268575
33591,0.049306,172.31.36.0-255,66,268575,1,268575
33592,0.0,74.125.24.0-255,145,145,1,333120
33593,3e-05,172.31.36.0-255,66,211,1,333120
33594,3.6e-05,74.125.24.0-255,1484,1695,1,333120
33595,3.9e-05,172.31.36.0-255,66,1761,1,333120
33596,4.4e-05,74.125.24.0-255,2902,4663,1,333120
33597,4.8e-05,172.31.36.0-255,66,4729,1,333120
33598,5.4e-05,74.125.24.0-255,5738,10467,1,333120
33599,5.7e-05,172.31.36.0-255,66,10533,1,333120
33600,7.6e-05,74.125.24.0-255,1484,12017,1,333120
33601,8.1e-05,172.31.36.0-255,66,12083,1,333120
33602,9.2e-05,74.125.24.0-255,5738,17821,1,333120
33603,9.6e-05,172.31.36.0-255,66,17887,1,333120
33604,0.000115,74.125.24.0-255,4902,22789,1,333120
33605,0.000118,172.31.36.0-255,66,22855,1,333120
33606,0.000132,74.125.24.0-255,4320,27175,1,333120
33607,0.000135,172.31.36.0-255,66,27241,1,333120
33608,0.00015,74.125.24.0-255,3961,31202,1,333120
33609,0.000153,172.31.36.0-255,66,31268,1,333120
33610,0.000179,74.125.24.0-255,5738,37006,1,333120
33611,0.000182,172.31.36.0-255,66,37072,1,333120
33612,0.000203,74.125.24.0-255,2902,39974,1,333120
33613,0.000206,172.31.36.0-255,66,40040,1,333120
33614,0.000209,74.125.24.0-255,1484,41524,1,333120
33615,0.000211,172.31.36.0-255,66,41590,1,333120
33616,0.000222,172.31.36.0-255,66,41656,1,333120
33617,0.000256,74.125.24.0-255,3961,45617,1,333120
33618,0.00026,172.31.36.0-255,66,45683,1,333120
33619,0.000272,172.31.36.0-255,66,45749,1,333120
33620,0.000275,74.125.24.0-255,399,46148,1,333120
33621,0.000278,172.31.36.0-255,66,46214,1,333120
33622,0.000325,74.125.24.0-255,376,46590,1,333120
33623,0.00046,74.125.24.0-255,1484,48074,1,333120
33624,0.000466,172.31.36.0-255,66,48140,1,333120
33625,0.000471,74.125.24.0-255,2902,51042,1,333120
33626,0.000473,172.31.36.0-255,66,51108,1,333120
33627,0.000508,74.125.24.0-255,2902,54010,1,333120
33628,0.000511,172.31.36.0-255,66,54076,1,333120
33629,0.000531,74.125.24.0-255,2902,56978,1,333120
33630,0.000534,172.31.36.0-255,66,57044,1,333120
33631,0.000541,74.125.24.0-255,6797,63841,1,333120
33632,0.000544,172.31.36.0-255,66,63907,1,333120
33633,0.00055,74.125.24.0-255,5738,69645,1,333120
33634,0.000553,172.31.36.0-255,66,69711,1,333120
33635,0.00056,74.125.24.0-255,7156,76867,1,333120
33636,0.000564,172.31.36.0-255,66,76933,1,333120
33637,0.000589,74.125.24.0-255,3961,80894,1,333120
33638,0.000592,172.31.36.0-255,66,80960,1,333120
33639,0.001217,74.125.24.0-255,1484,82444,1,333120
33640,0.001228,74.125.24.0-255,2902,85346,1,333120
33641,0.001233,172.31.36.0-255,66,85412,1,333120
33642,0.00124,74.125.24.0-255,5738,91150,1,333120
33643,0.001243,172.31.36.0-255,66,91216,1,333120
33644,0.001246,74.125.24.0-255,1484,92700,1,333120
33645,0.00127,74.125.24.0-255,2902,95602,1,333120
33646,0.001273,172.31.36.0-255,66,95668,1,333120
33647,0.00128,74.125.24.0-255,5738,101406,1,333120
33648,0.001283,172.31.36.0-255,66,101472,1,333120
33649,0.001289,74.125.24.0-255,5738,107210,1,333120
33650,0.001291,172.31.36.0-255,66,107276,1,333120
33651,0.001317,74.125.24.0-255,7156,114432,1,333120
33652,0.00132,172.31.36.0-255,66,114498,1,333120
33653,0.001323,74.125.24.0-255,766,115264,1,333120
33654,0.001346,74.125.24.0-255,2902,118166,1,333120
33655,0.001349,172.31.36.0-255,66,118232,1,333120
33656,0.001375,74.125.24.0-255,5738,123970,1,333120
33657,0.001377,172.31.36.0-255,66,124036,1,333120
33658,0.001388,172.31.36.0-255,66,124102,1,333120
33659,0.001402,74.125.24.0-255,5738,129840,1,333120
33660,0.001405,172.31.36.0-255,66,129906,1,333120
33661,0.001431,172.31.36.0-255,66,129972,1,333120
33662,0.001674,74.125.24.0-255,1484,131456,1,333120
33663,0.001681,74.125.24.0-255,2902,134358,1,333120
33664,0.001685,172.31.36.0-255,66,134424,1,333120
33665,0.001693,74.125.24.0-255,5738,140162,1,333120
33666,0.001695,172.31.36.0-255,66,140228,1,333120
33667,0.001698,74.125.24.0-255,1484,141712,1,333120
33668,0.001721,172.31.36.0-255,66,141778,1,333120
33669,0.001785,74.125.24.0-255,2902,144680,1,333120
33670,0.001787,172.31.36.0-255,66,144746,1,333120
33671,0.001807,172.31.36.0-255,66,144812,1,333120
33672,0.001833,74.125.24.0-255,4320,149132,1,333120
33673,0.001835,172.31.36.0-255,66,149198,1,333120
33674,0.001862,172.31.36.0-255,66,149264,1,333120
33675,0.001874,172.31.36.0-255,66,149330,1,333120
33676,0.001892,74.125.24.0-255,5738,155068,1,333120
33677,0.001894,172.31.36.0-255,66,155134,1,333120
33678,0.001916,74.125.24.0-255,2184,157318,1,333120
33679,0.001918,172.31.36.0-255,66,157384,1,333120
33680,0.001951,74.125.24.0-255,2902,160286,1,333120
33681,0.001953,172.31.36.0-255,66,160352,1,333120
33682,0.001956,74.125.24.0-255,1484,161836,1,333120
33683,0.001975,74.125.24.0-255,5738,167574,1,333120
33684,0.001977,172.31.36.0-255,66,167640,1,333120
33685,0.001989,74.125.24.0-255,4320,171960,1,333120
33686,0.001991,172.31.36.0-255,66,172026,1,333120
33687,0.002021,172.31.36.0-255,66,172092,1,333120
33688,0.002071,74.125.24.0-255,7156,179248,1,333120
33689,0.002074,172.31.36.0-255,66,179314,1,333120
33690,0.002086,74.125.24.0-255,3602,182916,1,333120
33691,0.002088,172.31.36.0-255,66,182982,1,333120
33692,0.002219,74.125.24.0-255,1484,184466,1,333120
33693,0.002241,74.125.24.0-255,2902,187368,1,333120
33694,0.002243,172.31.36.0-255,66,187434,1,333120
33695,0.002257,74.125.24.0-255,4320,191754,1,333120
33696,0.00226,172.31.36.0-255,66,191820,1,333120
33697,0.002276,74.125.24.0-255,1484,193304,1,333120
33698,0.002283,74.125.24.0-255,5738,199042,1,333120
33699,0.002285,172.31.36.0-255,66,199108,1,333120
33700,0.00229,74.125.24.0-255,4320,203428,1,333120
33701,0.002292,172.31.36.0-255,66,203494,1,333120
33702,0.002312,172.31.36.0-255,66,203560,1,333120
33703,0.002339,74.125.24.0-255,5020,208580,1,333120
33704,0.002341,172.31.36.0-255,66,208646,1,333120
33705,0.004637,74.125.24.0-255,5738,214384,1,333120
33706,0.004641,172.31.36.0-255,66,214450,1,333120
33707,0.006964,74.125.24.0-255,5738,220188,1,333120
33708,0.006973,172.31.36.0-255,66,220254,1,333120
33709,0.00929,74.125.24.0-255,5738,225992,1,333120
33710,0.009301,172.31.36.0-255,66,226058,1,333120
33711,0.011629,74.125.24.0-255,5738,231796,1,333120
33712,0.011638,172.31.36.0-255,66,231862,1,333120
33713,0.013951,74.125.24.0-255,5738,237600,1,333120
33714,0.013959,172.31.36.0-255,66,237666,1,333120
33715,0.016287,74.125.24.0-255,5738,243404,1,333120
33716,0.016298,172.31.36.0-255,66,243470,1,333120
33717,0.018613,74.125.24.0-255,5738,249208,1,333120
33718,0.018625,172.31.36.0-255,66,249274,1,333120
33719,0.020938,74.125.24.0-255,5738,255012,1,333120
33720,0.020946,172.31.36.0-255,66,255078,1,333120
33721,0.023278,74.125.24.0-255,5738,260816,1,333120
33722,0.023285,172.31.36.0-255,66,260882,1,333120
33723,0.025647,74.125.24.0-255,5738,266620,1,333120
33724,0.025657,172.31.36.0-255,66,266686,1,333120
33725,0.027996,74.125.24.0-255,5738,272424,1,333120
33726,0.028006,172.31.36.0-255,66,272490,1,333120
33727,0.0303,74.125.24.0-255,5738,278228,1,333120
33728,0.030306,172.31.36.0-255,66,278294,1,333120
33729,0.032227,172.31.36.0-255,172,278466,1,333120
33730,0.032261,172.31.36.0-255,1114,279580,1,333120
33731,0.032339,172.31.36.0-255,1514,281094,1,333120
33732,0.032341,172.31.36.0-255,1514,282608,1,333120
33733,0.032346,172.31.36.0-255,1514,284122,1,333120
33734,0.032347,172.31.36.0-255,1514,285636,1,333120
33735,0.032366,172.31.36.0-255,1491,287127,1,333120
33736,0.032607,74.125.24.0-255,5738,292865,1,333120
33737,0.032615,172.31.36.0-255,66,292931,1,333120
33738,0.033763,104.244.42.0-255,66,292997,1,333120
33739,0.03379,104.244.42.0-255,66,293063,1,333120
33740,0.033904,104.244.42.0-255,66,293129,1,333120
33741,0.033948,104.244.42.0-255,66,293195,1,333120
33742,0.034906,74.125.24.0-255,5738,298933,1,333120
33743,0.034913,172.31.36.0-255,66,298999,1,333120
33744,0.037209,74.125.24.0-255,5738,304737,1,333120
33745,0.037222,172.31.36.0-255,66,304803,1,333120
33746,0.039552,74.125.24.0-255,5738,310541,1,333120
33747,0.039565,172.31.36.0-255,66,310607,1,333120
33748,0.041877,74.125.24.0-255,5738,316345,1,333120
33749,0.041889,172.31.36.0-255,66,316411,1,333120
33750,0.04422,74.125.24.0-255,5738,322149,1,333120
33751,0.044228,172.31.36.0-255,66,322215,1,333120
33752,0.046552,74.125.24.0-255,5738,327953,1,333120
33753,0.046561,172.31.36.0-255,66,328019,1,333120
33754,0.048905,74.125.24.0-255,4930,332949,1,333120
33755,0.048912,172.31.36.0-255,66,333015,1,333120
33756,0.049141,172.31.36.0-255,105,333120,1,333120
33757,0.0,74.125.24.0-255,153,153,1,266055
33758,2.2e-05,172.31.36.0-255,66,219,1,266055
33759,2.9e-05,74.125.24.0-255,1484,1703,1,266055
33760,3.5e-05,172.31.36.0-255,66,1769,1,266055
33761,4.1e-05,74.125.24.0-255,2902,4671,1,266055
33762,4.5e-05,172.31.36.0-255,66,4737,1,266055
33763,5e-05,74.125.24.0-255,2902,7639,1,266055
33764,5.3e-05,172.31.36.0-255,66,7705,1,266055
33765,8.6e-05,74.125.24.0-255,2902,10607,1,266055
33766,8.9e-05,172.31.36.0-255,66,10673,1,266055
33767,0.00011,74.125.24.0-255,3458,14131,1,266055
33768,0.000113,172.31.36.0-255,66,14197,1,266055
33769,0.000357,74.125.24.0-255,1484,15681,1,266055
33770,0.000363,172.31.36.0-255,66,15747,1,266055
33771,0.00037,74.125.24.0-255,2902,18649,1,266055
33772,0.000373,172.31.36.0-255,66,18715,1,266055
33773,0.000399,74.125.24.0-255,5738,24453,1,266055
33774,0.000407,172.31.36.0-255,66,24519,1,266055
33775,0.000452,74.125.24.0-255,6797,31316,1,266055
33776,0.000455,172.31.36.0-255,66,31382,1,266055
33777,0.000459,74.125.24.0-255,1484,32866,1,266055
33778,0.000461,172.31.36.0-255,66,32932,1,266055
33779,0.000482,74.125.24.0-255,5738,38670,1,266055
33780,0.000485,172.31.36.0-255,66,38736,1,266055
33781,0.000501,74.125.24.0-255,5738,44474,1,266055
33782,0.000503,172.31.36.0-255,66,44540,1,266055
33783,0.000518,74.125.24.0-255,2902,47442,1,266055
33784,0.000523,172.31.36.0-255,66,47508,1,266055
33785,0.000532,74.125.24.0-255,1125,48633,1,266055
33786,0.000534,172.31.36.0-255,66,48699,1,266055
33787,0.000582,74.125.24.0-255,1484,50183,1,266055
33788,0.000586,172.31.36.0-255,66,50249,1,266055
33789,0.000589,74.125.24.0-255,1484,51733,1,266055
33790,0.000616,74.125.24.0-255,4320,56053,1,266055
33791,0.000619,172.31.36.0-255,66,56119,1,266055
33792,0.000647,172.31.36.0-255,66,56185,1,266055
33793,0.000798,74.125.24.0-255,115,56300,1,266055
33794,0.001057,74.125.24.0-255,330,56630,1,266055
33795,0.001063,172.31.36.0-255,66,56696,1,266055
33796,0.001088,172.31.36.0-255,66,56762,1,266055
33797,0.001388,74.125.24.0-255,1484,58246,1,266055
33798,0.001398,74.125.24.0-255,2902,61148,1,266055
33799,0.001402,172.31.36.0-255,66,61214,1,266055
33800,0.001426,74.125.24.0-255,5738,66952,1,266055
33801,0.001429,172.31.36.0-255,66,67018,1,266055
33802,0.001435,74.125.24.0-255,4320,71338,1,266055
33803,0.001437,172.31.36.0-255,66,71404,1,266055
33804,0.001461,172.31.36.0-255,66,71470,1,266055
33805,0.001469,74.125.24.0-255,7156,78626,1,266055
33806,0.001472,172.31.36.0-255,66,78692,1,266055
33807,0.0015,74.125.24.0-255,3602,82294,1,266055
33808,0.001503,172.31.36.0-255,66,82360,1,266055
33809,0.0021,74.125.24.0-255,1484,83844,1,266055
33810,0.002108,74.125.24.0-255,2902,86746,1,266055
33811,0.002112,172.31.36.0-255,66,86812,1,266055
33812,0.002121,74.125.24.0-255,5738,92550,1,266055
33813,0.002123,172.31.36.0-255,66,92616,1,266055
33814,0.002157,172.31.36.0-255,66,92682,1,266055
33815,0.00218,74.125.24.0-255,2902,95584,1,266055
33816,0.002182,172.31.36.0-255,66,95650,1,266055
33817,0.002195,172.31.36.0-255,66,95716,1,266055
33818,0.002761,74.125.24.0-255,1484,97200,1,266055
33819,0.002787,74.125.24.0-255,2902,100102,1,266055
33820,0.00279,172.31.36.0-255,66,100168,1,266055
33821,0.002822,74.125.24.0-255,2902,103070,1,266055
33822,0.002825,172.31.36.0-255,66,103136,1,266055
33823,0.002848,74.125.24.0-255,2902,106038,1,266055
33824,0.002851,172.31.36.0-255,66,106104,1,266055
33825,0.002866,172.31.36.0-255,66,106170,1,266055
33826,0.002871,74.125.24.0-255,4320,110490,1,266055
33827,0.002874,172.31.36.0-255,66,110556,1,266055
33828,0.002876,74.125.24.0-255,1484,112040,1,266055
33829,0.002883,74.125.24.0-255,5020,117060,1,266055
33830,0.002886,172.31.36.0-255,66,117126,1,266055
33831,0.003136,74.125.24.0-255,1484,118610,1,266055
33832,0.003159,74.125.24.0-255,2902,121512,1,266055
33833,0.003164,172.31.36.0-255,66,121578,1,266055
33834,0.00317,74.125.24.0-255,5738,127316,1,266055
33835,0.003172,172.31.36.0-255,66,127382,1,266055
33836,0.0032,74.125.24.0-255,5738,133120,1,266055
33837,0.003203,172.31.36.0-255,66,133186,1,266055
33838,0.003209,74.125.24.0-255,5738,138924,1,266055
33839,0.003211,172.31.36.0-255,66,138990,1,266055
33840,0.003229,74.125.24.0-255,1484,140474,1,266055
33841,0.003263,74.125.24.0-255,5738,146212,1,266055
33842,0.003266,172.31.36.0-255,66,146278,1,266055
33843,0.003282,74.125.24.0-255,5020,151298,1,266055
33844,0.003284,172.31.36.0-255,66,151364,1,266055
33845,0.003547,74.125.24.0-255,1484,152848,1,266055
33846,0.003562,74.125.24.0-255,2902,155750,1,266055
33847,0.003564,172.31.36.0-255,66,155816,1,266055
33848,0.003588,74.125.24.0-255,5738,161554,1,266055
33849,0.003591,172.31.36.0-255,66,161620,1,266055
33850,0.003603,172.31.36.0-255,66,161686,1,266055
33851,0.00362,74.125.24.0-255,4320,166006,1,266055
33852,0.003623,172.31.36.0-255,66,166072,1,266055
33853,0.003635,172.31.36.0-255,66,166138,1,266055
33854,0.003652,74.125.24.0-255,2902,169040,1,266055
33855,0.003654,172.31.36.0-255,66,169106,1,266055
33856,0.003699,172.31.36.0-255,66,169172,1,266055
33857,0.00371,172.31.36.0-255,66,169238,1,266055
33858,0.003794,74.125.24.0-255,1484,170722,1,266055
33859,0.0038,74.125.24.0-255,2902,173624,1,266055
33860,0.003802,172.31.36.0-255,66,173690,1,266055
33861,0.003807,74.125.24.0-255,2902,176592,1,266055
33862,0.003809,172.31.36.0-255,66,176658,1,266055
33863,0.003835,74.125.24.0-255,7156,183814,1,266055
33864,0.003839,172.31.36.0-255,66,183880,1,266055
33865,0.003847,74.125.24.0-255,7156,191036,1,266055
33866,0.003849,172.31.36.0-255,66,191102,1,266055
33867,0.003861,74.125.24.0-255,1484,192586,1,266055
33868,0.003866,74.125.24.0-255,2902,195488,1,266055
33869,0.003869,172.31.36.0-255,66,195554,1,266055
33870,0.003877,74.125.24.0-255,7156,202710,1,266055
33871,0.003879,172.31.36.0-255,66,202776,1,266055
33872,0.003882,74.125.24.0-255,766,203542,1,266055
33873,0.003989,74.125.24.0-255,1484,205026,1,266055
33874,0.003993,172.31.36.0-255,66,205092,1,266055
33875,0.003998,74.125.24.0-255,2902,207994,1,266055
33876,0.004001,172.31.36.0-255,66,208060,1,266055
33877,0.004019,74.125.24.0-255,1484,209544,1,266055
33878,0.004033,74.125.24.0-255,4320,213864,1,266055
33879,0.004036,172.31.36.0-255,66,213930,1,266055
33880,0.004072,74.125.24.0-255,2902,216832,1,266055
33881,0.004075,172.31.36.0-255,66,216898,1,266055
33882,0.004091,74.125.24.0-255,4320,221218,1,266055
33883,0.004094,172.31.36.0-255,66,221284,1,266055
33884,0.004155,172.31.36.0-255,66,221350,1,266055
33885,0.004173,74.125.24.0-255,2902,224252,1,266055
33886,0.004175,172.31.36.0-255,66,224318,1,266055
33887,0.004182,74.125.24.0-255,5020,229338,1,266055
33888,0.004185,172.31.36.0-255,66,229404,1,266055
33889,0.004188,74.125.24.0-255,1484,230888,1,266055
33890,0.004192,74.125.24.0-255,2902,233790,1,266055
33891,0.004195,172.31.36.0-255,66,233856,1,266055
33892,0.004222,74.125.24.0-255,5738,239594,1,266055
33893,0.004225,172.31.36.0-255,66,239660,1,266055
33894,0.004234,74.125.24.0-255,7156,246816,1,266055
33895,0.004237,172.31.36.0-255,66,246882,1,266055
33896,0.004273,172.31.36.0-255,66,246948,1,266055
33897,0.004293,74.125.24.0-255,1484,248432,1,266055
33898,0.0043,74.125.24.0-255,5020,253452,1,266055
33899,0.004302,172.31.36.0-255,66,253518,1,266055
33900,0.004314,74.125.24.0-255,1484,255002,1,266055
33901,0.004353,172.31.36.0-255,66,255068,1,266055
33902,0.004366,172.31.36.0-255,66,255134,1,266055
33903,0.004385,74.125.24.0-255,1484,256618,1,266055
33904,0.004431,172.31.36.0-255,66,256684,1,266055
33905,0.004434,74.125.24.0-255,105,256789,1,266055
33906,0.00718,172.31.36.0-255,66,256855,1,266055
33907,0.007219,172.31.36.0-255,105,256960,1,266055
33908,0.009527,74.125.24.0-255,66,257026,1,266055
33909,0.039433,172.31.36.0-255,172,257198,1,266055
33910,0.039464,172.31.36.0-255,1114,258312,1,266055
33911,0.039529,172.31.36.0-255,1514,259826,1,266055
33912,0.039531,172.31.36.0-255,1514,261340,1,266055
33913,0.039539,172.31.36.0-255,1514,262854,1,266055
33914,0.03954,172.31.36.0-255,1514,264368,1,266055
33915,0.039557,172.31.36.0-255,1489,265857,1,266055
33916,0.041001,104.244.42.0-255,66,265923,1,266055
33917,0.041039,104.244.42.0-255,66,265989,1,266055
33918,0.041108,104.244.42.0-255,66,266055,1,266055
33919,0.0,172.217.194.0-255,143,143,1,228229
33920,2.4e-05,172.31.36.0-255,66,209,1,228229
33921,3.2e-05,172.217.194.0-255,1484,1693,1,228229
33922,3.6e-05,172.31.36.0-255,66,1759,1,228229
33923,4.3e-05,172.217.194.0-255,2902,4661,1,228229
33924,4.7e-05,172.31.36.0-255,66,4727,1,228229
33925,5.4e-05,172.217.194.0-255,7156,11883,1,228229
33926,5.8e-05,172.31.36.0-255,66,11949,1,228229
33927,6.2e-05,172.217.194.0-255,3435,15384,1,228229
33928,6.5e-05,172.31.36.0-255,66,15450,1,228229
33929,7.1e-05,172.217.194.0-255,4320,19770,1,228229
33930,7.4e-05,172.31.36.0-255,66,19836,1,228229
33931,0.000116,172.31.36.0-255,66,19902,1,228229
33932,0.000137,172.217.194.0-255,1484,21386,1,228229
33933,0.00014,172.31.36.0-255,66,21452,1,228229
33934,0.000143,172.217.194.0-255,1125,22577,1,228229
33935,0.000146,172.31.36.0-255,66,22643,1,228229
33936,0.000174,172.217.194.0-255,1484,24127,1,228229
33937,0.000177,172.31.36.0-255,66,24193,1,228229
33938,0.000199,172.217.194.0-255,2902,27095,1,228229
33939,0.000201,172.31.36.0-255,66,27161,1,228229
33940,0.000208,172.217.194.0-255,5738,32899,1,228229
33941,0.000211,172.31.36.0-255,66,32965,1,228229
33942,0.000245,172.217.194.0-255,2902,35867,1,228229
33943,0.000247,172.31.36.0-255,66,35933,1,228229
33944,0.000276,172.31.36.0-255,66,35999,1,228229
33945,0.000321,172.31.36.0-255,66,36065,1,228229
33946,0.000347,172.217.194.0-255,1484,37549,1,228229
33947,0.000349,172.31.36.0-255,66,37615,1,228229
33948,0.000354,172.217.194.0-255,2902,40517,1,228229
33949,0.000356,172.31.36.0-255,66,40583,1,228229
33950,0.00038,172.217.194.0-255,5738,46321,1,228229
33951,0.000383,172.31.36.0-255,66,46387,1,228229
33952,0.000406,172.217.194.0-255,5738,52125,1,228229
33953,0.000408,172.31.36.0-255,66,52191,1,228229
33954,0.000432,172.217.194.0-255,4320,56511,1,228229
33955,0.000435,172.31.36.0-255,66,56577,1,228229
33956,0.000448,172.31.36.0-255,66,56643,1,228229
33957,0.000452,172.217.194.0-255,2184,58827,1,228229
33958,0.000454,172.31.36.0-255,66,58893,1,228229
33959,0.000677,172.217.194.0-255,1484,60377,1,228229
33960,0.000686,172.217.194.0-255,2902,63279,1,228229
33961,0.00069,172.31.36.0-255,66,63345,1,228229
33962,0.000694,172.217.194.0-255,1484,64829,1,228229
33963,0.000714,172.217.194.0-255,4320,69149,1,228229
33964,0.000717,172.31.36.0-255,66,69215,1,228229
33965,0.000733,172.217.194.0-255,7156,76371,1,228229
33966,0.000735,172.31.36.0-255,66,76437,1,228229
33967,0.000756,172.217.194.0-255,5738,82175,1,228229
33968,0.000758,172.31.36.0-255,66,82241,1,228229
33969,0.000771,172.31.36.0-255,66,82307,1,228229
33970,0.00083,172.217.194.0-255,1484,83791,1,228229
33971,0.000834,172.217.194.0-255,2902,86693,1,228229
33972,0.000837,172.31.36.0-255,66,86759,1,228229
33973,0.000856,172.217.194.0-255,1484,88243,1,228229
33974,0.000871,172.217.194.0-255,4320,92563,1,228229
33975,0.000874,172.31.36.0-255,66,92629,1,228229
33976,0.000877,172.217.194.0-255,1484,94113,1,228229
33977,0.000903,172.31.36.0-255,66,94179,1,228229
33978,0.000909,172.217.194.0-255,4320,98499,1,228229
33979,0.000911,172.31.36.0-255,66,98565,1,228229
33980,0.000926,172.217.194.0-255,5738,104303,1,228229
33981,0.000929,172.31.36.0-255,66,104369,1,228229
33982,0.00096,172.217.194.0-255,3602,107971,1,228229
33983,0.000963,172.31.36.0-255,66,108037,1,228229
33984,0.001058,172.217.194.0-255,1484,109521,1,228229
33985,0.001075,172.217.194.0-255,2902,112423,1,228229
33986,0.001078,172.31.36.0-255,66,112489,1,228229
33987,0.001085,172.217.194.0-255,5738,118227,1,228229
33988,0.001087,172.31.36.0-255,66,118293,1,228229
33989,0.001126,172.31.36.0-255,66,118359,1,228229
33990,0.001139,172.217.194.0-255,1484,119843,1,228229
33991,0.001156,172.217.194.0-255,1484,121327,1,228229
33992,0.001159,172.31.36.0-255,66,121393,1,228229
33993,0.001183,172.31.36.0-255,66,121459,1,228229
33994,0.001195,172.31.36.0-255,66,121525,1,228229
33995,0.001262,172.31.36.0-255,66,121591,1,228229
33996,0.001281,172.31.36.0-255,66,121657,1,228229
33997,0.001289,172.217.194.0-255,7156,128813,1,228229
33998,0.001291,172.31.36.0-255,66,128879,1,228229
33999,0.001332,172.217.194.0-255,2902,131781,1,228229
34000,0.001334,172.31.36.0-255,66,131847,1,228229
34001,0.001357,172.31.36.0-255,66,131913,1,228229
34002,0.001471,172.217.194.0-255,1484,133397,1,228229
34003,0.001476,172.217.194.0-255,1484,134881,1,228229
34004,0.001479,172.31.36.0-255,66,134947,1,228229
34005,0.001492,172.217.194.0-255,1484,136431,1,228229
34006,0.001498,172.217.194.0-255,5738,142169,1,228229
34007,0.001501,172.31.36.0-255,66,142235,1,228229
34008,0.001521,172.217.194.0-255,2902,145137,1,228229
34009,0.001525,172.31.36.0-255,66,145203,1,228229
34010,0.001559,172.31.36.0-255,66,145269,1,228229
34011,0.001577,172.217.194.0-255,2902,148171,1,228229
34012,0.001583,172.31.36.0-255,66,148237,1,228229
34013,0.001609,172.31.36.0-255,66,148303,1,228229
34014,0.001666,172.217.194.0-255,1484,149787,1,228229
34015,0.001673,172.217.194.0-255,2902,152689,1,228229
34016,0.001676,172.31.36.0-255,66,152755,1,228229
34017,0.001682,172.217.194.0-255,2902,155657,1,228229
34018,0.001685,172.31.36.0-255,66,155723,1,228229
34019,0.001698,172.217.194.0-255,2902,158625,1,228229
34020,0.0017,172.31.36.0-255,66,158691,1,228229
34021,0.001708,172.217.194.0-255,7156,165847,1,228229
34022,0.001711,172.31.36.0-255,66,165913,1,228229
34023,0.001738,172.217.194.0-255,5738,171651,1,228229
34024,0.001744,172.217.194.0-255,5738,177389,1,228229
34025,0.001748,172.31.36.0-255,66,177455,1,228229
34026,0.001756,172.31.36.0-255,66,177521,1,228229
34027,0.001763,172.217.194.0-255,5020,182541,1,228229
34028,0.001765,172.31.36.0-255,66,182607,1,228229
34029,0.001795,172.31.36.0-255,66,182673,1,228229
34030,0.001822,172.217.194.0-255,7156,189829,1,228229
34031,0.001826,172.31.36.0-255,66,189895,1,228229
34032,0.001843,172.31.36.0-255,66,189961,1,228229
34033,0.001845,172.217.194.0-255,766,190727,1,228229
34034,0.001865,172.217.194.0-255,1484,192211,1,228229
34035,0.001868,172.31.36.0-255,66,192277,1,228229
34036,0.001888,172.217.194.0-255,4320,196597,1,228229
34037,0.001891,172.31.36.0-255,66,196663,1,228229
34038,0.001898,172.217.194.0-255,5738,202401,1,228229
34039,0.0019,172.31.36.0-255,66,202467,1,228229
34040,0.001917,172.217.194.0-255,2902,205369,1,228229
34041,0.00192,172.31.36.0-255,66,205435,1,228229
34042,0.001942,172.31.36.0-255,66,205501,1,228229
34043,0.001976,172.217.194.0-255,1484,206985,1,228229
34044,0.001994,172.217.194.0-255,6438,213423,1,228229
34045,0.001997,172.31.36.0-255,66,213489,1,228229
34046,0.002008,172.31.36.0-255,66,213555,1,228229
34047,0.002014,172.217.194.0-255,4442,217997,1,228229
34048,0.002017,172.31.36.0-255,66,218063,1,228229
34049,0.00202,172.217.194.0-255,105,218168,1,228229
34050,0.002044,172.217.194.0-255,129,218297,1,228229
34051,0.010457,172.217.194.0-255,129,218426,1,228229
34052,0.010465,172.31.36.0-255,78,218504,1,228229
34053,0.01097,172.31.36.0-255,105,218609,1,228229
34054,0.011005,172.31.36.0-255,105,218714,1,228229
34055,0.011274,172.31.36.0-255,90,218804,1,228229
34056,0.011282,172.31.36.0-255,66,218870,1,228229
34057,0.013188,172.217.194.0-255,66,218936,1,228229
34058,0.013231,172.217.194.0-255,66,219002,1,228229
34059,0.013474,172.217.194.0-255,66,219068,1,228229
34060,0.014079,172.217.194.0-255,66,219134,1,228229
34061,0.014091,172.31.36.0-255,66,219200,1,228229
34062,0.033928,172.31.36.0-255,172,219372,1,228229
34063,0.03396,172.31.36.0-255,1115,220487,1,228229
34064,0.034047,172.31.36.0-255,1514,222001,1,228229
34065,0.034049,172.31.36.0-255,1514,223515,1,228229
34066,0.03405,172.31.36.0-255,1514,225029,1,228229
34067,0.034051,172.31.36.0-255,1514,226543,1,228229
34068,0.034078,172.31.36.0-255,1488,228031,1,228229
34069,0.035491,104.244.42.0-255,66,228097,1,228229
34070,0.035529,104.244.42.0-255,66,228163,1,228229
34071,0.035632,104.244.42.0-255,66,228229,1,228229
34072,0.0,172.217.160.0-255,153,153,1,222535
34073,3e-05,172.31.36.0-255,66,219,1,222535
34074,3.7e-05,172.217.160.0-255,1484,1703,1,222535
34075,4.2e-05,172.31.36.0-255,66,1769,1,222535
34076,5.7e-05,172.217.160.0-255,2902,4671,1,222535
34077,6.1e-05,172.31.36.0-255,66,4737,1,222535
34078,6.6e-05,172.217.160.0-255,4320,9057,1,222535
34079,6.9e-05,172.31.36.0-255,66,9123,1,222535
34080,0.00011,172.31.36.0-255,66,9189,1,222535
34081,0.000146,172.31.36.0-255,66,9255,1,222535
34082,0.000158,172.217.160.0-255,1125,10380,1,222535
34083,0.00016,172.31.36.0-255,66,10446,1,222535
34084,0.000177,172.31.36.0-255,66,10512,1,222535
34085,0.000213,172.217.160.0-255,6797,17309,1,222535
34086,0.000216,172.31.36.0-255,66,17375,1,222535
34087,0.000287,172.217.160.0-255,1484,18859,1,222535
34088,0.000292,172.31.36.0-255,66,18925,1,222535
34089,0.000297,172.217.160.0-255,2902,21827,1,222535
34090,0.000299,172.217.160.0-255,1484,23311,1,222535
34091,0.000302,172.31.36.0-255,66,23377,1,222535
34092,0.000307,172.31.36.0-255,66,23443,1,222535
34093,0.000329,172.217.160.0-255,4320,27763,1,222535
34094,0.000337,172.31.36.0-255,66,27829,1,222535
34095,0.000344,172.217.160.0-255,6797,34626,1,222535
34096,0.000347,172.31.36.0-255,66,34692,1,222535
34097,0.000371,172.217.160.0-255,373,35065,1,222535
34098,0.000379,172.31.36.0-255,66,35131,1,222535
34099,0.001404,172.217.160.0-255,105,35236,1,222535
34100,0.001411,172.31.36.0-255,66,35302,1,222535
34101,0.001551,172.217.160.0-255,1484,36786,1,222535
34102,0.001557,172.217.160.0-255,2902,39688,1,222535
34103,0.00156,172.31.36.0-255,66,39754,1,222535
34104,0.001563,172.217.160.0-255,1484,41238,1,222535
34105,0.00159,172.217.160.0-255,4320,45558,1,222535
34106,0.001592,172.31.36.0-255,66,45624,1,222535
34107,0.001599,172.217.160.0-255,5738,51362,1,222535
34108,0.001601,172.31.36.0-255,66,51428,1,222535
34109,0.001616,172.217.160.0-255,1125,52553,1,222535
34110,0.001623,172.217.160.0-255,7156,59709,1,222535
34111,0.001629,172.31.36.0-255,66,59775,1,222535
34112,0.001653,172.217.160.0-255,5738,65513,1,222535
34113,0.001656,172.31.36.0-255,66,65579,1,222535
34114,0.001679,172.217.160.0-255,3961,69540,1,222535
34115,0.001682,172.31.36.0-255,66,69606,1,222535
34116,0.003565,172.217.160.0-255,1484,71090,1,222535
34117,0.00361,172.217.160.0-255,4320,75410,1,222535
34118,0.003612,172.31.36.0-255,66,75476,1,222535
34119,0.005519,172.217.160.0-255,5738,81214,1,222535
34120,0.005522,172.31.36.0-255,66,81280,1,222535
34121,0.007444,172.217.160.0-255,5738,87018,1,222535
34122,0.007452,172.31.36.0-255,66,87084,1,222535
34123,0.00937,172.217.160.0-255,5738,92822,1,222535
34124,0.009377,172.31.36.0-255,66,92888,1,222535
34125,0.01129,172.217.160.0-255,5738,98626,1,222535
34126,0.011297,172.31.36.0-255,66,98692,1,222535
34127,0.013216,172.217.160.0-255,5738,104430,1,222535
34128,0.013222,172.31.36.0-255,66,104496,1,222535
34129,0.015141,172.217.160.0-255,5738,110234,1,222535
34130,0.015148,172.31.36.0-255,66,110300,1,222535
34131,0.01707,172.217.160.0-255,5738,116038,1,222535
34132,0.017078,172.31.36.0-255,66,116104,1,222535
34133,0.018997,172.217.160.0-255,5738,121842,1,222535
34134,0.019004,172.31.36.0-255,66,121908,1,222535
34135,0.020926,172.217.160.0-255,5738,127646,1,222535
34136,0.020938,172.31.36.0-255,66,127712,1,222535
34137,0.022851,172.217.160.0-255,5738,133450,1,222535
34138,0.022858,172.31.36.0-255,66,133516,1,222535
34139,0.02477,172.217.160.0-255,5738,139254,1,222535
34140,0.024777,172.31.36.0-255,66,139320,1,222535
34141,0.026693,172.217.160.0-255,5738,145058,1,222535
34142,0.0267,172.31.36.0-255,66,145124,1,222535
34143,0.028621,172.217.160.0-255,5738,150862,1,222535
34144,0.028628,172.31.36.0-255,66,150928,1,222535
34145,0.030546,172.217.160.0-255,5738,156666,1,222535
34146,0.030553,172.31.36.0-255,66,156732,1,222535
34147,0.031699,172.31.36.0-255,190,156922,1,222535
34148,0.03173,172.31.36.0-255,1116,158038,1,222535
34149,0.031776,172.31.36.0-255,1514,159552,1,222535
34150,0.031778,172.31.36.0-255,1514,161066,1,222535
34151,0.031784,172.31.36.0-255,1514,162580,1,222535
34152,0.031785,172.31.36.0-255,1514,164094,1,222535
34153,0.03181,172.31.36.0-255,1489,165583,1,222535
34154,0.032474,172.217.160.0-255,5738,171321,1,222535
34155,0.032481,172.31.36.0-255,66,171387,1,222535
34156,0.033259,104.244.42.0-255,66,171453,1,222535
34157,0.033316,104.244.42.0-255,66,171519,1,222535
34158,0.033375,104.244.42.0-255,66,171585,1,222535
34159,0.03338,104.244.42.0-255,66,171651,1,222535
34160,0.034394,172.217.160.0-255,5738,177389,1,222535
34161,0.0344,172.31.36.0-255,66,177455,1,222535
34162,0.036315,172.217.160.0-255,5738,183193,1,222535
34163,0.036321,172.31.36.0-255,66,183259,1,222535
34164,0.038244,172.217.160.0-255,4320,187579,1,222535
34165,0.038249,172.31.36.0-255,66,187645,1,222535
34166,0.038286,172.217.160.0-255,1484,189129,1,222535
34167,0.040157,172.217.160.0-255,4320,193449,1,222535
34168,0.040162,172.31.36.0-255,66,193515,1,222535
34169,0.042075,172.217.160.0-255,5738,199253,1,222535
34170,0.042081,172.31.36.0-255,66,199319,1,222535
34171,0.044001,172.217.160.0-255,5738,205057,1,222535
34172,0.044006,172.31.36.0-255,66,205123,1,222535
34173,0.04592,172.217.160.0-255,5738,210861,1,222535
34174,0.045925,172.31.36.0-255,66,210927,1,222535
34175,0.047831,172.217.160.0-255,5738,216665,1,222535
34176,0.047836,172.31.36.0-255,66,216731,1,222535
34177,0.049749,172.217.160.0-255,5738,222469,1,222535
34178,0.049754,172.31.36.0-255,66,222535,1,222535
34179,0.0,74.125.200.0-255,153,153,1,344775
34180,2.3e-05,172.31.36.0-255,66,219,1,344775
34181,3e-05,74.125.200.0-255,1484,1703,1,344775
34182,3.5e-05,172.31.36.0-255,66,1769,1,344775
34183,4e-05,74.125.200.0-255,2902,4671,1,344775
34184,4.3e-05,172.31.36.0-255,66,4737,1,344775
34185,4.7e-05,74.125.200.0-255,1484,6221,1,344775
34186,5e-05,172.31.36.0-255,66,6287,1,344775
34187,5.5e-05,74.125.200.0-255,2902,9189,1,344775
34188,5.8e-05,172.31.36.0-255,66,9255,1,344775
34189,6.5e-05,74.125.200.0-255,6254,15509,1,344775
34190,6.8e-05,172.31.36.0-255,66,15575,1,344775
34191,7.3e-05,74.125.200.0-255,2902,18477,1,344775
34192,7.6e-05,172.31.36.0-255,66,18543,1,344775
34193,0.000108,74.125.200.0-255,4320,22863,1,344775
34194,0.000111,172.31.36.0-255,66,22929,1,344775
34195,0.000122,172.31.36.0-255,66,22995,1,344775
34196,0.000199,74.125.200.0-255,1484,24479,1,344775
34197,0.000202,172.31.36.0-255,66,24545,1,344775
34198,0.000218,74.125.200.0-255,2902,27447,1,344775
34199,0.00022,172.31.36.0-255,66,27513,1,344775
34200,0.000224,74.125.200.0-255,1484,28997,1,344775
34201,0.000226,172.31.36.0-255,66,29063,1,344775
34202,0.000243,74.125.200.0-255,2902,31965,1,344775
34203,0.000246,172.31.36.0-255,66,32031,1,344775
34204,0.000249,74.125.200.0-255,1484,33515,1,344775
34205,0.000265,172.31.36.0-255,66,33581,1,344775
34206,0.000293,74.125.200.0-255,4320,37901,1,344775
34207,0.000296,172.31.36.0-255,66,37967,1,344775
34208,0.000299,74.125.200.0-255,1484,39451,1,344775
34209,0.000301,172.31.36.0-255,66,39517,1,344775
34210,0.000306,74.125.200.0-255,2543,42060,1,344775
34211,0.000308,172.31.36.0-255,66,42126,1,344775
34212,0.000314,74.125.200.0-255,4320,46446,1,344775
34213,0.000316,172.31.36.0-255,66,46512,1,344775
34214,0.000343,74.125.200.0-255,1484,47996,1,344775
34215,0.000348,74.125.200.0-255,2902,50898,1,344775
34216,0.00035,172.31.36.0-255,66,50964,1,344775
34217,0.000382,74.125.200.0-255,5738,56702,1,344775
34218,0.000385,172.31.36.0-255,66,56768,1,344775
34219,0.000415,74.125.200.0-255,1441,58209,1,344775
34220,0.000418,74.125.200.0-255,341,58550,1,344775
34221,0.00042,172.31.36.0-255,66,58616,1,344775
34222,0.00061,74.125.200.0-255,1484,60100,1,344775
34223,0.000638,74.125.200.0-255,1484,61584,1,344775
34224,0.000642,172.31.36.0-255,66,61650,1,344775
34225,0.000657,74.125.200.0-255,2902,64552,1,344775
34226,0.000659,172.31.36.0-255,66,64618,1,344775
34227,0.000664,74.125.200.0-255,2902,67520,1,344775
34228,0.000667,172.31.36.0-255,66,67586,1,344775
34229,0.000689,74.125.200.0-255,2902,70488,1,344775
34230,0.000692,172.31.36.0-255,66,70554,1,344775
34231,0.000695,74.125.200.0-255,1484,72038,1,344775
34232,0.000713,74.125.200.0-255,2902,74940,1,344775
34233,0.000715,172.31.36.0-255,66,75006,1,344775
34234,0.000722,74.125.200.0-255,5738,80744,1,344775
34235,0.000725,172.31.36.0-255,66,80810,1,344775
34236,0.00076,74.125.200.0-255,1484,82294,1,344775
34237,0.000766,74.125.200.0-255,2902,85196,1,344775
34238,0.000768,172.31.36.0-255,66,85262,1,344775
34239,0.000796,74.125.200.0-255,1484,86746,1,344775
34240,0.000801,74.125.200.0-255,2902,89648,1,344775
34241,0.000804,172.31.36.0-255,66,89714,1,344775
34242,0.000833,74.125.200.0-255,1484,91198,1,344775
34243,0.000845,74.125.200.0-255,2184,93382,1,344775
34244,0.000848,172.31.36.0-255,66,93448,1,344775
34245,0.001314,74.125.200.0-255,1484,94932,1,344775
34246,0.001319,74.125.200.0-255,1484,96416,1,344775
34247,0.001323,172.31.36.0-255,66,96482,1,344775
34248,0.001344,74.125.200.0-255,1484,97966,1,344775
34249,0.001348,74.125.200.0-255,2902,100868,1,344775
34250,0.001353,74.125.200.0-255,4320,105188,1,344775
34251,0.001362,172.31.36.0-255,66,105254,1,344775
34252,0.001366,172.31.36.0-255,66,105320,1,344775
34253,0.001372,74.125.200.0-255,4320,109640,1,344775
34254,0.001374,172.31.36.0-255,66,109706,1,344775
34255,0.001404,74.125.200.0-255,4320,114026,1,344775
34256,0.001407,172.31.36.0-255,66,114092,1,344775
34257,0.001415,74.125.200.0-255,7156,121248,1,344775
34258,0.001417,172.31.36.0-255,66,121314,1,344775
34259,0.00144,74.125.200.0-255,2902,124216,1,344775
34260,0.001442,172.31.36.0-255,66,124282,1,344775
34261,0.001463,74.125.200.0-255,3602,127884,1,344775
34262,0.001465,172.31.36.0-255,66,127950,1,344775
34263,0.00154,74.125.200.0-255,1484,129434,1,344775
34264,0.001557,74.125.200.0-255,2902,132336,1,344775
34265,0.00156,172.31.36.0-255,66,132402,1,344775
34266,0.001564,74.125.200.0-255,1484,133886,1,344775
34267,0.001583,74.125.200.0-255,4320,138206,1,344775
34268,0.001586,172.31.36.0-255,66,138272,1,344775
34269,0.00159,74.125.200.0-255,2902,141174,1,344775
34270,0.001593,172.31.36.0-255,66,141240,1,344775
34271,0.001609,74.125.200.0-255,4320,145560,1,344775
34272,0.001611,172.31.36.0-255,66,145626,1,344775
34273,0.001615,74.125.200.0-255,2902,148528,1,344775
34274,0.001617,172.31.36.0-255,66,148594,1,344775
34275,0.00165,74.125.200.0-255,5738,154332,1,344775
34276,0.001654,172.31.36.0-255,66,154398,1,344775
34277,0.001661,74.125.200.0-255,7156,161554,1,344775
34278,0.001663,172.31.36.0-255,66,161620,1,344775
34279,0.001666,74.125.200.0-255,766,162386,1,344775
34280,0.001785,74.125.200.0-255,1484,163870,1,344775
34281,0.00179,172.31.36.0-255,66,163936,1,344775
34282,0.001795,74.125.200.0-255,2902,166838,1,344775
34283,0.001798,172.31.36.0-255,66,166904,1,344775
34284,0.001817,74.125.200.0-255,5738,172642,1,344775
34285,0.001821,172.31.36.0-255,66,172708,1,344775
34286,0.001841,74.125.200.0-255,1484,174192,1,344775
34287,0.001855,74.125.200.0-255,4320,178512,1,344775
34288,0.001858,172.31.36.0-255,66,178578,1,344775
34289,0.00188,74.125.200.0-255,4320,182898,1,344775
34290,0.001882,172.31.36.0-255,66,182964,1,344775
34291,0.001896,172.31.36.0-255,66,183030,1,344775
34292,0.001901,74.125.200.0-255,3602,186632,1,344775
34293,0.001903,172.31.36.0-255,66,186698,1,344775
34294,0.001932,74.125.200.0-255,4320,191018,1,344775
34295,0.001935,172.31.36.0-255,66,191084,1,344775
34296,0.001942,74.125.200.0-255,5738,196822,1,344775
34297,0.001944,172.31.36.0-255,66,196888,1,344775
34298,0.00197,74.125.200.0-255,4320,201208,1,344775
34299,0.001973,172.31.36.0-255,66,201274,1,344775
34300,0.001979,74.125.200.0-255,5738,207012,1,344775
34301,0.001982,172.31.36.0-255,66,207078,1,344775
34302,0.001989,74.125.200.0-255,7156,214234,1,344775
34303,0.001991,172.31.36.0-255,66,214300,1,344775
34304,0.002015,74.125.200.0-255,5020,219320,1,344775
34305,0.002018,172.31.36.0-255,66,219386,1,344775
34306,0.004384,74.125.200.0-255,5738,225124,1,344775
34307,0.004391,172.31.36.0-255,66,225190,1,344775
34308,0.006753,74.125.200.0-255,5738,230928,1,344775
34309,0.006758,172.31.36.0-255,66,230994,1,344775
34310,0.009144,74.125.200.0-255,5738,236732,1,344775
34311,0.009151,172.31.36.0-255,66,236798,1,344775
34312,0.011518,74.125.200.0-255,5738,242536,1,344775
34313,0.011526,172.31.36.0-255,66,242602,1,344775
34314,0.013882,74.125.200.0-255,5738,248340,1,344775
34315,0.01389,172.31.36.0-255,66,248406,1,344775
34316,0.016266,74.125.200.0-255,5738,254144,1,344775
34317,0.016274,172.31.36.0-255,66,254210,1,344775
34318,0.018629,74.125.200.0-255,5738,259948,1,344775
34319,0.018637,172.31.36.0-255,66,260014,1,344775
34320,0.021004,74.125.200.0-255,5738,265752,1,344775
34321,0.021011,172.31.36.0-255,66,265818,1,344775
34322,0.023378,74.125.200.0-255,2902,268720,1,344775
34323,0.023386,172.31.36.0-255,66,268786,1,344775
34324,0.023406,74.125.200.0-255,2902,271688,1,344775
34325,0.023409,172.31.36.0-255,66,271754,1,344775
34326,0.025779,74.125.200.0-255,5738,277492,1,344775
34327,0.025787,172.31.36.0-255,66,277558,1,344775
34328,0.028151,74.125.200.0-255,5738,283296,1,344775
34329,0.028158,172.31.36.0-255,66,283362,1,344775
34330,0.030524,74.125.200.0-255,5738,289100,1,344775
34331,0.030533,172.31.36.0-255,66,289166,1,344775
34332,0.032903,74.125.200.0-255,5738,294904,1,344775
34333,0.032912,172.31.36.0-255,66,294970,1,344775
34334,0.035284,74.125.200.0-255,5738,300708,1,344775
34335,0.035291,172.31.36.0-255,66,300774,1,344775
34336,0.037654,74.125.200.0-255,5738,306512,1,344775
34337,0.037661,172.31.36.0-255,66,306578,1,344775
34338,0.040028,74.125.200.0-255,5738,312316,1,344775
34339,0.040037,172.31.36.0-255,66,312382,1,344775
34340,0.041699,172.31.36.0-255,188,312570,1,344775
34341,0.04173,172.31.36.0-255,958,313528,1,344775
34342,0.041922,172.31.36.0-255,1514,315042,1,344775
34343,0.041925,172.31.36.0-255,1514,316556,1,344775
34344,0.041926,172.31.36.0-255,1514,318070,1,344775
34345,0.041931,172.31.36.0-255,1514,319584,1,344775
34346,0.041933,172.31.36.0-255,1514,321098,1,344775
34347,0.041933,172.31.36.0-255,197,321295,1,344775
34348,0.042403,74.125.200.0-255,5738,327033,1,344775
34349,0.042413,172.31.36.0-255,66,327099,1,344775
34350,0.043258,104.244.42.0-255,66,327165,1,344775
34351,0.0433,104.244.42.0-255,66,327231,1,344775
34352,0.043517,104.244.42.0-255,66,327297,1,344775
34353,0.043524,104.244.42.0-255,66,327363,1,344775
34354,0.044782,74.125.200.0-255,5738,333101,1,344775
34355,0.044789,172.31.36.0-255,66,333167,1,344775
34356,0.047151,74.125.200.0-255,5738,338905,1,344775
34357,0.047159,172.31.36.0-255,66,338971,1,344775
34358,0.049545,74.125.200.0-255,5738,344709,1,344775
34359,0.049556,172.31.36.0-255,66,344775,1,344775
34360,0.0,35.164.178.0-255,97,97,1,260
34361,0.000157,172.31.36.0-255,97,194,1,260
34362,0.000168,172.31.36.0-255,66,260,1,260
34363,0.0,172.217.194.0-255,150,150,1,168413
34364,2.2e-05,172.31.36.0-255,66,216,1,168413
34365,3e-05,172.217.194.0-255,1484,1700,1,168413
34366,3.4e-05,172.31.36.0-255,66,1766,1,168413
34367,4e-05,172.217.194.0-255,2902,4668,1,168413
34368,4.3e-05,172.31.36.0-255,66,4734,1,168413
34369,7.7e-05,172.217.194.0-255,7156,11890,1,168413
34370,7.9e-05,172.31.36.0-255,66,11956,1,168413
34371,8.3e-05,172.217.194.0-255,2080,14036,1,168413
34372,9.8e-05,172.31.36.0-255,66,14102,1,168413
34373,0.000971,172.217.194.0-255,1484,15586,1,168413
34374,0.000978,172.31.36.0-255,66,15652,1,168413
34375,0.000986,172.217.194.0-255,1484,17136,1,168413
34376,0.000989,172.31.36.0-255,66,17202,1,168413
34377,0.000994,172.217.194.0-255,2902,20104,1,168413
34378,0.000998,172.31.36.0-255,66,20170,1,168413
34379,0.001001,172.217.194.0-255,1484,21654,1,168413
34380,0.001003,172.31.36.0-255,66,21720,1,168413
34381,0.001022,172.217.194.0-255,4320,26040,1,168413
34382,0.001024,172.31.36.0-255,66,26106,1,168413
34383,0.001039,172.217.194.0-255,2902,29008,1,168413
34384,0.001041,172.31.36.0-255,66,29074,1,168413
34385,0.001055,172.217.194.0-255,2543,31617,1,168413
34386,0.001058,172.31.36.0-255,66,31683,1,168413
34387,0.001128,172.217.194.0-255,1484,33167,1,168413
34388,0.001132,172.31.36.0-255,66,33233,1,168413
34389,0.001138,172.217.194.0-255,2902,36135,1,168413
34390,0.001141,172.31.36.0-255,66,36201,1,168413
34391,0.001169,172.217.194.0-255,5738,41939,1,168413
34392,0.001172,172.31.36.0-255,66,42005,1,168413
34393,0.001221,172.217.194.0-255,6797,48802,1,168413
34394,0.001224,172.31.36.0-255,66,48868,1,168413
34395,0.00376,172.217.194.0-255,5738,54606,1,168413
34396,0.003766,172.31.36.0-255,66,54672,1,168413
34397,0.006333,172.217.194.0-255,5738,60410,1,168413
34398,0.006341,172.31.36.0-255,66,60476,1,168413
34399,0.008899,172.217.194.0-255,5738,66214,1,168413
34400,0.008907,172.31.36.0-255,66,66280,1,168413
34401,0.011447,172.217.194.0-255,5738,72018,1,168413
34402,0.011456,172.31.36.0-255,66,72084,1,168413
34403,0.014018,172.217.194.0-255,5738,77822,1,168413
34404,0.014032,172.31.36.0-255,66,77888,1,168413
34405,0.016608,172.217.194.0-255,5738,83626,1,168413
34406,0.016616,172.31.36.0-255,66,83692,1,168413
34407,0.019164,172.217.194.0-255,5738,89430,1,168413
34408,0.019172,172.31.36.0-255,66,89496,1,168413
34409,0.021723,172.217.194.0-255,5738,95234,1,168413
34410,0.021731,172.31.36.0-255,66,95300,1,168413
34411,0.024267,172.217.194.0-255,5738,101038,1,168413
34412,0.024274,172.31.36.0-255,66,101104,1,168413
34413,0.02684,172.217.194.0-255,5738,106842,1,168413
34414,0.026848,172.31.36.0-255,66,106908,1,168413
34415,0.027655,172.31.36.0-255,172,107080,1,168413
34416,0.027684,172.31.36.0-255,1114,108194,1,168413
34417,0.027753,172.31.36.0-255,1514,109708,1,168413
34418,0.027755,172.31.36.0-255,1514,111222,1,168413
34419,0.027756,172.31.36.0-255,1514,112736,1,168413
34420,0.027757,172.31.36.0-255,1514,114250,1,168413
34421,0.027784,172.31.36.0-255,1489,115739,1,168413
34422,0.029205,104.244.42.0-255,66,115805,1,168413
34423,0.029251,104.244.42.0-255,66,115871,1,168413
34424,0.029298,104.244.42.0-255,66,115937,1,168413
34425,0.029395,104.244.42.0-255,66,116003,1,168413
34426,0.029401,172.217.194.0-255,5738,121741,1,168413
34427,0.029405,172.31.36.0-255,66,121807,1,168413
34428,0.031541,104.244.42.0-255,108,121915,1,168413
34429,0.031552,172.31.36.0-255,66,121981,1,168413
34430,0.031959,172.217.194.0-255,5738,127719,1,168413
34431,0.031964,172.31.36.0-255,66,127785,1,168413
34432,0.034522,172.217.194.0-255,5738,133523,1,168413
34433,0.034529,172.31.36.0-255,66,133589,1,168413
34434,0.037093,172.217.194.0-255,5738,139327,1,168413
34435,0.0371,172.31.36.0-255,66,139393,1,168413
34436,0.039653,172.217.194.0-255,5738,145131,1,168413
34437,0.039662,172.31.36.0-255,66,145197,1,168413
34438,0.042221,172.217.194.0-255,5738,150935,1,168413
34439,0.042229,172.31.36.0-255,66,151001,1,168413
34440,0.04481,172.217.194.0-255,5738,156739,1,168413
34441,0.044816,172.31.36.0-255,66,156805,1,168413
34442,0.047397,172.217.194.0-255,5738,162543,1,168413
34443,0.047404,172.31.36.0-255,66,162609,1,168413
34444,0.049977,172.217.194.0-255,5738,168347,1,168413
34445,0.049983,172.31.36.0-255,66,168413,1,168413
34446,0.0,74.125.200.0-255,149,149,1,306712
34447,2.2e-05,172.31.36.0-255,66,215,1,306712
34448,3e-05,74.125.200.0-255,1484,1699,1,306712
34449,3.5e-05,172.31.36.0-255,66,1765,1,306712
34450,4.2e-05,74.125.200.0-255,2902,4667,1,306712
34451,4.4e-05,172.31.36.0-255,66,4733,1,306712
34452,6e-05,74.125.200.0-255,5738,10471,1,306712
34453,6.3e-05,172.31.36.0-255,66,10537,1,306712
34454,6.9e-05,74.125.200.0-255,3409,13946,1,306712
34455,7.2e-05,172.31.36.0-255,66,14012,1,306712
34456,0.000112,74.125.200.0-255,4320,18332,1,306712
34457,0.000116,172.31.36.0-255,66,18398,1,306712
34458,0.000123,74.125.200.0-255,5738,24136,1,306712
34459,0.000126,172.31.36.0-255,66,24202,1,306712
34460,0.000194,74.125.200.0-255,6797,30999,1,306712
34461,0.000198,172.31.36.0-255,66,31065,1,306712
34462,0.000256,74.125.200.0-255,1484,32549,1,306712
34463,0.000259,172.31.36.0-255,66,32615,1,306712
34464,0.000264,74.125.200.0-255,2902,35517,1,306712
34465,0.000266,172.31.36.0-255,66,35583,1,306712
34466,0.000286,74.125.200.0-255,2902,38485,1,306712
34467,0.000288,172.31.36.0-255,66,38551,1,306712
34468,0.000318,74.125.200.0-255,2902,41453,1,306712
34469,0.000321,172.31.36.0-255,66,41519,1,306712
34470,0.000328,74.125.200.0-255,6797,48316,1,306712
34471,0.00033,172.31.36.0-255,66,48382,1,306712
34472,0.000333,74.125.200.0-255,1484,49866,1,306712
34473,0.000339,172.31.36.0-255,66,49932,1,306712
34474,0.000373,74.125.200.0-255,5738,55670,1,306712
34475,0.000376,172.31.36.0-255,66,55736,1,306712
34476,0.000387,172.31.36.0-255,66,55802,1,306712
34477,0.000416,74.125.200.0-255,1402,57204,1,306712
34478,0.00042,74.125.200.0-255,131,57335,1,306712
34479,0.000487,74.125.200.0-255,1484,58819,1,306712
34480,0.000491,172.31.36.0-255,66,58885,1,306712
34481,0.000497,74.125.200.0-255,2902,61787,1,306712
34482,0.0005,172.31.36.0-255,66,61853,1,306712
34483,0.000529,74.125.200.0-255,2902,64755,1,306712
34484,0.000532,172.31.36.0-255,66,64821,1,306712
34485,0.000538,74.125.200.0-255,4320,69141,1,306712
34486,0.00054,172.31.36.0-255,66,69207,1,306712
34487,0.000556,172.31.36.0-255,66,69273,1,306712
34488,0.000591,74.125.200.0-255,7156,76429,1,306712
34489,0.000594,172.31.36.0-255,66,76495,1,306712
34490,0.000609,74.125.200.0-255,1484,77979,1,306712
34491,0.000633,74.125.200.0-255,5299,83278,1,306712
34492,0.000636,172.31.36.0-255,66,83344,1,306712
34493,0.001449,74.125.200.0-255,1484,84828,1,306712
34494,0.001455,74.125.200.0-255,2902,87730,1,306712
34495,0.001464,172.31.36.0-255,66,87796,1,306712
34496,0.001501,74.125.200.0-255,5738,93534,1,306712
34497,0.001505,74.125.200.0-255,2902,96436,1,306712
34498,0.001518,172.31.36.0-255,66,96502,1,306712
34499,0.001522,172.31.36.0-255,66,96568,1,306712
34500,0.001529,172.31.36.0-255,66,96634,1,306712
34501,0.001536,74.125.200.0-255,5738,102372,1,306712
34502,0.001538,172.31.36.0-255,66,102438,1,306712
34503,0.001567,74.125.200.0-255,5020,107458,1,306712
34504,0.00157,172.31.36.0-255,66,107524,1,306712
34505,0.001592,74.125.200.0-255,1484,109008,1,306712
34506,0.001596,74.125.200.0-255,1484,110492,1,306712
34507,0.001599,172.31.36.0-255,66,110558,1,306712
34508,0.001611,74.125.200.0-255,1484,112042,1,306712
34509,0.001621,74.125.200.0-255,5738,117780,1,306712
34510,0.001624,172.31.36.0-255,66,117846,1,306712
34511,0.001628,74.125.200.0-255,2902,120748,1,306712
34512,0.00163,172.31.36.0-255,66,120814,1,306712
34513,0.001682,172.31.36.0-255,66,120880,1,306712
34514,0.001695,172.31.36.0-255,66,120946,1,306712
34515,0.001907,74.125.200.0-255,1484,122430,1,306712
34516,0.001913,74.125.200.0-255,2902,125332,1,306712
34517,0.001916,172.31.36.0-255,66,125398,1,306712
34518,0.001952,74.125.200.0-255,4320,129718,1,306712
34519,0.001955,172.31.36.0-255,66,129784,1,306712
34520,0.001961,74.125.200.0-255,5738,135522,1,306712
34521,0.001963,172.31.36.0-255,66,135588,1,306712
34522,0.001968,74.125.200.0-255,2902,138490,1,306712
34523,0.00197,172.31.36.0-255,66,138556,1,306712
34524,0.002016,74.125.200.0-255,4320,142876,1,306712
34525,0.002021,172.31.36.0-255,66,142942,1,306712
34526,0.002029,172.31.36.0-255,66,143008,1,306712
34527,0.00204,74.125.200.0-255,3602,146610,1,306712
34528,0.002042,172.31.36.0-255,66,146676,1,306712
34529,0.002048,74.125.200.0-255,4320,150996,1,306712
34530,0.00205,172.31.36.0-255,66,151062,1,306712
34531,0.002117,172.31.36.0-255,66,151128,1,306712
34532,0.002123,74.125.200.0-255,4320,155448,1,306712
34533,0.002126,172.31.36.0-255,66,155514,1,306712
34534,0.002146,74.125.200.0-255,5738,161252,1,306712
34535,0.002157,172.31.36.0-255,66,161318,1,306712
34536,0.002192,172.31.36.0-255,66,161384,1,306712
34537,0.002196,74.125.200.0-255,1484,162868,1,306712
34538,0.0022,74.125.200.0-255,2902,165770,1,306712
34539,0.002202,172.31.36.0-255,66,165836,1,306712
34540,0.002213,74.125.200.0-255,5738,171574,1,306712
34541,0.002215,172.31.36.0-255,66,171640,1,306712
34542,0.002263,172.31.36.0-255,66,171706,1,306712
34543,0.002293,74.125.200.0-255,5738,177444,1,306712
34544,0.002296,172.31.36.0-255,66,177510,1,306712
34545,0.002324,74.125.200.0-255,5020,182530,1,306712
34546,0.002327,172.31.36.0-255,66,182596,1,306712
34547,0.004673,74.125.200.0-255,5738,188334,1,306712
34548,0.004682,172.31.36.0-255,66,188400,1,306712
34549,0.00704,74.125.200.0-255,5738,194138,1,306712
34550,0.007043,172.31.36.0-255,66,194204,1,306712
34551,0.009411,74.125.200.0-255,5738,199942,1,306712
34552,0.009419,172.31.36.0-255,66,200008,1,306712
34553,0.011762,74.125.200.0-255,5738,205746,1,306712
34554,0.01177,172.31.36.0-255,66,205812,1,306712
34555,0.014085,74.125.200.0-255,5738,211550,1,306712
34556,0.014092,172.31.36.0-255,66,211616,1,306712
34557,0.0164,74.125.200.0-255,5738,217354,1,306712
34558,0.016407,172.31.36.0-255,66,217420,1,306712
34559,0.018738,74.125.200.0-255,5738,223158,1,306712
34560,0.018748,172.31.36.0-255,66,223224,1,306712
34561,0.021062,74.125.200.0-255,5738,228962,1,306712
34562,0.021069,172.31.36.0-255,66,229028,1,306712
34563,0.023408,74.125.200.0-255,5738,234766,1,306712
34564,0.023415,172.31.36.0-255,66,234832,1,306712
34565,0.025741,74.125.200.0-255,5738,240570,1,306712
34566,0.025754,172.31.36.0-255,66,240636,1,306712
34567,0.028073,74.125.200.0-255,5738,246374,1,306712
34568,0.028081,172.31.36.0-255,66,246440,1,306712
34569,0.030408,74.125.200.0-255,5738,252178,1,306712
34570,0.030416,172.31.36.0-255,66,252244,1,306712
34571,0.032735,74.125.200.0-255,5738,257982,1,306712
34572,0.032743,172.31.36.0-255,66,258048,1,306712
34573,0.035059,74.125.200.0-255,5738,263786,1,306712
34574,0.035068,172.31.36.0-255,66,263852,1,306712
34575,0.037381,74.125.200.0-255,5738,269590,1,306712
34576,0.037387,172.31.36.0-255,66,269656,1,306712
34577,0.037906,172.31.36.0-255,187,269843,1,306712
34578,0.037931,172.31.36.0-255,982,270825,1,306712
34579,0.037989,172.31.36.0-255,1514,272339,1,306712
34580,0.03801,172.31.36.0-255,1514,273853,1,306712
34581,0.038011,172.31.36.0-255,1514,275367,1,306712
34582,0.038037,172.31.36.0-255,1514,276881,1,306712
34583,0.038039,172.31.36.0-255,481,277362,1,306712
34584,0.039476,104.244.42.0-255,66,277428,1,306712
34585,0.039506,104.244.42.0-255,66,277494,1,306712
34586,0.039567,104.244.42.0-255,66,277560,1,306712
34587,0.039674,104.244.42.0-255,66,277626,1,306712
34588,0.039687,74.125.200.0-255,1484,279110,1,306712
34589,0.039712,74.125.200.0-255,4320,283430,1,306712
34590,0.039718,172.31.36.0-255,66,283496,1,306712
34591,0.042054,74.125.200.0-255,5738,289234,1,306712
34592,0.042062,172.31.36.0-255,66,289300,1,306712
34593,0.044384,74.125.200.0-255,5738,295038,1,306712
34594,0.04439,172.31.36.0-255,66,295104,1,306712
34595,0.046708,74.125.200.0-255,5738,300842,1,306712
34596,0.046714,172.31.36.0-255,66,300908,1,306712
34597,0.049088,74.125.200.0-255,5738,306646,1,306712
34598,0.049094,172.31.36.0-255,66,306712,1,306712
34599,0.0,74.125.24.0-255,297,297,1,313779
34600,2.5e-05,172.31.36.0-255,66,363,1,313779
34601,3.2e-05,74.125.24.0-255,1484,1847,1,313779
34602,3.6e-05,172.31.36.0-255,66,1913,1,313779
34603,4.4e-05,74.125.24.0-255,4320,6233,1,313779
34604,4.8e-05,172.31.36.0-255,66,6299,1,313779
34605,6e-05,172.31.36.0-255,66,6365,1,313779
34606,7.5e-05,172.31.36.0-255,66,6431,1,313779
34607,0.0001,74.125.24.0-255,2543,8974,1,313779
34608,0.000103,172.31.36.0-255,66,9040,1,313779
34609,0.000363,74.125.24.0-255,1484,10524,1,313779
34610,0.000369,172.31.36.0-255,66,10590,1,313779
34611,0.000375,74.125.24.0-255,2902,13492,1,313779
34612,0.000378,172.31.36.0-255,66,13558,1,313779
34613,0.000383,74.125.24.0-255,2902,16460,1,313779
34614,0.000384,172.31.36.0-255,66,16526,1,313779
34615,0.000403,74.125.24.0-255,2902,19428,1,313779
34616,0.000405,172.31.36.0-255,66,19494,1,313779
34617,0.000411,74.125.24.0-255,5738,25232,1,313779
34618,0.000413,172.31.36.0-255,66,25298,1,313779
34619,0.00044,74.125.24.0-255,3961,29259,1,313779
34620,0.000444,172.31.36.0-255,66,29325,1,313779
34621,0.000456,172.31.36.0-255,66,29391,1,313779
34622,0.000481,74.125.24.0-255,3961,33352,1,313779
34623,0.000484,172.31.36.0-255,66,33418,1,313779
34624,0.000603,74.125.24.0-255,645,34063,1,313779
34625,0.000607,172.31.36.0-255,66,34129,1,313779
34626,0.00077,74.125.24.0-255,1484,35613,1,313779
34627,0.000776,172.31.36.0-255,66,35679,1,313779
34628,0.00079,74.125.24.0-255,2902,38581,1,313779
34629,0.000792,172.31.36.0-255,66,38647,1,313779
34630,0.000798,74.125.24.0-255,4320,42967,1,313779
34631,0.0008,172.31.36.0-255,66,43033,1,313779
34632,0.000823,74.125.24.0-255,1484,44517,1,313779
34633,0.000853,172.31.36.0-255,66,44583,1,313779
34634,0.00086,74.125.24.0-255,5738,50321,1,313779
34635,0.000863,172.31.36.0-255,66,50387,1,313779
34636,0.000887,74.125.24.0-255,5738,56125,1,313779
34637,0.00089,172.31.36.0-255,66,56191,1,313779
34638,0.000911,74.125.24.0-255,3961,60152,1,313779
34639,0.000914,172.31.36.0-255,66,60218,1,313779
34640,0.001066,74.125.24.0-255,1484,61702,1,313779
34641,0.001082,74.125.24.0-255,2902,64604,1,313779
34642,0.001085,172.31.36.0-255,66,64670,1,313779
34643,0.001109,74.125.24.0-255,5738,70408,1,313779
34644,0.001112,172.31.36.0-255,66,70474,1,313779
34645,0.001119,74.125.24.0-255,5738,76212,1,313779
34646,0.001121,172.31.36.0-255,66,76278,1,313779
34647,0.00116,74.125.24.0-255,7156,83434,1,313779
34648,0.001163,172.31.36.0-255,66,83500,1,313779
34649,0.001189,74.125.24.0-255,5738,89238,1,313779
34650,0.001192,172.31.36.0-255,66,89304,1,313779
34651,0.001198,74.125.24.0-255,5020,94324,1,313779
34652,0.0012,172.31.36.0-255,66,94390,1,313779
34653,0.001244,74.125.24.0-255,1484,95874,1,313779
34654,0.001248,74.125.24.0-255,1484,97358,1,313779
34655,0.00125,172.31.36.0-255,66,97424,1,313779
34656,0.001266,74.125.24.0-255,1484,98908,1,313779
34657,0.001272,74.125.24.0-255,4320,103228,1,313779
34658,0.001274,172.31.36.0-255,66,103294,1,313779
34659,0.001288,74.125.24.0-255,1484,104778,1,313779
34660,0.001299,172.31.36.0-255,66,104844,1,313779
34661,0.001323,74.125.24.0-255,4320,109164,1,313779
34662,0.001325,172.31.36.0-255,66,109230,1,313779
34663,0.001335,172.31.36.0-255,66,109296,1,313779
34664,0.001359,74.125.24.0-255,2184,111480,1,313779
34665,0.001361,172.31.36.0-255,66,111546,1,313779
34666,0.00138,74.125.24.0-255,1484,113030,1,313779
34667,0.001407,74.125.24.0-255,2902,115932,1,313779
34668,0.00141,172.31.36.0-255,66,115998,1,313779
34669,0.001416,74.125.24.0-255,5738,121736,1,313779
34670,0.001418,172.31.36.0-255,66,121802,1,313779
34671,0.001431,172.31.36.0-255,66,121868,1,313779
34672,0.001446,74.125.24.0-255,1484,123352,1,313779
34673,0.00145,74.125.24.0-255,2902,126254,1,313779
34674,0.001452,172.31.36.0-255,66,126320,1,313779
34675,0.001457,74.125.24.0-255,2902,129222,1,313779
34676,0.001459,172.31.36.0-255,66,129288,1,313779
34677,0.001477,74.125.24.0-255,1484,130772,1,313779
34678,0.001482,74.125.24.0-255,3602,134374,1,313779
34679,0.001485,172.31.36.0-255,66,134440,1,313779
34680,0.001599,74.125.24.0-255,1484,135924,1,313779
34681,0.001603,74.125.24.0-255,1484,137408,1,313779
34682,0.001606,172.31.36.0-255,66,137474,1,313779
34683,0.00162,74.125.24.0-255,1484,138958,1,313779
34684,0.001628,74.125.24.0-255,5738,144696,1,313779
34685,0.00163,172.31.36.0-255,66,144762,1,313779
34686,0.00166,74.125.24.0-255,7156,151918,1,313779
34687,0.001663,172.31.36.0-255,66,151984,1,313779
34688,0.001666,74.125.24.0-255,1484,153468,1,313779
34689,0.001683,74.125.24.0-255,7156,160624,1,313779
34690,0.001686,172.31.36.0-255,66,160690,1,313779
34691,0.001714,74.125.24.0-255,5738,166428,1,313779
34692,0.001717,74.125.24.0-255,2184,168612,1,313779
34693,0.001721,172.31.36.0-255,66,168678,1,313779
34694,0.001725,172.31.36.0-255,66,168744,1,313779
34695,0.001946,74.125.24.0-255,1484,170228,1,313779
34696,0.001967,74.125.24.0-255,2902,173130,1,313779
34697,0.001971,172.31.36.0-255,66,173196,1,313779
34698,0.001978,74.125.24.0-255,5738,178934,1,313779
34699,0.00198,172.31.36.0-255,66,179000,1,313779
34700,0.002012,172.31.36.0-255,66,179066,1,313779
34701,0.002023,172.31.36.0-255,66,179132,1,313779
34702,0.002055,74.125.24.0-255,5738,184870,1,313779
34703,0.002058,172.31.36.0-255,66,184936,1,313779
34704,0.002093,172.31.36.0-255,66,185002,1,313779
34705,0.002105,172.31.36.0-255,66,185068,1,313779
34706,0.002109,74.125.24.0-255,2902,187970,1,313779
34707,0.002112,172.31.36.0-255,66,188036,1,313779
34708,0.002137,74.125.24.0-255,2184,190220,1,313779
34709,0.002139,172.31.36.0-255,66,190286,1,313779
34710,0.004219,74.125.24.0-255,5738,196024,1,313779
34711,0.004228,172.31.36.0-255,66,196090,1,313779
34712,0.006353,74.125.24.0-255,5738,201828,1,313779
34713,0.00636,172.31.36.0-255,66,201894,1,313779
34714,0.008421,74.125.24.0-255,5738,207632,1,313779
34715,0.008428,172.31.36.0-255,66,207698,1,313779
34716,0.010502,74.125.24.0-255,5738,213436,1,313779
34717,0.010507,172.31.36.0-255,66,213502,1,313779
34718,0.012575,74.125.24.0-255,5738,219240,1,313779
34719,0.012582,172.31.36.0-255,66,219306,1,313779
34720,0.014649,74.125.24.0-255,5738,225044,1,313779
34721,0.014656,172.31.36.0-255,66,225110,1,313779
34722,0.01675,74.125.24.0-255,5738,230848,1,313779
34723,0.016758,172.31.36.0-255,66,230914,1,313779
34724,0.018857,74.125.24.0-255,5738,236652,1,313779
34725,0.018865,172.31.36.0-255,66,236718,1,313779
34726,0.020944,74.125.24.0-255,5738,242456,1,313779
34727,0.020955,172.31.36.0-255,66,242522,1,313779
34728,0.023061,74.125.24.0-255,5738,248260,1,313779
34729,0.023069,172.31.36.0-255,66,248326,1,313779
34730,0.025172,74.125.24.0-255,5738,254064,1,313779
34731,0.02518,172.31.36.0-255,66,254130,1,313779
34732,0.027261,74.125.24.0-255,5738,259868,1,313779
34733,0.027268,172.31.36.0-255,66,259934,1,313779
34734,0.02937,74.125.24.0-255,5738,265672,1,313779
34735,0.029378,172.31.36.0-255,66,265738,1,313779
34736,0.031473,74.125.24.0-255,5738,271476,1,313779
34737,0.031481,172.31.36.0-255,66,271542,1,313779
34738,0.033563,74.125.24.0-255,5738,277280,1,313779
34739,0.033572,172.31.36.0-255,66,277346,1,313779
34740,0.035651,74.125.24.0-255,5738,283084,1,313779
34741,0.035659,172.31.36.0-255,66,283150,1,313779
34742,0.037769,74.125.24.0-255,5738,288888,1,313779
34743,0.037777,172.31.36.0-255,66,288954,1,313779
34744,0.039878,74.125.24.0-255,5738,294692,1,313779
34745,0.039887,172.31.36.0-255,66,294758,1,313779
34746,0.042008,74.125.24.0-255,5738,300496,1,313779
34747,0.042018,172.31.36.0-255,66,300562,1,313779
34748,0.044116,74.125.24.0-255,3710,304272,1,313779
34749,0.044125,172.31.36.0-255,66,304338,1,313779
34750,0.044321,172.31.36.0-255,105,304443,1,313779
34751,0.046411,74.125.24.0-255,66,304509,1,313779
34752,0.046571,172.31.36.0-255,172,304681,1,313779
34753,0.046605,172.31.36.0-255,1114,305795,1,313779
34754,0.04667,172.31.36.0-255,1514,307309,1,313779
34755,0.046672,172.31.36.0-255,1514,308823,1,313779
34756,0.046673,172.31.36.0-255,1514,310337,1,313779
34757,0.046674,172.31.36.0-255,1514,311851,1,313779
34758,0.0467,172.31.36.0-255,1490,313341,1,313779
34759,0.04816,104.244.42.0-255,66,313407,1,313779
34760,0.04819,104.244.42.0-255,66,313473,1,313779
34761,0.048285,104.244.42.0-255,66,313539,1,313779
34762,0.048292,104.244.42.0-255,66,313605,1,313779
34763,0.048943,104.244.42.0-255,108,313713,1,313779
34764,0.048955,172.31.36.0-255,66,313779,1,313779
34765,0.0,172.217.194.0-255,153,153,1,273236
34766,2.8e-05,172.31.36.0-255,66,219,1,273236
34767,3.5e-05,172.217.194.0-255,1484,1703,1,273236
34768,3.9e-05,172.31.36.0-255,66,1769,1,273236
34769,4.4e-05,172.217.194.0-255,2902,4671,1,273236
34770,4.7e-05,172.31.36.0-255,66,4737,1,273236
34771,5.5e-05,172.217.194.0-255,7156,11893,1,273236
34772,5.8e-05,172.31.36.0-255,66,11959,1,273236
34773,6.2e-05,172.217.194.0-255,2063,14022,1,273236
34774,6.5e-05,172.31.36.0-255,66,14088,1,273236
34775,0.000111,172.217.194.0-255,1484,15572,1,273236
34776,0.000114,172.31.36.0-255,66,15638,1,273236
34777,0.000119,172.217.194.0-255,2902,18540,1,273236
34778,0.000121,172.31.36.0-255,66,18606,1,273236
34779,0.000146,172.217.194.0-255,5738,24344,1,273236
34780,0.000149,172.31.36.0-255,66,24410,1,273236
34781,0.000165,172.217.194.0-255,1484,25894,1,273236
34782,0.000169,172.31.36.0-255,66,25960,1,273236
34783,0.000185,172.217.194.0-255,5379,31339,1,273236
34784,0.000188,172.31.36.0-255,66,31405,1,273236
34785,0.000209,172.217.194.0-255,7156,38561,1,273236
34786,0.000212,172.31.36.0-255,66,38627,1,273236
34787,0.000218,172.217.194.0-255,5738,44365,1,273236
34788,0.00022,172.31.36.0-255,66,44431,1,273236
34789,0.000242,172.217.194.0-255,3961,48392,1,273236
34790,0.000245,172.31.36.0-255,66,48458,1,273236
34791,0.000324,172.217.194.0-255,1484,49942,1,273236
34792,0.000327,172.31.36.0-255,66,50008,1,273236
34793,0.000332,172.217.194.0-255,2902,52910,1,273236
34794,0.000335,172.31.36.0-255,66,52976,1,273236
34795,0.000359,172.217.194.0-255,5738,58714,1,273236
34796,0.000362,172.31.36.0-255,66,58780,1,273236
34797,0.000367,172.217.194.0-255,4320,63100,1,273236
34798,0.00037,172.31.36.0-255,66,63166,1,273236
34799,0.000419,172.217.194.0-255,3124,66290,1,273236
34800,0.000422,172.31.36.0-255,66,66356,1,273236
34801,0.000646,172.217.194.0-255,1484,67840,1,273236
34802,0.000652,172.217.194.0-255,2902,70742,1,273236
34803,0.000655,172.31.36.0-255,66,70808,1,273236
34804,0.000673,172.217.194.0-255,5738,76546,1,273236
34805,0.000676,172.31.36.0-255,66,76612,1,273236
34806,0.000679,172.217.194.0-255,1484,78096,1,273236
34807,0.00072,172.217.194.0-255,4829,82925,1,273236
34808,0.000724,172.31.36.0-255,66,82991,1,273236
34809,0.000974,172.217.194.0-255,1484,84475,1,273236
34810,0.000979,172.217.194.0-255,1484,85959,1,273236
34811,0.000983,172.31.36.0-255,66,86025,1,273236
34812,0.001001,172.217.194.0-255,1484,87509,1,273236
34813,0.001007,172.217.194.0-255,5738,93247,1,273236
34814,0.001009,172.31.36.0-255,66,93313,1,273236
34815,0.001014,172.217.194.0-255,4320,97633,1,273236
34816,0.001018,172.31.36.0-255,66,97699,1,273236
34817,0.001041,172.31.36.0-255,66,97765,1,273236
34818,0.001051,172.31.36.0-255,66,97831,1,273236
34819,0.001076,172.217.194.0-255,2184,100015,1,273236
34820,0.001079,172.31.36.0-255,66,100081,1,273236
34821,0.001103,172.217.194.0-255,2902,102983,1,273236
34822,0.001105,172.31.36.0-255,66,103049,1,273236
34823,0.001127,172.217.194.0-255,7156,110205,1,273236
34824,0.001131,172.217.194.0-255,2902,113107,1,273236
34825,0.001131,172.31.36.0-255,66,113173,1,273236
34826,0.001134,172.31.36.0-255,66,113239,1,273236
34827,0.001145,172.217.194.0-255,2902,116141,1,273236
34828,0.001147,172.31.36.0-255,66,116207,1,273236
34829,0.001173,172.217.194.0-255,4320,120527,1,273236
34830,0.001177,172.31.36.0-255,66,120593,1,273236
34831,0.001207,172.31.36.0-255,66,120659,1,273236
34832,0.001211,172.217.194.0-255,3602,124261,1,273236
34833,0.001213,172.31.36.0-255,66,124327,1,273236
34834,0.001542,172.217.194.0-255,1484,125811,1,273236
34835,0.001552,172.217.194.0-255,2902,128713,1,273236
34836,0.001556,172.31.36.0-255,66,128779,1,273236
34837,0.001561,172.217.194.0-255,1484,130263,1,273236
34838,0.001579,172.217.194.0-255,4320,134583,1,273236
34839,0.001582,172.31.36.0-255,66,134649,1,273236
34840,0.001617,172.217.194.0-255,2902,137551,1,273236
34841,0.001623,172.31.36.0-255,66,137617,1,273236
34842,0.001653,172.31.36.0-255,66,137683,1,273236
34843,0.001665,172.31.36.0-255,66,137749,1,273236
34844,0.001668,172.217.194.0-255,766,138515,1,273236
34845,0.001671,172.217.194.0-255,1484,139999,1,273236
34846,0.001673,172.31.36.0-255,66,140065,1,273236
34847,0.001678,172.217.194.0-255,4320,144385,1,273236
34848,0.00168,172.31.36.0-255,66,144451,1,273236
34849,0.001687,172.217.194.0-255,5738,150189,1,273236
34850,0.001689,172.31.36.0-255,66,150255,1,273236
34851,0.001711,172.217.194.0-255,4320,154575,1,273236
34852,0.001714,172.31.36.0-255,66,154641,1,273236
34853,0.00173,172.31.36.0-255,66,154707,1,273236
34854,0.001755,172.217.194.0-255,5020,159727,1,273236
34855,0.001759,172.31.36.0-255,66,159793,1,273236
34856,0.001765,172.217.194.0-255,5738,165531,1,273236
34857,0.001768,172.31.36.0-255,66,165597,1,273236
34858,0.001798,172.31.36.0-255,66,165663,1,273236
34859,0.001847,172.31.36.0-255,66,165729,1,273236
34860,0.001969,172.217.194.0-255,1484,167213,1,273236
34861,0.001976,172.217.194.0-255,2902,170115,1,273236
34862,0.00198,172.31.36.0-255,66,170181,1,273236
34863,0.001984,172.217.194.0-255,1484,171665,1,273236
34864,0.002001,172.217.194.0-255,4320,175985,1,273236
34865,0.002005,172.31.36.0-255,66,176051,1,273236
34866,0.002048,172.31.36.0-255,66,176117,1,273236
34867,0.002068,172.217.194.0-255,4320,180437,1,273236
34868,0.002071,172.31.36.0-255,66,180503,1,273236
34869,0.00209,172.217.194.0-255,6438,186941,1,273236
34870,0.002092,172.31.36.0-255,66,187007,1,273236
34871,0.002207,172.217.194.0-255,1484,188491,1,273236
34872,0.00222,172.217.194.0-255,2902,191393,1,273236
34873,0.002223,172.31.36.0-255,66,191459,1,273236
34874,0.002245,172.217.194.0-255,5738,197197,1,273236
34875,0.002248,172.31.36.0-255,66,197263,1,273236
34876,0.002252,172.217.194.0-255,2902,200165,1,273236
34877,0.002254,172.31.36.0-255,66,200231,1,273236
34878,0.002275,172.31.36.0-255,66,200297,1,273236
34879,0.002281,172.217.194.0-255,7156,207453,1,273236
34880,0.002284,172.31.36.0-255,66,207519,1,273236
34881,0.002321,172.217.194.0-255,2902,210421,1,273236
34882,0.002324,172.31.36.0-255,66,210487,1,273236
34883,0.002345,172.217.194.0-255,2184,212671,1,273236
34884,0.002347,172.31.36.0-255,66,212737,1,273236
34885,0.002353,172.217.194.0-255,5738,218475,1,273236
34886,0.002355,172.31.36.0-255,66,218541,1,273236
34887,0.002366,172.31.36.0-255,66,218607,1,273236
34888,0.002394,172.31.36.0-255,66,218673,1,273236
34889,0.002461,172.31.36.0-255,66,218739,1,273236
34890,0.004848,172.217.194.0-255,5738,224477,1,273236
34891,0.004853,172.31.36.0-255,66,224543,1,273236
34892,0.007256,172.217.194.0-255,5738,230281,1,273236
34893,0.007263,172.31.36.0-255,66,230347,1,273236
34894,0.009655,172.217.194.0-255,5738,236085,1,273236
34895,0.009662,172.31.36.0-255,66,236151,1,273236
34896,0.012038,172.217.194.0-255,5738,241889,1,273236
34897,0.012045,172.31.36.0-255,66,241955,1,273236
34898,0.014437,172.217.194.0-255,5738,247693,1,273236
34899,0.014444,172.31.36.0-255,66,247759,1,273236
34900,0.016826,172.217.194.0-255,5738,253497,1,273236
34901,0.016834,172.31.36.0-255,66,253563,1,273236
34902,0.019214,172.217.194.0-255,5738,259301,1,273236
34903,0.019223,172.31.36.0-255,66,259367,1,273236
34904,0.021573,172.217.194.0-255,4537,263904,1,273236
34905,0.02158,172.31.36.0-255,66,263970,1,273236
34906,0.021778,172.31.36.0-255,105,264075,1,273236
34907,0.024092,172.217.194.0-255,66,264141,1,273236
34908,0.038067,172.31.36.0-255,172,264313,1,273236
34909,0.038099,172.31.36.0-255,1115,265428,1,273236
34910,0.038149,172.31.36.0-255,1514,266942,1,273236
34911,0.03815,172.31.36.0-255,1514,268456,1,273236
34912,0.038156,172.31.36.0-255,1514,269970,1,273236
34913,0.038157,172.31.36.0-255,1514,271484,1,273236
34914,0.038185,172.31.36.0-255,1488,272972,1,273236
34915,0.039641,104.244.42.0-255,66,273038,1,273236
34916,0.039652,104.244.42.0-255,66,273104,1,273236
34917,0.039684,104.244.42.0-255,66,273170,1,273236
34918,0.039735,104.244.42.0-255,66,273236,1,273236
34919,0.0,172.217.194.0-255,298,298,1,186745
34920,2.3e-05,172.31.36.0-255,66,364,1,186745
34921,2.9e-05,172.217.194.0-255,1484,1848,1,186745
34922,3.3e-05,172.31.36.0-255,66,1914,1,186745
34923,4.8e-05,172.217.194.0-255,2902,4816,1,186745
34924,5.2e-05,172.31.36.0-255,66,4882,1,186745
34925,5.8e-05,172.217.194.0-255,4320,9202,1,186745
34926,6.1e-05,172.31.36.0-255,66,9268,1,186745
34927,6.8e-05,172.217.194.0-255,4692,13960,1,186745
34928,7e-05,172.31.36.0-255,66,14026,1,186745
34929,0.000124,172.217.194.0-255,5738,19764,1,186745
34930,0.000127,172.31.36.0-255,66,19830,1,186745
34931,0.000145,172.31.36.0-255,66,19896,1,186745
34932,0.000264,172.217.194.0-255,1484,21380,1,186745
34933,0.000268,172.31.36.0-255,66,21446,1,186745
34934,0.000273,172.217.194.0-255,2902,24348,1,186745
34935,0.000276,172.31.36.0-255,66,24414,1,186745
34936,0.000307,172.217.194.0-255,5738,30152,1,186745
34937,0.00031,172.31.36.0-255,66,30218,1,186745
34938,0.00035,172.31.36.0-255,66,30284,1,186745
34939,0.000375,172.217.194.0-255,1125,31409,1,186745
34940,0.000377,172.31.36.0-255,66,31475,1,186745
34941,0.000409,172.31.36.0-255,66,31541,1,186745
34942,0.000661,172.217.194.0-255,1484,33025,1,186745
34943,0.000666,172.31.36.0-255,66,33091,1,186745
34944,0.000672,172.217.194.0-255,2902,35993,1,186745
34945,0.000675,172.31.36.0-255,66,36059,1,186745
34946,0.000686,172.217.194.0-255,4320,40379,1,186745
34947,0.000688,172.31.36.0-255,66,40445,1,186745
34948,0.000712,172.217.194.0-255,1484,41929,1,186745
34949,0.000728,172.31.36.0-255,66,41995,1,186745
34950,0.000739,172.31.36.0-255,66,42061,1,186745
34951,0.000763,172.217.194.0-255,2184,44245,1,186745
34952,0.000765,172.31.36.0-255,66,44311,1,186745
34953,0.001202,172.217.194.0-255,1484,45795,1,186745
34954,0.001208,172.217.194.0-255,2902,48697,1,186745
34955,0.001211,172.31.36.0-255,66,48763,1,186745
34956,0.001219,172.217.194.0-255,5738,54501,1,186745
34957,0.001221,172.31.36.0-255,66,54567,1,186745
34958,0.001249,172.217.194.0-255,1484,56051,1,186745
34959,0.001261,172.31.36.0-255,66,56117,1,186745
34960,0.001288,172.217.194.0-255,4320,60437,1,186745
34961,0.001295,172.217.194.0-255,5738,66175,1,186745
34962,0.0013,172.31.36.0-255,66,66241,1,186745
34963,0.001303,172.31.36.0-255,66,66307,1,186745
34964,0.001325,172.217.194.0-255,3602,69909,1,186745
34965,0.001328,172.31.36.0-255,66,69975,1,186745
34966,0.00152,172.217.194.0-255,1484,71459,1,186745
34967,0.001525,172.217.194.0-255,2902,74361,1,186745
34968,0.001529,172.31.36.0-255,66,74427,1,186745
34969,0.001533,172.217.194.0-255,1484,75911,1,186745
34970,0.001565,172.217.194.0-255,4320,80231,1,186745
34971,0.001567,172.31.36.0-255,66,80297,1,186745
34972,0.001587,172.31.36.0-255,66,80363,1,186745
34973,0.001598,172.31.36.0-255,66,80429,1,186745
34974,0.001622,172.217.194.0-255,766,81195,1,186745
34975,0.001762,172.217.194.0-255,1484,82679,1,186745
34976,0.001767,172.31.36.0-255,66,82745,1,186745
34977,0.001801,172.217.194.0-255,2902,85647,1,186745
34978,0.001803,172.31.36.0-255,66,85713,1,186745
34979,0.00181,172.217.194.0-255,5738,91451,1,186745
34980,0.001812,172.31.36.0-255,66,91517,1,186745
34981,0.001829,172.31.36.0-255,66,91583,1,186745
34982,0.001861,172.217.194.0-255,2902,94485,1,186745
34983,0.001864,172.31.36.0-255,66,94551,1,186745
34984,0.001877,172.31.36.0-255,66,94617,1,186745
34985,0.001952,172.31.36.0-255,66,94683,1,186745
34986,0.001966,172.31.36.0-255,66,94749,1,186745
34987,0.001991,172.217.194.0-255,7156,101905,1,186745
34988,0.001995,172.31.36.0-255,66,101971,1,186745
34989,0.002024,172.217.194.0-255,7156,109127,1,186745
34990,0.002064,172.31.36.0-255,66,109193,1,186745
34991,0.002067,172.217.194.0-255,1484,110677,1,186745
34992,0.00209,172.217.194.0-255,2902,113579,1,186745
34993,0.002106,172.217.194.0-255,4320,117899,1,186745
34994,0.002122,172.217.194.0-255,1484,119383,1,186745
34995,0.002156,172.217.194.0-255,2902,122285,1,186745
34996,0.00217,172.217.194.0-255,2902,125187,1,186745
34997,0.002187,172.217.194.0-255,2902,128089,1,186745
34998,0.0022,172.217.194.0-255,4320,132409,1,186745
34999,0.002231,172.217.194.0-255,4320,136729,1,186745
35000,0.002248,172.217.194.0-255,6438,143167,1,186745
35001,0.002253,172.217.194.0-255,4320,147487,1,186745
35002,0.002277,172.217.194.0-255,7156,154643,1,186745
35003,0.002302,172.217.194.0-255,2902,157545,1,186745
35004,0.002325,172.217.194.0-255,4320,161865,1,186745
35005,0.002355,172.217.194.0-255,4320,166185,1,186745
35006,0.002388,172.217.194.0-255,7156,173341,1,186745
35007,0.002472,172.217.194.0-255,2902,176243,1,186745
35008,0.002497,172.217.194.0-255,97,176340,1,186745
35009,0.002499,172.217.194.0-255,105,176445,1,186745
35010,0.005911,172.31.36.0-255,66,176511,1,186745
35011,0.005917,172.31.36.0-255,66,176577,1,186745
35012,0.005919,172.31.36.0-255,66,176643,1,186745
35013,0.005923,172.31.36.0-255,66,176709,1,186745
35014,0.005935,172.31.36.0-255,66,176775,1,186745
35015,0.005938,172.31.36.0-255,66,176841,1,186745
35016,0.005941,172.31.36.0-255,66,176907,1,186745
35017,0.005944,172.31.36.0-255,66,176973,1,186745
35018,0.005946,172.31.36.0-255,66,177039,1,186745
35019,0.005949,172.31.36.0-255,66,177105,1,186745
35020,0.005952,172.31.36.0-255,66,177171,1,186745
35021,0.005955,172.31.36.0-255,66,177237,1,186745
35022,0.005958,172.31.36.0-255,66,177303,1,186745
35023,0.006005,172.31.36.0-255,66,177369,1,186745
35024,0.012307,172.31.36.0-255,105,177474,1,186745
35025,0.014867,172.217.194.0-255,66,177540,1,186745
35026,0.040791,172.31.36.0-255,172,177712,1,186745
35027,0.040827,172.31.36.0-255,1115,178827,1,186745
35028,0.040897,172.31.36.0-255,1514,180341,1,186745
35029,0.040898,172.31.36.0-255,1514,181855,1,186745
35030,0.0409,172.31.36.0-255,1514,183369,1,186745
35031,0.040904,172.31.36.0-255,1514,184883,1,186745
35032,0.040905,172.31.36.0-255,1490,186373,1,186745
35033,0.04231,104.244.42.0-255,66,186439,1,186745
35034,0.042445,104.244.42.0-255,66,186505,1,186745
35035,0.04245,104.244.42.0-255,66,186571,1,186745
35036,0.042966,104.244.42.0-255,108,186679,1,186745
35037,0.042973,172.31.36.0-255,66,186745,1,186745
35038,0.0,172.217.194.0-255,146,146,1,308550
35039,3.2e-05,172.31.36.0-255,66,212,1,308550
35040,4e-05,172.217.194.0-255,1484,1696,1,308550
35041,4.4e-05,172.31.36.0-255,66,1762,1,308550
35042,5e-05,172.217.194.0-255,2902,4664,1,308550
35043,5.3e-05,172.31.36.0-255,66,4730,1,308550
35044,6e-05,172.217.194.0-255,7156,11886,1,308550
35045,6.3e-05,172.31.36.0-255,66,11952,1,308550
35046,6.6e-05,172.217.194.0-255,2105,14057,1,308550
35047,6.8e-05,172.31.36.0-255,66,14123,1,308550
35048,0.000106,172.217.194.0-255,1484,15607,1,308550
35049,0.00011,172.31.36.0-255,66,15673,1,308550
35050,0.000114,172.217.194.0-255,2902,18575,1,308550
35051,0.000117,172.31.36.0-255,66,18641,1,308550
35052,0.000122,172.217.194.0-255,5738,24379,1,308550
35053,0.000124,172.31.36.0-255,66,24445,1,308550
35054,0.000159,172.217.194.0-255,1484,25929,1,308550
35055,0.000163,172.31.36.0-255,66,25995,1,308550
35056,0.000184,172.217.194.0-255,5379,31374,1,308550
35057,0.000188,172.31.36.0-255,66,31440,1,308550
35058,0.000194,172.217.194.0-255,7156,38596,1,308550
35059,0.000196,172.31.36.0-255,66,38662,1,308550
35060,0.000201,172.217.194.0-255,4320,42982,1,308550
35061,0.000204,172.31.36.0-255,66,43048,1,308550
35062,0.000222,172.217.194.0-255,2902,45950,1,308550
35063,0.000225,172.31.36.0-255,66,46016,1,308550
35064,0.000259,172.217.194.0-255,2543,48559,1,308550
35065,0.000263,172.31.36.0-255,66,48625,1,308550
35066,0.000924,172.217.194.0-255,1484,50109,1,308550
35067,0.000931,172.31.36.0-255,66,50175,1,308550
35068,0.000941,172.217.194.0-255,2902,53077,1,308550
35069,0.000943,172.31.36.0-255,66,53143,1,308550
35070,0.000952,172.217.194.0-255,5738,58881,1,308550
35071,0.000954,172.31.36.0-255,66,58947,1,308550
35072,0.000981,172.217.194.0-255,2902,61849,1,308550
35073,0.000984,172.31.36.0-255,66,61915,1,308550
35074,0.001014,172.217.194.0-255,3961,65876,1,308550
35075,0.001017,172.31.36.0-255,66,65942,1,308550
35076,0.001114,172.217.194.0-255,1484,67426,1,308550
35077,0.001133,172.217.194.0-255,2902,70328,1,308550
35078,0.001138,172.31.36.0-255,66,70394,1,308550
35079,0.001162,172.217.194.0-255,5738,76132,1,308550
35080,0.001166,172.31.36.0-255,66,76198,1,308550
35081,0.001173,172.217.194.0-255,5738,81936,1,308550
35082,0.001175,172.31.36.0-255,66,82002,1,308550
35083,0.001199,172.217.194.0-255,1125,83127,1,308550
35084,0.001282,172.217.194.0-255,1484,84611,1,308550
35085,0.001288,172.217.194.0-255,2902,87513,1,308550
35086,0.001294,172.217.194.0-255,5738,93251,1,308550
35087,0.0013,172.31.36.0-255,66,93317,1,308550
35088,0.001309,172.31.36.0-255,66,93383,1,308550
35089,0.001312,172.31.36.0-255,66,93449,1,308550
35090,0.001319,172.217.194.0-255,6797,100246,1,308550
35091,0.001321,172.31.36.0-255,66,100312,1,308550
35092,0.001561,172.217.194.0-255,1484,101796,1,308550
35093,0.001565,172.217.194.0-255,1484,103280,1,308550
35094,0.001568,172.31.36.0-255,66,103346,1,308550
35095,0.00159,172.217.194.0-255,1484,104830,1,308550
35096,0.001596,172.217.194.0-255,5738,110568,1,308550
35097,0.001598,172.31.36.0-255,66,110634,1,308550
35098,0.001629,172.217.194.0-255,7156,117790,1,308550
35099,0.001632,172.31.36.0-255,66,117856,1,308550
35100,0.001654,172.217.194.0-255,5738,123594,1,308550
35101,0.001657,172.31.36.0-255,66,123660,1,308550
35102,0.001667,172.31.36.0-255,66,123726,1,308550
35103,0.001688,172.217.194.0-255,2184,125910,1,308550
35104,0.00169,172.31.36.0-255,66,125976,1,308550
35105,0.001695,172.217.194.0-255,2902,128878,1,308550
35106,0.001697,172.31.36.0-255,66,128944,1,308550
35107,0.001713,172.217.194.0-255,7156,136100,1,308550
35108,0.001715,172.31.36.0-255,66,136166,1,308550
35109,0.001746,172.217.194.0-255,7156,143322,1,308550
35110,0.00175,172.31.36.0-255,66,143388,1,308550
35111,0.001772,172.217.194.0-255,1484,144872,1,308550
35112,0.001783,172.31.36.0-255,66,144938,1,308550
35113,0.001789,172.217.194.0-255,5020,149958,1,308550
35114,0.001791,172.31.36.0-255,66,150024,1,308550
35115,0.002325,172.217.194.0-255,1484,151508,1,308550
35116,0.002332,172.217.194.0-255,1484,152992,1,308550
35117,0.002335,172.31.36.0-255,66,153058,1,308550
35118,0.002356,172.217.194.0-255,1484,154542,1,308550
35119,0.002362,172.217.194.0-255,5738,160280,1,308550
35120,0.002364,172.31.36.0-255,66,160346,1,308550
35121,0.002368,172.217.194.0-255,4320,164666,1,308550
35122,0.00237,172.31.36.0-255,66,164732,1,308550
35123,0.002385,172.217.194.0-255,5738,170470,1,308550
35124,0.002387,172.31.36.0-255,66,170536,1,308550
35125,0.002416,172.217.194.0-255,4320,174856,1,308550
35126,0.002418,172.31.36.0-255,66,174922,1,308550
35127,0.002446,172.31.36.0-255,66,174988,1,308550
35128,0.002463,172.217.194.0-255,1484,176472,1,308550
35129,0.002475,172.217.194.0-255,2902,179374,1,308550
35130,0.002478,172.31.36.0-255,66,179440,1,308550
35131,0.002482,172.217.194.0-255,2902,182342,1,308550
35132,0.002483,172.31.36.0-255,66,182408,1,308550
35133,0.002497,172.217.194.0-255,2902,185310,1,308550
35134,0.002499,172.31.36.0-255,66,185376,1,308550
35135,0.002536,172.31.36.0-255,66,185442,1,308550
35136,0.002567,172.217.194.0-255,5738,191180,1,308550
35137,0.00257,172.31.36.0-255,66,191246,1,308550
35138,0.002585,172.217.194.0-255,5020,196266,1,308550
35139,0.002587,172.31.36.0-255,66,196332,1,308550
35140,0.005138,172.217.194.0-255,5738,202070,1,308550
35141,0.005142,172.31.36.0-255,66,202136,1,308550
35142,0.007716,172.217.194.0-255,5738,207874,1,308550
35143,0.007724,172.31.36.0-255,66,207940,1,308550
35144,0.010285,172.217.194.0-255,5738,213678,1,308550
35145,0.010291,172.31.36.0-255,66,213744,1,308550
35146,0.01284,172.217.194.0-255,5738,219482,1,308550
35147,0.012851,172.31.36.0-255,66,219548,1,308550
35148,0.01539,172.217.194.0-255,5738,225286,1,308550
35149,0.015398,172.31.36.0-255,66,225352,1,308550
35150,0.01798,172.217.194.0-255,5738,231090,1,308550
35151,0.017986,172.31.36.0-255,66,231156,1,308550
35152,0.020538,172.217.194.0-255,5738,236894,1,308550
35153,0.020546,172.31.36.0-255,66,236960,1,308550
35154,0.023088,172.217.194.0-255,5738,242698,1,308550
35155,0.023095,172.31.36.0-255,66,242764,1,308550
35156,0.025693,172.217.194.0-255,5738,248502,1,308550
35157,0.0257,172.31.36.0-255,66,248568,1,308550
35158,0.028229,172.217.194.0-255,5738,254306,1,308550
35159,0.028241,172.31.36.0-255,66,254372,1,308550
35160,0.028798,172.31.36.0-255,172,254544,1,308550
35161,0.028839,172.31.36.0-255,1114,255658,1,308550
35162,0.02891,172.31.36.0-255,1514,257172,1,308550
35163,0.028913,172.31.36.0-255,1514,258686,1,308550
35164,0.028918,172.31.36.0-255,1514,260200,1,308550
35165,0.028919,172.31.36.0-255,1514,261714,1,308550
35166,0.028942,172.31.36.0-255,1492,263206,1,308550
35167,0.030373,104.244.42.0-255,66,263272,1,308550
35168,0.030381,104.244.42.0-255,66,263338,1,308550
35169,0.030465,104.244.42.0-255,66,263404,1,308550
35170,0.030545,104.244.42.0-255,66,263470,1,308550
35171,0.030792,172.217.194.0-255,5738,269208,1,308550
35172,0.030799,172.31.36.0-255,66,269274,1,308550
35173,0.033343,172.217.194.0-255,5738,275012,1,308550
35174,0.033349,172.31.36.0-255,66,275078,1,308550
35175,0.035873,172.217.194.0-255,5738,280816,1,308550
35176,0.035879,172.31.36.0-255,66,280882,1,308550
35177,0.038421,172.217.194.0-255,5738,286620,1,308550
35178,0.038427,172.31.36.0-255,66,286686,1,308550
35179,0.040976,172.217.194.0-255,5738,292424,1,308550
35180,0.040981,172.31.36.0-255,66,292490,1,308550
35181,0.043517,172.217.194.0-255,5738,298228,1,308550
35182,0.043538,172.31.36.0-255,66,298294,1,308550
35183,0.046081,172.217.194.0-255,4320,302614,1,308550
35184,0.046087,172.31.36.0-255,66,302680,1,308550
35185,0.046109,172.217.194.0-255,1484,304164,1,308550
35186,0.048625,172.217.194.0-255,4320,308484,1,308550
35187,0.048631,172.31.36.0-255,66,308550,1,308550
35188,0.0,74.125.24.0-255,152,152,1,332316
35189,4.1e-05,172.31.36.0-255,66,218,1,332316
35190,4.8e-05,74.125.24.0-255,1484,1702,1,332316
35191,5.2e-05,172.31.36.0-255,66,1768,1,332316
35192,5.8e-05,74.125.24.0-255,2902,4670,1,332316
35193,6.1e-05,172.31.36.0-255,66,4736,1,332316
35194,6.6e-05,74.125.24.0-255,2902,7638,1,332316
35195,6.9e-05,172.31.36.0-255,66,7704,1,332316
35196,7.4e-05,74.125.24.0-255,4320,12024,1,332316
35197,7.6e-05,172.31.36.0-255,66,12090,1,332316
35198,0.000118,74.125.24.0-255,2068,14158,1,332316
35199,0.000121,172.31.36.0-255,66,14224,1,332316
35200,0.000196,74.125.24.0-255,1484,15708,1,332316
35201,0.0002,172.31.36.0-255,66,15774,1,332316
35202,0.000205,74.125.24.0-255,2902,18676,1,332316
35203,0.000208,172.31.36.0-255,66,18742,1,332316
35204,0.000237,74.125.24.0-255,5738,24480,1,332316
35205,0.000239,172.31.36.0-255,66,24546,1,332316
35206,0.000244,74.125.24.0-255,4320,28866,1,332316
35207,0.000246,172.31.36.0-255,66,28932,1,332316
35208,0.000293,74.125.24.0-255,4320,33252,1,332316
35209,0.000299,172.31.36.0-255,66,33318,1,332316
35210,0.000321,74.125.24.0-255,2543,35861,1,332316
35211,0.000325,172.31.36.0-255,66,35927,1,332316
35212,0.000332,74.125.24.0-255,7156,43083,1,332316
35213,0.000334,172.31.36.0-255,66,43149,1,332316
35214,0.00034,74.125.24.0-255,4320,47469,1,332316
35215,0.000342,172.31.36.0-255,66,47535,1,332316
35216,0.000357,74.125.24.0-255,1125,48660,1,332316
35217,0.00036,172.31.36.0-255,66,48726,1,332316
35218,0.000385,74.125.24.0-255,2902,51628,1,332316
35219,0.000391,172.31.36.0-255,66,51694,1,332316
35220,0.000398,74.125.24.0-255,2902,54596,1,332316
35221,0.000401,172.31.36.0-255,66,54662,1,332316
35222,0.000406,74.125.24.0-255,2902,57564,1,332316
35223,0.000408,172.31.36.0-255,66,57630,1,332316
35224,0.000426,74.125.24.0-255,4320,61950,1,332316
35225,0.000429,172.31.36.0-255,66,62016,1,332316
35226,0.000455,74.125.24.0-255,4294,66310,1,332316
35227,0.000458,172.31.36.0-255,66,66376,1,332316
35228,0.000514,74.125.24.0-255,107,66483,1,332316
35229,0.000691,74.125.24.0-255,1484,67967,1,332316
35230,0.000696,172.31.36.0-255,66,68033,1,332316
35231,0.000701,74.125.24.0-255,2902,70935,1,332316
35232,0.000704,172.31.36.0-255,66,71001,1,332316
35233,0.000711,74.125.24.0-255,4320,75321,1,332316
35234,0.000713,172.31.36.0-255,66,75387,1,332316
35235,0.000734,74.125.24.0-255,1484,76871,1,332316
35236,0.000738,74.125.24.0-255,1484,78355,1,332316
35237,0.00074,172.31.36.0-255,66,78421,1,332316
35238,0.000771,172.31.36.0-255,66,78487,1,332316
35239,0.000811,172.31.36.0-255,66,78553,1,332316
35240,0.001227,74.125.24.0-255,333,78886,1,332316
35241,0.001255,74.125.24.0-255,1484,80370,1,332316
35242,0.00126,172.31.36.0-255,66,80436,1,332316
35243,0.001267,74.125.24.0-255,4320,84756,1,332316
35244,0.001269,172.31.36.0-255,66,84822,1,332316
35245,0.001291,74.125.24.0-255,1484,86306,1,332316
35246,0.001312,74.125.24.0-255,7156,93462,1,332316
35247,0.001315,172.31.36.0-255,66,93528,1,332316
35248,0.001348,74.125.24.0-255,5738,99266,1,332316
35249,0.001351,172.31.36.0-255,66,99332,1,332316
35250,0.001371,74.125.24.0-255,4320,103652,1,332316
35251,0.001373,172.31.36.0-255,66,103718,1,332316
35252,0.001384,172.31.36.0-255,66,103784,1,332316
35253,0.001412,74.125.24.0-255,1484,105268,1,332316
35254,0.001417,74.125.24.0-255,2902,108170,1,332316
35255,0.001419,172.31.36.0-255,66,108236,1,332316
35256,0.001439,74.125.24.0-255,5738,113974,1,332316
35257,0.001442,172.31.36.0-255,66,114040,1,332316
35258,0.001447,74.125.24.0-255,2902,116942,1,332316
35259,0.001448,172.31.36.0-255,66,117008,1,332316
35260,0.001462,74.125.24.0-255,1484,118492,1,332316
35261,0.001487,172.31.36.0-255,66,118558,1,332316
35262,0.001505,74.125.24.0-255,1484,120042,1,332316
35263,0.001536,172.31.36.0-255,66,120108,1,332316
35264,0.001564,74.125.24.0-255,1484,121592,1,332316
35265,0.001568,74.125.24.0-255,1484,123076,1,332316
35266,0.001572,172.31.36.0-255,66,123142,1,332316
35267,0.001593,74.125.24.0-255,1484,124626,1,332316
35268,0.001601,74.125.24.0-255,5738,130364,1,332316
35269,0.001604,172.31.36.0-255,66,130430,1,332316
35270,0.00161,74.125.24.0-255,7156,137586,1,332316
35271,0.001613,172.31.36.0-255,66,137652,1,332316
35272,0.001637,172.31.36.0-255,66,137718,1,332316
35273,0.001662,74.125.24.0-255,4320,142038,1,332316
35274,0.001664,172.31.36.0-255,66,142104,1,332316
35275,0.001668,74.125.24.0-255,2184,144288,1,332316
35276,0.001671,172.31.36.0-255,66,144354,1,332316
35277,0.001693,74.125.24.0-255,1484,145838,1,332316
35278,0.001705,74.125.24.0-255,1484,147322,1,332316
35279,0.001708,172.31.36.0-255,66,147388,1,332316
35280,0.001713,74.125.24.0-255,4320,151708,1,332316
35281,0.001715,172.31.36.0-255,66,151774,1,332316
35282,0.001717,74.125.24.0-255,1484,153258,1,332316
35283,0.001741,74.125.24.0-255,7156,160414,1,332316
35284,0.001743,172.31.36.0-255,66,160480,1,332316
35285,0.001771,172.31.36.0-255,66,160546,1,332316
35286,0.001802,74.125.24.0-255,2902,163448,1,332316
35287,0.001804,172.31.36.0-255,66,163514,1,332316
35288,0.001819,74.125.24.0-255,5020,168534,1,332316
35289,0.001822,172.31.36.0-255,66,168600,1,332316
35290,0.001828,74.125.24.0-255,7156,175756,1,332316
35291,0.001831,172.31.36.0-255,66,175822,1,332316
35292,0.001849,74.125.24.0-255,1484,177306,1,332316
35293,0.00189,172.31.36.0-255,66,177372,1,332316
35294,0.001911,74.125.24.0-255,1484,178856,1,332316
35295,0.001929,74.125.24.0-255,5020,183876,1,332316
35296,0.001931,172.31.36.0-255,66,183942,1,332316
35297,0.003907,74.125.24.0-255,5738,189680,1,332316
35298,0.003911,172.31.36.0-255,66,189746,1,332316
35299,0.005937,74.125.24.0-255,5738,195484,1,332316
35300,0.005943,172.31.36.0-255,66,195550,1,332316
35301,0.007926,74.125.24.0-255,5738,201288,1,332316
35302,0.007933,172.31.36.0-255,66,201354,1,332316
35303,0.009883,74.125.24.0-255,5738,207092,1,332316
35304,0.00989,172.31.36.0-255,66,207158,1,332316
35305,0.011986,74.125.24.0-255,5738,212896,1,332316
35306,0.011993,172.31.36.0-255,66,212962,1,332316
35307,0.013989,74.125.24.0-255,5738,218700,1,332316
35308,0.013996,172.31.36.0-255,66,218766,1,332316
35309,0.015969,74.125.24.0-255,5738,224504,1,332316
35310,0.015978,172.31.36.0-255,66,224570,1,332316
35311,0.017939,74.125.24.0-255,5738,230308,1,332316
35312,0.017947,172.31.36.0-255,66,230374,1,332316
35313,0.019965,74.125.24.0-255,5738,236112,1,332316
35314,0.019978,172.31.36.0-255,66,236178,1,332316
35315,0.02195,74.125.24.0-255,5738,241916,1,332316
35316,0.021965,172.31.36.0-255,66,241982,1,332316
35317,0.023925,74.125.24.0-255,5738,247720,1,332316
35318,0.023931,172.31.36.0-255,66,247786,1,332316
35319,0.025908,74.125.24.0-255,5738,253524,1,332316
35320,0.025917,172.31.36.0-255,66,253590,1,332316
35321,0.027916,74.125.24.0-255,5738,259328,1,332316
35322,0.027924,172.31.36.0-255,66,259394,1,332316
35323,0.029907,74.125.24.0-255,5738,265132,1,332316
35324,0.029915,172.31.36.0-255,66,265198,1,332316
35325,0.031928,74.125.24.0-255,5738,270936,1,332316
35326,0.031936,172.31.36.0-255,66,271002,1,332316
35327,0.033876,74.125.24.0-255,5738,276740,1,332316
35328,0.033883,172.31.36.0-255,66,276806,1,332316
35329,0.035865,74.125.24.0-255,5738,282544,1,332316
35330,0.035872,172.31.36.0-255,66,282610,1,332316
35331,0.037813,74.125.24.0-255,5738,288348,1,332316
35332,0.037821,172.31.36.0-255,66,288414,1,332316
35333,0.039763,74.125.24.0-255,5738,294152,1,332316
35334,0.03977,172.31.36.0-255,66,294218,1,332316
35335,0.040167,172.31.36.0-255,221,294439,1,332316
35336,0.040197,172.31.36.0-255,1114,295553,1,332316
35337,0.040243,172.31.36.0-255,1514,297067,1,332316
35338,0.040245,172.31.36.0-255,1514,298581,1,332316
35339,0.040251,172.31.36.0-255,1514,300095,1,332316
35340,0.040252,172.31.36.0-255,1514,301609,1,332316
35341,0.040274,172.31.36.0-255,1489,303098,1,332316
35342,0.041706,104.244.42.0-255,66,303164,1,332316
35343,0.04172,74.125.24.0-255,5738,308902,1,332316
35344,0.041741,172.31.36.0-255,66,308968,1,332316
35345,0.041786,104.244.42.0-255,66,309034,1,332316
35346,0.041836,104.244.42.0-255,66,309100,1,332316
35347,0.043681,74.125.24.0-255,5738,314838,1,332316
35348,0.043686,172.31.36.0-255,66,314904,1,332316
35349,0.045644,74.125.24.0-255,5738,320642,1,332316
35350,0.045649,172.31.36.0-255,66,320708,1,332316
35351,0.047642,74.125.24.0-255,5738,326446,1,332316
35352,0.047647,172.31.36.0-255,66,326512,1,332316
35353,0.049618,74.125.24.0-255,5738,332250,1,332316
35354,0.049627,172.31.36.0-255,66,332316,1,332316
35355,0.0,172.217.24.0-255,152,152,1,235358
35356,2.8e-05,172.31.36.0-255,66,218,1,235358
35357,3.4e-05,172.217.24.0-255,1484,1702,1,235358
35358,3.9e-05,172.31.36.0-255,66,1768,1,235358
35359,4.5e-05,172.217.24.0-255,2902,4670,1,235358
35360,4.8e-05,172.31.36.0-255,66,4736,1,235358
35361,5.2e-05,172.217.24.0-255,2902,7638,1,235358
35362,5.4e-05,172.31.36.0-255,66,7704,1,235358
35363,7.4e-05,172.217.24.0-255,4320,12024,1,235358
35364,7.7e-05,172.31.36.0-255,66,12090,1,235358
35365,8.6e-05,172.31.36.0-255,66,12156,1,235358
35366,0.000109,172.217.24.0-255,1484,13640,1,235358
35367,0.000112,172.31.36.0-255,66,13706,1,235358
35368,0.000147,172.31.36.0-255,66,13772,1,235358
35369,0.000183,172.217.24.0-255,1484,15256,1,235358
35370,0.000186,172.31.36.0-255,66,15322,1,235358
35371,0.000194,172.217.24.0-255,2902,18224,1,235358
35372,0.000196,172.31.36.0-255,66,18290,1,235358
35373,0.0002,172.217.24.0-255,2902,21192,1,235358
35374,0.000202,172.31.36.0-255,66,21258,1,235358
35375,0.000207,172.217.24.0-255,4320,25578,1,235358
35376,0.000209,172.31.36.0-255,66,25644,1,235358
35377,0.000266,172.217.24.0-255,5379,31023,1,235358
35378,0.000269,172.31.36.0-255,66,31089,1,235358
35379,0.000406,172.217.24.0-255,1484,32573,1,235358
35380,0.00041,172.31.36.0-255,66,32639,1,235358
35381,0.000416,172.217.24.0-255,2902,35541,1,235358
35382,0.000421,172.31.36.0-255,66,35607,1,235358
35383,0.000433,172.217.24.0-255,5738,41345,1,235358
35384,0.000438,172.31.36.0-255,66,41411,1,235358
35385,0.000462,172.217.24.0-255,7089,48500,1,235358
35386,0.000465,172.31.36.0-255,66,48566,1,235358
35387,0.00101,172.217.24.0-255,387,48953,1,235358
35388,0.001198,172.217.24.0-255,1484,50437,1,235358
35389,0.001204,172.31.36.0-255,66,50503,1,235358
35390,0.001211,172.217.24.0-255,2902,53405,1,235358
35391,0.001213,172.31.36.0-255,66,53471,1,235358
35392,0.001218,172.217.24.0-255,2902,56373,1,235358
35393,0.00122,172.31.36.0-255,66,56439,1,235358
35394,0.001225,172.217.24.0-255,4320,60759,1,235358
35395,0.001226,172.31.36.0-255,66,60825,1,235358
35396,0.00127,172.31.36.0-255,66,60891,1,235358
35397,0.001283,172.31.36.0-255,66,60957,1,235358
35398,0.001789,172.217.24.0-255,1484,62441,1,235358
35399,0.001796,172.217.24.0-255,2902,65343,1,235358
35400,0.001801,172.31.36.0-255,66,65409,1,235358
35401,0.001807,172.217.24.0-255,5738,71147,1,235358
35402,0.001809,172.31.36.0-255,66,71213,1,235358
35403,0.001814,172.217.24.0-255,4320,75533,1,235358
35404,0.001816,172.31.36.0-255,66,75599,1,235358
35405,0.001843,172.217.24.0-255,2902,78501,1,235358
35406,0.001845,172.31.36.0-255,66,78567,1,235358
35407,0.001855,172.31.36.0-255,66,78633,1,235358
35408,0.001871,172.217.24.0-255,4320,82953,1,235358
35409,0.001872,172.31.36.0-255,66,83019,1,235358
35410,0.001891,172.217.24.0-255,3602,86621,1,235358
35411,0.001893,172.31.36.0-255,66,86687,1,235358
35412,0.001903,172.31.36.0-255,66,86753,1,235358
35413,0.001939,172.217.24.0-255,1484,88237,1,235358
35414,0.00383,172.217.24.0-255,4320,92557,1,235358
35415,0.003834,172.31.36.0-255,66,92623,1,235358
35416,0.005764,172.217.24.0-255,5738,98361,1,235358
35417,0.005767,172.31.36.0-255,66,98427,1,235358
35418,0.007702,172.217.24.0-255,5738,104165,1,235358
35419,0.007708,172.31.36.0-255,66,104231,1,235358
35420,0.009647,172.217.24.0-255,5738,109969,1,235358
35421,0.009657,172.31.36.0-255,66,110035,1,235358
35422,0.011601,172.217.24.0-255,5738,115773,1,235358
35423,0.01161,172.31.36.0-255,66,115839,1,235358
35424,0.013555,172.217.24.0-255,5738,121577,1,235358
35425,0.013564,172.31.36.0-255,66,121643,1,235358
35426,0.015508,172.217.24.0-255,5738,127381,1,235358
35427,0.015517,172.31.36.0-255,66,127447,1,235358
35428,0.017455,172.217.24.0-255,5738,133185,1,235358
35429,0.017462,172.31.36.0-255,66,133251,1,235358
35430,0.019399,172.217.24.0-255,5738,138989,1,235358
35431,0.019407,172.31.36.0-255,66,139055,1,235358
35432,0.021348,172.217.24.0-255,5738,144793,1,235358
35433,0.021358,172.31.36.0-255,66,144859,1,235358
35434,0.023298,172.217.24.0-255,5738,150597,1,235358
35435,0.023304,172.31.36.0-255,66,150663,1,235358
35436,0.025239,172.217.24.0-255,5738,156401,1,235358
35437,0.025246,172.31.36.0-255,66,156467,1,235358
35438,0.02719,172.217.24.0-255,5738,162205,1,235358
35439,0.027197,172.31.36.0-255,66,162271,1,235358
35440,0.029145,172.217.24.0-255,5738,168009,1,235358
35441,0.029152,172.31.36.0-255,66,168075,1,235358
35442,0.029557,172.31.36.0-255,188,168263,1,235358
35443,0.02959,172.31.36.0-255,958,169221,1,235358
35444,0.029633,172.31.36.0-255,1514,170735,1,235358
35445,0.029635,172.31.36.0-255,1514,172249,1,235358
35446,0.02964,172.31.36.0-255,1514,173763,1,235358
35447,0.029641,172.31.36.0-255,1514,175277,1,235358
35448,0.029666,172.31.36.0-255,1514,176791,1,235358
35449,0.029667,172.31.36.0-255,197,176988,1,235358
35450,0.031136,172.217.24.0-255,5738,182726,1,235358
35451,0.031143,172.31.36.0-255,66,182792,1,235358
35452,0.031166,104.244.42.0-255,66,182858,1,235358
35453,0.031172,104.244.42.0-255,66,182924,1,235358
35454,0.031199,104.244.42.0-255,66,182990,1,235358
35455,0.031203,104.244.42.0-255,66,183056,1,235358
35456,0.031205,104.244.42.0-255,66,183122,1,235358
35457,0.03308,172.217.24.0-255,5738,188860,1,235358
35458,0.033086,172.31.36.0-255,66,188926,1,235358
35459,0.035016,172.217.24.0-255,5738,194664,1,235358
35460,0.035022,172.31.36.0-255,66,194730,1,235358
35461,0.036975,172.217.24.0-255,5738,200468,1,235358
35462,0.036981,172.31.36.0-255,66,200534,1,235358
35463,0.038919,172.217.24.0-255,5738,206272,1,235358
35464,0.038925,172.31.36.0-255,66,206338,1,235358
35465,0.040856,172.217.24.0-255,5738,212076,1,235358
35466,0.040877,172.31.36.0-255,66,212142,1,235358
35467,0.042814,172.217.24.0-255,5738,217880,1,235358
35468,0.042819,172.31.36.0-255,66,217946,1,235358
35469,0.04475,172.217.24.0-255,5738,223684,1,235358
35470,0.044755,172.31.36.0-255,66,223750,1,235358
35471,0.046684,172.217.24.0-255,5738,229488,1,235358
35472,0.046689,172.31.36.0-255,66,229554,1,235358
35473,0.048619,172.217.24.0-255,5738,235292,1,235358
35474,0.048624,172.31.36.0-255,66,235358,1,235358
35475,0.0,74.125.24.0-255,152,152,1,228189
35476,2.6e-05,172.31.36.0-255,66,218,1,228189
35477,3.3e-05,74.125.24.0-255,1484,1702,1,228189
35478,3.7e-05,172.31.36.0-255,66,1768,1,228189
35479,4.1e-05,74.125.24.0-255,1484,3252,1,228189
35480,4.3e-05,172.31.36.0-255,66,3318,1,228189
35481,6.3e-05,74.125.24.0-255,1484,4802,1,228189
35482,6.6e-05,172.31.36.0-255,66,4868,1,228189
35483,7.2e-05,74.125.24.0-255,4320,9188,1,228189
35484,7.4e-05,172.31.36.0-255,66,9254,1,228189
35485,0.000108,172.31.36.0-255,66,9320,1,228189
35486,0.000118,172.31.36.0-255,66,9386,1,228189
35487,0.000153,74.125.24.0-255,3961,13347,1,228189
35488,0.000156,172.31.36.0-255,66,13413,1,228189
35489,0.00022,74.125.24.0-255,1484,14897,1,228189
35490,0.000238,172.31.36.0-255,66,14963,1,228189
35491,0.000244,74.125.24.0-255,2902,17865,1,228189
35492,0.000247,172.31.36.0-255,66,17931,1,228189
35493,0.000254,74.125.24.0-255,5738,23669,1,228189
35494,0.000256,172.31.36.0-255,66,23735,1,228189
35495,0.000259,74.125.24.0-255,1484,25219,1,228189
35496,0.000262,172.31.36.0-255,66,25285,1,228189
35497,0.000306,74.125.24.0-255,7156,32441,1,228189
35498,0.000309,172.31.36.0-255,66,32507,1,228189
35499,0.000321,74.125.24.0-255,2543,35050,1,228189
35500,0.000323,172.31.36.0-255,66,35116,1,228189
35501,0.000328,74.125.24.0-255,4320,39436,1,228189
35502,0.000331,172.31.36.0-255,66,39502,1,228189
35503,0.000381,74.125.24.0-255,7156,46658,1,228189
35504,0.000385,172.31.36.0-255,66,46724,1,228189
35505,0.000402,74.125.24.0-255,1125,47849,1,228189
35506,0.000406,74.125.24.0-255,399,48248,1,228189
35507,0.000817,172.31.36.0-255,66,48314,1,228189
35508,0.000838,74.125.24.0-255,113,48427,1,228189
35509,0.000877,172.31.36.0-255,66,48493,1,228189
35510,0.000936,74.125.24.0-255,1484,49977,1,228189
35511,0.000944,74.125.24.0-255,2902,52879,1,228189
35512,0.000947,172.31.36.0-255,66,52945,1,228189
35513,0.000951,74.125.24.0-255,1484,54429,1,228189
35514,0.000969,74.125.24.0-255,4320,58749,1,228189
35515,0.000972,172.31.36.0-255,66,58815,1,228189
35516,0.001009,172.31.36.0-255,66,58881,1,228189
35517,0.001024,74.125.24.0-255,1125,60006,1,228189
35518,0.001029,74.125.24.0-255,1484,61490,1,228189
35519,0.001032,172.31.36.0-255,66,61556,1,228189
35520,0.001048,74.125.24.0-255,5738,67294,1,228189
35521,0.001051,172.31.36.0-255,66,67360,1,228189
35522,0.001071,74.125.24.0-255,2543,69903,1,228189
35523,0.001074,172.31.36.0-255,66,69969,1,228189
35524,0.002045,74.125.24.0-255,1484,71453,1,228189
35525,0.002066,74.125.24.0-255,1484,72937,1,228189
35526,0.002071,172.31.36.0-255,66,73003,1,228189
35527,0.00209,74.125.24.0-255,1484,74487,1,228189
35528,0.002096,74.125.24.0-255,5738,80225,1,228189
35529,0.002098,172.31.36.0-255,66,80291,1,228189
35530,0.002113,74.125.24.0-255,5738,86029,1,228189
35531,0.002114,172.31.36.0-255,66,86095,1,228189
35532,0.002134,74.125.24.0-255,7156,93251,1,228189
35533,0.002137,172.31.36.0-255,66,93317,1,228189
35534,0.002161,74.125.24.0-255,4320,97637,1,228189
35535,0.002163,172.31.36.0-255,66,97703,1,228189
35536,0.002177,74.125.24.0-255,6438,104141,1,228189
35537,0.00218,172.31.36.0-255,66,104207,1,228189
35538,0.004459,74.125.24.0-255,1484,105691,1,228189
35539,0.00448,74.125.24.0-255,4320,110011,1,228189
35540,0.004483,172.31.36.0-255,66,110077,1,228189
35541,0.006798,74.125.24.0-255,5738,115815,1,228189
35542,0.006807,172.31.36.0-255,66,115881,1,228189
35543,0.009107,74.125.24.0-255,5738,121619,1,228189
35544,0.009114,172.31.36.0-255,66,121685,1,228189
35545,0.011451,74.125.24.0-255,5738,127423,1,228189
35546,0.011459,172.31.36.0-255,66,127489,1,228189
35547,0.013747,74.125.24.0-255,5738,133227,1,228189
35548,0.013755,172.31.36.0-255,66,133293,1,228189
35549,0.016064,74.125.24.0-255,5738,139031,1,228189
35550,0.016072,172.31.36.0-255,66,139097,1,228189
35551,0.018377,74.125.24.0-255,5738,144835,1,228189
35552,0.018387,172.31.36.0-255,66,144901,1,228189
35553,0.020695,74.125.24.0-255,5738,150639,1,228189
35554,0.020705,172.31.36.0-255,66,150705,1,228189
35555,0.023067,74.125.24.0-255,5738,156443,1,228189
35556,0.023076,172.31.36.0-255,66,156509,1,228189
35557,0.025367,74.125.24.0-255,5738,162247,1,228189
35558,0.025376,172.31.36.0-255,66,162313,1,228189
35559,0.027661,74.125.24.0-255,5738,168051,1,228189
35560,0.027668,172.31.36.0-255,66,168117,1,228189
35561,0.029986,74.125.24.0-255,5738,173855,1,228189
35562,0.029994,172.31.36.0-255,66,173921,1,228189
35563,0.031887,172.31.36.0-255,199,174120,1,228189
35564,0.031918,172.31.36.0-255,1114,175234,1,228189
35565,0.031963,172.31.36.0-255,1514,176748,1,228189
35566,0.031966,172.31.36.0-255,1514,178262,1,228189
35567,0.031967,172.31.36.0-255,1514,179776,1,228189
35568,0.031972,172.31.36.0-255,1514,181290,1,228189
35569,0.031973,172.31.36.0-255,1489,182779,1,228189
35570,0.032314,74.125.24.0-255,5738,188517,1,228189
35571,0.032321,172.31.36.0-255,66,188583,1,228189
35572,0.033444,104.244.42.0-255,66,188649,1,228189
35573,0.033495,104.244.42.0-255,66,188715,1,228189
35574,0.03354,104.244.42.0-255,66,188781,1,228189
35575,0.034622,74.125.24.0-255,5738,194519,1,228189
35576,0.034627,172.31.36.0-255,66,194585,1,228189
35577,0.036937,74.125.24.0-255,5738,200323,1,228189
35578,0.036942,172.31.36.0-255,66,200389,1,228189
35579,0.039223,74.125.24.0-255,5738,206127,1,228189
35580,0.039229,172.31.36.0-255,66,206193,1,228189
35581,0.041535,74.125.24.0-255,5738,211931,1,228189
35582,0.041541,172.31.36.0-255,66,211997,1,228189
35583,0.043852,74.125.24.0-255,4320,216317,1,228189
35584,0.043858,172.31.36.0-255,66,216383,1,228189
35585,0.043889,74.125.24.0-255,1484,217867,1,228189
35586,0.046147,74.125.24.0-255,4320,222187,1,228189
35587,0.046154,172.31.36.0-255,66,222253,1,228189
35588,0.048448,74.125.24.0-255,2902,225155,1,228189
35589,0.048454,172.31.36.0-255,66,225221,1,228189
35590,0.048486,74.125.24.0-255,2902,228123,1,228189
35591,0.048489,172.31.36.0-255,66,228189,1,228189
35592,0.0,74.125.24.0-255,153,153,1,214587
35593,2.6e-05,172.31.36.0-255,66,219,1,214587
35594,3.4e-05,74.125.24.0-255,1484,1703,1,214587
35595,3.8e-05,172.31.36.0-255,66,1769,1,214587
35596,4.3e-05,74.125.24.0-255,2902,4671,1,214587
35597,5.4e-05,172.31.36.0-255,66,4737,1,214587
35598,5.8e-05,74.125.24.0-255,2902,7639,1,214587
35599,6e-05,172.31.36.0-255,66,7705,1,214587
35600,8.8e-05,74.125.24.0-255,6292,13997,1,214587
35601,9.2e-05,172.31.36.0-255,66,14063,1,214587
35602,0.000115,74.125.24.0-255,2902,16965,1,214587
35603,0.000118,172.31.36.0-255,66,17031,1,214587
35604,0.000147,74.125.24.0-255,4320,21351,1,214587
35605,0.00015,172.31.36.0-255,66,21417,1,214587
35606,0.000157,74.125.24.0-255,7156,28573,1,214587
35607,0.00016,172.31.36.0-255,66,28639,1,214587
35608,0.000209,74.125.24.0-255,2543,31182,1,214587
35609,0.000213,172.31.36.0-255,66,31248,1,214587
35610,0.00042,74.125.24.0-255,1484,32732,1,214587
35611,0.000425,172.31.36.0-255,66,32798,1,214587
35612,0.00043,74.125.24.0-255,2902,35700,1,214587
35613,0.000433,172.31.36.0-255,66,35766,1,214587
35614,0.000436,74.125.24.0-255,1484,37250,1,214587
35615,0.000446,172.31.36.0-255,66,37316,1,214587
35616,0.000477,74.125.24.0-255,2902,40218,1,214587
35617,0.00048,172.31.36.0-255,66,40284,1,214587
35618,0.000492,172.31.36.0-255,66,40350,1,214587
35619,0.000509,172.31.36.0-255,66,40416,1,214587
35620,0.000531,74.125.24.0-255,1125,41541,1,214587
35621,0.000534,172.31.36.0-255,66,41607,1,214587
35622,0.00057,74.125.24.0-255,647,42254,1,214587
35623,0.000807,172.31.36.0-255,66,42320,1,214587
35624,0.000828,74.125.24.0-255,1484,43804,1,214587
35625,0.000834,74.125.24.0-255,2902,46706,1,214587
35626,0.000838,172.31.36.0-255,66,46772,1,214587
35627,0.000862,74.125.24.0-255,5738,52510,1,214587
35628,0.000864,172.31.36.0-255,66,52576,1,214587
35629,0.00087,74.125.24.0-255,4320,56896,1,214587
35630,0.000872,172.31.36.0-255,66,56962,1,214587
35631,0.000903,172.31.36.0-255,66,57028,1,214587
35632,0.00092,172.31.36.0-255,66,57094,1,214587
35633,0.001702,74.125.24.0-255,1484,58578,1,214587
35634,0.00171,74.125.24.0-255,2902,61480,1,214587
35635,0.001715,172.31.36.0-255,66,61546,1,214587
35636,0.001719,74.125.24.0-255,1484,63030,1,214587
35637,0.001738,74.125.24.0-255,4320,67350,1,214587
35638,0.00174,172.31.36.0-255,66,67416,1,214587
35639,0.001743,74.125.24.0-255,1484,68900,1,214587
35640,0.001772,74.125.24.0-255,7156,76056,1,214587
35641,0.001775,172.31.36.0-255,66,76122,1,214587
35642,0.001799,74.125.24.0-255,2902,79024,1,214587
35643,0.001801,172.31.36.0-255,66,79090,1,214587
35644,0.001838,172.31.36.0-255,66,79156,1,214587
35645,0.002285,74.125.24.0-255,1484,80640,1,214587
35646,0.002302,74.125.24.0-255,2902,83542,1,214587
35647,0.002304,172.31.36.0-255,66,83608,1,214587
35648,0.002307,74.125.24.0-255,1484,85092,1,214587
35649,0.00456,74.125.24.0-255,4320,89412,1,214587
35650,0.004564,172.31.36.0-255,66,89478,1,214587
35651,0.006827,74.125.24.0-255,5738,95216,1,214587
35652,0.006833,172.31.36.0-255,66,95282,1,214587
35653,0.009085,74.125.24.0-255,5738,101020,1,214587
35654,0.009094,172.31.36.0-255,66,101086,1,214587
35655,0.011357,74.125.24.0-255,5738,106824,1,214587
35656,0.011365,172.31.36.0-255,66,106890,1,214587
35657,0.013625,74.125.24.0-255,5738,112628,1,214587
35658,0.013633,172.31.36.0-255,66,112694,1,214587
35659,0.015871,74.125.24.0-255,5738,118432,1,214587
35660,0.015879,172.31.36.0-255,66,118498,1,214587
35661,0.018136,74.125.24.0-255,5738,124236,1,214587
35662,0.018143,172.31.36.0-255,66,124302,1,214587
35663,0.020386,74.125.24.0-255,5738,130040,1,214587
35664,0.020392,172.31.36.0-255,66,130106,1,214587
35665,0.022649,74.125.24.0-255,5738,135844,1,214587
35666,0.022656,172.31.36.0-255,66,135910,1,214587
35667,0.024967,74.125.24.0-255,5738,141648,1,214587
35668,0.024978,172.31.36.0-255,66,141714,1,214587
35669,0.027243,74.125.24.0-255,5738,147452,1,214587
35670,0.027251,172.31.36.0-255,66,147518,1,214587
35671,0.029489,74.125.24.0-255,5738,153256,1,214587
35672,0.029497,172.31.36.0-255,66,153322,1,214587
35673,0.031779,74.125.24.0-255,5738,159060,1,214587
35674,0.031785,172.31.36.0-255,66,159126,1,214587
35675,0.033899,172.31.36.0-255,172,159298,1,214587
35676,0.033933,172.31.36.0-255,1113,160411,1,214587
35677,0.033978,172.31.36.0-255,1514,161925,1,214587
35678,0.03398,172.31.36.0-255,1514,163439,1,214587
35679,0.033985,172.31.36.0-255,1514,164953,1,214587
35680,0.033987,172.31.36.0-255,1514,166467,1,214587
35681,0.034004,172.31.36.0-255,1490,167957,1,214587
35682,0.034046,74.125.24.0-255,5738,173695,1,214587
35683,0.034051,172.31.36.0-255,66,173761,1,214587
35684,0.03543,104.244.42.0-255,66,173827,1,214587
35685,0.0355,104.244.42.0-255,66,173893,1,214587
35686,0.035546,104.244.42.0-255,66,173959,1,214587
35687,0.036288,74.125.24.0-255,5738,179697,1,214587
35688,0.036295,172.31.36.0-255,66,179763,1,214587
35689,0.038547,74.125.24.0-255,5738,185501,1,214587
35690,0.038554,172.31.36.0-255,66,185567,1,214587
35691,0.040848,74.125.24.0-255,5738,191305,1,214587
35692,0.040856,172.31.36.0-255,66,191371,1,214587
35693,0.043103,74.125.24.0-255,5738,197109,1,214587
35694,0.04311,172.31.36.0-255,66,197175,1,214587
35695,0.04537,74.125.24.0-255,5738,202913,1,214587
35696,0.045378,172.31.36.0-255,66,202979,1,214587
35697,0.047612,74.125.24.0-255,5738,208717,1,214587
35698,0.047617,172.31.36.0-255,66,208783,1,214587
35699,0.049872,74.125.24.0-255,5738,214521,1,214587
35700,0.049877,172.31.36.0-255,66,214587,1,214587
35701,0.0,74.125.200.0-255,147,147,1,326671
35702,3.3e-05,172.31.36.0-255,66,213,1,326671
35703,4e-05,74.125.200.0-255,1484,1697,1,326671
35704,4.4e-05,172.31.36.0-255,66,1763,1,326671
35705,4.8e-05,74.125.200.0-255,2902,4665,1,326671
35706,5.1e-05,172.31.36.0-255,66,4731,1,326671
35707,5.3e-05,74.125.200.0-255,1484,6215,1,326671
35708,5.6e-05,172.31.36.0-255,66,6281,1,326671
35709,7.6e-05,74.125.200.0-255,4320,10601,1,326671
35710,7.9e-05,172.31.36.0-255,66,10667,1,326671
35711,8.4e-05,74.125.200.0-255,4839,15506,1,326671
35712,8.6e-05,172.31.36.0-255,66,15572,1,326671
35713,9.1e-05,74.125.200.0-255,2902,18474,1,326671
35714,9.2e-05,172.31.36.0-255,66,18540,1,326671
35715,0.000119,74.125.200.0-255,2902,21442,1,326671
35716,0.000121,172.31.36.0-255,66,21508,1,326671
35717,0.000187,172.31.36.0-255,66,21574,1,326671
35718,0.000219,74.125.200.0-255,1484,23058,1,326671
35719,0.000222,172.31.36.0-255,66,23124,1,326671
35720,0.000241,74.125.200.0-255,2902,26026,1,326671
35721,0.000244,172.31.36.0-255,66,26092,1,326671
35722,0.000251,74.125.200.0-255,4320,30412,1,326671
35723,0.000253,172.31.36.0-255,66,30478,1,326671
35724,0.000268,74.125.200.0-255,1484,31962,1,326671
35725,0.00027,172.31.36.0-255,66,32028,1,326671
35726,0.000304,172.31.36.0-255,66,32094,1,326671
35727,0.00031,74.125.200.0-255,4320,36414,1,326671
35728,0.000312,172.31.36.0-255,66,36480,1,326671
35729,0.000329,74.125.200.0-255,4320,40800,1,326671
35730,0.000333,172.31.36.0-255,66,40866,1,326671
35731,0.000336,74.125.200.0-255,1484,42350,1,326671
35732,0.000351,74.125.200.0-255,2902,45252,1,326671
35733,0.000353,172.31.36.0-255,66,45318,1,326671
35734,0.000386,74.125.200.0-255,2543,47861,1,326671
35735,0.000393,172.31.36.0-255,66,47927,1,326671
35736,0.000424,74.125.200.0-255,415,48342,1,326671
35737,0.000458,74.125.200.0-255,330,48672,1,326671
35738,0.000575,74.125.200.0-255,1484,50156,1,326671
35739,0.000581,172.31.36.0-255,66,50222,1,326671
35740,0.000585,74.125.200.0-255,1484,51706,1,326671
35741,0.00059,74.125.200.0-255,2902,54608,1,326671
35742,0.000593,172.31.36.0-255,66,54674,1,326671
35743,0.000614,74.125.200.0-255,2902,57576,1,326671
35744,0.000617,172.31.36.0-255,66,57642,1,326671
35745,0.000636,74.125.200.0-255,2902,60544,1,326671
35746,0.000639,172.31.36.0-255,66,60610,1,326671
35747,0.000645,74.125.200.0-255,5379,65989,1,326671
35748,0.000647,172.31.36.0-255,66,66055,1,326671
35749,0.000686,74.125.200.0-255,5738,71793,1,326671
35750,0.000691,172.31.36.0-255,66,71859,1,326671
35751,0.000696,74.125.200.0-255,2902,74761,1,326671
35752,0.000698,172.31.36.0-255,66,74827,1,326671
35753,0.000743,74.125.200.0-255,5738,80565,1,326671
35754,0.000747,172.31.36.0-255,66,80631,1,326671
35755,0.000766,74.125.200.0-255,2543,83174,1,326671
35756,0.000769,172.31.36.0-255,66,83240,1,326671
35757,0.001407,74.125.200.0-255,1484,84724,1,326671
35758,0.001416,74.125.200.0-255,2902,87626,1,326671
35759,0.00142,172.31.36.0-255,66,87692,1,326671
35760,0.001425,74.125.200.0-255,2902,90594,1,326671
35761,0.001427,172.31.36.0-255,66,90660,1,326671
35762,0.001441,74.125.200.0-255,2902,93562,1,326671
35763,0.001443,172.31.36.0-255,66,93628,1,326671
35764,0.001448,74.125.200.0-255,5738,99366,1,326671
35765,0.00145,172.31.36.0-255,66,99432,1,326671
35766,0.001467,74.125.200.0-255,7156,106588,1,326671
35767,0.001468,172.31.36.0-255,66,106654,1,326671
35768,0.001501,74.125.200.0-255,5738,112392,1,326671
35769,0.001503,172.31.36.0-255,66,112458,1,326671
35770,0.001517,74.125.200.0-255,5020,117478,1,326671
35771,0.001519,172.31.36.0-255,66,117544,1,326671
35772,0.001564,74.125.200.0-255,1484,119028,1,326671
35773,0.001586,74.125.200.0-255,1484,120512,1,326671
35774,0.001588,172.31.36.0-255,66,120578,1,326671
35775,0.001605,74.125.200.0-255,1484,122062,1,326671
35776,0.001607,74.125.200.0-255,1484,123546,1,326671
35777,0.001608,172.31.36.0-255,66,123612,1,326671
35778,0.001642,74.125.200.0-255,5738,129350,1,326671
35779,0.001644,172.31.36.0-255,66,129416,1,326671
35780,0.001666,74.125.200.0-255,5738,135154,1,326671
35781,0.001668,172.31.36.0-255,66,135220,1,326671
35782,0.001684,74.125.200.0-255,1484,136704,1,326671
35783,0.001695,74.125.200.0-255,4320,141024,1,326671
35784,0.001697,172.31.36.0-255,66,141090,1,326671
35785,0.001708,74.125.200.0-255,1484,142574,1,326671
35786,0.001711,74.125.200.0-255,1484,144058,1,326671
35787,0.001712,172.31.36.0-255,66,144124,1,326671
35788,0.001716,74.125.200.0-255,2902,147026,1,326671
35789,0.001718,172.31.36.0-255,66,147092,1,326671
35790,0.001754,74.125.200.0-255,5020,152112,1,326671
35791,0.001756,172.31.36.0-255,66,152178,1,326671
35792,0.001852,74.125.200.0-255,1484,153662,1,326671
35793,0.001865,74.125.200.0-255,2902,156564,1,326671
35794,0.001867,172.31.36.0-255,66,156630,1,326671
35795,0.001887,74.125.200.0-255,5738,162368,1,326671
35796,0.001889,172.31.36.0-255,66,162434,1,326671
35797,0.001905,74.125.200.0-255,2902,165336,1,326671
35798,0.001907,172.31.36.0-255,66,165402,1,326671
35799,0.00193,74.125.200.0-255,5738,171140,1,326671
35800,0.001932,172.31.36.0-255,66,171206,1,326671
35801,0.001942,172.31.36.0-255,66,171272,1,326671
35802,0.001957,74.125.200.0-255,5020,176292,1,326671
35803,0.001959,172.31.36.0-255,66,176358,1,326671
35804,0.002053,74.125.200.0-255,1484,177842,1,326671
35805,0.002069,74.125.200.0-255,2902,180744,1,326671
35806,0.002071,172.31.36.0-255,66,180810,1,326671
35807,0.002093,74.125.200.0-255,4320,185130,1,326671
35808,0.002095,172.31.36.0-255,66,185196,1,326671
35809,0.004119,74.125.200.0-255,1484,186680,1,326671
35810,0.004134,74.125.200.0-255,4320,191000,1,326671
35811,0.004138,172.31.36.0-255,66,191066,1,326671
35812,0.006203,74.125.200.0-255,5738,196804,1,326671
35813,0.006209,172.31.36.0-255,66,196870,1,326671
35814,0.008274,74.125.200.0-255,5738,202608,1,326671
35815,0.008284,172.31.36.0-255,66,202674,1,326671
35816,0.010348,74.125.200.0-255,5738,208412,1,326671
35817,0.010357,172.31.36.0-255,66,208478,1,326671
35818,0.012407,74.125.200.0-255,5738,214216,1,326671
35819,0.012415,172.31.36.0-255,66,214282,1,326671
35820,0.014477,74.125.200.0-255,5738,220020,1,326671
35821,0.014487,172.31.36.0-255,66,220086,1,326671
35822,0.016551,74.125.200.0-255,5738,225824,1,326671
35823,0.016558,172.31.36.0-255,66,225890,1,326671
35824,0.018621,74.125.200.0-255,5738,231628,1,326671
35825,0.018633,172.31.36.0-255,66,231694,1,326671
35826,0.02069,74.125.200.0-255,5738,237432,1,326671
35827,0.020698,172.31.36.0-255,66,237498,1,326671
35828,0.022748,74.125.200.0-255,5738,243236,1,326671
35829,0.022756,172.31.36.0-255,66,243302,1,326671
35830,0.024806,74.125.200.0-255,5738,249040,1,326671
35831,0.024813,172.31.36.0-255,66,249106,1,326671
35832,0.026883,74.125.200.0-255,5738,254844,1,326671
35833,0.026892,172.31.36.0-255,66,254910,1,326671
35834,0.028941,74.125.200.0-255,4320,259230,1,326671
35835,0.02895,172.31.36.0-255,66,259296,1,326671
35836,0.028978,74.125.200.0-255,1484,260780,1,326671
35837,0.030589,172.31.36.0-255,172,260952,1,326671
35838,0.030625,172.31.36.0-255,1113,262065,1,326671
35839,0.030681,172.31.36.0-255,1514,263579,1,326671
35840,0.030682,172.31.36.0-255,1514,265093,1,326671
35841,0.030684,172.31.36.0-255,1514,266607,1,326671
35842,0.030685,172.31.36.0-255,1514,268121,1,326671
35843,0.030711,172.31.36.0-255,1490,269611,1,326671
35844,0.030993,74.125.200.0-255,4320,273931,1,326671
35845,0.031,172.31.36.0-255,66,273997,1,326671
35846,0.032137,104.244.42.0-255,66,274063,1,326671
35847,0.032178,104.244.42.0-255,66,274129,1,326671
35848,0.032274,104.244.42.0-255,66,274195,1,326671
35849,0.03228,104.244.42.0-255,66,274261,1,326671
35850,0.033061,74.125.200.0-255,5738,279999,1,326671
35851,0.033069,172.31.36.0-255,66,280065,1,326671
35852,0.033565,104.244.42.0-255,108,280173,1,326671
35853,0.033576,172.31.36.0-255,66,280239,1,326671
35854,0.035144,74.125.200.0-255,5738,285977,1,326671
35855,0.035152,172.31.36.0-255,66,286043,1,326671
35856,0.037221,74.125.200.0-255,5738,291781,1,326671
35857,0.037228,172.31.36.0-255,66,291847,1,326671
35858,0.039289,74.125.200.0-255,5738,297585,1,326671
35859,0.039295,172.31.36.0-255,66,297651,1,326671
35860,0.04134,74.125.200.0-255,5738,303389,1,326671
35861,0.041346,172.31.36.0-255,66,303455,1,326671
35862,0.04341,74.125.200.0-255,5738,309193,1,326671
35863,0.043417,172.31.36.0-255,66,309259,1,326671
35864,0.045466,74.125.200.0-255,5738,314997,1,326671
35865,0.045473,172.31.36.0-255,66,315063,1,326671
35866,0.047531,74.125.200.0-255,5738,320801,1,326671
35867,0.047538,172.31.36.0-255,66,320867,1,326671
35868,0.0496,74.125.200.0-255,5738,326605,1,326671
35869,0.049605,172.31.36.0-255,66,326671,1,326671
35870,0.0,74.125.200.0-255,300,300,1,256683
35871,1.5e-05,172.31.36.0-255,66,366,1,256683
35872,2.3e-05,74.125.200.0-255,1484,1850,1,256683
35873,2.7e-05,172.31.36.0-255,66,1916,1,256683
35874,3.4e-05,74.125.200.0-255,4320,6236,1,256683
35875,3.6e-05,172.31.36.0-255,66,6302,1,256683
35876,7.1e-05,172.31.36.0-255,66,6368,1,256683
35877,7.8e-05,74.125.200.0-255,5738,12106,1,256683
35878,8.1e-05,172.31.36.0-255,66,12172,1,256683
35879,9.7e-05,74.125.200.0-255,4320,16492,1,256683
35880,0.0001,172.31.36.0-255,66,16558,1,256683
35881,0.000107,74.125.200.0-255,5379,21937,1,256683
35882,0.000109,172.31.36.0-255,66,22003,1,256683
35883,0.000392,74.125.200.0-255,1484,23487,1,256683
35884,0.000397,172.31.36.0-255,66,23553,1,256683
35885,0.000417,74.125.200.0-255,2902,26455,1,256683
35886,0.00042,172.31.36.0-255,66,26521,1,256683
35887,0.000427,74.125.200.0-255,4320,30841,1,256683
35888,0.000429,172.31.36.0-255,66,30907,1,256683
35889,0.000441,74.125.200.0-255,1484,32391,1,256683
35890,0.000443,172.31.36.0-255,66,32457,1,256683
35891,0.000448,74.125.200.0-255,2902,35359,1,256683
35892,0.00045,172.31.36.0-255,66,35425,1,256683
35893,0.000469,74.125.200.0-255,4320,39745,1,256683
35894,0.000472,172.31.36.0-255,66,39811,1,256683
35895,0.000499,74.125.200.0-255,5738,45549,1,256683
35896,0.000502,172.31.36.0-255,66,45615,1,256683
35897,0.000509,74.125.200.0-255,5738,51353,1,256683
35898,0.000512,172.31.36.0-255,66,51419,1,256683
35899,0.000526,74.125.200.0-255,5020,56439,1,256683
35900,0.000529,172.31.36.0-255,66,56505,1,256683
35901,0.000781,74.125.200.0-255,647,57152,1,256683
35902,0.000815,74.125.200.0-255,1484,58636,1,256683
35903,0.000819,172.31.36.0-255,66,58702,1,256683
35904,0.000824,74.125.200.0-255,2902,61604,1,256683
35905,0.000826,172.31.36.0-255,66,61670,1,256683
35906,0.000833,74.125.200.0-255,5738,67408,1,256683
35907,0.000835,172.31.36.0-255,66,67474,1,256683
35908,0.000842,74.125.200.0-255,5738,73212,1,256683
35909,0.000845,172.31.36.0-255,66,73278,1,256683
35910,0.000874,74.125.200.0-255,7156,80434,1,256683
35911,0.000878,172.31.36.0-255,66,80500,1,256683
35912,0.000888,74.125.200.0-255,2902,83402,1,256683
35913,0.00089,172.31.36.0-255,66,83468,1,256683
35914,0.000914,172.31.36.0-255,66,83534,1,256683
35915,0.001013,74.125.200.0-255,1484,85018,1,256683
35916,0.00102,74.125.200.0-255,2902,87920,1,256683
35917,0.001023,172.31.36.0-255,66,87986,1,256683
35918,0.001027,74.125.200.0-255,1484,89470,1,256683
35919,0.001044,74.125.200.0-255,4320,93790,1,256683
35920,0.001047,172.31.36.0-255,66,93856,1,256683
35921,0.00105,74.125.200.0-255,1484,95340,1,256683
35922,0.001075,172.31.36.0-255,66,95406,1,256683
35923,0.001097,74.125.200.0-255,2902,98308,1,256683
35924,0.0011,172.31.36.0-255,66,98374,1,256683
35925,0.001111,172.31.36.0-255,66,98440,1,256683
35926,0.001148,74.125.200.0-255,2902,101342,1,256683
35927,0.001151,172.31.36.0-255,66,101408,1,256683
35928,0.001188,172.31.36.0-255,66,101474,1,256683
35929,0.001205,172.31.36.0-255,66,101540,1,256683
35930,0.001209,74.125.200.0-255,2184,103724,1,256683
35931,0.001211,172.31.36.0-255,66,103790,1,256683
35932,0.00123,74.125.200.0-255,1484,105274,1,256683
35933,0.001247,74.125.200.0-255,2902,108176,1,256683
35934,0.001251,172.31.36.0-255,66,108242,1,256683
35935,0.001268,74.125.200.0-255,2902,111144,1,256683
35936,0.001271,172.31.36.0-255,66,111210,1,256683
35937,0.001291,74.125.200.0-255,2902,114112,1,256683
35938,0.001294,172.31.36.0-255,66,114178,1,256683
35939,0.001312,74.125.200.0-255,2902,117080,1,256683
35940,0.001315,172.31.36.0-255,66,117146,1,256683
35941,0.00133,74.125.200.0-255,2902,120048,1,256683
35942,0.001333,172.31.36.0-255,66,120114,1,256683
35943,0.00136,74.125.200.0-255,7156,127270,1,256683
35944,0.001364,172.31.36.0-255,66,127336,1,256683
35945,0.001393,172.31.36.0-255,66,127402,1,256683
35946,0.00141,74.125.200.0-255,2184,129586,1,256683
35947,0.001413,172.31.36.0-255,66,129652,1,256683
35948,0.001624,74.125.200.0-255,1484,131136,1,256683
35949,0.001643,74.125.200.0-255,2902,134038,1,256683
35950,0.001649,74.125.200.0-255,4320,138358,1,256683
35951,0.001654,172.31.36.0-255,66,138424,1,256683
35952,0.001662,172.31.36.0-255,66,138490,1,256683
35953,0.001665,74.125.200.0-255,1484,139974,1,256683
35954,0.00167,74.125.200.0-255,4320,144294,1,256683
35955,0.001673,172.31.36.0-255,66,144360,1,256683
35956,0.001711,172.31.36.0-255,66,144426,1,256683
35957,0.001716,74.125.200.0-255,4320,148746,1,256683
35958,0.001718,172.31.36.0-255,66,148812,1,256683
35959,0.001739,74.125.200.0-255,2902,151714,1,256683
35960,0.001742,172.31.36.0-255,66,151780,1,256683
35961,0.001773,172.31.36.0-255,66,151846,1,256683
35962,0.001776,74.125.200.0-255,1484,153330,1,256683
35963,0.001806,172.31.36.0-255,66,153396,1,256683
35964,0.001828,74.125.200.0-255,5738,159134,1,256683
35965,0.001831,172.31.36.0-255,66,159200,1,256683
35966,0.001839,74.125.200.0-255,6438,165638,1,256683
35967,0.001841,172.31.36.0-255,66,165704,1,256683
35968,0.001852,74.125.200.0-255,1484,167188,1,256683
35969,0.001869,74.125.200.0-255,2902,170090,1,256683
35970,0.001874,172.31.36.0-255,66,170156,1,256683
35971,0.001893,74.125.200.0-255,4320,174476,1,256683
35972,0.001896,172.31.36.0-255,66,174542,1,256683
35973,0.001916,74.125.200.0-255,1484,176026,1,256683
35974,0.001922,74.125.200.0-255,5738,181764,1,256683
35975,0.001925,172.31.36.0-255,66,181830,1,256683
35976,0.001931,74.125.200.0-255,4320,186150,1,256683
35977,0.001933,172.31.36.0-255,66,186216,1,256683
35978,0.001949,74.125.200.0-255,2902,189118,1,256683
35979,0.001952,172.31.36.0-255,66,189184,1,256683
35980,0.001966,74.125.200.0-255,4320,193504,1,256683
35981,0.001968,172.31.36.0-255,66,193570,1,256683
35982,0.001994,74.125.200.0-255,6438,200008,1,256683
35983,0.001998,172.31.36.0-255,66,200074,1,256683
35984,0.002003,74.125.200.0-255,4320,204394,1,256683
35985,0.002005,172.31.36.0-255,66,204460,1,256683
35986,0.002034,74.125.200.0-255,7156,211616,1,256683
35987,0.002037,172.31.36.0-255,66,211682,1,256683
35988,0.002042,74.125.200.0-255,4320,216002,1,256683
35989,0.002045,172.31.36.0-255,66,216068,1,256683
35990,0.002093,172.31.36.0-255,66,216134,1,256683
35991,0.002118,74.125.200.0-255,4320,220454,1,256683
35992,0.002122,172.31.36.0-255,66,220520,1,256683
35993,0.002138,172.31.36.0-255,66,220586,1,256683
35994,0.002153,172.31.36.0-255,66,220652,1,256683
35995,0.002156,74.125.200.0-255,766,221418,1,256683
35996,0.002183,74.125.200.0-255,5738,227156,1,256683
35997,0.002186,172.31.36.0-255,66,227222,1,256683
35998,0.002209,74.125.200.0-255,5738,232960,1,256683
35999,0.002212,172.31.36.0-255,66,233026,1,256683
36000,0.002225,172.31.36.0-255,66,233092,1,256683
36001,0.002249,74.125.200.0-255,2902,235994,1,256683
36002,0.002252,172.31.36.0-255,66,236060,1,256683
36003,0.002258,74.125.200.0-255,4320,240380,1,256683
36004,0.00226,172.31.36.0-255,66,240446,1,256683
36005,0.002288,74.125.200.0-255,4320,244766,1,256683
36006,0.002291,172.31.36.0-255,66,244832,1,256683
36007,0.002303,172.31.36.0-255,66,244898,1,256683
36008,0.002307,74.125.200.0-255,2251,247149,1,256683
36009,0.002309,172.31.36.0-255,66,247215,1,256683
36010,0.002312,74.125.200.0-255,97,247312,1,256683
36011,0.002327,74.125.200.0-255,105,247417,1,256683
36012,0.010349,172.31.36.0-255,66,247483,1,256683
36013,0.010395,172.31.36.0-255,105,247588,1,256683
36014,0.012379,74.125.200.0-255,66,247654,1,256683
36015,0.037317,172.31.36.0-255,172,247826,1,256683
36016,0.037351,172.31.36.0-255,1113,248939,1,256683
36017,0.037419,172.31.36.0-255,1514,250453,1,256683
36018,0.037421,172.31.36.0-255,1514,251967,1,256683
36019,0.037422,172.31.36.0-255,1514,253481,1,256683
36020,0.037427,172.31.36.0-255,1514,254995,1,256683
36021,0.037429,172.31.36.0-255,1490,256485,1,256683
36022,0.038866,104.244.42.0-255,66,256551,1,256683
36023,0.038926,104.244.42.0-255,66,256617,1,256683
36024,0.039059,104.244.42.0-255,66,256683,1,256683
36025,0.0,172.217.24.0-255,146,146,1,273439
36026,3.1e-05,172.31.36.0-255,66,212,1,273439
36027,3.9e-05,172.217.24.0-255,1484,1696,1,273439
36028,4.3e-05,172.31.36.0-255,66,1762,1,273439
36029,4.7e-05,172.217.24.0-255,2902,4664,1,273439
36030,5e-05,172.31.36.0-255,66,4730,1,273439
36031,5.5e-05,172.217.24.0-255,4320,9050,1,273439
36032,5.8e-05,172.31.36.0-255,66,9116,1,273439
36033,8.8e-05,172.217.24.0-255,4320,13436,1,273439
36034,9e-05,172.31.36.0-255,66,13502,1,273439
36035,0.000107,172.217.24.0-255,548,14050,1,273439
36036,0.00011,172.31.36.0-255,66,14116,1,273439
36037,0.000539,172.217.24.0-255,1484,15600,1,273439
36038,0.000545,172.31.36.0-255,66,15666,1,273439
36039,0.000555,172.217.24.0-255,2902,18568,1,273439
36040,0.000558,172.31.36.0-255,66,18634,1,273439
36041,0.000565,172.217.24.0-255,5738,24372,1,273439
36042,0.000567,172.31.36.0-255,66,24438,1,273439
36043,0.0006,172.217.24.0-255,6797,31235,1,273439
36044,0.000604,172.31.36.0-255,66,31301,1,273439
36045,0.000747,172.217.24.0-255,1484,32785,1,273439
36046,0.000752,172.31.36.0-255,66,32851,1,273439
36047,0.000758,172.217.24.0-255,2902,35753,1,273439
36048,0.00076,172.31.36.0-255,66,35819,1,273439
36049,0.000785,172.217.24.0-255,5738,41557,1,273439
36050,0.000789,172.31.36.0-255,66,41623,1,273439
36051,0.000815,172.217.24.0-255,6797,48420,1,273439
36052,0.000817,172.31.36.0-255,66,48486,1,273439
36053,0.000962,172.217.24.0-255,1484,49970,1,273439
36054,0.000967,172.31.36.0-255,66,50036,1,273439
36055,0.000973,172.217.24.0-255,2902,52938,1,273439
36056,0.000975,172.31.36.0-255,66,53004,1,273439
36057,0.000981,172.217.24.0-255,4320,57324,1,273439
36058,0.000984,172.31.36.0-255,66,57390,1,273439
36059,0.001,172.217.24.0-255,1484,58874,1,273439
36060,0.001005,172.217.24.0-255,4320,63194,1,273439
36061,0.001009,172.31.36.0-255,66,63260,1,273439
36062,0.001043,172.217.24.0-255,2868,66128,1,273439
36063,0.001046,172.31.36.0-255,66,66194,1,273439
36064,0.00147,172.217.24.0-255,119,66313,1,273439
36065,0.001584,172.217.24.0-255,1484,67797,1,273439
36066,0.001589,172.31.36.0-255,66,67863,1,273439
36067,0.001593,172.217.24.0-255,2902,70765,1,273439
36068,0.001595,172.31.36.0-255,66,70831,1,273439
36069,0.001599,172.217.24.0-255,2902,73733,1,273439
36070,0.001602,172.31.36.0-255,66,73799,1,273439
36071,0.001618,172.217.24.0-255,4320,78119,1,273439
36072,0.001621,172.31.36.0-255,66,78185,1,273439
36073,0.00165,172.217.24.0-255,5379,83564,1,273439
36074,0.001652,172.31.36.0-255,66,83630,1,273439
36075,0.001674,172.217.24.0-255,5738,89368,1,273439
36076,0.001676,172.31.36.0-255,66,89434,1,273439
36077,0.001712,172.217.24.0-255,7156,96590,1,273439
36078,0.001715,172.31.36.0-255,66,96656,1,273439
36079,0.001731,172.217.24.0-255,3961,100617,1,273439
36080,0.001733,172.31.36.0-255,66,100683,1,273439
36081,0.00183,172.217.24.0-255,1484,102167,1,273439
36082,0.001834,172.217.24.0-255,2902,105069,1,273439
36083,0.001836,172.31.36.0-255,66,105135,1,273439
36084,0.001843,172.217.24.0-255,5738,110873,1,273439
36085,0.001845,172.31.36.0-255,66,110939,1,273439
36086,0.001848,172.217.24.0-255,1484,112423,1,273439
36087,0.001889,172.217.24.0-255,7156,119579,1,273439
36088,0.001892,172.31.36.0-255,66,119645,1,273439
36089,0.001902,172.31.36.0-255,66,119711,1,273439
36090,0.001908,172.217.24.0-255,5020,124731,1,273439
36091,0.001911,172.31.36.0-255,66,124797,1,273439
36092,0.003829,172.217.24.0-255,5738,130535,1,273439
36093,0.003837,172.31.36.0-255,66,130601,1,273439
36094,0.004094,172.31.36.0-255,101,130702,1,273439
36095,0.005765,172.217.24.0-255,5738,136440,1,273439
36096,0.005771,172.31.36.0-255,66,136506,1,273439
36097,0.005973,172.217.24.0-255,66,136572,1,273439
36098,0.007708,172.217.24.0-255,5738,142310,1,273439
36099,0.007715,172.31.36.0-255,66,142376,1,273439
36100,0.00964,172.217.24.0-255,5738,148114,1,273439
36101,0.009647,172.31.36.0-255,66,148180,1,273439
36102,0.011574,172.217.24.0-255,5738,153918,1,273439
36103,0.011581,172.31.36.0-255,66,153984,1,273439
36104,0.013509,172.217.24.0-255,5738,159722,1,273439
36105,0.013516,172.31.36.0-255,66,159788,1,273439
36106,0.015449,172.217.24.0-255,5738,165526,1,273439
36107,0.015457,172.31.36.0-255,66,165592,1,273439
36108,0.017378,172.217.24.0-255,5738,171330,1,273439
36109,0.017385,172.31.36.0-255,66,171396,1,273439
36110,0.01931,172.217.24.0-255,5738,177134,1,273439
36111,0.019319,172.31.36.0-255,66,177200,1,273439
36112,0.021249,172.217.24.0-255,5738,182938,1,273439
36113,0.021256,172.31.36.0-255,66,183004,1,273439
36114,0.023191,172.217.24.0-255,5738,188742,1,273439
36115,0.023203,172.31.36.0-255,66,188808,1,273439
36116,0.025133,172.217.24.0-255,5738,194546,1,273439
36117,0.025141,172.31.36.0-255,66,194612,1,273439
36118,0.027073,172.217.24.0-255,5738,200350,1,273439
36119,0.02708,172.31.36.0-255,66,200416,1,273439
36120,0.029022,172.217.24.0-255,5738,206154,1,273439
36121,0.02903,172.31.36.0-255,66,206220,1,273439
36122,0.030962,172.217.24.0-255,5738,211958,1,273439
36123,0.030969,172.31.36.0-255,66,212024,1,273439
36124,0.032896,172.217.24.0-255,5738,217762,1,273439
36125,0.032902,172.31.36.0-255,66,217828,1,273439
36126,0.03487,172.217.24.0-255,5738,223566,1,273439
36127,0.034878,172.31.36.0-255,66,223632,1,273439
36128,0.036807,172.217.24.0-255,5738,229370,1,273439
36129,0.036813,172.31.36.0-255,66,229436,1,273439
36130,0.037261,172.31.36.0-255,188,229624,1,273439
36131,0.037296,172.31.36.0-255,958,230582,1,273439
36132,0.03734,172.31.36.0-255,1514,232096,1,273439
36133,0.037342,172.31.36.0-255,1514,233610,1,273439
36134,0.037347,172.31.36.0-255,1514,235124,1,273439
36135,0.037348,172.31.36.0-255,1514,236638,1,273439
36136,0.037368,172.31.36.0-255,1514,238152,1,273439
36137,0.03737,172.31.36.0-255,199,238351,1,273439
36138,0.038745,172.217.24.0-255,5738,244089,1,273439
36139,0.038752,172.31.36.0-255,66,244155,1,273439
36140,0.038773,104.244.42.0-255,66,244221,1,273439
36141,0.038834,104.244.42.0-255,66,244287,1,273439
36142,0.038913,104.244.42.0-255,66,244353,1,273439
36143,0.038917,104.244.42.0-255,66,244419,1,273439
36144,0.040679,172.217.24.0-255,5738,250157,1,273439
36145,0.040702,172.31.36.0-255,66,250223,1,273439
36146,0.042633,172.217.24.0-255,5738,255961,1,273439
36147,0.042638,172.31.36.0-255,66,256027,1,273439
36148,0.044566,172.217.24.0-255,5738,261765,1,273439
36149,0.044572,172.31.36.0-255,66,261831,1,273439
36150,0.046493,172.217.24.0-255,5738,267569,1,273439
36151,0.046498,172.31.36.0-255,66,267635,1,273439
36152,0.048421,172.217.24.0-255,5738,273373,1,273439
36153,0.048427,172.31.36.0-255,66,273439,1,273439
36154,0.0,172.217.194.0-255,152,152,1,192245
36155,2.5e-05,172.31.36.0-255,66,218,1,192245
36156,3.2e-05,172.217.194.0-255,1484,1702,1,192245
36157,3.7e-05,172.31.36.0-255,66,1768,1,192245
36158,5.5e-05,172.217.194.0-255,2902,4670,1,192245
36159,5.9e-05,172.31.36.0-255,66,4736,1,192245
36160,6.8e-05,172.217.194.0-255,7156,11892,1,192245
36161,7e-05,172.31.36.0-255,66,11958,1,192245
36162,7.5e-05,172.217.194.0-255,1986,13944,1,192245
36163,7.8e-05,172.31.36.0-255,66,14010,1,192245
36164,0.000107,172.217.194.0-255,2902,16912,1,192245
36165,0.00011,172.31.36.0-255,66,16978,1,192245
36166,0.000116,172.217.194.0-255,4320,21298,1,192245
36167,0.000118,172.31.36.0-255,66,21364,1,192245
36168,0.00016,172.31.36.0-255,66,21430,1,192245
36169,0.000163,172.217.194.0-255,1125,22555,1,192245
36170,0.000165,172.31.36.0-255,66,22621,1,192245
36171,0.000293,172.217.194.0-255,1484,24105,1,192245
36172,0.000297,172.31.36.0-255,66,24171,1,192245
36173,0.000301,172.217.194.0-255,1484,25655,1,192245
36174,0.000303,172.31.36.0-255,66,25721,1,192245
36175,0.000323,172.217.194.0-255,1484,27205,1,192245
36176,0.000326,172.31.36.0-255,66,27271,1,192245
36177,0.000339,172.217.194.0-255,5738,33009,1,192245
36178,0.000342,172.31.36.0-255,66,33075,1,192245
36179,0.000349,172.217.194.0-255,5738,38813,1,192245
36180,0.000351,172.31.36.0-255,66,38879,1,192245
36181,0.000399,172.31.36.0-255,66,38945,1,192245
36182,0.000411,172.31.36.0-255,66,39011,1,192245
36183,0.000414,172.217.194.0-255,341,39352,1,192245
36184,0.0007,172.217.194.0-255,115,39467,1,192245
36185,0.000749,172.217.194.0-255,384,39851,1,192245
36186,0.000865,172.217.194.0-255,1484,41335,1,192245
36187,0.000871,172.31.36.0-255,66,41401,1,192245
36188,0.000876,172.217.194.0-255,1484,42885,1,192245
36189,0.000898,172.217.194.0-255,1484,44369,1,192245
36190,0.0009,172.31.36.0-255,66,44435,1,192245
36191,0.000909,172.217.194.0-255,4320,48755,1,192245
36192,0.000912,172.31.36.0-255,66,48821,1,192245
36193,0.000936,172.217.194.0-255,1484,50305,1,192245
36194,0.000943,172.217.194.0-255,7156,57461,1,192245
36195,0.000946,172.31.36.0-255,66,57527,1,192245
36196,0.000975,172.217.194.0-255,5738,63265,1,192245
36197,0.000979,172.31.36.0-255,66,63331,1,192245
36198,0.001039,172.31.36.0-255,66,63397,1,192245
36199,0.001381,172.217.194.0-255,1484,64881,1,192245
36200,0.00139,172.217.194.0-255,2902,67783,1,192245
36201,0.001394,172.31.36.0-255,66,67849,1,192245
36202,0.001402,172.217.194.0-255,5738,73587,1,192245
36203,0.001404,172.31.36.0-255,66,73653,1,192245
36204,0.001451,172.31.36.0-255,66,73719,1,192245
36205,0.001489,172.31.36.0-255,66,73785,1,192245
36206,0.001521,172.217.194.0-255,3602,77387,1,192245
36207,0.001525,172.31.36.0-255,66,77453,1,192245
36208,0.001641,172.217.194.0-255,1484,78937,1,192245
36209,0.001648,172.217.194.0-255,2902,81839,1,192245
36210,0.001651,172.31.36.0-255,66,81905,1,192245
36211,0.001658,172.217.194.0-255,4320,86225,1,192245
36212,0.001661,172.31.36.0-255,66,86291,1,192245
36213,0.001689,172.217.194.0-255,1484,87775,1,192245
36214,0.001697,172.217.194.0-255,7156,94931,1,192245
36215,0.00171,172.31.36.0-255,66,94997,1,192245
36216,0.001763,172.31.36.0-255,66,95063,1,192245
36217,0.001803,172.217.194.0-255,1484,96547,1,192245
36218,0.001817,172.217.194.0-255,2902,99449,1,192245
36219,0.001825,172.31.36.0-255,66,99515,1,192245
36220,0.001837,172.217.194.0-255,5738,105253,1,192245
36221,0.001863,172.31.36.0-255,66,105319,1,192245
36222,0.001868,172.217.194.0-255,4320,109639,1,192245
36223,0.001907,172.217.194.0-255,5738,115377,1,192245
36224,0.00191,172.31.36.0-255,66,115443,1,192245
36225,0.001916,172.31.36.0-255,66,115509,1,192245
36226,0.001936,172.217.194.0-255,4320,119829,1,192245
36227,0.001958,172.217.194.0-255,6438,126267,1,192245
36228,0.001981,172.31.36.0-255,66,126333,1,192245
36229,0.002009,172.31.36.0-255,66,126399,1,192245
36230,0.002029,172.217.194.0-255,2184,128583,1,192245
36231,0.002045,172.31.36.0-255,66,128649,1,192245
36232,0.0021,172.217.194.0-255,1484,130133,1,192245
36233,0.002105,172.217.194.0-255,2902,133035,1,192245
36234,0.002108,172.217.194.0-255,1484,134519,1,192245
36235,0.002118,172.31.36.0-255,66,134585,1,192245
36236,0.002137,172.217.194.0-255,4320,138905,1,192245
36237,0.002142,172.217.194.0-255,2902,141807,1,192245
36238,0.002157,172.217.194.0-255,1484,143291,1,192245
36239,0.002165,172.31.36.0-255,66,143357,1,192245
36240,0.002199,172.217.194.0-255,2902,146259,1,192245
36241,0.002215,172.217.194.0-255,5738,151997,1,192245
36242,0.002228,172.31.36.0-255,66,152063,1,192245
36243,0.002247,172.217.194.0-255,2902,154965,1,192245
36244,0.002269,172.31.36.0-255,66,155031,1,192245
36245,0.002343,172.217.194.0-255,1484,156515,1,192245
36246,0.002348,172.217.194.0-255,2902,159417,1,192245
36247,0.002355,172.217.194.0-255,5738,165155,1,192245
36248,0.002396,172.31.36.0-255,66,165221,1,192245
36249,0.002429,172.217.194.0-255,7156,172377,1,192245
36250,0.002434,172.217.194.0-255,4320,176697,1,192245
36251,0.002451,172.31.36.0-255,66,176763,1,192245
36252,0.002514,172.31.36.0-255,66,176829,1,192245
36253,0.002606,172.217.194.0-255,1484,178313,1,192245
36254,0.002639,172.31.36.0-255,66,178379,1,192245
36255,0.002644,172.31.36.0-255,66,178445,1,192245
36256,0.00266,172.217.194.0-255,3602,182047,1,192245
36257,0.002704,172.31.36.0-255,66,182113,1,192245
36258,0.005282,172.217.194.0-255,866,182979,1,192245
36259,0.00557,172.31.36.0-255,66,183045,1,192245
36260,0.005607,172.31.36.0-255,105,183150,1,192245
36261,0.008203,172.217.194.0-255,66,183216,1,192245
36262,0.037834,172.31.36.0-255,172,183388,1,192245
36263,0.037869,172.31.36.0-255,1114,184502,1,192245
36264,0.037938,172.31.36.0-255,1514,186016,1,192245
36265,0.03794,172.31.36.0-255,1514,187530,1,192245
36266,0.037941,172.31.36.0-255,1514,189044,1,192245
36267,0.037942,172.31.36.0-255,1514,190558,1,192245
36268,0.03797,172.31.36.0-255,1489,192047,1,192245
36269,0.039377,104.244.42.0-255,66,192113,1,192245
36270,0.039429,104.244.42.0-255,66,192179,1,192245
36271,0.039549,104.244.42.0-255,66,192245,1,192245
36272,0.0,74.125.24.0-255,146,146,1,243887
36273,3.5e-05,172.31.36.0-255,66,212,1,243887
36274,4.2e-05,74.125.24.0-255,1484,1696,1,243887
36275,4.7e-05,172.31.36.0-255,66,1762,1,243887
36276,6e-05,74.125.24.0-255,2902,4664,1,243887
36277,6.2e-05,172.31.36.0-255,66,4730,1,243887
36278,7e-05,74.125.24.0-255,5738,10468,1,243887
36279,7.3e-05,172.31.36.0-255,66,10534,1,243887
36280,0.000123,172.31.36.0-255,66,10600,1,243887
36281,0.000135,172.31.36.0-255,66,10666,1,243887
36282,0.000138,74.125.24.0-255,1125,11791,1,243887
36283,0.00014,172.31.36.0-255,66,11857,1,243887
36284,0.000189,74.125.24.0-255,1484,13341,1,243887
36285,0.000192,172.31.36.0-255,66,13407,1,243887
36286,0.000218,74.125.24.0-255,2902,16309,1,243887
36287,0.00022,172.31.36.0-255,66,16375,1,243887
36288,0.000225,74.125.24.0-255,2902,19277,1,243887
36289,0.000228,172.31.36.0-255,66,19343,1,243887
36290,0.000253,74.125.24.0-255,2902,22245,1,243887
36291,0.000256,172.31.36.0-255,66,22311,1,243887
36292,0.000266,172.31.36.0-255,66,22377,1,243887
36293,0.000279,172.31.36.0-255,66,22443,1,243887
36294,0.00031,74.125.24.0-255,5352,27795,1,243887
36295,0.000314,172.31.36.0-255,66,27861,1,243887
36296,0.000435,74.125.24.0-255,345,28206,1,243887
36297,0.00044,172.31.36.0-255,66,28272,1,243887
36298,0.0006,74.125.24.0-255,1484,29756,1,243887
36299,0.000605,172.31.36.0-255,66,29822,1,243887
36300,0.00061,74.125.24.0-255,2902,32724,1,243887
36301,0.000612,172.31.36.0-255,66,32790,1,243887
36302,0.000643,74.125.24.0-255,4320,37110,1,243887
36303,0.000646,172.31.36.0-255,66,37176,1,243887
36304,0.000675,74.125.24.0-255,1484,38660,1,243887
36305,0.000678,74.125.24.0-255,1484,40144,1,243887
36306,0.000681,172.31.36.0-255,66,40210,1,243887
36307,0.000686,74.125.24.0-255,2902,43112,1,243887
36308,0.000688,172.31.36.0-255,66,43178,1,243887
36309,0.000694,74.125.24.0-255,5738,48916,1,243887
36310,0.000696,172.31.36.0-255,66,48982,1,243887
36311,0.000709,172.31.36.0-255,66,49048,1,243887
36312,0.000712,74.125.24.0-255,766,49814,1,243887
36313,0.001051,172.31.36.0-255,66,49880,1,243887
36314,0.001258,74.125.24.0-255,1484,51364,1,243887
36315,0.001268,74.125.24.0-255,2902,54266,1,243887
36316,0.001272,172.31.36.0-255,66,54332,1,243887
36317,0.001305,74.125.24.0-255,5738,60070,1,243887
36318,0.001309,172.31.36.0-255,66,60136,1,243887
36319,0.001321,172.31.36.0-255,66,60202,1,243887
36320,0.001346,74.125.24.0-255,4320,64522,1,243887
36321,0.001349,172.31.36.0-255,66,64588,1,243887
36322,0.001382,172.31.36.0-255,66,64654,1,243887
36323,0.001397,172.31.36.0-255,66,64720,1,243887
36324,0.001404,74.125.24.0-255,7156,71876,1,243887
36325,0.001406,172.31.36.0-255,66,71942,1,243887
36326,0.001438,172.31.36.0-255,66,72008,1,243887
36327,0.001443,74.125.24.0-255,3602,75610,1,243887
36328,0.001445,172.31.36.0-255,66,75676,1,243887
36329,0.001862,74.125.24.0-255,1484,77160,1,243887
36330,0.001869,74.125.24.0-255,2902,80062,1,243887
36331,0.001874,172.31.36.0-255,66,80128,1,243887
36332,0.001879,74.125.24.0-255,2902,83030,1,243887
36333,0.001881,172.31.36.0-255,66,83096,1,243887
36334,0.001901,74.125.24.0-255,2902,85998,1,243887
36335,0.001903,172.31.36.0-255,66,86064,1,243887
36336,0.001913,74.125.24.0-255,4320,90384,1,243887
36337,0.001915,172.31.36.0-255,66,90450,1,243887
36338,0.00192,74.125.24.0-255,4320,94770,1,243887
36339,0.001921,172.31.36.0-255,66,94836,1,243887
36340,0.001953,74.125.24.0-255,1484,96320,1,243887
36341,0.001965,172.31.36.0-255,66,96386,1,243887
36342,0.001969,74.125.24.0-255,2184,98570,1,243887
36343,0.00197,172.31.36.0-255,66,98636,1,243887
36344,0.00211,74.125.24.0-255,1484,100120,1,243887
36345,0.002126,74.125.24.0-255,2902,103022,1,243887
36346,0.002129,172.31.36.0-255,66,103088,1,243887
36347,0.002151,74.125.24.0-255,2902,105990,1,243887
36348,0.002153,172.31.36.0-255,66,106056,1,243887
36349,0.002172,74.125.24.0-255,2902,108958,1,243887
36350,0.002174,172.31.36.0-255,66,109024,1,243887
36351,0.002181,74.125.24.0-255,7156,116180,1,243887
36352,0.002183,172.31.36.0-255,66,116246,1,243887
36353,0.002226,172.31.36.0-255,66,116312,1,243887
36354,0.00223,74.125.24.0-255,2184,118496,1,243887
36355,0.002232,172.31.36.0-255,66,118562,1,243887
36356,0.004501,74.125.24.0-255,1484,120046,1,243887
36357,0.004518,74.125.24.0-255,4320,124366,1,243887
36358,0.004521,172.31.36.0-255,66,124432,1,243887
36359,0.00677,74.125.24.0-255,5738,130170,1,243887
36360,0.006776,172.31.36.0-255,66,130236,1,243887
36361,0.009055,74.125.24.0-255,5738,135974,1,243887
36362,0.009062,172.31.36.0-255,66,136040,1,243887
36363,0.01136,74.125.24.0-255,5738,141778,1,243887
36364,0.011369,172.31.36.0-255,66,141844,1,243887
36365,0.013651,74.125.24.0-255,5738,147582,1,243887
36366,0.013658,172.31.36.0-255,66,147648,1,243887
36367,0.015945,74.125.24.0-255,5738,153386,1,243887
36368,0.015954,172.31.36.0-255,66,153452,1,243887
36369,0.018248,74.125.24.0-255,5738,159190,1,243887
36370,0.018255,172.31.36.0-255,66,159256,1,243887
36371,0.020507,74.125.24.0-255,5738,164994,1,243887
36372,0.020513,172.31.36.0-255,66,165060,1,243887
36373,0.022781,74.125.24.0-255,5738,170798,1,243887
36374,0.022788,172.31.36.0-255,66,170864,1,243887
36375,0.02514,74.125.24.0-255,5738,176602,1,243887
36376,0.025148,172.31.36.0-255,66,176668,1,243887
36377,0.027405,74.125.24.0-255,5738,182406,1,243887
36378,0.027413,172.31.36.0-255,66,182472,1,243887
36379,0.029695,74.125.24.0-255,5738,188210,1,243887
36380,0.029702,172.31.36.0-255,66,188276,1,243887
36381,0.031972,74.125.24.0-255,5738,194014,1,243887
36382,0.031979,172.31.36.0-255,66,194080,1,243887
36383,0.034284,74.125.24.0-255,5738,199818,1,243887
36384,0.034292,172.31.36.0-255,66,199884,1,243887
36385,0.036545,74.125.24.0-255,5738,205622,1,243887
36386,0.036552,172.31.36.0-255,66,205688,1,243887
36387,0.038814,74.125.24.0-255,5738,211426,1,243887
36388,0.038822,172.31.36.0-255,66,211492,1,243887
36389,0.038958,172.31.36.0-255,189,211681,1,243887
36390,0.038982,172.31.36.0-255,925,212606,1,243887
36391,0.039092,172.31.36.0-255,1514,214120,1,243887
36392,0.039094,172.31.36.0-255,1514,215634,1,243887
36393,0.039095,172.31.36.0-255,1514,217148,1,243887
36394,0.039096,172.31.36.0-255,1514,218662,1,243887
36395,0.039097,172.31.36.0-255,1514,220176,1,243887
36396,0.039126,172.31.36.0-255,231,220407,1,243887
36397,0.040477,104.244.42.0-255,66,220473,1,243887
36398,0.040522,104.244.42.0-255,66,220539,1,243887
36399,0.040672,104.244.42.0-255,66,220605,1,243887
36400,0.040677,104.244.42.0-255,66,220671,1,243887
36401,0.041129,74.125.24.0-255,5738,226409,1,243887
36402,0.041134,172.31.36.0-255,66,226475,1,243887
36403,0.043381,74.125.24.0-255,5738,232213,1,243887
36404,0.0434,172.31.36.0-255,66,232279,1,243887
36405,0.045696,74.125.24.0-255,5738,238017,1,243887
36406,0.045702,172.31.36.0-255,66,238083,1,243887
36407,0.048022,74.125.24.0-255,5738,243821,1,243887
36408,0.048028,172.31.36.0-255,66,243887,1,243887
36409,0.0,74.125.24.0-255,153,153,1,198278
36410,3.2e-05,172.31.36.0-255,66,219,1,198278
36411,3.9e-05,74.125.24.0-255,1484,1703,1,198278
36412,4.3e-05,172.31.36.0-255,66,1769,1,198278
36413,4.8e-05,74.125.24.0-255,2902,4671,1,198278
36414,5e-05,172.31.36.0-255,66,4737,1,198278
36415,5.7e-05,74.125.24.0-255,7156,11893,1,198278
36416,6e-05,172.31.36.0-255,66,11959,1,198278
36417,8.1e-05,74.125.24.0-255,2013,13972,1,198278
36418,8.4e-05,172.31.36.0-255,66,14038,1,198278
36419,0.000179,74.125.24.0-255,1484,15522,1,198278
36420,0.000184,172.31.36.0-255,66,15588,1,198278
36421,0.000191,74.125.24.0-255,2902,18490,1,198278
36422,0.000195,172.31.36.0-255,66,18556,1,198278
36423,0.000201,74.125.24.0-255,5738,24294,1,198278
36424,0.000203,172.31.36.0-255,66,24360,1,198278
36425,0.000244,74.125.24.0-255,2902,27262,1,198278
36426,0.000247,172.31.36.0-255,66,27328,1,198278
36427,0.000267,74.125.24.0-255,3961,31289,1,198278
36428,0.00027,172.31.36.0-255,66,31355,1,198278
36429,0.000576,74.125.24.0-255,1484,32839,1,198278
36430,0.000581,172.31.36.0-255,66,32905,1,198278
36431,0.000589,74.125.24.0-255,2902,35807,1,198278
36432,0.000592,172.31.36.0-255,66,35873,1,198278
36433,0.000597,74.125.24.0-255,2902,38775,1,198278
36434,0.000599,172.31.36.0-255,66,38841,1,198278
36435,0.000628,74.125.24.0-255,7156,45997,1,198278
36436,0.00063,172.31.36.0-255,66,46063,1,198278
36437,0.000645,74.125.24.0-255,4320,50383,1,198278
36438,0.000648,172.31.36.0-255,66,50449,1,198278
36439,0.000686,172.31.36.0-255,66,50515,1,198278
36440,0.000691,74.125.24.0-255,2543,53058,1,198278
36441,0.000694,172.31.36.0-255,66,53124,1,198278
36442,0.001045,74.125.24.0-255,646,53770,1,198278
36443,0.001085,74.125.24.0-255,1484,55254,1,198278
36444,0.001099,74.125.24.0-255,2902,58156,1,198278
36445,0.00112,74.125.24.0-255,1484,59640,1,198278
36446,0.001156,74.125.24.0-255,1484,61124,1,198278
36447,0.001174,74.125.24.0-255,2902,64026,1,198278
36448,0.001193,74.125.24.0-255,5020,69046,1,198278
36449,0.001755,74.125.24.0-255,1484,70530,1,198278
36450,0.00176,74.125.24.0-255,1484,72014,1,198278
36451,0.001774,74.125.24.0-255,1484,73498,1,198278
36452,0.001779,74.125.24.0-255,2902,76400,1,198278
36453,0.001796,74.125.24.0-255,2902,79302,1,198278
36454,0.001803,74.125.24.0-255,7156,86458,1,198278
36455,0.001816,74.125.24.0-255,2902,89360,1,198278
36456,0.001852,74.125.24.0-255,1484,90844,1,198278
36457,0.001855,74.125.24.0-255,2184,93028,1,198278
36458,0.005845,172.31.36.0-255,66,93094,1,198278
36459,0.008198,74.125.24.0-255,5738,98832,1,198278
36460,0.008206,172.31.36.0-255,66,98898,1,198278
36461,0.010562,74.125.24.0-255,5738,104636,1,198278
36462,0.010571,172.31.36.0-255,66,104702,1,198278
36463,0.012873,74.125.24.0-255,5738,110440,1,198278
36464,0.012881,172.31.36.0-255,66,110506,1,198278
36465,0.015185,74.125.24.0-255,5738,116244,1,198278
36466,0.015192,172.31.36.0-255,66,116310,1,198278
36467,0.017526,74.125.24.0-255,5738,122048,1,198278
36468,0.017533,172.31.36.0-255,66,122114,1,198278
36469,0.019856,74.125.24.0-255,5738,127852,1,198278
36470,0.019866,172.31.36.0-255,66,127918,1,198278
36471,0.022196,74.125.24.0-255,5738,133656,1,198278
36472,0.022203,172.31.36.0-255,66,133722,1,198278
36473,0.024509,74.125.24.0-255,5738,139460,1,198278
36474,0.024517,172.31.36.0-255,66,139526,1,198278
36475,0.026848,74.125.24.0-255,5738,145264,1,198278
36476,0.026854,172.31.36.0-255,66,145330,1,198278
36477,0.029178,74.125.24.0-255,5738,151068,1,198278
36478,0.029186,172.31.36.0-255,66,151134,1,198278
36479,0.03149,74.125.24.0-255,5738,156872,1,198278
36480,0.031497,172.31.36.0-255,66,156938,1,198278
36481,0.031849,172.31.36.0-255,188,157126,1,198278
36482,0.031882,172.31.36.0-255,958,158084,1,198278
36483,0.031956,172.31.36.0-255,720,158804,1,198278
36484,0.033399,104.244.42.0-255,66,158870,1,198278
36485,0.033447,104.244.42.0-255,66,158936,1,198278
36486,0.033496,104.244.42.0-255,66,159002,1,198278
36487,0.033815,74.125.24.0-255,5738,164740,1,198278
36488,0.033819,172.31.36.0-255,66,164806,1,198278
36489,0.036116,74.125.24.0-255,5738,170544,1,198278
36490,0.036122,172.31.36.0-255,66,170610,1,198278
36491,0.038424,74.125.24.0-255,5738,176348,1,198278
36492,0.03843,172.31.36.0-255,66,176414,1,198278
36493,0.040724,74.125.24.0-255,5738,182152,1,198278
36494,0.040745,172.31.36.0-255,66,182218,1,198278
36495,0.043042,74.125.24.0-255,5738,187956,1,198278
36496,0.043047,172.31.36.0-255,66,188022,1,198278
36497,0.045363,74.125.24.0-255,4320,192342,1,198278
36498,0.045369,172.31.36.0-255,66,192408,1,198278
36499,0.045403,74.125.24.0-255,1484,193892,1,198278
36500,0.047683,74.125.24.0-255,4320,198212,1,198278
36501,0.047689,172.31.36.0-255,66,198278,1,198278
36502,0.0,172.217.194.0-255,153,153,1,234771
36503,1.6e-05,172.31.36.0-255,66,219,1,234771
36504,2.4e-05,172.217.194.0-255,1484,1703,1,234771
36505,2.8e-05,172.31.36.0-255,66,1769,1,234771
36506,3.3e-05,172.217.194.0-255,2902,4671,1,234771
36507,3.7e-05,172.31.36.0-255,66,4737,1,234771
36508,5.2e-05,172.217.194.0-255,7156,11893,1,234771
36509,5.5e-05,172.31.36.0-255,66,11959,1,234771
36510,6e-05,172.217.194.0-255,2045,14004,1,234771
36511,6.3e-05,172.31.36.0-255,66,14070,1,234771
36512,0.000165,172.217.194.0-255,1484,15554,1,234771
36513,0.00017,172.31.36.0-255,66,15620,1,234771
36514,0.000175,172.217.194.0-255,2902,18522,1,234771
36515,0.000177,172.31.36.0-255,66,18588,1,234771
36516,0.000211,172.217.194.0-255,5738,24326,1,234771
36517,0.000214,172.31.36.0-255,66,24392,1,234771
36518,0.000244,172.217.194.0-255,5738,30130,1,234771
36519,0.000247,172.31.36.0-255,66,30196,1,234771
36520,0.000259,172.217.194.0-255,1125,31321,1,234771
36521,0.000267,172.31.36.0-255,66,31387,1,234771
36522,0.000275,172.217.194.0-255,7156,38543,1,234771
36523,0.000278,172.31.36.0-255,66,38609,1,234771
36524,0.000306,172.217.194.0-255,5738,44347,1,234771
36525,0.000308,172.31.36.0-255,66,44413,1,234771
36526,0.000339,172.217.194.0-255,3961,48374,1,234771
36527,0.000341,172.31.36.0-255,66,48440,1,234771
36528,0.000945,172.217.194.0-255,1484,49924,1,234771
36529,0.00095,172.31.36.0-255,66,49990,1,234771
36530,0.000958,172.217.194.0-255,2902,52892,1,234771
36531,0.000961,172.31.36.0-255,66,52958,1,234771
36532,0.000973,172.217.194.0-255,5738,58696,1,234771
36533,0.000975,172.31.36.0-255,66,58762,1,234771
36534,0.000979,172.217.194.0-255,1484,60246,1,234771
36535,0.001012,172.217.194.0-255,5379,65625,1,234771
36536,0.001015,172.31.36.0-255,66,65691,1,234771
36537,0.00115,172.217.194.0-255,1484,67175,1,234771
36538,0.001157,172.217.194.0-255,2902,70077,1,234771
36539,0.00116,172.31.36.0-255,66,70143,1,234771
36540,0.001167,172.217.194.0-255,5738,75881,1,234771
36541,0.00117,172.31.36.0-255,66,75947,1,234771
36542,0.00121,172.31.36.0-255,66,76013,1,234771
36543,0.001235,172.217.194.0-255,1484,77497,1,234771
36544,0.001259,172.31.36.0-255,66,77563,1,234771
36545,0.00162,172.217.194.0-255,1484,79047,1,234771
36546,0.001629,172.217.194.0-255,2902,81949,1,234771
36547,0.001633,172.31.36.0-255,66,82015,1,234771
36548,0.001641,172.217.194.0-255,5738,87753,1,234771
36549,0.001644,172.31.36.0-255,66,87819,1,234771
36550,0.001657,172.217.194.0-255,7156,94975,1,234771
36551,0.00166,172.31.36.0-255,66,95041,1,234771
36552,0.001702,172.217.194.0-255,4320,99361,1,234771
36553,0.001705,172.31.36.0-255,66,99427,1,234771
36554,0.001751,172.31.36.0-255,66,99493,1,234771
36555,0.002189,172.217.194.0-255,1484,100977,1,234771
36556,0.002197,172.217.194.0-255,2902,103879,1,234771
36557,0.002203,172.31.36.0-255,66,103945,1,234771
36558,0.00221,172.217.194.0-255,5738,109683,1,234771
36559,0.002213,172.31.36.0-255,66,109749,1,234771
36560,0.002248,172.31.36.0-255,66,109815,1,234771
36561,0.002285,172.31.36.0-255,66,109881,1,234771
36562,0.002516,172.217.194.0-255,1484,111365,1,234771
36563,0.002521,172.217.194.0-255,1484,112849,1,234771
36564,0.002525,172.31.36.0-255,66,112915,1,234771
36565,0.002553,172.217.194.0-255,1484,114399,1,234771
36566,0.002561,172.217.194.0-255,5738,120137,1,234771
36567,0.002564,172.31.36.0-255,66,120203,1,234771
36568,0.002576,172.31.36.0-255,66,120269,1,234771
36569,0.002625,172.31.36.0-255,66,120335,1,234771
36570,0.002655,172.217.194.0-255,6438,126773,1,234771
36571,0.002658,172.31.36.0-255,66,126839,1,234771
36572,0.005286,172.217.194.0-255,5738,132577,1,234771
36573,0.005292,172.31.36.0-255,66,132643,1,234771
36574,0.007128,172.31.36.0-255,101,132744,1,234771
36575,0.007899,172.217.194.0-255,5738,138482,1,234771
36576,0.007904,172.31.36.0-255,66,138548,1,234771
36577,0.00971,172.217.194.0-255,66,138614,1,234771
36578,0.010526,172.217.194.0-255,5738,144352,1,234771
36579,0.010534,172.31.36.0-255,66,144418,1,234771
36580,0.013167,172.217.194.0-255,5738,150156,1,234771
36581,0.013175,172.31.36.0-255,66,150222,1,234771
36582,0.015806,172.217.194.0-255,5738,155960,1,234771
36583,0.015815,172.31.36.0-255,66,156026,1,234771
36584,0.018451,172.217.194.0-255,5738,161764,1,234771
36585,0.018459,172.31.36.0-255,66,161830,1,234771
36586,0.021084,172.217.194.0-255,5738,167568,1,234771
36587,0.021092,172.31.36.0-255,66,167634,1,234771
36588,0.023715,172.217.194.0-255,5738,173372,1,234771
36589,0.023722,172.31.36.0-255,66,173438,1,234771
36590,0.026385,172.217.194.0-255,5738,179176,1,234771
36591,0.026392,172.31.36.0-255,66,179242,1,234771
36592,0.029012,172.217.194.0-255,5738,184980,1,234771
36593,0.029019,172.31.36.0-255,66,185046,1,234771
36594,0.031657,172.217.194.0-255,5738,190784,1,234771
36595,0.031666,172.31.36.0-255,66,190850,1,234771
36596,0.034294,172.217.194.0-255,5738,196588,1,234771
36597,0.034303,172.31.36.0-255,66,196654,1,234771
36598,0.036806,172.31.36.0-255,172,196826,1,234771
36599,0.036833,172.31.36.0-255,1113,197939,1,234771
36600,0.036893,172.31.36.0-255,1514,199453,1,234771
36601,0.036895,172.31.36.0-255,1514,200967,1,234771
36602,0.036899,172.31.36.0-255,1514,202481,1,234771
36603,0.036901,172.31.36.0-255,1514,203995,1,234771
36604,0.036919,172.31.36.0-255,1492,205487,1,234771
36605,0.036949,172.217.194.0-255,5738,211225,1,234771
36606,0.036953,172.31.36.0-255,66,211291,1,234771
36607,0.038338,104.244.42.0-255,66,211357,1,234771
36608,0.038401,104.244.42.0-255,66,211423,1,234771
36609,0.038454,104.244.42.0-255,66,211489,1,234771
36610,0.038459,104.244.42.0-255,66,211555,1,234771
36611,0.039569,172.217.194.0-255,5738,217293,1,234771
36612,0.039577,172.31.36.0-255,66,217359,1,234771
36613,0.04221,172.217.194.0-255,5738,223097,1,234771
36614,0.042216,172.31.36.0-255,66,223163,1,234771
36615,0.044855,172.217.194.0-255,5738,228901,1,234771
36616,0.044864,172.31.36.0-255,66,228967,1,234771
36617,0.047462,172.217.194.0-255,5738,234705,1,234771
36618,0.047468,172.31.36.0-255,66,234771,1,234771
36619,0.0,74.125.24.0-255,153,153,1,204400
36620,3.5e-05,172.31.36.0-255,66,219,1,204400
36621,4.2e-05,74.125.24.0-255,1484,1703,1,204400
36622,4.6e-05,172.31.36.0-255,66,1769,1,204400
36623,5.1e-05,74.125.24.0-255,2902,4671,1,204400
36624,5.3e-05,172.31.36.0-255,66,4737,1,204400
36625,6.1e-05,74.125.24.0-255,7156,11893,1,204400
36626,6.4e-05,172.31.36.0-255,66,11959,1,204400
36627,7e-05,74.125.24.0-255,3423,15382,1,204400
36628,7.3e-05,172.31.36.0-255,66,15448,1,204400
36629,7.9e-05,74.125.24.0-255,5738,21186,1,204400
36630,8.1e-05,172.31.36.0-255,66,21252,1,204400
36631,0.000106,74.125.24.0-255,7156,28408,1,204400
36632,0.000108,172.31.36.0-255,66,28474,1,204400
36633,0.000112,74.125.24.0-255,2543,31017,1,204400
36634,0.000114,172.31.36.0-255,66,31083,1,204400
36635,0.000147,74.125.24.0-255,2902,33985,1,204400
36636,0.00015,172.31.36.0-255,66,34051,1,204400
36637,0.00017,74.125.24.0-255,4320,38371,1,204400
36638,0.000173,172.31.36.0-255,66,38437,1,204400
36639,0.000186,172.31.36.0-255,66,38503,1,204400
36640,0.000188,74.125.24.0-255,1125,39628,1,204400
36641,0.00019,172.31.36.0-255,66,39694,1,204400
36642,0.000287,74.125.24.0-255,1484,41178,1,204400
36643,0.000291,172.31.36.0-255,66,41244,1,204400
36644,0.000297,74.125.24.0-255,2902,44146,1,204400
36645,0.0003,172.31.36.0-255,66,44212,1,204400
36646,0.000304,74.125.24.0-255,2902,47114,1,204400
36647,0.000306,172.31.36.0-255,66,47180,1,204400
36648,0.000326,74.125.24.0-255,2902,50082,1,204400
36649,0.00033,172.31.36.0-255,66,50148,1,204400
36650,0.000365,74.125.24.0-255,1484,51632,1,204400
36651,0.000385,74.125.24.0-255,5379,57011,1,204400
36652,0.000395,172.31.36.0-255,66,57077,1,204400
36653,0.001258,74.125.24.0-255,646,57723,1,204400
36654,0.003072,74.125.24.0-255,1484,59207,1,204400
36655,0.003078,172.31.36.0-255,66,59273,1,204400
36656,0.003114,74.125.24.0-255,2902,62175,1,204400
36657,0.003117,172.31.36.0-255,66,62241,1,204400
36658,0.005099,74.125.24.0-255,2902,65143,1,204400
36659,0.005104,172.31.36.0-255,66,65209,1,204400
36660,0.005149,74.125.24.0-255,2902,68111,1,204400
36661,0.005152,172.31.36.0-255,66,68177,1,204400
36662,0.007138,74.125.24.0-255,2902,71079,1,204400
36663,0.007144,172.31.36.0-255,66,71145,1,204400
36664,0.007166,74.125.24.0-255,2902,74047,1,204400
36665,0.007169,172.31.36.0-255,66,74113,1,204400
36666,0.009141,74.125.24.0-255,2902,77015,1,204400
36667,0.009148,172.31.36.0-255,66,77081,1,204400
36668,0.009169,74.125.24.0-255,2902,79983,1,204400
36669,0.009172,172.31.36.0-255,66,80049,1,204400
36670,0.01113,74.125.24.0-255,2902,82951,1,204400
36671,0.011138,172.31.36.0-255,66,83017,1,204400
36672,0.011166,74.125.24.0-255,2902,85919,1,204400
36673,0.01117,172.31.36.0-255,66,85985,1,204400
36674,0.013146,74.125.24.0-255,2902,88887,1,204400
36675,0.013159,172.31.36.0-255,66,88953,1,204400
36676,0.013187,74.125.24.0-255,2902,91855,1,204400
36677,0.013191,172.31.36.0-255,66,91921,1,204400
36678,0.015197,74.125.24.0-255,5738,97659,1,204400
36679,0.01521,172.31.36.0-255,66,97725,1,204400
36680,0.017236,74.125.24.0-255,5738,103463,1,204400
36681,0.017245,172.31.36.0-255,66,103529,1,204400
36682,0.019258,74.125.24.0-255,5738,109267,1,204400
36683,0.019268,172.31.36.0-255,66,109333,1,204400
36684,0.021285,74.125.24.0-255,5738,115071,1,204400
36685,0.021293,172.31.36.0-255,66,115137,1,204400
36686,0.023288,74.125.24.0-255,5738,120875,1,204400
36687,0.023295,172.31.36.0-255,66,120941,1,204400
36688,0.025327,74.125.24.0-255,5738,126679,1,204400
36689,0.025332,172.31.36.0-255,66,126745,1,204400
36690,0.02736,74.125.24.0-255,5738,132483,1,204400
36691,0.027368,172.31.36.0-255,66,132549,1,204400
36692,0.029355,74.125.24.0-255,5738,138287,1,204400
36693,0.029364,172.31.36.0-255,66,138353,1,204400
36694,0.031294,172.31.36.0-255,172,138525,1,204400
36695,0.031326,172.31.36.0-255,1113,139638,1,204400
36696,0.031383,172.31.36.0-255,1514,141152,1,204400
36697,0.031385,172.31.36.0-255,1514,142666,1,204400
36698,0.031387,172.31.36.0-255,1514,144180,1,204400
36699,0.031387,172.31.36.0-255,1514,145694,1,204400
36700,0.031403,74.125.24.0-255,5738,151432,1,204400
36701,0.031407,172.31.36.0-255,66,151498,1,204400
36702,0.031424,172.31.36.0-255,1490,152988,1,204400
36703,0.032855,104.244.42.0-255,66,153054,1,204400
36704,0.032899,104.244.42.0-255,66,153120,1,204400
36705,0.032952,104.244.42.0-255,66,153186,1,204400
36706,0.033053,104.244.42.0-255,66,153252,1,204400
36707,0.033392,74.125.24.0-255,5738,158990,1,204400
36708,0.033398,172.31.36.0-255,66,159056,1,204400
36709,0.035407,74.125.24.0-255,5738,164794,1,204400
36710,0.035413,172.31.36.0-255,66,164860,1,204400
36711,0.037445,74.125.24.0-255,4320,169180,1,204400
36712,0.03745,172.31.36.0-255,66,169246,1,204400
36713,0.037463,74.125.24.0-255,1484,170730,1,204400
36714,0.039528,74.125.24.0-255,4320,175050,1,204400
36715,0.039532,172.31.36.0-255,66,175116,1,204400
36716,0.041533,74.125.24.0-255,5738,180854,1,204400
36717,0.04154,172.31.36.0-255,66,180920,1,204400
36718,0.043541,74.125.24.0-255,5738,186658,1,204400
36719,0.043553,172.31.36.0-255,66,186724,1,204400
36720,0.045533,74.125.24.0-255,2902,189626,1,204400
36721,0.045538,172.31.36.0-255,66,189692,1,204400
36722,0.045566,74.125.24.0-255,2902,192594,1,204400
36723,0.045569,172.31.36.0-255,66,192660,1,204400
36724,0.047523,74.125.24.0-255,2902,195562,1,204400
36725,0.047527,172.31.36.0-255,66,195628,1,204400
36726,0.047556,74.125.24.0-255,2902,198530,1,204400
36727,0.047559,172.31.36.0-255,66,198596,1,204400
36728,0.049541,74.125.24.0-255,5738,204334,1,204400
36729,0.049546,172.31.36.0-255,66,204400,1,204400
36730,0.0,74.125.24.0-255,153,153,1,239967
36731,2.1e-05,172.31.36.0-255,66,219,1,239967
36732,2.8e-05,74.125.24.0-255,1484,1703,1,239967
36733,3.2e-05,172.31.36.0-255,66,1769,1,239967
36734,3.7e-05,74.125.24.0-255,2902,4671,1,239967
36735,4e-05,172.31.36.0-255,66,4737,1,239967
36736,4.8e-05,74.125.24.0-255,7156,11893,1,239967
36737,5.1e-05,172.31.36.0-255,66,11959,1,239967
36738,5.5e-05,74.125.24.0-255,2047,14006,1,239967
36739,5.8e-05,172.31.36.0-255,66,14072,1,239967
36740,0.000184,74.125.24.0-255,1484,15556,1,239967
36741,0.000189,172.31.36.0-255,66,15622,1,239967
36742,0.000195,74.125.24.0-255,2902,18524,1,239967
36743,0.000197,172.31.36.0-255,66,18590,1,239967
36744,0.000205,74.125.24.0-255,5738,24328,1,239967
36745,0.000208,172.31.36.0-255,66,24394,1,239967
36746,0.000235,74.125.24.0-255,5738,30132,1,239967
36747,0.000238,172.31.36.0-255,66,30198,1,239967
36748,0.000251,74.125.24.0-255,1125,31323,1,239967
36749,0.000253,172.31.36.0-255,66,31389,1,239967
36750,0.000515,74.125.24.0-255,1484,32873,1,239967
36751,0.000522,172.31.36.0-255,66,32939,1,239967
36752,0.000528,74.125.24.0-255,2902,35841,1,239967
36753,0.00053,172.31.36.0-255,66,35907,1,239967
36754,0.00056,74.125.24.0-255,5738,41645,1,239967
36755,0.000563,172.31.36.0-255,66,41711,1,239967
36756,0.00057,74.125.24.0-255,6797,48508,1,239967
36757,0.000576,172.31.36.0-255,66,48574,1,239967
36758,0.000606,74.125.24.0-255,5738,54312,1,239967
36759,0.000609,172.31.36.0-255,66,54378,1,239967
36760,0.00064,172.31.36.0-255,66,54444,1,239967
36761,0.000645,74.125.24.0-255,2543,56987,1,239967
36762,0.000647,172.31.36.0-255,66,57053,1,239967
36763,0.000649,74.125.24.0-255,399,57452,1,239967
36764,0.000931,74.125.24.0-255,346,57798,1,239967
36765,0.001066,74.125.24.0-255,1484,59282,1,239967
36766,0.00107,172.31.36.0-255,66,59348,1,239967
36767,0.001075,74.125.24.0-255,2902,62250,1,239967
36768,0.001078,172.31.36.0-255,66,62316,1,239967
36769,0.001101,74.125.24.0-255,4320,66636,1,239967
36770,0.001104,172.31.36.0-255,66,66702,1,239967
36771,0.001122,74.125.24.0-255,1484,68186,1,239967
36772,0.00113,74.125.24.0-255,6797,74983,1,239967
36773,0.001135,172.31.36.0-255,66,75049,1,239967
36774,0.001303,74.125.24.0-255,1484,76533,1,239967
36775,0.001312,74.125.24.0-255,2902,79435,1,239967
36776,0.001315,172.31.36.0-255,66,79501,1,239967
36777,0.001319,74.125.24.0-255,1484,80985,1,239967
36778,0.001338,74.125.24.0-255,4320,85305,1,239967
36779,0.00134,172.31.36.0-255,66,85371,1,239967
36780,0.001371,74.125.24.0-255,2902,88273,1,239967
36781,0.001374,172.31.36.0-255,66,88339,1,239967
36782,0.001392,74.125.24.0-255,3410,91749,1,239967
36783,0.001395,172.31.36.0-255,66,91815,1,239967
36784,0.001402,74.125.24.0-255,7156,98971,1,239967
36785,0.001404,172.31.36.0-255,66,99037,1,239967
36786,0.001456,172.31.36.0-255,66,99103,1,239967
36787,0.001469,74.125.24.0-255,1111,100214,1,239967
36788,0.003509,74.125.24.0-255,4320,104534,1,239967
36789,0.003516,172.31.36.0-255,66,104600,1,239967
36790,0.00557,74.125.24.0-255,5738,110338,1,239967
36791,0.005572,172.31.36.0-255,66,110404,1,239967
36792,0.007578,74.125.24.0-255,5738,116142,1,239967
36793,0.007584,172.31.36.0-255,66,116208,1,239967
36794,0.00966,74.125.24.0-255,5738,121946,1,239967
36795,0.009667,172.31.36.0-255,66,122012,1,239967
36796,0.011699,74.125.24.0-255,5738,127750,1,239967
36797,0.011707,172.31.36.0-255,66,127816,1,239967
36798,0.013719,74.125.24.0-255,5738,133554,1,239967
36799,0.013726,172.31.36.0-255,66,133620,1,239967
36800,0.015787,74.125.24.0-255,5738,139358,1,239967
36801,0.015795,172.31.36.0-255,66,139424,1,239967
36802,0.017846,74.125.24.0-255,5738,145162,1,239967
36803,0.017874,172.31.36.0-255,66,145228,1,239967
36804,0.019912,74.125.24.0-255,5738,150966,1,239967
36805,0.019918,172.31.36.0-255,66,151032,1,239967
36806,0.021938,74.125.24.0-255,5738,156770,1,239967
36807,0.021945,172.31.36.0-255,66,156836,1,239967
36808,0.023973,74.125.24.0-255,5738,162574,1,239967
36809,0.02398,172.31.36.0-255,66,162640,1,239967
36810,0.026004,74.125.24.0-255,5738,168378,1,239967
36811,0.02601,172.31.36.0-255,66,168444,1,239967
36812,0.028065,74.125.24.0-255,5738,174182,1,239967
36813,0.028072,172.31.36.0-255,66,174248,1,239967
36814,0.029148,172.31.36.0-255,172,174420,1,239967
36815,0.029183,172.31.36.0-255,1114,175534,1,239967
36816,0.029215,172.31.36.0-255,1514,177048,1,239967
36817,0.029216,172.31.36.0-255,1514,178562,1,239967
36818,0.029218,172.31.36.0-255,1514,180076,1,239967
36819,0.029219,172.31.36.0-255,1514,181590,1,239967
36820,0.029244,172.31.36.0-255,1491,183081,1,239967
36821,0.030083,74.125.24.0-255,5738,188819,1,239967
36822,0.030089,172.31.36.0-255,66,188885,1,239967
36823,0.030638,104.244.42.0-255,66,188951,1,239967
36824,0.03067,104.244.42.0-255,66,189017,1,239967
36825,0.030739,104.244.42.0-255,66,189083,1,239967
36826,0.032114,74.125.24.0-255,5738,194821,1,239967
36827,0.032121,172.31.36.0-255,66,194887,1,239967
36828,0.034151,74.125.24.0-255,5738,200625,1,239967
36829,0.034158,172.31.36.0-255,66,200691,1,239967
36830,0.036208,74.125.24.0-255,5738,206429,1,239967
36831,0.036214,172.31.36.0-255,66,206495,1,239967
36832,0.038235,74.125.24.0-255,5738,212233,1,239967
36833,0.038257,172.31.36.0-255,66,212299,1,239967
36834,0.040345,74.125.24.0-255,5738,218037,1,239967
36835,0.04035,172.31.36.0-255,66,218103,1,239967
36836,0.042429,74.125.24.0-255,5738,223841,1,239967
36837,0.042435,172.31.36.0-255,66,223907,1,239967
36838,0.044484,74.125.24.0-255,4320,228227,1,239967
36839,0.044489,172.31.36.0-255,66,228293,1,239967
36840,0.044518,74.125.24.0-255,1484,229777,1,239967
36841,0.046536,74.125.24.0-255,4320,234097,1,239967
36842,0.046541,172.31.36.0-255,66,234163,1,239967
36843,0.048599,74.125.24.0-255,5738,239901,1,239967
36844,0.048605,172.31.36.0-255,66,239967,1,239967
36845,0.0,172.217.194.0-255,739,739,1,108878
36846,2.7e-05,172.217.194.0-255,1484,2223,1,108878
36847,3.3e-05,172.31.36.0-255,66,2289,1,108878
36848,4.1e-05,172.217.194.0-255,4320,6609,1,108878
36849,4.4e-05,172.31.36.0-255,66,6675,1,108878
36850,0.000165,172.217.194.0-255,6282,12957,1,108878
36851,0.00017,172.31.36.0-255,66,13023,1,108878
36852,0.000391,172.217.194.0-255,7156,20179,1,108878
36853,0.000396,172.31.36.0-255,66,20245,1,108878
36854,0.000664,172.31.36.0-255,66,20311,1,108878
36855,0.002406,172.217.194.0-255,5738,26049,1,108878
36856,0.002536,172.217.194.0-255,1484,27533,1,108878
36857,0.002956,172.217.194.0-255,5738,33271,1,108878
36858,0.002978,172.217.194.0-255,7156,40427,1,108878
36859,0.002998,172.217.194.0-255,5738,46165,1,108878
36860,0.003621,172.217.194.0-255,5738,51903,1,108878
36861,0.00424,172.217.194.0-255,7156,59059,1,108878
36862,0.005716,172.31.36.0-255,66,59125,1,108878
36863,0.00604,172.31.36.0-255,66,59191,1,108878
36864,0.008108,172.31.36.0-255,66,59257,1,108878
36865,0.008243,172.31.36.0-255,66,59323,1,108878
36866,0.008269,172.31.36.0-255,66,59389,1,108878
36867,0.008761,172.217.194.0-255,6000,65389,1,108878
36868,0.008767,172.31.36.0-255,66,65455,1,108878
36869,0.008924,172.217.194.0-255,5738,71193,1,108878
36870,0.008929,172.31.36.0-255,66,71259,1,108878
36871,0.00895,172.217.194.0-255,6894,78153,1,108878
36872,0.008953,172.31.36.0-255,66,78219,1,108878
36873,0.00929,172.31.36.0-255,66,78285,1,108878
36874,0.009331,172.31.36.0-255,66,78351,1,108878
36875,0.009808,172.217.194.0-255,5356,83707,1,108878
36876,0.009814,172.31.36.0-255,66,83773,1,108878
36877,0.010501,172.31.36.0-255,66,83839,1,108878
36878,0.010674,172.31.36.0-255,66,83905,1,108878
36879,0.011231,172.31.36.0-255,66,83971,1,108878
36880,0.011263,172.217.194.0-255,2902,86873,1,108878
36881,0.011267,172.31.36.0-255,66,86939,1,108878
36882,0.011712,172.31.36.0-255,66,87005,1,108878
36883,0.011738,172.217.194.0-255,5738,92743,1,108878
36884,0.011741,172.31.36.0-255,66,92809,1,108878
36885,0.012233,172.31.36.0-255,66,92875,1,108878
36886,0.012277,172.31.36.0-255,66,92941,1,108878
36887,0.013077,172.31.36.0-255,66,93007,1,108878
36888,0.013107,172.31.36.0-255,66,93073,1,108878
36889,0.013707,172.217.194.0-255,7156,100229,1,108878
36890,0.013713,172.31.36.0-255,66,100295,1,108878
36891,0.013771,172.31.36.0-255,66,100361,1,108878
36892,0.014288,172.31.36.0-255,66,100427,1,108878
36893,0.014342,172.31.36.0-255,66,100493,1,108878
36894,0.014628,172.31.36.0-255,66,100559,1,108878
36895,0.014711,172.31.36.0-255,66,100625,1,108878
36896,0.014993,172.31.36.0-255,66,100691,1,108878
36897,0.015016,172.31.36.0-255,66,100757,1,108878
36898,0.015392,172.31.36.0-255,105,100862,1,108878
36899,0.021269,172.217.194.0-255,66,100928,1,108878
36900,0.039539,172.31.36.0-255,167,101095,1,108878
36901,0.03957,172.31.36.0-255,1147,102242,1,108878
36902,0.03963,172.31.36.0-255,1514,103756,1,108878
36903,0.039631,172.31.36.0-255,1514,105270,1,108878
36904,0.039633,172.31.36.0-255,1514,106784,1,108878
36905,0.039634,172.31.36.0-255,1514,108298,1,108878
36906,0.039635,172.31.36.0-255,316,108614,1,108878
36907,0.041099,104.244.42.0-255,66,108680,1,108878
36908,0.041129,104.244.42.0-255,66,108746,1,108878
36909,0.041183,104.244.42.0-255,66,108812,1,108878
36910,0.041187,104.244.42.0-255,66,108878,1,108878
36911,0.0,172.217.194.0-255,153,153,1,206916
36912,1.8e-05,172.31.36.0-255,66,219,1,206916
36913,2.5e-05,172.217.194.0-255,1484,1703,1,206916
36914,3e-05,172.31.36.0-255,66,1769,1,206916
36915,3.6e-05,172.217.194.0-255,2902,4671,1,206916
36916,4e-05,172.31.36.0-255,66,4737,1,206916
36917,4.8e-05,172.217.194.0-255,7156,11893,1,206916
36918,5.1e-05,172.31.36.0-255,66,11959,1,206916
36919,8.8e-05,172.31.36.0-255,66,12025,1,206916
36920,0.000112,172.217.194.0-255,6339,18364,1,206916
36921,0.000114,172.31.36.0-255,66,18430,1,206916
36922,0.000118,172.217.194.0-255,2543,20973,1,206916
36923,0.000121,172.31.36.0-255,66,21039,1,206916
36924,0.000248,172.217.194.0-255,1484,22523,1,206916
36925,0.000253,172.31.36.0-255,66,22589,1,206916
36926,0.000259,172.217.194.0-255,2902,25491,1,206916
36927,0.000261,172.31.36.0-255,66,25557,1,206916
36928,0.000268,172.217.194.0-255,5738,31295,1,206916
36929,0.000271,172.31.36.0-255,66,31361,1,206916
36930,0.000288,172.217.194.0-255,2902,34263,1,206916
36931,0.000291,172.31.36.0-255,66,34329,1,206916
36932,0.000315,172.31.36.0-255,66,34395,1,206916
36933,0.000327,172.31.36.0-255,66,34461,1,206916
36934,0.000343,172.217.194.0-255,119,34580,1,206916
36935,0.000345,172.31.36.0-255,66,34646,1,206916
36936,0.000511,172.217.194.0-255,381,35027,1,206916
36937,0.000515,172.31.36.0-255,66,35093,1,206916
36938,0.000653,172.217.194.0-255,1484,36577,1,206916
36939,0.000663,172.31.36.0-255,66,36643,1,206916
36940,0.000669,172.217.194.0-255,2902,39545,1,206916
36941,0.000671,172.31.36.0-255,66,39611,1,206916
36942,0.000676,172.217.194.0-255,2902,42513,1,206916
36943,0.000678,172.31.36.0-255,66,42579,1,206916
36944,0.000698,172.217.194.0-255,2902,45481,1,206916
36945,0.000701,172.31.36.0-255,66,45547,1,206916
36946,0.000708,172.217.194.0-255,6246,51793,1,206916
36947,0.00071,172.31.36.0-255,66,51859,1,206916
36948,0.000823,172.217.194.0-255,1484,53343,1,206916
36949,0.000831,172.217.194.0-255,2902,56245,1,206916
36950,0.000834,172.31.36.0-255,66,56311,1,206916
36951,0.000841,172.217.194.0-255,5738,62049,1,206916
36952,0.000844,172.31.36.0-255,66,62115,1,206916
36953,0.000857,172.217.194.0-255,1484,63599,1,206916
36954,0.000876,172.217.194.0-255,5738,69337,1,206916
36955,0.000879,172.31.36.0-255,66,69403,1,206916
36956,0.000893,172.31.36.0-255,66,69469,1,206916
36957,0.00091,172.217.194.0-255,2902,72371,1,206916
36958,0.000912,172.31.36.0-255,66,72437,1,206916
36959,0.000916,172.217.194.0-255,2184,74621,1,206916
36960,0.000918,172.31.36.0-255,66,74687,1,206916
36961,0.001969,172.217.194.0-255,1484,76171,1,206916
36962,0.00198,172.217.194.0-255,2902,79073,1,206916
36963,0.001985,172.31.36.0-255,66,79139,1,206916
36964,0.001995,172.217.194.0-255,5738,84877,1,206916
36965,0.001997,172.31.36.0-255,66,84943,1,206916
36966,0.002,172.217.194.0-255,1484,86427,1,206916
36967,0.002036,172.31.36.0-255,66,86493,1,206916
36968,0.002065,172.31.36.0-255,66,86559,1,206916
36969,0.004349,172.217.194.0-255,5738,92297,1,206916
36970,0.004355,172.31.36.0-255,66,92363,1,206916
36971,0.006684,172.217.194.0-255,5738,98101,1,206916
36972,0.006688,172.31.36.0-255,66,98167,1,206916
36973,0.008987,172.217.194.0-255,5738,103905,1,206916
36974,0.008994,172.31.36.0-255,66,103971,1,206916
36975,0.011346,172.217.194.0-255,5738,109709,1,206916
36976,0.011354,172.31.36.0-255,66,109775,1,206916
36977,0.013707,172.217.194.0-255,5738,115513,1,206916
36978,0.013714,172.31.36.0-255,66,115579,1,206916
36979,0.016038,172.217.194.0-255,5738,121317,1,206916
36980,0.016046,172.31.36.0-255,66,121383,1,206916
36981,0.018369,172.217.194.0-255,5738,127121,1,206916
36982,0.018378,172.31.36.0-255,66,127187,1,206916
36983,0.020685,172.217.194.0-255,5738,132925,1,206916
36984,0.020693,172.31.36.0-255,66,132991,1,206916
36985,0.023012,172.217.194.0-255,5738,138729,1,206916
36986,0.023021,172.31.36.0-255,66,138795,1,206916
36987,0.025316,172.217.194.0-255,5738,144533,1,206916
36988,0.025324,172.31.36.0-255,66,144599,1,206916
36989,0.027643,172.217.194.0-255,5738,150337,1,206916
36990,0.027651,172.31.36.0-255,66,150403,1,206916
36991,0.029032,172.31.36.0-255,164,150567,1,206916
36992,0.029065,172.31.36.0-255,1121,151688,1,206916
36993,0.029122,172.31.36.0-255,1514,153202,1,206916
36994,0.029124,172.31.36.0-255,1280,154482,1,206916
36995,0.029959,172.217.194.0-255,5738,160220,1,206916
36996,0.029966,172.31.36.0-255,66,160286,1,206916
36997,0.030591,104.244.42.0-255,66,160352,1,206916
36998,0.030637,104.244.42.0-255,66,160418,1,206916
36999,0.030702,104.244.42.0-255,66,160484,1,206916
37000,0.032332,172.217.194.0-255,5738,166222,1,206916
37001,0.03234,172.31.36.0-255,66,166288,1,206916
37002,0.03469,172.217.194.0-255,5738,172026,1,206916
37003,0.034696,172.31.36.0-255,66,172092,1,206916
37004,0.036982,172.217.194.0-255,5738,177830,1,206916
37005,0.036989,172.31.36.0-255,66,177896,1,206916
37006,0.039281,172.217.194.0-255,5738,183634,1,206916
37007,0.03929,172.31.36.0-255,66,183700,1,206916
37008,0.041578,172.217.194.0-255,5738,189438,1,206916
37009,0.041585,172.31.36.0-255,66,189504,1,206916
37010,0.043893,172.217.194.0-255,5738,195242,1,206916
37011,0.0439,172.31.36.0-255,66,195308,1,206916
37012,0.046194,172.217.194.0-255,5738,201046,1,206916
37013,0.0462,172.31.36.0-255,66,201112,1,206916
37014,0.0485,172.217.194.0-255,5738,206850,1,206916
37015,0.048505,172.31.36.0-255,66,206916,1,206916
37016,0.0,74.125.24.0-255,152,152,1,197871
37017,2.4e-05,172.31.36.0-255,66,218,1,197871
37018,3.1e-05,74.125.24.0-255,1484,1702,1,197871
37019,3.6e-05,172.31.36.0-255,66,1768,1,197871
37020,5.1e-05,74.125.24.0-255,2902,4670,1,197871
37021,5.5e-05,172.31.36.0-255,66,4736,1,197871
37022,6.2e-05,74.125.24.0-255,5738,10474,1,197871
37023,6.5e-05,172.31.36.0-255,66,10540,1,197871
37024,9.1e-05,74.125.24.0-255,3459,13999,1,197871
37025,9.4e-05,172.31.36.0-255,66,14065,1,197871
37026,0.000105,74.125.24.0-255,4320,18385,1,197871
37027,0.000109,172.31.36.0-255,66,18451,1,197871
37028,0.000144,74.125.24.0-255,5738,24189,1,197871
37029,0.000148,172.31.36.0-255,66,24255,1,197871
37030,0.00018,74.125.24.0-255,2902,27157,1,197871
37031,0.000183,172.31.36.0-255,66,27223,1,197871
37032,0.000201,74.125.24.0-255,3961,31184,1,197871
37033,0.000203,172.31.36.0-255,66,31250,1,197871
37034,0.000299,74.125.24.0-255,1484,32734,1,197871
37035,0.000302,172.31.36.0-255,66,32800,1,197871
37036,0.000308,74.125.24.0-255,2902,35702,1,197871
37037,0.000311,172.31.36.0-255,66,35768,1,197871
37038,0.000314,74.125.24.0-255,1484,37252,1,197871
37039,0.00032,172.31.36.0-255,66,37318,1,197871
37040,0.000348,74.125.24.0-255,2902,40220,1,197871
37041,0.00035,172.31.36.0-255,66,40286,1,197871
37042,0.000354,74.125.24.0-255,1484,41770,1,197871
37043,0.000356,172.31.36.0-255,66,41836,1,197871
37044,0.000395,172.31.36.0-255,66,41902,1,197871
37045,0.000402,74.125.24.0-255,7156,49058,1,197871
37046,0.000405,172.31.36.0-255,66,49124,1,197871
37047,0.000437,172.31.36.0-255,66,49190,1,197871
37048,0.000479,74.125.24.0-255,130,49320,1,197871
37049,0.001085,74.125.24.0-255,349,49669,1,197871
37050,0.001133,172.31.36.0-255,66,49735,1,197871
37051,0.001254,74.125.24.0-255,1484,51219,1,197871
37052,0.001276,74.125.24.0-255,2902,54121,1,197871
37053,0.00128,172.31.36.0-255,66,54187,1,197871
37054,0.001287,74.125.24.0-255,5738,59925,1,197871
37055,0.001289,172.31.36.0-255,66,59991,1,197871
37056,0.001305,172.31.36.0-255,66,60057,1,197871
37057,0.00135,172.31.36.0-255,66,60123,1,197871
37058,0.001356,74.125.24.0-255,5020,65143,1,197871
37059,0.001358,172.31.36.0-255,66,65209,1,197871
37060,0.002272,74.125.24.0-255,1484,66693,1,197871
37061,0.002281,74.125.24.0-255,2902,69595,1,197871
37062,0.002285,172.31.36.0-255,66,69661,1,197871
37063,0.002292,74.125.24.0-255,4320,73981,1,197871
37064,0.002294,172.31.36.0-255,66,74047,1,197871
37065,0.002313,74.125.24.0-255,1484,75531,1,197871
37066,0.004562,74.125.24.0-255,4320,79851,1,197871
37067,0.004566,172.31.36.0-255,66,79917,1,197871
37068,0.006851,74.125.24.0-255,5738,85655,1,197871
37069,0.006858,172.31.36.0-255,66,85721,1,197871
37070,0.009163,74.125.24.0-255,5738,91459,1,197871
37071,0.00917,172.31.36.0-255,66,91525,1,197871
37072,0.011457,74.125.24.0-255,5738,97263,1,197871
37073,0.011466,172.31.36.0-255,66,97329,1,197871
37074,0.013756,74.125.24.0-255,5738,103067,1,197871
37075,0.013764,172.31.36.0-255,66,103133,1,197871
37076,0.016066,74.125.24.0-255,5738,108871,1,197871
37077,0.016076,172.31.36.0-255,66,108937,1,197871
37078,0.018372,74.125.24.0-255,5738,114675,1,197871
37079,0.018381,172.31.36.0-255,66,114741,1,197871
37080,0.020659,74.125.24.0-255,5738,120479,1,197871
37081,0.020666,172.31.36.0-255,66,120545,1,197871
37082,0.022912,74.125.24.0-255,5738,126283,1,197871
37083,0.02292,172.31.36.0-255,66,126349,1,197871
37084,0.02524,74.125.24.0-255,5738,132087,1,197871
37085,0.025248,172.31.36.0-255,66,132153,1,197871
37086,0.02753,74.125.24.0-255,5738,137891,1,197871
37087,0.027538,172.31.36.0-255,66,137957,1,197871
37088,0.029836,74.125.24.0-255,5738,143695,1,197871
37089,0.029844,172.31.36.0-255,66,143761,1,197871
37090,0.032111,74.125.24.0-255,4320,148081,1,197871
37091,0.032117,172.31.36.0-255,66,148147,1,197871
37092,0.032142,74.125.24.0-255,1484,149631,1,197871
37093,0.032398,172.31.36.0-255,172,149803,1,197871
37094,0.032425,172.31.36.0-255,1113,150916,1,197871
37095,0.032482,172.31.36.0-255,1514,152430,1,197871
37096,0.032484,172.31.36.0-255,1514,153944,1,197871
37097,0.032488,172.31.36.0-255,1514,155458,1,197871
37098,0.032489,172.31.36.0-255,1514,156972,1,197871
37099,0.032512,172.31.36.0-255,1491,158463,1,197871
37100,0.033945,104.244.42.0-255,66,158529,1,197871
37101,0.033991,104.244.42.0-255,66,158595,1,197871
37102,0.034104,104.244.42.0-255,66,158661,1,197871
37103,0.034381,74.125.24.0-255,4320,162981,1,197871
37104,0.034386,172.31.36.0-255,66,163047,1,197871
37105,0.036653,74.125.24.0-255,5738,168785,1,197871
37106,0.03666,172.31.36.0-255,66,168851,1,197871
37107,0.038949,74.125.24.0-255,5738,174589,1,197871
37108,0.038956,172.31.36.0-255,66,174655,1,197871
37109,0.041253,74.125.24.0-255,5738,180393,1,197871
37110,0.041259,172.31.36.0-255,66,180459,1,197871
37111,0.043506,74.125.24.0-255,5738,186197,1,197871
37112,0.043513,172.31.36.0-255,66,186263,1,197871
37113,0.045794,74.125.24.0-255,5738,192001,1,197871
37114,0.045801,172.31.36.0-255,66,192067,1,197871
37115,0.048092,74.125.24.0-255,5738,197805,1,197871
37116,0.048098,172.31.36.0-255,66,197871,1,197871
37117,0.0,74.125.24.0-255,148,148,1,244835
37118,3.4e-05,172.31.36.0-255,66,214,1,244835
37119,4.1e-05,74.125.24.0-255,1484,1698,1,244835
37120,4.6e-05,172.31.36.0-255,66,1764,1,244835
37121,5.1e-05,74.125.24.0-255,2902,4666,1,244835
37122,5.5e-05,172.31.36.0-255,66,4732,1,244835
37123,6.3e-05,74.125.24.0-255,7156,11888,1,244835
37124,6.5e-05,172.31.36.0-255,66,11954,1,244835
37125,6.8e-05,74.125.24.0-255,1484,13438,1,244835
37126,7.1e-05,172.31.36.0-255,66,13504,1,244835
37127,0.000108,172.31.36.0-255,66,13570,1,244835
37128,0.000116,74.125.24.0-255,6797,20367,1,244835
37129,0.000118,172.31.36.0-255,66,20433,1,244835
37130,0.000204,74.125.24.0-255,1484,21917,1,244835
37131,0.000208,172.31.36.0-255,66,21983,1,244835
37132,0.000239,74.125.24.0-255,2902,24885,1,244835
37133,0.000242,172.31.36.0-255,66,24951,1,244835
37134,0.000248,74.125.24.0-255,5738,30689,1,244835
37135,0.00025,172.31.36.0-255,66,30755,1,244835
37136,0.000265,172.31.36.0-255,66,30821,1,244835
37137,0.000271,74.125.24.0-255,5738,36559,1,244835
37138,0.000274,172.31.36.0-255,66,36625,1,244835
37139,0.00031,74.125.24.0-255,4305,40930,1,244835
37140,0.000313,172.31.36.0-255,66,40996,1,244835
37141,0.00033,74.125.24.0-255,343,41339,1,244835
37142,0.000332,172.31.36.0-255,66,41405,1,244835
37143,0.0004,74.125.24.0-255,1484,42889,1,244835
37144,0.000404,172.31.36.0-255,66,42955,1,244835
37145,0.000408,74.125.24.0-255,2902,45857,1,244835
37146,0.000411,172.31.36.0-255,66,45923,1,244835
37147,0.000414,74.125.24.0-255,1484,47407,1,244835
37148,0.000436,74.125.24.0-255,4320,51727,1,244835
37149,0.000441,74.125.24.0-255,2902,54629,1,244835
37150,0.00045,172.31.36.0-255,66,54695,1,244835
37151,0.00047,172.31.36.0-255,66,54761,1,244835
37152,0.000485,172.31.36.0-255,66,54827,1,244835
37153,0.000527,74.125.24.0-255,1125,55952,1,244835
37154,0.000956,74.125.24.0-255,1484,57436,1,244835
37155,0.000962,172.31.36.0-255,66,57502,1,244835
37156,0.000967,74.125.24.0-255,2902,60404,1,244835
37157,0.00097,172.31.36.0-255,66,60470,1,244835
37158,0.000976,74.125.24.0-255,5738,66208,1,244835
37159,0.000981,172.31.36.0-255,66,66274,1,244835
37160,0.001009,172.31.36.0-255,66,66340,1,244835
37161,0.001021,74.125.24.0-255,2902,69242,1,244835
37162,0.001024,74.125.24.0-255,1484,70726,1,244835
37163,0.001024,172.31.36.0-255,66,70792,1,244835
37164,0.001027,74.125.24.0-255,2902,73694,1,244835
37165,0.00103,74.125.24.0-255,1484,75178,1,244835
37166,0.001042,172.31.36.0-255,66,75244,1,244835
37167,0.00105,74.125.24.0-255,4320,79564,1,244835
37168,0.001053,74.125.24.0-255,766,80330,1,244835
37169,0.001059,172.31.36.0-255,66,80396,1,244835
37170,0.001096,74.125.24.0-255,1484,81880,1,244835
37171,0.00111,74.125.24.0-255,4320,86200,1,244835
37172,0.001116,172.31.36.0-255,66,86266,1,244835
37173,0.001136,74.125.24.0-255,7156,93422,1,244835
37174,0.001142,172.31.36.0-255,66,93488,1,244835
37175,0.001169,172.31.36.0-255,66,93554,1,244835
37176,0.001195,74.125.24.0-255,7156,100710,1,244835
37177,0.001199,172.31.36.0-255,66,100776,1,244835
37178,0.001201,74.125.24.0-255,5020,105796,1,244835
37179,0.001217,74.125.24.0-255,1484,107280,1,244835
37180,0.001221,172.31.36.0-255,66,107346,1,244835
37181,0.001242,74.125.24.0-255,2902,110248,1,244835
37182,0.001246,172.31.36.0-255,66,110314,1,244835
37183,0.001248,74.125.24.0-255,5738,116052,1,244835
37184,0.001263,172.31.36.0-255,66,116118,1,244835
37185,0.001272,74.125.24.0-255,5738,121856,1,244835
37186,0.001278,172.31.36.0-255,66,121922,1,244835
37187,0.001288,74.125.24.0-255,7156,129078,1,244835
37188,0.001292,172.31.36.0-255,66,129144,1,244835
37189,0.001344,74.125.24.0-255,4320,133464,1,244835
37190,0.001355,172.31.36.0-255,66,133530,1,244835
37191,0.00136,74.125.24.0-255,6438,139968,1,244835
37192,0.001368,172.31.36.0-255,66,140034,1,244835
37193,0.001373,74.125.24.0-255,1484,141518,1,244835
37194,0.001398,74.125.24.0-255,2902,144420,1,244835
37195,0.001405,74.125.24.0-255,5738,150158,1,244835
37196,0.00141,172.31.36.0-255,66,150224,1,244835
37197,0.001475,172.31.36.0-255,66,150290,1,244835
37198,0.001484,74.125.24.0-255,4320,154610,1,244835
37199,0.001492,172.31.36.0-255,66,154676,1,244835
37200,0.001511,172.31.36.0-255,66,154742,1,244835
37201,0.001559,74.125.24.0-255,1484,156226,1,244835
37202,0.001565,74.125.24.0-255,2902,159128,1,244835
37203,0.001577,74.125.24.0-255,1484,160612,1,244835
37204,0.001578,172.31.36.0-255,66,160678,1,244835
37205,0.00159,74.125.24.0-255,4320,164998,1,244835
37206,0.001593,74.125.24.0-255,1484,166482,1,244835
37207,0.001594,172.31.36.0-255,66,166548,1,244835
37208,0.001624,74.125.24.0-255,5738,172286,1,244835
37209,0.00165,74.125.24.0-255,5738,178024,1,244835
37210,0.00167,74.125.24.0-255,1484,179508,1,244835
37211,0.001673,74.125.24.0-255,1484,180992,1,244835
37212,0.001686,74.125.24.0-255,1484,182476,1,244835
37213,0.001692,74.125.24.0-255,4320,186796,1,244835
37214,0.001706,74.125.24.0-255,1484,188280,1,244835
37215,0.001748,74.125.24.0-255,1484,189764,1,244835
37216,0.001754,74.125.24.0-255,7156,196920,1,244835
37217,0.00177,74.125.24.0-255,4320,201240,1,244835
37218,0.001836,74.125.24.0-255,3602,204842,1,244835
37219,0.001841,74.125.24.0-255,4320,209162,1,244835
37220,0.001857,74.125.24.0-255,7156,216318,1,244835
37221,0.001871,74.125.24.0-255,2902,219220,1,244835
37222,0.001958,74.125.24.0-255,7156,226376,1,244835
37223,0.002028,74.125.24.0-255,7156,233532,1,244835
37224,0.002043,74.125.24.0-255,6786,240318,1,244835
37225,0.002046,74.125.24.0-255,105,240423,1,244835
37226,0.0058,172.31.36.0-255,66,240489,1,244835
37227,0.008045,172.31.36.0-255,105,240594,1,244835
37228,0.010336,74.125.24.0-255,66,240660,1,244835
37229,0.027643,172.31.36.0-255,172,240832,1,244835
37230,0.027673,172.31.36.0-255,1114,241946,1,244835
37231,0.027716,172.31.36.0-255,1514,243460,1,244835
37232,0.027718,172.31.36.0-255,1177,244637,1,244835
37233,0.029131,104.244.42.0-255,66,244703,1,244835
37234,0.029155,104.244.42.0-255,66,244769,1,244835
37235,0.029212,104.244.42.0-255,66,244835,1,244835
37236,0.0,172.217.194.0-255,152,152,1,149976
37237,3.3e-05,172.31.36.0-255,66,218,1,149976
37238,4.1e-05,172.217.194.0-255,1484,1702,1,149976
37239,4.5e-05,172.31.36.0-255,66,1768,1,149976
37240,5e-05,172.217.194.0-255,2902,4670,1,149976
37241,5.3e-05,172.31.36.0-255,66,4736,1,149976
37242,6e-05,172.217.194.0-255,5738,10474,1,149976
37243,6.3e-05,172.31.36.0-255,66,10540,1,149976
37244,6.8e-05,172.217.194.0-255,4320,14860,1,149976
37245,7.1e-05,172.31.36.0-255,66,14926,1,149976
37246,0.000106,172.31.36.0-255,66,14992,1,149976
37247,0.00011,172.217.194.0-255,1484,16476,1,149976
37248,0.000112,172.31.36.0-255,66,16542,1,149976
37249,0.000126,172.217.194.0-255,4320,20862,1,149976
37250,0.000129,172.31.36.0-255,66,20928,1,149976
37251,0.00015,172.217.194.0-255,1125,22053,1,149976
37252,0.000152,172.31.36.0-255,66,22119,1,149976
37253,0.0002,172.217.194.0-255,1484,23603,1,149976
37254,0.000203,172.31.36.0-255,66,23669,1,149976
37255,0.000209,172.217.194.0-255,2902,26571,1,149976
37256,0.000212,172.31.36.0-255,66,26637,1,149976
37257,0.000238,172.217.194.0-255,5738,32375,1,149976
37258,0.00024,172.31.36.0-255,66,32441,1,149976
37259,0.000267,172.217.194.0-255,4320,36761,1,149976
37260,0.00027,172.31.36.0-255,66,36827,1,149976
37261,0.000289,172.217.194.0-255,2543,39370,1,149976
37262,0.000295,172.31.36.0-255,66,39436,1,149976
37263,0.000305,172.217.194.0-255,1484,40920,1,149976
37264,0.000307,172.31.36.0-255,66,40986,1,149976
37265,0.000311,172.217.194.0-255,2902,43888,1,149976
37266,0.000314,172.31.36.0-255,66,43954,1,149976
37267,0.000317,172.217.194.0-255,1484,45438,1,149976
37268,0.000342,172.217.194.0-255,4320,49758,1,149976
37269,0.000346,172.31.36.0-255,66,49824,1,149976
37270,0.000353,172.217.194.0-255,5738,55562,1,149976
37271,0.000356,172.31.36.0-255,66,55628,1,149976
37272,0.000391,172.217.194.0-255,1413,57041,1,149976
37273,0.000534,172.217.194.0-255,366,57407,1,149976
37274,0.000538,172.31.36.0-255,66,57473,1,149976
37275,0.000929,172.217.194.0-255,1484,58957,1,149976
37276,0.000939,172.217.194.0-255,2902,61859,1,149976
37277,0.000943,172.31.36.0-255,66,61925,1,149976
37278,0.000949,172.217.194.0-255,2902,64827,1,149976
37279,0.000951,172.31.36.0-255,66,64893,1,149976
37280,0.000967,172.217.194.0-255,2902,67795,1,149976
37281,0.00097,172.31.36.0-255,66,67861,1,149976
37282,0.000973,172.217.194.0-255,1484,69345,1,149976
37283,0.000984,172.31.36.0-255,66,69411,1,149976
37284,0.001011,172.217.194.0-255,4320,73731,1,149976
37285,0.001015,172.31.36.0-255,66,73797,1,149976
37286,0.001044,172.31.36.0-255,66,73863,1,149976
37287,0.001111,172.217.194.0-255,1484,75347,1,149976
37288,0.001116,172.217.194.0-255,2902,78249,1,149976
37289,0.001119,172.31.36.0-255,66,78315,1,149976
37290,0.001125,172.217.194.0-255,4320,82635,1,149976
37291,0.001127,172.31.36.0-255,66,82701,1,149976
37292,0.001139,172.217.194.0-255,1484,84185,1,149976
37293,0.001161,172.217.194.0-255,4320,88505,1,149976
37294,0.001165,172.31.36.0-255,66,88571,1,149976
37295,0.001193,172.31.36.0-255,66,88637,1,149976
37296,0.001206,172.31.36.0-255,66,88703,1,149976
37297,0.001229,172.31.36.0-255,66,88769,1,149976
37298,0.001273,172.31.36.0-255,66,88835,1,149976
37299,0.001284,172.31.36.0-255,66,88901,1,149976
37300,0.00131,172.217.194.0-255,1484,90385,1,149976
37301,0.001329,172.217.194.0-255,2902,93287,1,149976
37302,0.001332,172.31.36.0-255,66,93353,1,149976
37303,0.001339,172.217.194.0-255,5738,99091,1,149976
37304,0.001341,172.31.36.0-255,66,99157,1,149976
37305,0.001405,172.31.36.0-255,66,99223,1,149976
37306,0.001424,172.217.194.0-255,2902,102125,1,149976
37307,0.001427,172.31.36.0-255,66,102191,1,149976
37308,0.00144,172.31.36.0-255,66,102257,1,149976
37309,0.001454,172.31.36.0-255,66,102323,1,149976
37310,0.001467,172.31.36.0-255,66,102389,1,149976
37311,0.001483,172.217.194.0-255,2902,105291,1,149976
37312,0.001485,172.31.36.0-255,66,105357,1,149976
37313,0.001488,172.217.194.0-255,1484,106841,1,149976
37314,0.00152,172.31.36.0-255,66,106907,1,149976
37315,0.001526,172.217.194.0-255,5738,112645,1,149976
37316,0.001528,172.31.36.0-255,66,112711,1,149976
37317,0.001562,172.31.36.0-255,66,112777,1,149976
37318,0.001572,172.31.36.0-255,66,112843,1,149976
37319,0.001592,172.217.194.0-255,1484,114327,1,149976
37320,0.001608,172.217.194.0-255,5738,120065,1,149976
37321,0.00161,172.31.36.0-255,66,120131,1,149976
37322,0.00164,172.31.36.0-255,66,120197,1,149976
37323,0.001646,172.217.194.0-255,5738,125935,1,149976
37324,0.001649,172.31.36.0-255,66,126001,1,149976
37325,0.001691,172.31.36.0-255,66,126067,1,149976
37326,0.001697,172.217.194.0-255,4320,130387,1,149976
37327,0.001699,172.31.36.0-255,66,130453,1,149976
37328,0.001731,172.31.36.0-255,66,130519,1,149976
37329,0.001736,172.217.194.0-255,2902,133421,1,149976
37330,0.001738,172.31.36.0-255,66,133487,1,149976
37331,0.001856,172.217.194.0-255,5738,139225,1,149976
37332,0.001927,172.217.194.0-255,1379,140604,1,149976
37333,0.00193,172.217.194.0-255,105,140709,1,149976
37334,0.00287,172.31.36.0-255,66,140775,1,149976
37335,0.010208,172.31.36.0-255,105,140880,1,149976
37336,0.012472,172.217.194.0-255,66,140946,1,149976
37337,0.04336,172.31.36.0-255,172,141118,1,149976
37338,0.043393,172.31.36.0-255,1114,142232,1,149976
37339,0.043438,172.31.36.0-255,1514,143746,1,149976
37340,0.04344,172.31.36.0-255,1514,145260,1,149976
37341,0.043441,172.31.36.0-255,1514,146774,1,149976
37342,0.043442,172.31.36.0-255,1514,148288,1,149976
37343,0.043469,172.31.36.0-255,1490,149778,1,149976
37344,0.044889,104.244.42.0-255,66,149844,1,149976
37345,0.045035,104.244.42.0-255,66,149910,1,149976
37346,0.045041,104.244.42.0-255,66,149976,1,149976
37347,0.0,74.125.24.0-255,153,153,1,238105
37348,2.5e-05,172.31.36.0-255,66,219,1,238105
37349,3.3e-05,74.125.24.0-255,1484,1703,1,238105
37350,3.7e-05,172.31.36.0-255,66,1769,1,238105
37351,4.3e-05,74.125.24.0-255,2902,4671,1,238105
37352,4.7e-05,172.31.36.0-255,66,4737,1,238105
37353,5.5e-05,74.125.24.0-255,7156,11893,1,238105
37354,5.9e-05,172.31.36.0-255,66,11959,1,238105
37355,9.7e-05,74.125.24.0-255,2048,14007,1,238105
37356,0.0001,172.31.36.0-255,66,14073,1,238105
37357,0.000165,74.125.24.0-255,1484,15557,1,238105
37358,0.000168,172.31.36.0-255,66,15623,1,238105
37359,0.000182,74.125.24.0-255,2902,18525,1,238105
37360,0.000184,172.31.36.0-255,66,18591,1,238105
37361,0.000191,74.125.24.0-255,5738,24329,1,238105
37362,0.000193,172.31.36.0-255,66,24395,1,238105
37363,0.000198,74.125.24.0-255,2902,27297,1,238105
37364,0.000201,172.31.36.0-255,66,27363,1,238105
37365,0.000221,74.125.24.0-255,3961,31324,1,238105
37366,0.000225,172.31.36.0-255,66,31390,1,238105
37367,0.000318,74.125.24.0-255,1484,32874,1,238105
37368,0.000322,172.31.36.0-255,66,32940,1,238105
37369,0.000328,74.125.24.0-255,2902,35842,1,238105
37370,0.00033,172.31.36.0-255,66,35908,1,238105
37371,0.000352,74.125.24.0-255,5738,41646,1,238105
37372,0.000355,172.31.36.0-255,66,41712,1,238105
37373,0.000396,172.31.36.0-255,66,41778,1,238105
37374,0.000407,172.31.36.0-255,66,41844,1,238105
37375,0.000447,74.125.24.0-255,1125,42969,1,238105
37376,0.000449,172.31.36.0-255,66,43035,1,238105
37377,0.000477,74.125.24.0-255,400,43435,1,238105
37378,0.000503,74.125.24.0-255,109,43544,1,238105
37379,0.000525,74.125.24.0-255,331,43875,1,238105
37380,0.000839,74.125.24.0-255,1484,45359,1,238105
37381,0.000843,172.31.36.0-255,66,45425,1,238105
37382,0.00085,74.125.24.0-255,2902,48327,1,238105
37383,0.000852,172.31.36.0-255,66,48393,1,238105
37384,0.000859,74.125.24.0-255,5738,54131,1,238105
37385,0.000861,172.31.36.0-255,66,54197,1,238105
37386,0.000903,172.31.36.0-255,66,54263,1,238105
37387,0.000924,172.31.36.0-255,66,54329,1,238105
37388,0.000936,74.125.24.0-255,2184,56513,1,238105
37389,0.000938,172.31.36.0-255,66,56579,1,238105
37390,0.001283,74.125.24.0-255,1484,58063,1,238105
37391,0.001289,74.125.24.0-255,2902,60965,1,238105
37392,0.001292,172.31.36.0-255,66,61031,1,238105
37393,0.001296,74.125.24.0-255,1484,62515,1,238105
37394,0.001312,74.125.24.0-255,4320,66835,1,238105
37395,0.001314,172.31.36.0-255,66,66901,1,238105
37396,0.001321,74.125.24.0-255,5738,72639,1,238105
37397,0.001323,172.31.36.0-255,66,72705,1,238105
37398,0.001347,74.125.24.0-255,7156,79861,1,238105
37399,0.001349,172.31.36.0-255,66,79927,1,238105
37400,0.001368,74.125.24.0-255,5738,85665,1,238105
37401,0.00137,172.31.36.0-255,66,85731,1,238105
37402,0.001385,74.125.24.0-255,5020,90751,1,238105
37403,0.001388,172.31.36.0-255,66,90817,1,238105
37404,0.002275,74.125.24.0-255,1484,92301,1,238105
37405,0.002285,74.125.24.0-255,2902,95203,1,238105
37406,0.00229,172.31.36.0-255,66,95269,1,238105
37407,0.0023,74.125.24.0-255,5738,101007,1,238105
37408,0.002302,172.31.36.0-255,66,101073,1,238105
37409,0.002337,172.31.36.0-255,66,101139,1,238105
37410,0.00235,172.31.36.0-255,66,101205,1,238105
37411,0.002369,74.125.24.0-255,5020,106225,1,238105
37412,0.002371,172.31.36.0-255,66,106291,1,238105
37413,0.002394,74.125.24.0-255,5738,112029,1,238105
37414,0.002397,172.31.36.0-255,66,112095,1,238105
37415,0.0024,74.125.24.0-255,1484,113579,1,238105
37416,0.002427,172.31.36.0-255,66,113645,1,238105
37417,0.002431,74.125.24.0-255,1484,115129,1,238105
37418,0.002486,74.125.24.0-255,7156,122285,1,238105
37419,0.00249,172.31.36.0-255,66,122351,1,238105
37420,0.002516,74.125.24.0-255,6438,128789,1,238105
37421,0.002519,172.31.36.0-255,66,128855,1,238105
37422,0.002535,74.125.24.0-255,1484,130339,1,238105
37423,0.002563,74.125.24.0-255,5738,136077,1,238105
37424,0.007498,172.31.36.0-255,66,136143,1,238105
37425,0.010015,74.125.24.0-255,5738,141881,1,238105
37426,0.010023,172.31.36.0-255,66,141947,1,238105
37427,0.012544,74.125.24.0-255,5738,147685,1,238105
37428,0.012552,172.31.36.0-255,66,147751,1,238105
37429,0.015049,74.125.24.0-255,5738,153489,1,238105
37430,0.015059,172.31.36.0-255,66,153555,1,238105
37431,0.017574,74.125.24.0-255,5738,159293,1,238105
37432,0.017583,172.31.36.0-255,66,159359,1,238105
37433,0.020105,74.125.24.0-255,5738,165097,1,238105
37434,0.020112,172.31.36.0-255,66,165163,1,238105
37435,0.022614,74.125.24.0-255,5738,170901,1,238105
37436,0.02262,172.31.36.0-255,66,170967,1,238105
37437,0.025131,74.125.24.0-255,5738,176705,1,238105
37438,0.025139,172.31.36.0-255,66,176771,1,238105
37439,0.027634,74.125.24.0-255,5738,182509,1,238105
37440,0.027643,172.31.36.0-255,66,182575,1,238105
37441,0.030151,74.125.24.0-255,5738,188313,1,238105
37442,0.030158,172.31.36.0-255,66,188379,1,238105
37443,0.032657,74.125.24.0-255,5738,194117,1,238105
37444,0.032666,172.31.36.0-255,66,194183,1,238105
37445,0.035212,74.125.24.0-255,5738,199921,1,238105
37446,0.035221,172.31.36.0-255,66,199987,1,238105
37447,0.037708,74.125.24.0-255,5738,205725,1,238105
37448,0.037721,172.31.36.0-255,66,205791,1,238105
37449,0.038743,172.31.36.0-255,172,205963,1,238105
37450,0.038776,172.31.36.0-255,1114,207077,1,238105
37451,0.03884,172.31.36.0-255,1514,208591,1,238105
37452,0.038842,172.31.36.0-255,1514,210105,1,238105
37453,0.038848,172.31.36.0-255,1514,211619,1,238105
37454,0.038849,172.31.36.0-255,1514,213133,1,238105
37455,0.038867,172.31.36.0-255,1492,214625,1,238105
37456,0.040208,74.125.24.0-255,5738,220363,1,238105
37457,0.040219,172.31.36.0-255,66,220429,1,238105
37458,0.040254,104.244.42.0-255,66,220495,1,238105
37459,0.040302,104.244.42.0-255,66,220561,1,238105
37460,0.040404,104.244.42.0-255,66,220627,1,238105
37461,0.04041,104.244.42.0-255,66,220693,1,238105
37462,0.04273,74.125.24.0-255,5738,226431,1,238105
37463,0.042737,172.31.36.0-255,66,226497,1,238105
37464,0.045252,74.125.24.0-255,5738,232235,1,238105
37465,0.045258,172.31.36.0-255,66,232301,1,238105
37466,0.047732,74.125.24.0-255,5738,238039,1,238105
37467,0.047739,172.31.36.0-255,66,238105,1,238105
37468,0.0,74.125.130.0-255,153,153,1,261855
37469,1.4e-05,172.31.36.0-255,66,219,1,261855
37470,2.2e-05,74.125.130.0-255,1484,1703,1,261855
37471,2.5e-05,172.31.36.0-255,66,1769,1,261855
37472,2.9e-05,74.125.130.0-255,1484,3253,1,261855
37473,3.1e-05,172.31.36.0-255,66,3319,1,261855
37474,4.6e-05,74.125.130.0-255,2902,6221,1,261855
37475,5e-05,172.31.36.0-255,66,6287,1,261855
37476,5.7e-05,74.125.130.0-255,5738,12025,1,261855
37477,6e-05,172.31.36.0-255,66,12091,1,261855
37478,8.6e-05,74.125.130.0-255,4918,17009,1,261855
37479,9.3e-05,172.31.36.0-255,66,17075,1,261855
37480,0.0001,74.125.130.0-255,5738,22813,1,261855
37481,0.000103,172.31.36.0-255,66,22879,1,261855
37482,0.000136,74.125.130.0-255,5738,28617,1,261855
37483,0.000138,172.31.36.0-255,66,28683,1,261855
37484,0.000153,74.125.130.0-255,2543,31226,1,261855
37485,0.000157,172.31.36.0-255,66,31292,1,261855
37486,0.00031,74.125.130.0-255,1484,32776,1,261855
37487,0.000315,172.31.36.0-255,66,32842,1,261855
37488,0.000345,74.125.130.0-255,2902,35744,1,261855
37489,0.000349,172.31.36.0-255,66,35810,1,261855
37490,0.000351,74.125.130.0-255,1484,37294,1,261855
37491,0.000353,172.31.36.0-255,66,37360,1,261855
37492,0.000358,74.125.130.0-255,2902,40262,1,261855
37493,0.000365,172.31.36.0-255,66,40328,1,261855
37494,0.000372,74.125.130.0-255,5738,46066,1,261855
37495,0.000376,172.31.36.0-255,66,46132,1,261855
37496,0.000407,74.125.130.0-255,2543,48675,1,261855
37497,0.00041,172.31.36.0-255,66,48741,1,261855
37498,0.000414,74.125.130.0-255,2902,51643,1,261855
37499,0.000416,172.31.36.0-255,66,51709,1,261855
37500,0.000422,74.125.130.0-255,4320,56029,1,261855
37501,0.000439,74.125.130.0-255,2902,58931,1,261855
37502,0.000449,74.125.130.0-255,5738,64669,1,261855
37503,0.000481,74.125.130.0-255,1379,66048,1,261855
37504,0.000538,172.31.36.0-255,66,66114,1,261855
37505,0.000572,74.125.130.0-255,117,66231,1,261855
37506,0.00059,74.125.130.0-255,380,66611,1,261855
37507,0.000994,74.125.130.0-255,1484,68095,1,261855
37508,0.000999,74.125.130.0-255,2902,70997,1,261855
37509,0.001004,172.31.36.0-255,66,71063,1,261855
37510,0.001015,74.125.130.0-255,2902,73965,1,261855
37511,0.00103,74.125.130.0-255,2902,76867,1,261855
37512,0.001032,74.125.130.0-255,1484,78351,1,261855
37513,0.001036,172.31.36.0-255,66,78417,1,261855
37514,0.001067,74.125.130.0-255,2902,81319,1,261855
37515,0.001087,172.31.36.0-255,66,81385,1,261855
37516,0.001107,74.125.130.0-255,5738,87123,1,261855
37517,0.00111,74.125.130.0-255,1484,88607,1,261855
37518,0.001128,74.125.130.0-255,5738,94345,1,261855
37519,0.00115,172.31.36.0-255,66,94411,1,261855
37520,0.001158,74.125.130.0-255,6438,100849,1,261855
37521,0.001175,172.31.36.0-255,66,100915,1,261855
37522,0.001903,74.125.130.0-255,1484,102399,1,261855
37523,0.001914,74.125.130.0-255,2902,105301,1,261855
37524,0.001919,172.31.36.0-255,66,105367,1,261855
37525,0.001953,74.125.130.0-255,5738,111105,1,261855
37526,0.001958,74.125.130.0-255,2902,114007,1,261855
37527,0.001964,74.125.130.0-255,4320,118327,1,261855
37528,0.001978,74.125.130.0-255,1484,119811,1,261855
37529,0.001995,74.125.130.0-255,7156,126967,1,261855
37530,0.001998,74.125.130.0-255,1484,128451,1,261855
37531,0.002015,74.125.130.0-255,4320,132771,1,261855
37532,0.002046,74.125.130.0-255,2184,134955,1,261855
37533,0.002169,74.125.130.0-255,1484,136439,1,261855
37534,0.002176,74.125.130.0-255,2902,139341,1,261855
37535,0.002179,74.125.130.0-255,1484,140825,1,261855
37536,0.002199,74.125.130.0-255,4320,145145,1,261855
37537,0.002202,74.125.130.0-255,1484,146629,1,261855
37538,0.002311,74.125.130.0-255,1484,148113,1,261855
37539,0.006713,172.31.36.0-255,66,148179,1,261855
37540,0.009007,74.125.130.0-255,5738,153917,1,261855
37541,0.009015,172.31.36.0-255,66,153983,1,261855
37542,0.011329,74.125.130.0-255,5738,159721,1,261855
37543,0.011338,172.31.36.0-255,66,159787,1,261855
37544,0.013642,74.125.130.0-255,5738,165525,1,261855
37545,0.01365,172.31.36.0-255,66,165591,1,261855
37546,0.015944,74.125.130.0-255,5738,171329,1,261855
37547,0.015953,172.31.36.0-255,66,171395,1,261855
37548,0.018261,74.125.130.0-255,5738,177133,1,261855
37549,0.018272,172.31.36.0-255,66,177199,1,261855
37550,0.02059,74.125.130.0-255,5738,182937,1,261855
37551,0.020604,172.31.36.0-255,66,183003,1,261855
37552,0.022899,74.125.130.0-255,5738,188741,1,261855
37553,0.022913,172.31.36.0-255,66,188807,1,261855
37554,0.025217,74.125.130.0-255,5738,194545,1,261855
37555,0.025228,172.31.36.0-255,66,194611,1,261855
37556,0.027516,74.125.130.0-255,5738,200349,1,261855
37557,0.027521,172.31.36.0-255,66,200415,1,261855
37558,0.029818,74.125.130.0-255,5738,206153,1,261855
37559,0.029828,172.31.36.0-255,66,206219,1,261855
37560,0.032117,74.125.130.0-255,5738,211957,1,261855
37561,0.032124,172.31.36.0-255,66,212023,1,261855
37562,0.034412,74.125.130.0-255,5738,217761,1,261855
37563,0.034421,172.31.36.0-255,66,217827,1,261855
37564,0.036538,172.31.36.0-255,172,217999,1,261855
37565,0.03657,172.31.36.0-255,1114,219113,1,261855
37566,0.036638,172.31.36.0-255,1514,220627,1,261855
37567,0.036644,172.31.36.0-255,1514,222141,1,261855
37568,0.036645,172.31.36.0-255,1514,223655,1,261855
37569,0.036647,172.31.36.0-255,1514,225169,1,261855
37570,0.036675,172.31.36.0-255,1490,226659,1,261855
37571,0.036718,74.125.130.0-255,5738,232397,1,261855
37572,0.036723,172.31.36.0-255,66,232463,1,261855
37573,0.038107,104.244.42.0-255,66,232529,1,261855
37574,0.038116,104.244.42.0-255,66,232595,1,261855
37575,0.038205,104.244.42.0-255,66,232661,1,261855
37576,0.039012,74.125.130.0-255,5738,238399,1,261855
37577,0.039023,172.31.36.0-255,66,238465,1,261855
37578,0.039436,104.244.42.0-255,108,238573,1,261855
37579,0.039445,172.31.36.0-255,66,238639,1,261855
37580,0.041302,74.125.130.0-255,5738,244377,1,261855
37581,0.041309,172.31.36.0-255,66,244443,1,261855
37582,0.043591,74.125.130.0-255,5738,250181,1,261855
37583,0.043598,172.31.36.0-255,66,250247,1,261855
37584,0.045889,74.125.130.0-255,5738,255985,1,261855
37585,0.045896,172.31.36.0-255,66,256051,1,261855
37586,0.048187,74.125.130.0-255,5738,261789,1,261855
37587,0.048194,172.31.36.0-255,66,261855,1,261855
37588,0.0,74.125.24.0-255,153,153,1,253924
37589,1.1e-05,172.31.36.0-255,66,219,1,253924
37590,3.1e-05,74.125.24.0-255,1484,1703,1,253924
37591,3.5e-05,172.31.36.0-255,66,1769,1,253924
37592,4.1e-05,74.125.24.0-255,2902,4671,1,253924
37593,4.3e-05,172.31.36.0-255,66,4737,1,253924
37594,4.7e-05,74.125.24.0-255,1484,6221,1,253924
37595,5e-05,172.31.36.0-255,66,6287,1,253924
37596,8.4e-05,74.125.24.0-255,5738,12025,1,253924
37597,8.7e-05,172.31.36.0-255,66,12091,1,253924
37598,9.1e-05,74.125.24.0-255,1988,14079,1,253924
37599,9.3e-05,172.31.36.0-255,66,14145,1,253924
37600,0.000107,172.31.36.0-255,66,14211,1,253924
37601,0.000169,172.31.36.0-255,66,14277,1,253924
37602,0.000186,172.31.36.0-255,66,14343,1,253924
37603,0.000192,74.125.24.0-255,4270,18613,1,253924
37604,0.000194,172.31.36.0-255,66,18679,1,253924
37605,0.000411,74.125.24.0-255,109,18788,1,253924
37606,0.000417,172.31.36.0-255,66,18854,1,253924
37607,0.00063,74.125.24.0-255,1484,20338,1,253924
37608,0.000634,172.31.36.0-255,66,20404,1,253924
37609,0.000639,74.125.24.0-255,2902,23306,1,253924
37610,0.000642,172.31.36.0-255,66,23372,1,253924
37611,0.000662,74.125.24.0-255,5738,29110,1,253924
37612,0.000664,172.31.36.0-255,66,29176,1,253924
37613,0.000695,74.125.24.0-255,7156,36332,1,253924
37614,0.000698,172.31.36.0-255,66,36398,1,253924
37615,0.000705,74.125.24.0-255,5738,42136,1,253924
37616,0.000707,172.31.36.0-255,66,42202,1,253924
37617,0.00071,74.125.24.0-255,1484,43686,1,253924
37618,0.000739,74.125.24.0-255,5738,49424,1,253924
37619,0.000741,172.31.36.0-255,66,49490,1,253924
37620,0.00076,74.125.24.0-255,3602,53092,1,253924
37621,0.000763,172.31.36.0-255,66,53158,1,253924
37622,0.001101,74.125.24.0-255,1484,54642,1,253924
37623,0.001124,74.125.24.0-255,2902,57544,1,253924
37624,0.001128,172.31.36.0-255,66,57610,1,253924
37625,0.001135,74.125.24.0-255,4320,61930,1,253924
37626,0.001137,172.31.36.0-255,66,61996,1,253924
37627,0.001149,74.125.24.0-255,1484,63480,1,253924
37628,0.001155,74.125.24.0-255,4320,67800,1,253924
37629,0.001158,172.31.36.0-255,66,67866,1,253924
37630,0.001187,74.125.24.0-255,1484,69350,1,253924
37631,0.001196,74.125.24.0-255,7156,76506,1,253924
37632,0.001198,172.31.36.0-255,66,76572,1,253924
37633,0.001204,74.125.24.0-255,4320,80892,1,253924
37634,0.001207,172.31.36.0-255,66,80958,1,253924
37635,0.001233,74.125.24.0-255,5738,86696,1,253924
37636,0.001236,172.31.36.0-255,66,86762,1,253924
37637,0.001239,74.125.24.0-255,766,87528,1,253924
37638,0.001525,74.125.24.0-255,1484,89012,1,253924
37639,0.00153,172.31.36.0-255,66,89078,1,253924
37640,0.001535,74.125.24.0-255,2902,91980,1,253924
37641,0.001537,172.31.36.0-255,66,92046,1,253924
37642,0.001563,74.125.24.0-255,5738,97784,1,253924
37643,0.001566,172.31.36.0-255,66,97850,1,253924
37644,0.00157,74.125.24.0-255,1484,99334,1,253924
37645,0.00159,74.125.24.0-255,5738,105072,1,253924
37646,0.001592,172.31.36.0-255,66,105138,1,253924
37647,0.001633,172.31.36.0-255,66,105204,1,253924
37648,0.001637,74.125.24.0-255,2184,107388,1,253924
37649,0.001639,172.31.36.0-255,66,107454,1,253924
37650,0.001989,74.125.24.0-255,1484,108938,1,253924
37651,0.001995,74.125.24.0-255,2902,111840,1,253924
37652,0.001998,172.31.36.0-255,66,111906,1,253924
37653,0.002022,74.125.24.0-255,5738,117644,1,253924
37654,0.002026,172.31.36.0-255,66,117710,1,253924
37655,0.00205,74.125.24.0-255,7156,124866,1,253924
37656,0.002053,172.31.36.0-255,66,124932,1,253924
37657,0.002086,172.31.36.0-255,66,124998,1,253924
37658,0.00216,172.31.36.0-255,66,125064,1,253924
37659,0.002178,74.125.24.0-255,2184,127248,1,253924
37660,0.002181,172.31.36.0-255,66,127314,1,253924
37661,0.002187,74.125.24.0-255,4320,131634,1,253924
37662,0.002189,172.31.36.0-255,66,131700,1,253924
37663,0.002206,172.31.36.0-255,66,131766,1,253924
37664,0.002257,172.31.36.0-255,66,131832,1,253924
37665,0.002262,74.125.24.0-255,2902,134734,1,253924
37666,0.002265,172.31.36.0-255,66,134800,1,253924
37667,0.002297,172.31.36.0-255,66,134866,1,253924
37668,0.0023,74.125.24.0-255,766,135632,1,253924
37669,0.002333,74.125.24.0-255,5738,141370,1,253924
37670,0.002335,172.31.36.0-255,66,141436,1,253924
37671,0.00237,172.31.36.0-255,66,141502,1,253924
37672,0.002383,172.31.36.0-255,66,141568,1,253924
37673,0.002408,172.31.36.0-255,66,141634,1,253924
37674,0.002412,74.125.24.0-255,1484,143118,1,253924
37675,0.004772,74.125.24.0-255,4320,147438,1,253924
37676,0.004781,172.31.36.0-255,66,147504,1,253924
37677,0.00715,74.125.24.0-255,5738,153242,1,253924
37678,0.007156,172.31.36.0-255,66,153308,1,253924
37679,0.009509,74.125.24.0-255,5738,159046,1,253924
37680,0.009517,172.31.36.0-255,66,159112,1,253924
37681,0.011923,74.125.24.0-255,5738,164850,1,253924
37682,0.011944,172.31.36.0-255,66,164916,1,253924
37683,0.014324,74.125.24.0-255,5738,170654,1,253924
37684,0.014334,172.31.36.0-255,66,170720,1,253924
37685,0.01672,74.125.24.0-255,5738,176458,1,253924
37686,0.016737,172.31.36.0-255,66,176524,1,253924
37687,0.019117,74.125.24.0-255,5738,182262,1,253924
37688,0.01913,172.31.36.0-255,66,182328,1,253924
37689,0.021501,74.125.24.0-255,5738,188066,1,253924
37690,0.021509,172.31.36.0-255,66,188132,1,253924
37691,0.02388,74.125.24.0-255,5738,193870,1,253924
37692,0.023886,172.31.36.0-255,66,193936,1,253924
37693,0.02625,74.125.24.0-255,5738,199674,1,253924
37694,0.02626,172.31.36.0-255,66,199740,1,253924
37695,0.028628,74.125.24.0-255,5738,205478,1,253924
37696,0.028637,172.31.36.0-255,66,205544,1,253924
37697,0.030988,74.125.24.0-255,5738,211282,1,253924
37698,0.030996,172.31.36.0-255,66,211348,1,253924
37699,0.033382,74.125.24.0-255,5738,217086,1,253924
37700,0.033395,172.31.36.0-255,66,217152,1,253924
37701,0.035778,74.125.24.0-255,5738,222890,1,253924
37702,0.035786,172.31.36.0-255,66,222956,1,253924
37703,0.038164,74.125.24.0-255,5738,228694,1,253924
37704,0.038171,172.31.36.0-255,66,228760,1,253924
37705,0.040535,74.125.24.0-255,5738,234498,1,253924
37706,0.040546,172.31.36.0-255,66,234564,1,253924
37707,0.042939,74.125.24.0-255,5738,240302,1,253924
37708,0.042945,172.31.36.0-255,66,240368,1,253924
37709,0.045315,74.125.24.0-255,4418,244786,1,253924
37710,0.045325,172.31.36.0-255,66,244852,1,253924
37711,0.045537,172.31.36.0-255,105,244957,1,253924
37712,0.047895,74.125.24.0-255,66,245023,1,253924
37713,0.048428,172.31.36.0-255,176,245199,1,253924
37714,0.048459,172.31.36.0-255,1114,246313,1,253924
37715,0.048529,172.31.36.0-255,1514,247827,1,253924
37716,0.048531,172.31.36.0-255,1514,249341,1,253924
37717,0.048532,172.31.36.0-255,1514,250855,1,253924
37718,0.048533,172.31.36.0-255,1514,252369,1,253924
37719,0.048559,172.31.36.0-255,1489,253858,1,253924
37720,0.049968,104.244.42.0-255,66,253924,1,253924
37721,0.0,172.217.194.0-255,153,153,1,262075
37722,3.2e-05,172.31.36.0-255,66,219,1,262075
37723,3.9e-05,172.217.194.0-255,1484,1703,1,262075
37724,4.4e-05,172.31.36.0-255,66,1769,1,262075
37725,4.8e-05,172.217.194.0-255,2902,4671,1,262075
37726,5.1e-05,172.31.36.0-255,66,4737,1,262075
37727,5.8e-05,172.217.194.0-255,7156,11893,1,262075
37728,6.1e-05,172.31.36.0-255,66,11959,1,262075
37729,8.8e-05,172.217.194.0-255,2108,14067,1,262075
37730,9.1e-05,172.31.36.0-255,66,14133,1,262075
37731,0.000113,172.217.194.0-255,2902,17035,1,262075
37732,0.000115,172.31.36.0-255,66,17101,1,262075
37733,0.000122,172.217.194.0-255,7156,24257,1,262075
37734,0.000124,172.31.36.0-255,66,24323,1,262075
37735,0.000151,172.217.194.0-255,6797,31120,1,262075
37736,0.000155,172.31.36.0-255,66,31186,1,262075
37737,0.000187,172.217.194.0-255,1484,32670,1,262075
37738,0.00019,172.31.36.0-255,66,32736,1,262075
37739,0.000194,172.217.194.0-255,1484,34220,1,262075
37740,0.000196,172.31.36.0-255,66,34286,1,262075
37741,0.000208,172.217.194.0-255,1484,35770,1,262075
37742,0.00021,172.31.36.0-255,66,35836,1,262075
37743,0.000218,172.217.194.0-255,5738,41574,1,262075
37744,0.000221,172.31.36.0-255,66,41640,1,262075
37745,0.000247,172.217.194.0-255,6797,48437,1,262075
37746,0.00025,172.31.36.0-255,66,48503,1,262075
37747,0.000286,172.217.194.0-255,1484,49987,1,262075
37748,0.000289,172.31.36.0-255,66,50053,1,262075
37749,0.000294,172.217.194.0-255,2902,52955,1,262075
37750,0.000296,172.31.36.0-255,66,53021,1,262075
37751,0.000309,172.217.194.0-255,1484,54505,1,262075
37752,0.000312,172.31.36.0-255,66,54571,1,262075
37753,0.000338,172.217.194.0-255,4320,58891,1,262075
37754,0.000341,172.31.36.0-255,66,58957,1,262075
37755,0.00035,172.217.194.0-255,6797,65754,1,262075
37756,0.000352,172.31.36.0-255,66,65820,1,262075
37757,0.000369,172.217.194.0-255,363,66183,1,262075
37758,0.000373,172.217.194.0-255,382,66565,1,262075
37759,0.000554,172.217.194.0-255,1484,68049,1,262075
37760,0.000558,172.31.36.0-255,66,68115,1,262075
37761,0.000562,172.217.194.0-255,1484,69599,1,262075
37762,0.000579,172.217.194.0-255,1484,71083,1,262075
37763,0.000582,172.31.36.0-255,66,71149,1,262075
37764,0.000589,172.217.194.0-255,5738,76887,1,262075
37765,0.000592,172.31.36.0-255,66,76953,1,262075
37766,0.000596,172.217.194.0-255,2902,79855,1,262075
37767,0.000599,172.31.36.0-255,66,79921,1,262075
37768,0.000627,172.217.194.0-255,3961,83882,1,262075
37769,0.00063,172.31.36.0-255,66,83948,1,262075
37770,0.000673,172.217.194.0-255,2902,86850,1,262075
37771,0.000679,172.31.36.0-255,66,86916,1,262075
37772,0.000689,172.217.194.0-255,5738,92654,1,262075
37773,0.000692,172.31.36.0-255,66,92720,1,262075
37774,0.000713,172.31.36.0-255,66,92786,1,262075
37775,0.001011,172.217.194.0-255,1484,94270,1,262075
37776,0.001026,172.217.194.0-255,2902,97172,1,262075
37777,0.001029,172.31.36.0-255,66,97238,1,262075
37778,0.001036,172.217.194.0-255,5738,102976,1,262075
37779,0.001038,172.31.36.0-255,66,103042,1,262075
37780,0.001054,172.217.194.0-255,1484,104526,1,262075
37781,0.001068,172.217.194.0-255,4320,108846,1,262075
37782,0.001071,172.31.36.0-255,66,108912,1,262075
37783,0.001093,172.217.194.0-255,1484,110396,1,262075
37784,0.001108,172.31.36.0-255,66,110462,1,262075
37785,0.001113,172.217.194.0-255,2184,112646,1,262075
37786,0.001115,172.31.36.0-255,66,112712,1,262075
37787,0.00179,172.217.194.0-255,1484,114196,1,262075
37788,0.001811,172.217.194.0-255,2902,117098,1,262075
37789,0.001816,172.31.36.0-255,66,117164,1,262075
37790,0.001823,172.217.194.0-255,2902,120066,1,262075
37791,0.001825,172.31.36.0-255,66,120132,1,262075
37792,0.001838,172.217.194.0-255,2902,123034,1,262075
37793,0.00184,172.31.36.0-255,66,123100,1,262075
37794,0.001845,172.217.194.0-255,2902,126002,1,262075
37795,0.001847,172.31.36.0-255,66,126068,1,262075
37796,0.001881,172.31.36.0-255,66,126134,1,262075
37797,0.0019,172.217.194.0-255,1484,127618,1,262075
37798,0.001906,172.217.194.0-255,4320,131938,1,262075
37799,0.001908,172.31.36.0-255,66,132004,1,262075
37800,0.001931,172.217.194.0-255,6438,138442,1,262075
37801,0.001933,172.31.36.0-255,66,138508,1,262075
37802,0.002074,172.217.194.0-255,1484,139992,1,262075
37803,0.002077,172.217.194.0-255,1484,141476,1,262075
37804,0.002079,172.31.36.0-255,66,141542,1,262075
37805,0.002094,172.217.194.0-255,1484,143026,1,262075
37806,0.002096,172.217.194.0-255,1484,144510,1,262075
37807,0.002098,172.31.36.0-255,66,144576,1,262075
37808,0.002127,172.217.194.0-255,4320,148896,1,262075
37809,0.002129,172.31.36.0-255,66,148962,1,262075
37810,0.002142,172.31.36.0-255,66,149028,1,262075
37811,0.002152,172.31.36.0-255,66,149094,1,262075
37812,0.002172,172.217.194.0-255,766,149860,1,262075
37813,0.004672,172.217.194.0-255,4320,154180,1,262075
37814,0.004676,172.31.36.0-255,66,154246,1,262075
37815,0.007209,172.217.194.0-255,5738,159984,1,262075
37816,0.007215,172.31.36.0-255,66,160050,1,262075
37817,0.009718,172.217.194.0-255,5738,165788,1,262075
37818,0.009726,172.31.36.0-255,66,165854,1,262075
37819,0.012255,172.217.194.0-255,5738,171592,1,262075
37820,0.012263,172.31.36.0-255,66,171658,1,262075
37821,0.014795,172.217.194.0-255,5738,177396,1,262075
37822,0.014806,172.31.36.0-255,66,177462,1,262075
37823,0.017288,172.217.194.0-255,5738,183200,1,262075
37824,0.017301,172.31.36.0-255,66,183266,1,262075
37825,0.019781,172.217.194.0-255,5738,189004,1,262075
37826,0.019788,172.31.36.0-255,66,189070,1,262075
37827,0.022326,172.217.194.0-255,5738,194808,1,262075
37828,0.022333,172.31.36.0-255,66,194874,1,262075
37829,0.02487,172.217.194.0-255,5738,200612,1,262075
37830,0.024877,172.31.36.0-255,66,200678,1,262075
37831,0.027384,172.217.194.0-255,5738,206416,1,262075
37832,0.027394,172.31.36.0-255,66,206482,1,262075
37833,0.029928,172.217.194.0-255,5738,212220,1,262075
37834,0.029935,172.31.36.0-255,66,212286,1,262075
37835,0.032475,172.217.194.0-255,5738,218024,1,262075
37836,0.032485,172.31.36.0-255,66,218090,1,262075
37837,0.035036,172.217.194.0-255,5738,223828,1,262075
37838,0.035046,172.31.36.0-255,66,223894,1,262075
37839,0.037542,172.217.194.0-255,5738,229632,1,262075
37840,0.037546,172.31.36.0-255,172,229804,1,262075
37841,0.037549,172.31.36.0-255,66,229870,1,262075
37842,0.037576,172.31.36.0-255,1114,230984,1,262075
37843,0.037624,172.31.36.0-255,1514,232498,1,262075
37844,0.037626,172.31.36.0-255,1514,234012,1,262075
37845,0.037627,172.31.36.0-255,1514,235526,1,262075
37846,0.037628,172.31.36.0-255,1514,237040,1,262075
37847,0.037672,172.31.36.0-255,1489,238529,1,262075
37848,0.039099,104.244.42.0-255,66,238595,1,262075
37849,0.039172,104.244.42.0-255,66,238661,1,262075
37850,0.039225,104.244.42.0-255,66,238727,1,262075
37851,0.040052,172.217.194.0-255,2902,241629,1,262075
37852,0.040074,172.31.36.0-255,66,241695,1,262075
37853,0.040093,172.217.194.0-255,2902,244597,1,262075
37854,0.040097,172.31.36.0-255,66,244663,1,262075
37855,0.042585,172.217.194.0-255,5738,250401,1,262075
37856,0.042591,172.31.36.0-255,66,250467,1,262075
37857,0.045126,172.217.194.0-255,5738,256205,1,262075
37858,0.045131,172.31.36.0-255,66,256271,1,262075
37859,0.047669,172.217.194.0-255,5738,262009,1,262075
37860,0.047674,172.31.36.0-255,66,262075,1,262075
37861,0.0,74.125.24.0-255,153,153,1,244532
37862,2.7e-05,172.31.36.0-255,66,219,1,244532
37863,3.3e-05,74.125.24.0-255,1484,1703,1,244532
37864,3.7e-05,172.31.36.0-255,66,1769,1,244532
37865,4.2e-05,74.125.24.0-255,2902,4671,1,244532
37866,4.4e-05,172.31.36.0-255,66,4737,1,244532
37867,5.1e-05,74.125.24.0-255,7156,11893,1,244532
37868,5.4e-05,172.31.36.0-255,66,11959,1,244532
37869,5.7e-05,74.125.24.0-255,2067,14026,1,244532
37870,5.9e-05,172.31.36.0-255,66,14092,1,244532
37871,0.000108,74.125.24.0-255,1484,15576,1,244532
37872,0.000111,172.31.36.0-255,66,15642,1,244532
37873,0.000117,74.125.24.0-255,2902,18544,1,244532
37874,0.000119,172.31.36.0-255,66,18610,1,244532
37875,0.000148,74.125.24.0-255,5738,24348,1,244532
37876,0.000152,172.31.36.0-255,66,24414,1,244532
37877,0.000169,74.125.24.0-255,5738,30152,1,244532
37878,0.000172,172.31.36.0-255,66,30218,1,244532
37879,0.000187,74.125.24.0-255,1125,31343,1,244532
37880,0.000189,172.31.36.0-255,66,31409,1,244532
37881,0.000364,74.125.24.0-255,1484,32893,1,244532
37882,0.000369,172.31.36.0-255,66,32959,1,244532
37883,0.000374,74.125.24.0-255,2902,35861,1,244532
37884,0.000377,172.31.36.0-255,66,35927,1,244532
37885,0.000406,74.125.24.0-255,5738,41665,1,244532
37886,0.00041,172.31.36.0-255,66,41731,1,244532
37887,0.000412,74.125.24.0-255,1484,43215,1,244532
37888,0.000414,172.31.36.0-255,66,43281,1,244532
37889,0.000462,74.125.24.0-255,4320,47601,1,244532
37890,0.000466,172.31.36.0-255,66,47667,1,244532
37891,0.00048,74.125.24.0-255,1125,48792,1,244532
37892,0.000483,172.31.36.0-255,66,48858,1,244532
37893,0.001534,74.125.24.0-255,1484,50342,1,244532
37894,0.001546,74.125.24.0-255,2902,53244,1,244532
37895,0.00155,172.31.36.0-255,66,53310,1,244532
37896,0.001557,74.125.24.0-255,5738,59048,1,244532
37897,0.001558,172.31.36.0-255,66,59114,1,244532
37898,0.001591,74.125.24.0-255,4320,63434,1,244532
37899,0.001605,74.125.24.0-255,2543,65977,1,244532
37900,0.001611,74.125.24.0-255,7156,73133,1,244532
37901,0.001639,74.125.24.0-255,2902,76035,1,244532
37902,0.001676,74.125.24.0-255,1484,77519,1,244532
37903,0.001715,74.125.24.0-255,2902,80421,1,244532
37904,0.001732,74.125.24.0-255,6797,87218,1,244532
37905,0.001737,74.125.24.0-255,4320,91538,1,244532
37906,0.00175,74.125.24.0-255,5738,97276,1,244532
37907,0.001777,74.125.24.0-255,3961,101237,1,244532
37908,0.001865,74.125.24.0-255,1484,102721,1,244532
37909,0.001884,74.125.24.0-255,2902,105623,1,244532
37910,0.001888,74.125.24.0-255,2902,108525,1,244532
37911,0.001903,74.125.24.0-255,2902,111427,1,244532
37912,0.001905,74.125.24.0-255,1484,112911,1,244532
37913,0.001933,74.125.24.0-255,4320,117231,1,244532
37914,0.001978,74.125.24.0-255,1484,118715,1,244532
37915,0.00199,74.125.24.0-255,2902,121617,1,244532
37916,0.002022,74.125.24.0-255,3412,125029,1,244532
37917,0.003524,172.31.36.0-255,66,125095,1,244532
37918,0.005863,74.125.24.0-255,5738,130833,1,244532
37919,0.005869,172.31.36.0-255,66,130899,1,244532
37920,0.008227,74.125.24.0-255,5738,136637,1,244532
37921,0.008234,172.31.36.0-255,66,136703,1,244532
37922,0.010599,74.125.24.0-255,5738,142441,1,244532
37923,0.010606,172.31.36.0-255,66,142507,1,244532
37924,0.012968,74.125.24.0-255,5738,148245,1,244532
37925,0.012974,172.31.36.0-255,66,148311,1,244532
37926,0.015315,74.125.24.0-255,5738,154049,1,244532
37927,0.015322,172.31.36.0-255,66,154115,1,244532
37928,0.017667,74.125.24.0-255,5738,159853,1,244532
37929,0.017678,172.31.36.0-255,66,159919,1,244532
37930,0.020083,74.125.24.0-255,5738,165657,1,244532
37931,0.020091,172.31.36.0-255,66,165723,1,244532
37932,0.022406,74.125.24.0-255,5738,171461,1,244532
37933,0.022414,172.31.36.0-255,66,171527,1,244532
37934,0.024766,74.125.24.0-255,5738,177265,1,244532
37935,0.024772,172.31.36.0-255,66,177331,1,244532
37936,0.027165,74.125.24.0-255,5738,183069,1,244532
37937,0.027172,172.31.36.0-255,66,183135,1,244532
37938,0.029524,74.125.24.0-255,5738,188873,1,244532
37939,0.02953,172.31.36.0-255,66,188939,1,244532
37940,0.031908,74.125.24.0-255,5738,194677,1,244532
37941,0.031916,172.31.36.0-255,66,194743,1,244532
37942,0.034102,172.31.36.0-255,172,194915,1,244532
37943,0.034132,172.31.36.0-255,1113,196028,1,244532
37944,0.034178,172.31.36.0-255,1514,197542,1,244532
37945,0.03418,172.31.36.0-255,1514,199056,1,244532
37946,0.034181,172.31.36.0-255,1514,200570,1,244532
37947,0.034187,172.31.36.0-255,1514,202084,1,244532
37948,0.034188,172.31.36.0-255,1490,203574,1,244532
37949,0.034233,74.125.24.0-255,5738,209312,1,244532
37950,0.034237,172.31.36.0-255,66,209378,1,244532
37951,0.035669,104.244.42.0-255,66,209444,1,244532
37952,0.035677,104.244.42.0-255,66,209510,1,244532
37953,0.035777,104.244.42.0-255,66,209576,1,244532
37954,0.036603,74.125.24.0-255,5738,215314,1,244532
37955,0.036611,172.31.36.0-255,66,215380,1,244532
37956,0.038991,74.125.24.0-255,5738,221118,1,244532
37957,0.038996,172.31.36.0-255,66,221184,1,244532
37958,0.041386,74.125.24.0-255,5738,226922,1,244532
37959,0.041408,172.31.36.0-255,66,226988,1,244532
37960,0.04376,74.125.24.0-255,5738,232726,1,244532
37961,0.043765,172.31.36.0-255,66,232792,1,244532
37962,0.046083,74.125.24.0-255,2902,235694,1,244532
37963,0.046089,172.31.36.0-255,66,235760,1,244532
37964,0.046122,74.125.24.0-255,2902,238662,1,244532
37965,0.046125,172.31.36.0-255,66,238728,1,244532
37966,0.048435,74.125.24.0-255,5738,244466,1,244532
37967,0.048441,172.31.36.0-255,66,244532,1,244532
37968,0.0,172.217.194.0-255,146,146,1,255266
37969,2.3e-05,172.31.36.0-255,66,212,1,255266
37970,3.1e-05,172.217.194.0-255,1484,1696,1,255266
37971,3.6e-05,172.31.36.0-255,66,1762,1,255266
37972,4.2e-05,172.217.194.0-255,2902,4664,1,255266
37973,4.5e-05,172.31.36.0-255,66,4730,1,255266
37974,5.2e-05,172.217.194.0-255,7156,11886,1,255266
37975,5.5e-05,172.31.36.0-255,66,11952,1,255266
37976,6e-05,172.217.194.0-255,2004,13956,1,255266
37977,6.3e-05,172.31.36.0-255,66,14022,1,255266
37978,9.9e-05,172.217.194.0-255,1484,15506,1,255266
37979,0.000102,172.31.36.0-255,66,15572,1,255266
37980,0.000108,172.217.194.0-255,2902,18474,1,255266
37981,0.000111,172.31.36.0-255,66,18540,1,255266
37982,0.000116,172.217.194.0-255,4320,22860,1,255266
37983,0.000119,172.31.36.0-255,66,22926,1,255266
37984,0.000147,172.217.194.0-255,1484,24410,1,255266
37985,0.000149,172.31.36.0-255,66,24476,1,255266
37986,0.000156,172.217.194.0-255,6797,31273,1,255266
37987,0.000158,172.31.36.0-255,66,31339,1,255266
37988,0.000191,172.217.194.0-255,1484,32823,1,255266
37989,0.000193,172.31.36.0-255,66,32889,1,255266
37990,0.000207,172.217.194.0-255,2902,35791,1,255266
37991,0.000209,172.31.36.0-255,66,35857,1,255266
37992,0.000212,172.217.194.0-255,1484,37341,1,255266
37993,0.000213,172.31.36.0-255,66,37407,1,255266
37994,0.000234,172.217.194.0-255,4320,41727,1,255266
37995,0.000236,172.31.36.0-255,66,41793,1,255266
37996,0.000242,172.217.194.0-255,5738,47531,1,255266
37997,0.000244,172.31.36.0-255,66,47597,1,255266
37998,0.000277,172.217.194.0-255,1125,48722,1,255266
37999,0.00028,172.31.36.0-255,66,48788,1,255266
38000,0.000295,172.217.194.0-255,1484,50272,1,255266
38001,0.000299,172.217.194.0-255,1484,51756,1,255266
38002,0.000301,172.31.36.0-255,66,51822,1,255266
38003,0.000319,172.217.194.0-255,2902,54724,1,255266
38004,0.000322,172.31.36.0-255,66,54790,1,255266
38005,0.000349,172.31.36.0-255,66,54856,1,255266
38006,0.000352,172.217.194.0-255,1421,56277,1,255266
38007,0.000425,172.217.194.0-255,382,56659,1,255266
38008,0.000428,172.31.36.0-255,66,56725,1,255266
38009,0.000756,172.217.194.0-255,1484,58209,1,255266
38010,0.000763,172.217.194.0-255,2902,61111,1,255266
38011,0.000767,172.31.36.0-255,66,61177,1,255266
38012,0.000772,172.217.194.0-255,2902,64079,1,255266
38013,0.000774,172.31.36.0-255,66,64145,1,255266
38014,0.00079,172.217.194.0-255,2902,67047,1,255266
38015,0.000792,172.31.36.0-255,66,67113,1,255266
38016,0.000796,172.217.194.0-255,1484,68597,1,255266
38017,0.000835,172.31.36.0-255,66,68663,1,255266
38018,0.000848,172.31.36.0-255,66,68729,1,255266
38019,0.001323,172.217.194.0-255,1484,70213,1,255266
38020,0.00133,172.217.194.0-255,2902,73115,1,255266
38021,0.001334,172.31.36.0-255,66,73181,1,255266
38022,0.001341,172.217.194.0-255,5738,78919,1,255266
38023,0.001343,172.31.36.0-255,66,78985,1,255266
38024,0.001364,172.217.194.0-255,1484,80469,1,255266
38025,0.001398,172.31.36.0-255,66,80535,1,255266
38026,0.001402,172.217.194.0-255,1484,82019,1,255266
38027,0.001454,172.31.36.0-255,66,82085,1,255266
38028,0.001466,172.31.36.0-255,66,82151,1,255266
38029,0.001469,172.217.194.0-255,1484,83635,1,255266
38030,0.001496,172.31.36.0-255,66,83701,1,255266
38031,0.001515,172.217.194.0-255,4320,88021,1,255266
38032,0.001517,172.31.36.0-255,66,88087,1,255266
38033,0.001522,172.217.194.0-255,2902,90989,1,255266
38034,0.001524,172.31.36.0-255,66,91055,1,255266
38035,0.001538,172.217.194.0-255,3602,94657,1,255266
38036,0.001541,172.31.36.0-255,66,94723,1,255266
38037,0.001915,172.217.194.0-255,1484,96207,1,255266
38038,0.00192,172.217.194.0-255,1484,97691,1,255266
38039,0.001923,172.31.36.0-255,66,97757,1,255266
38040,0.001942,172.217.194.0-255,1484,99241,1,255266
38041,0.001947,172.217.194.0-255,2902,102143,1,255266
38042,0.001949,172.31.36.0-255,66,102209,1,255266
38043,0.001969,172.217.194.0-255,2902,105111,1,255266
38044,0.001972,172.31.36.0-255,66,105177,1,255266
38045,0.001985,172.31.36.0-255,66,105243,1,255266
38046,0.001989,172.217.194.0-255,1484,106727,1,255266
38047,0.002024,172.31.36.0-255,66,106793,1,255266
38048,0.004057,172.217.194.0-255,5738,112531,1,255266
38049,0.004064,172.31.36.0-255,66,112597,1,255266
38050,0.006017,172.217.194.0-255,5738,118335,1,255266
38051,0.006021,172.31.36.0-255,66,118401,1,255266
38052,0.007984,172.217.194.0-255,5738,124139,1,255266
38053,0.00799,172.31.36.0-255,66,124205,1,255266
38054,0.00994,172.217.194.0-255,5738,129943,1,255266
38055,0.009947,172.31.36.0-255,66,130009,1,255266
38056,0.011917,172.217.194.0-255,5738,135747,1,255266
38057,0.011926,172.31.36.0-255,66,135813,1,255266
38058,0.013891,172.217.194.0-255,5738,141551,1,255266
38059,0.013899,172.31.36.0-255,66,141617,1,255266
38060,0.015888,172.217.194.0-255,5738,147355,1,255266
38061,0.015896,172.31.36.0-255,66,147421,1,255266
38062,0.017871,172.217.194.0-255,5738,153159,1,255266
38063,0.01788,172.31.36.0-255,66,153225,1,255266
38064,0.019861,172.217.194.0-255,5738,158963,1,255266
38065,0.019868,172.31.36.0-255,66,159029,1,255266
38066,0.021835,172.217.194.0-255,5738,164767,1,255266
38067,0.021845,172.31.36.0-255,66,164833,1,255266
38068,0.023811,172.217.194.0-255,5738,170571,1,255266
38069,0.023818,172.31.36.0-255,66,170637,1,255266
38070,0.025786,172.217.194.0-255,5738,176375,1,255266
38071,0.025795,172.31.36.0-255,66,176441,1,255266
38072,0.027765,172.217.194.0-255,5738,182179,1,255266
38073,0.027773,172.31.36.0-255,66,182245,1,255266
38074,0.029745,172.217.194.0-255,5738,187983,1,255266
38075,0.029753,172.31.36.0-255,66,188049,1,255266
38076,0.031707,172.217.194.0-255,5738,193787,1,255266
38077,0.031716,172.31.36.0-255,66,193853,1,255266
38078,0.03369,172.217.194.0-255,5738,199591,1,255266
38079,0.033699,172.31.36.0-255,66,199657,1,255266
38080,0.035644,172.217.194.0-255,5738,205395,1,255266
38081,0.035652,172.31.36.0-255,66,205461,1,255266
38082,0.037635,172.217.194.0-255,5738,211199,1,255266
38083,0.037644,172.31.36.0-255,66,211265,1,255266
38084,0.039672,172.217.194.0-255,5738,217003,1,255266
38085,0.03968,172.31.36.0-255,66,217069,1,255266
38086,0.040873,172.31.36.0-255,188,217257,1,255266
38087,0.040908,172.31.36.0-255,958,218215,1,255266
38088,0.041013,172.31.36.0-255,1514,219729,1,255266
38089,0.041015,172.31.36.0-255,1514,221243,1,255266
38090,0.041016,172.31.36.0-255,1514,222757,1,255266
38091,0.041017,172.31.36.0-255,1514,224271,1,255266
38092,0.041049,172.31.36.0-255,1514,225785,1,255266
38093,0.04105,172.31.36.0-255,197,225982,1,255266
38094,0.041668,172.217.194.0-255,5738,231720,1,255266
38095,0.041678,172.31.36.0-255,66,231786,1,255266
38096,0.042459,104.244.42.0-255,66,231852,1,255266
38097,0.042468,104.244.42.0-255,66,231918,1,255266
38098,0.042623,104.244.42.0-255,66,231984,1,255266
38099,0.04263,104.244.42.0-255,66,232050,1,255266
38100,0.043637,172.217.194.0-255,5738,237788,1,255266
38101,0.043644,172.31.36.0-255,66,237854,1,255266
38102,0.045621,172.217.194.0-255,5738,243592,1,255266
38103,0.045628,172.31.36.0-255,66,243658,1,255266
38104,0.047598,172.217.194.0-255,5738,249396,1,255266
38105,0.047605,172.31.36.0-255,66,249462,1,255266
38106,0.049564,172.217.194.0-255,5738,255200,1,255266
38107,0.04957,172.31.36.0-255,66,255266,1,255266
38108,0.0,172.217.194.0-255,319,319,1,220503
38109,2.4e-05,172.31.36.0-255,66,385,1,220503
38110,3.1e-05,172.217.194.0-255,1484,1869,1,220503
38111,3.6e-05,172.31.36.0-255,66,1935,1,220503
38112,4.2e-05,172.217.194.0-255,4320,6255,1,220503
38113,4.5e-05,172.31.36.0-255,66,6321,1,220503
38114,6.5e-05,172.31.36.0-255,66,6387,1,220503
38115,9.7e-05,172.217.194.0-255,1484,7871,1,220503
38116,0.0001,172.31.36.0-255,66,7937,1,220503
38117,0.000105,172.217.194.0-255,2902,10839,1,220503
38118,0.000107,172.31.36.0-255,66,10905,1,220503
38119,0.000111,172.217.194.0-255,1484,12389,1,220503
38120,0.000118,172.31.36.0-255,66,12455,1,220503
38121,0.000147,172.217.194.0-255,4320,16775,1,220503
38122,0.00015,172.31.36.0-255,66,16841,1,220503
38123,0.000158,172.217.194.0-255,6797,23638,1,220503
38124,0.000164,172.31.36.0-255,66,23704,1,220503
38125,0.00019,172.217.194.0-255,4320,28024,1,220503
38126,0.000192,172.31.36.0-255,66,28090,1,220503
38127,0.000218,172.217.194.0-255,2902,30992,1,220503
38128,0.000221,172.31.36.0-255,66,31058,1,220503
38129,0.000228,172.217.194.0-255,5738,36796,1,220503
38130,0.000231,172.31.36.0-255,66,36862,1,220503
38131,0.000271,172.217.194.0-255,3961,40823,1,220503
38132,0.000273,172.31.36.0-255,66,40889,1,220503
38133,0.001761,172.217.194.0-255,1484,42373,1,220503
38134,0.001769,172.31.36.0-255,66,42439,1,220503
38135,0.001779,172.217.194.0-255,2902,45341,1,220503
38136,0.001782,172.31.36.0-255,66,45407,1,220503
38137,0.001788,172.217.194.0-255,5738,51145,1,220503
38138,0.00179,172.31.36.0-255,66,51211,1,220503
38139,0.00182,172.217.194.0-255,5738,56949,1,220503
38140,0.001822,172.31.36.0-255,66,57015,1,220503
38141,0.001856,172.217.194.0-255,1125,58140,1,220503
38142,0.001882,172.217.194.0-255,1484,59624,1,220503
38143,0.001885,172.31.36.0-255,66,59690,1,220503
38144,0.001888,172.217.194.0-255,1484,61174,1,220503
38145,0.00192,172.217.194.0-255,1484,62658,1,220503
38146,0.001923,172.31.36.0-255,66,62724,1,220503
38147,0.001931,172.217.194.0-255,5738,68462,1,220503
38148,0.001933,172.31.36.0-255,66,68528,1,220503
38149,0.001945,172.217.194.0-255,6797,75325,1,220503
38150,0.001947,172.31.36.0-255,66,75391,1,220503
38151,0.00195,172.217.194.0-255,646,76037,1,220503
38152,0.002263,172.217.194.0-255,1484,77521,1,220503
38153,0.002269,172.31.36.0-255,66,77587,1,220503
38154,0.002275,172.217.194.0-255,2902,80489,1,220503
38155,0.002277,172.31.36.0-255,66,80555,1,220503
38156,0.002289,172.217.194.0-255,5738,86293,1,220503
38157,0.002292,172.31.36.0-255,66,86359,1,220503
38158,0.002317,172.217.194.0-255,1484,87843,1,220503
38159,0.002338,172.217.194.0-255,5379,93222,1,220503
38160,0.002341,172.31.36.0-255,66,93288,1,220503
38161,0.004653,172.217.194.0-255,5738,99026,1,220503
38162,0.00466,172.31.36.0-255,66,99092,1,220503
38163,0.006964,172.217.194.0-255,5738,104830,1,220503
38164,0.006969,172.31.36.0-255,66,104896,1,220503
38165,0.009283,172.217.194.0-255,5738,110634,1,220503
38166,0.009291,172.31.36.0-255,66,110700,1,220503
38167,0.01162,172.217.194.0-255,5738,116438,1,220503
38168,0.01163,172.31.36.0-255,66,116504,1,220503
38169,0.013965,172.217.194.0-255,5738,122242,1,220503
38170,0.013975,172.31.36.0-255,66,122308,1,220503
38171,0.016277,172.217.194.0-255,5738,128046,1,220503
38172,0.016285,172.31.36.0-255,66,128112,1,220503
38173,0.018584,172.217.194.0-255,5738,133850,1,220503
38174,0.018594,172.31.36.0-255,66,133916,1,220503
38175,0.020911,172.217.194.0-255,5738,139654,1,220503
38176,0.020921,172.31.36.0-255,66,139720,1,220503
38177,0.023211,172.217.194.0-255,5738,145458,1,220503
38178,0.023218,172.31.36.0-255,66,145524,1,220503
38179,0.025536,172.217.194.0-255,5738,151262,1,220503
38180,0.025546,172.31.36.0-255,66,151328,1,220503
38181,0.027902,172.217.194.0-255,5738,157066,1,220503
38182,0.027912,172.31.36.0-255,66,157132,1,220503
38183,0.030234,172.217.194.0-255,5738,162870,1,220503
38184,0.030242,172.31.36.0-255,66,162936,1,220503
38185,0.032544,172.217.194.0-255,5738,168674,1,220503
38186,0.032552,172.31.36.0-255,66,168740,1,220503
38187,0.034562,172.31.36.0-255,171,168911,1,220503
38188,0.034592,172.31.36.0-255,1138,170049,1,220503
38189,0.03466,172.31.36.0-255,1514,171563,1,220503
38190,0.034662,172.31.36.0-255,1514,173077,1,220503
38191,0.034664,172.31.36.0-255,1514,174591,1,220503
38192,0.034665,172.31.36.0-255,1514,176105,1,220503
38193,0.034693,172.31.36.0-255,1514,177619,1,220503
38194,0.034694,172.31.36.0-255,1514,179133,1,220503
38195,0.0347,172.31.36.0-255,106,179239,1,220503
38196,0.034877,172.217.194.0-255,2902,182141,1,220503
38197,0.034883,172.31.36.0-255,66,182207,1,220503
38198,0.034911,172.217.194.0-255,2902,185109,1,220503
38199,0.034914,172.31.36.0-255,66,185175,1,220503
38200,0.036111,104.244.42.0-255,66,185241,1,220503
38201,0.03614,104.244.42.0-255,66,185307,1,220503
38202,0.036255,104.244.42.0-255,66,185373,1,220503
38203,0.036258,104.244.42.0-255,66,185439,1,220503
38204,0.036261,104.244.42.0-255,66,185505,1,220503
38205,0.037206,172.217.194.0-255,5738,191243,1,220503
38206,0.037213,172.31.36.0-255,66,191309,1,220503
38207,0.037312,104.244.42.0-255,108,191417,1,220503
38208,0.037317,172.31.36.0-255,66,191483,1,220503
38209,0.039529,172.217.194.0-255,5738,197221,1,220503
38210,0.039536,172.31.36.0-255,66,197287,1,220503
38211,0.041894,172.217.194.0-255,5738,203025,1,220503
38212,0.041905,172.31.36.0-255,66,203091,1,220503
38213,0.044213,172.217.194.0-255,5738,208829,1,220503
38214,0.044223,172.31.36.0-255,66,208895,1,220503
38215,0.04654,172.217.194.0-255,5738,214633,1,220503
38216,0.046548,172.31.36.0-255,66,214699,1,220503
38217,0.048862,172.217.194.0-255,5738,220437,1,220503
38218,0.048873,172.31.36.0-255,66,220503,1,220503
38219,0.0,172.217.194.0-255,142,142,1,224589
38220,1.7e-05,172.31.36.0-255,66,208,1,224589
38221,2.4e-05,172.217.194.0-255,1484,1692,1,224589
38222,3e-05,172.31.36.0-255,66,1758,1,224589
38223,3.6e-05,172.217.194.0-255,2902,4660,1,224589
38224,4.7e-05,172.31.36.0-255,66,4726,1,224589
38225,5.5e-05,172.217.194.0-255,7156,11882,1,224589
38226,5.9e-05,172.31.36.0-255,66,11948,1,224589
38227,6.3e-05,172.217.194.0-255,2042,13990,1,224589
38228,6.5e-05,172.31.36.0-255,66,14056,1,224589
38229,0.000174,172.217.194.0-255,1484,15540,1,224589
38230,0.000177,172.31.36.0-255,66,15606,1,224589
38231,0.000183,172.217.194.0-255,2902,18508,1,224589
38232,0.000186,172.31.36.0-255,66,18574,1,224589
38233,0.000218,172.217.194.0-255,5738,24312,1,224589
38234,0.00022,172.31.36.0-255,66,24378,1,224589
38235,0.000228,172.217.194.0-255,6797,31175,1,224589
38236,0.00023,172.31.36.0-255,66,31241,1,224589
38237,0.000357,172.217.194.0-255,1484,32725,1,224589
38238,0.000362,172.31.36.0-255,66,32791,1,224589
38239,0.000369,172.217.194.0-255,2902,35693,1,224589
38240,0.000371,172.31.36.0-255,66,35759,1,224589
38241,0.000377,172.217.194.0-255,4320,40079,1,224589
38242,0.000385,172.31.36.0-255,66,40145,1,224589
38243,0.000408,172.217.194.0-255,1484,41629,1,224589
38244,0.000411,172.31.36.0-255,66,41695,1,224589
38245,0.000423,172.217.194.0-255,4320,46015,1,224589
38246,0.000425,172.31.36.0-255,66,46081,1,224589
38247,0.000461,172.31.36.0-255,66,46147,1,224589
38248,0.000473,172.31.36.0-255,66,46213,1,224589
38249,0.001356,172.217.194.0-255,647,46860,1,224589
38250,0.001687,172.217.194.0-255,1484,48344,1,224589
38251,0.001693,172.31.36.0-255,66,48410,1,224589
38252,0.0017,172.217.194.0-255,2902,51312,1,224589
38253,0.001702,172.31.36.0-255,66,51378,1,224589
38254,0.001729,172.217.194.0-255,5738,57116,1,224589
38255,0.001732,172.31.36.0-255,66,57182,1,224589
38256,0.00176,172.217.194.0-255,7156,64338,1,224589
38257,0.001762,172.31.36.0-255,66,64404,1,224589
38258,0.001787,172.217.194.0-255,5738,70142,1,224589
38259,0.001789,172.31.36.0-255,66,70208,1,224589
38260,0.001822,172.31.36.0-255,66,70274,1,224589
38261,0.002911,172.217.194.0-255,1484,71758,1,224589
38262,0.002919,172.217.194.0-255,2902,74660,1,224589
38263,0.002924,172.31.36.0-255,66,74726,1,224589
38264,0.002931,172.217.194.0-255,5738,80464,1,224589
38265,0.002933,172.31.36.0-255,66,80530,1,224589
38266,0.002942,172.217.194.0-255,1484,82014,1,224589
38267,0.002986,172.31.36.0-255,66,82080,1,224589
38268,0.002992,172.217.194.0-255,5738,87818,1,224589
38269,0.002994,172.31.36.0-255,66,87884,1,224589
38270,0.00304,172.217.194.0-255,5020,92904,1,224589
38271,0.003042,172.31.36.0-255,66,92970,1,224589
38272,0.003402,172.217.194.0-255,1484,94454,1,224589
38273,0.003418,172.217.194.0-255,2902,97356,1,224589
38274,0.00342,172.31.36.0-255,66,97422,1,224589
38275,0.003423,172.217.194.0-255,1484,98906,1,224589
38276,0.003446,172.217.194.0-255,2902,101808,1,224589
38277,0.003449,172.31.36.0-255,66,101874,1,224589
38278,0.003464,172.31.36.0-255,66,101940,1,224589
38279,0.003502,172.31.36.0-255,66,102006,1,224589
38280,0.003536,172.31.36.0-255,66,102072,1,224589
38281,0.00357,172.217.194.0-255,7156,109228,1,224589
38282,0.003573,172.31.36.0-255,66,109294,1,224589
38283,0.003594,172.31.36.0-255,66,109360,1,224589
38284,0.00369,172.31.36.0-255,66,109426,1,224589
38285,0.003692,172.217.194.0-255,1484,110910,1,224589
38286,0.003697,172.217.194.0-255,2902,113812,1,224589
38287,0.003699,172.31.36.0-255,66,113878,1,224589
38288,0.003711,172.217.194.0-255,5738,119616,1,224589
38289,0.003713,172.31.36.0-255,66,119682,1,224589
38290,0.003721,172.217.194.0-255,7156,126838,1,224589
38291,0.003723,172.31.36.0-255,66,126904,1,224589
38292,0.003744,172.31.36.0-255,66,126970,1,224589
38293,0.003775,172.217.194.0-255,2184,129154,1,224589
38294,0.003778,172.31.36.0-255,66,129220,1,224589
38295,0.004028,172.217.194.0-255,1484,130704,1,224589
38296,0.004034,172.217.194.0-255,2902,133606,1,224589
38297,0.004037,172.31.36.0-255,66,133672,1,224589
38298,0.004068,172.217.194.0-255,5738,139410,1,224589
38299,0.004071,172.31.36.0-255,66,139476,1,224589
38300,0.004078,172.217.194.0-255,7156,146632,1,224589
38301,0.004081,172.31.36.0-255,66,146698,1,224589
38302,0.004128,172.31.36.0-255,66,146764,1,224589
38303,0.004248,172.217.194.0-255,1484,148248,1,224589
38304,0.004253,172.217.194.0-255,2902,151150,1,224589
38305,0.004256,172.31.36.0-255,66,151216,1,224589
38306,0.004261,172.217.194.0-255,2902,154118,1,224589
38307,0.004263,172.31.36.0-255,66,154184,1,224589
38308,0.004283,172.217.194.0-255,2902,157086,1,224589
38309,0.004286,172.31.36.0-255,66,157152,1,224589
38310,0.004294,172.217.194.0-255,7156,164308,1,224589
38311,0.004296,172.31.36.0-255,66,164374,1,224589
38312,0.004325,172.217.194.0-255,5738,170112,1,224589
38313,0.004328,172.31.36.0-255,66,170178,1,224589
38314,0.004345,172.31.36.0-255,66,170244,1,224589
38315,0.00438,172.217.194.0-255,1484,171728,1,224589
38316,0.004393,172.217.194.0-255,2902,174630,1,224589
38317,0.004396,172.31.36.0-255,66,174696,1,224589
38318,0.004399,172.217.194.0-255,1484,176180,1,224589
38319,0.004422,172.217.194.0-255,4320,180500,1,224589
38320,0.004425,172.31.36.0-255,66,180566,1,224589
38321,0.004443,172.31.36.0-255,66,180632,1,224589
38322,0.004468,172.217.194.0-255,1484,182116,1,224589
38323,0.004489,172.31.36.0-255,66,182182,1,224589
38324,0.004512,172.217.194.0-255,766,182948,1,224589
38325,0.004529,172.217.194.0-255,1484,184432,1,224589
38326,0.004532,172.31.36.0-255,66,184498,1,224589
38327,0.004537,172.217.194.0-255,2902,187400,1,224589
38328,0.004539,172.31.36.0-255,66,187466,1,224589
38329,0.004586,172.217.194.0-255,5738,193204,1,224589
38330,0.00459,172.31.36.0-255,66,193270,1,224589
38331,0.004597,172.217.194.0-255,7156,200426,1,224589
38332,0.004599,172.31.36.0-255,66,200492,1,224589
38333,0.004654,172.31.36.0-255,66,200558,1,224589
38334,0.004671,172.217.194.0-255,1484,202042,1,224589
38335,0.004675,172.217.194.0-255,2184,204226,1,224589
38336,0.004677,172.31.36.0-255,66,204292,1,224589
38337,0.004845,172.217.194.0-255,1484,205776,1,224589
38338,0.004852,172.217.194.0-255,2902,208678,1,224589
38339,0.004856,172.31.36.0-255,66,208744,1,224589
38340,0.00486,172.217.194.0-255,1484,210228,1,224589
38341,0.004888,172.217.194.0-255,4320,214548,1,224589
38342,0.004891,172.31.36.0-255,66,214614,1,224589
38343,0.004893,172.217.194.0-255,603,215217,1,224589
38344,0.004915,172.217.194.0-255,105,215322,1,224589
38345,0.00742,172.31.36.0-255,66,215388,1,224589
38346,0.007459,172.31.36.0-255,105,215493,1,224589
38347,0.00974,172.217.194.0-255,66,215559,1,224589
38348,0.037683,172.31.36.0-255,172,215731,1,224589
38349,0.037719,172.31.36.0-255,1113,216844,1,224589
38350,0.03779,172.31.36.0-255,1514,218358,1,224589
38351,0.037792,172.31.36.0-255,1514,219872,1,224589
38352,0.037797,172.31.36.0-255,1514,221386,1,224589
38353,0.037799,172.31.36.0-255,1514,222900,1,224589
38354,0.037816,172.31.36.0-255,1491,224391,1,224589
38355,0.039218,104.244.42.0-255,66,224457,1,224589
38356,0.039253,104.244.42.0-255,66,224523,1,224589
38357,0.039365,104.244.42.0-255,66,224589,1,224589
38358,0.0,74.125.24.0-255,153,153,1,154405
38359,2.6e-05,172.31.36.0-255,66,219,1,154405
38360,3.4e-05,74.125.24.0-255,1484,1703,1,154405
38361,3.8e-05,172.31.36.0-255,66,1769,1,154405
38362,4.5e-05,74.125.24.0-255,2902,4671,1,154405
38363,4.9e-05,172.31.36.0-255,66,4737,1,154405
38364,5.6e-05,74.125.24.0-255,7156,11893,1,154405
38365,6e-05,172.31.36.0-255,66,11959,1,154405
38366,6.4e-05,74.125.24.0-255,2106,14065,1,154405
38367,6.7e-05,172.31.36.0-255,66,14131,1,154405
38368,8.6e-05,74.125.24.0-255,1484,15615,1,154405
38369,8.8e-05,172.31.36.0-255,66,15681,1,154405
38370,0.000108,74.125.24.0-255,1484,17165,1,154405
38371,0.00011,172.31.36.0-255,66,17231,1,154405
38372,0.000117,74.125.24.0-255,5738,22969,1,154405
38373,0.000119,172.31.36.0-255,66,23035,1,154405
38374,0.000154,74.125.24.0-255,1484,24519,1,154405
38375,0.000156,172.31.36.0-255,66,24585,1,154405
38376,0.000183,74.125.24.0-255,6797,31382,1,154405
38377,0.000186,172.31.36.0-255,66,31448,1,154405
38378,0.000954,74.125.24.0-255,1484,32932,1,154405
38379,0.000961,172.31.36.0-255,66,32998,1,154405
38380,0.000969,74.125.24.0-255,1484,34482,1,154405
38381,0.000972,172.31.36.0-255,66,34548,1,154405
38382,0.000986,74.125.24.0-255,1484,36032,1,154405
38383,0.000988,172.31.36.0-255,66,36098,1,154405
38384,0.000994,74.125.24.0-255,4320,40418,1,154405
38385,0.000997,172.31.36.0-255,66,40484,1,154405
38386,0.001046,172.31.36.0-255,66,40550,1,154405
38387,0.001057,172.31.36.0-255,66,40616,1,154405
38388,0.00108,74.125.24.0-255,5379,45995,1,154405
38389,0.001645,74.125.24.0-255,647,46642,1,154405
38390,0.009538,172.31.36.0-255,66,46708,1,154405
38391,0.011672,74.125.24.0-255,5738,52446,1,154405
38392,0.011688,172.31.36.0-255,66,52512,1,154405
38393,0.013812,74.125.24.0-255,5738,58250,1,154405
38394,0.016791,172.31.36.0-255,66,58316,1,154405
38395,0.018878,74.125.24.0-255,5738,64054,1,154405
38396,0.018892,172.31.36.0-255,66,64120,1,154405
38397,0.020993,74.125.24.0-255,5738,69858,1,154405
38398,0.021008,172.31.36.0-255,66,69924,1,154405
38399,0.023091,74.125.24.0-255,5738,75662,1,154405
38400,0.02311,172.31.36.0-255,66,75728,1,154405
38401,0.025216,74.125.24.0-255,5738,81466,1,154405
38402,0.025228,172.31.36.0-255,66,81532,1,154405
38403,0.027384,74.125.24.0-255,5738,87270,1,154405
38404,0.027397,172.31.36.0-255,66,87336,1,154405
38405,0.029519,74.125.24.0-255,5738,93074,1,154405
38406,0.029536,172.31.36.0-255,66,93140,1,154405
38407,0.031625,74.125.24.0-255,5738,98878,1,154405
38408,0.031642,172.31.36.0-255,66,98944,1,154405
38409,0.033709,74.125.24.0-255,5738,104682,1,154405
38410,0.033725,172.31.36.0-255,66,104748,1,154405
38411,0.035799,74.125.24.0-255,5738,110486,1,154405
38412,0.035811,172.31.36.0-255,66,110552,1,154405
38413,0.037878,74.125.24.0-255,5738,116290,1,154405
38414,0.037892,172.31.36.0-255,66,116356,1,154405
38415,0.038619,172.31.36.0-255,172,116528,1,154405
38416,0.038652,172.31.36.0-255,1114,117642,1,154405
38417,0.038734,172.31.36.0-255,1514,119156,1,154405
38418,0.038736,172.31.36.0-255,1514,120670,1,154405
38419,0.038737,172.31.36.0-255,1514,122184,1,154405
38420,0.038742,172.31.36.0-255,1514,123698,1,154405
38421,0.038743,172.31.36.0-255,1489,125187,1,154405
38422,0.039968,74.125.24.0-255,5738,130925,1,154405
38423,0.039981,172.31.36.0-255,66,130991,1,154405
38424,0.040171,104.244.42.0-255,66,131057,1,154405
38425,0.0402,104.244.42.0-255,66,131123,1,154405
38426,0.040322,104.244.42.0-255,66,131189,1,154405
38427,0.04206,74.125.24.0-255,5738,136927,1,154405
38428,0.04208,172.31.36.0-255,66,136993,1,154405
38429,0.044128,74.125.24.0-255,5738,142731,1,154405
38430,0.044137,172.31.36.0-255,66,142797,1,154405
38431,0.04623,74.125.24.0-255,5738,148535,1,154405
38432,0.046238,172.31.36.0-255,66,148601,1,154405
38433,0.048336,74.125.24.0-255,5738,154339,1,154405
38434,0.048346,172.31.36.0-255,66,154405,1,154405
38435,0.0,74.125.200.0-255,147,147,1,309920
38436,1.9e-05,172.31.36.0-255,66,213,1,309920
38437,2.6e-05,74.125.200.0-255,1484,1697,1,309920
38438,2.9e-05,172.31.36.0-255,66,1763,1,309920
38439,3.5e-05,74.125.200.0-255,2902,4665,1,309920
38440,3.8e-05,172.31.36.0-255,66,4731,1,309920
38441,5.1e-05,74.125.200.0-255,4320,9051,1,309920
38442,5.4e-05,172.31.36.0-255,66,9117,1,309920
38443,8.5e-05,74.125.200.0-255,4876,13993,1,309920
38444,8.8e-05,172.31.36.0-255,66,14059,1,309920
38445,0.000117,74.125.200.0-255,5738,19797,1,309920
38446,0.00012,172.31.36.0-255,66,19863,1,309920
38447,0.000125,74.125.200.0-255,2902,22765,1,309920
38448,0.000127,172.31.36.0-255,66,22831,1,309920
38449,0.00013,74.125.200.0-255,1484,24315,1,309920
38450,0.000132,172.31.36.0-255,66,24381,1,309920
38451,0.00016,74.125.200.0-255,2902,27283,1,309920
38452,0.000162,172.31.36.0-255,66,27349,1,309920
38453,0.000193,74.125.200.0-255,3961,31310,1,309920
38454,0.000195,172.31.36.0-255,66,31376,1,309920
38455,0.000257,74.125.200.0-255,1484,32860,1,309920
38456,0.00026,172.31.36.0-255,66,32926,1,309920
38457,0.000276,74.125.200.0-255,1484,34410,1,309920
38458,0.000278,172.31.36.0-255,66,34476,1,309920
38459,0.000282,74.125.200.0-255,1484,35960,1,309920
38460,0.000284,172.31.36.0-255,66,36026,1,309920
38461,0.000321,74.125.200.0-255,1484,37510,1,309920
38462,0.000324,172.31.36.0-255,66,37576,1,309920
38463,0.000331,74.125.200.0-255,5738,43314,1,309920
38464,0.000333,172.31.36.0-255,66,43380,1,309920
38465,0.000344,74.125.200.0-255,5379,48759,1,309920
38466,0.000346,172.31.36.0-255,66,48825,1,309920
38467,0.000352,74.125.200.0-255,5738,54563,1,309920
38468,0.000355,172.31.36.0-255,66,54629,1,309920
38469,0.000424,172.31.36.0-255,66,54695,1,309920
38470,0.000427,74.125.200.0-255,382,55077,1,309920
38471,0.000624,74.125.200.0-255,1484,56561,1,309920
38472,0.000628,74.125.200.0-255,2902,59463,1,309920
38473,0.000633,172.31.36.0-255,66,59529,1,309920
38474,0.000641,172.31.36.0-255,66,59595,1,309920
38475,0.000647,74.125.200.0-255,4320,63915,1,309920
38476,0.000649,172.31.36.0-255,66,63981,1,309920
38477,0.000682,74.125.200.0-255,1484,65465,1,309920
38478,0.000695,172.31.36.0-255,66,65531,1,309920
38479,0.0007,74.125.200.0-255,4320,69851,1,309920
38480,0.000702,172.31.36.0-255,66,69917,1,309920
38481,0.000746,74.125.200.0-255,6438,76355,1,309920
38482,0.000749,172.31.36.0-255,66,76421,1,309920
38483,0.000887,74.125.200.0-255,1484,77905,1,309920
38484,0.000893,74.125.200.0-255,2902,80807,1,309920
38485,0.000896,172.31.36.0-255,66,80873,1,309920
38486,0.000927,74.125.200.0-255,5738,86611,1,309920
38487,0.000932,172.31.36.0-255,66,86677,1,309920
38488,0.000952,74.125.200.0-255,5738,92415,1,309920
38489,0.000954,172.31.36.0-255,66,92481,1,309920
38490,0.000983,74.125.200.0-255,7156,99637,1,309920
38491,0.000985,172.31.36.0-255,66,99703,1,309920
38492,0.000989,74.125.200.0-255,1484,101187,1,309920
38493,0.001019,172.31.36.0-255,66,101253,1,309920
38494,0.001597,74.125.200.0-255,1484,102737,1,309920
38495,0.001604,74.125.200.0-255,2902,105639,1,309920
38496,0.001607,172.31.36.0-255,66,105705,1,309920
38497,0.00164,74.125.200.0-255,5738,111443,1,309920
38498,0.001642,172.31.36.0-255,66,111509,1,309920
38499,0.00165,74.125.200.0-255,7156,118665,1,309920
38500,0.001651,172.31.36.0-255,66,118731,1,309920
38501,0.001675,74.125.200.0-255,5738,124469,1,309920
38502,0.001677,172.31.36.0-255,66,124535,1,309920
38503,0.001708,74.125.200.0-255,7156,131691,1,309920
38504,0.00171,172.31.36.0-255,66,131757,1,309920
38505,0.001732,74.125.200.0-255,3602,135359,1,309920
38506,0.001734,172.31.36.0-255,66,135425,1,309920
38507,0.00192,74.125.200.0-255,1484,136909,1,309920
38508,0.001925,74.125.200.0-255,2902,139811,1,309920
38509,0.001928,172.31.36.0-255,66,139877,1,309920
38510,0.001931,74.125.200.0-255,1484,141361,1,309920
38511,0.001955,74.125.200.0-255,4320,145681,1,309920
38512,0.00196,74.125.200.0-255,4320,150001,1,309920
38513,0.001961,74.125.200.0-255,1484,151485,1,309920
38514,0.001965,172.31.36.0-255,66,151551,1,309920
38515,0.001967,172.31.36.0-255,66,151617,1,309920
38516,0.001978,74.125.200.0-255,4320,155937,1,309920
38517,0.001984,172.31.36.0-255,66,156003,1,309920
38518,0.00203,172.31.36.0-255,66,156069,1,309920
38519,0.002034,74.125.200.0-255,2184,158253,1,309920
38520,0.002036,172.31.36.0-255,66,158319,1,309920
38521,0.002084,172.31.36.0-255,66,158385,1,309920
38522,0.002091,74.125.200.0-255,5738,164123,1,309920
38523,0.002093,172.31.36.0-255,66,164189,1,309920
38524,0.002116,74.125.200.0-255,2902,167091,1,309920
38525,0.002118,172.31.36.0-255,66,167157,1,309920
38526,0.002153,172.31.36.0-255,66,167223,1,309920
38527,0.002214,172.31.36.0-255,66,167289,1,309920
38528,0.002241,172.31.36.0-255,66,167355,1,309920
38529,0.002247,74.125.200.0-255,7156,174511,1,309920
38530,0.002249,172.31.36.0-255,66,174577,1,309920
38531,0.00229,74.125.200.0-255,2902,177479,1,309920
38532,0.002307,74.125.200.0-255,5738,183217,1,309920
38533,0.002321,74.125.200.0-255,7156,190373,1,309920
38534,0.002324,74.125.200.0-255,1484,191857,1,309920
38535,0.002346,74.125.200.0-255,7156,199013,1,309920
38536,0.00235,74.125.200.0-255,2902,201915,1,309920
38537,0.009326,172.31.36.0-255,66,201981,1,309920
38538,0.011664,74.125.200.0-255,5738,207719,1,309920
38539,0.011676,172.31.36.0-255,66,207785,1,309920
38540,0.013997,74.125.200.0-255,5738,213523,1,309920
38541,0.014007,172.31.36.0-255,66,213589,1,309920
38542,0.016333,74.125.200.0-255,5738,219327,1,309920
38543,0.016342,172.31.36.0-255,66,219393,1,309920
38544,0.018656,74.125.200.0-255,5738,225131,1,309920
38545,0.018664,172.31.36.0-255,66,225197,1,309920
38546,0.020986,74.125.200.0-255,5738,230935,1,309920
38547,0.020993,172.31.36.0-255,66,231001,1,309920
38548,0.023317,74.125.200.0-255,5738,236739,1,309920
38549,0.023325,172.31.36.0-255,66,236805,1,309920
38550,0.025643,74.125.200.0-255,5738,242543,1,309920
38551,0.025651,172.31.36.0-255,66,242609,1,309920
38552,0.027966,74.125.200.0-255,5738,248347,1,309920
38553,0.027973,172.31.36.0-255,66,248413,1,309920
38554,0.030284,74.125.200.0-255,5738,254151,1,309920
38555,0.030292,172.31.36.0-255,66,254217,1,309920
38556,0.032601,74.125.200.0-255,5738,259955,1,309920
38557,0.032609,172.31.36.0-255,66,260021,1,309920
38558,0.033006,172.31.36.0-255,172,260193,1,309920
38559,0.03305,172.31.36.0-255,1113,261306,1,309920
38560,0.033141,172.31.36.0-255,1514,262820,1,309920
38561,0.033143,172.31.36.0-255,1514,264334,1,309920
38562,0.033144,172.31.36.0-255,1514,265848,1,309920
38563,0.033145,172.31.36.0-255,1514,267362,1,309920
38564,0.033173,172.31.36.0-255,1492,268854,1,309920
38565,0.034538,104.244.42.0-255,66,268920,1,309920
38566,0.034577,104.244.42.0-255,66,268986,1,309920
38567,0.034719,104.244.42.0-255,66,269052,1,309920
38568,0.034761,104.244.42.0-255,66,269118,1,309920
38569,0.034923,74.125.200.0-255,5738,274856,1,309920
38570,0.034929,172.31.36.0-255,66,274922,1,309920
38571,0.035292,104.244.42.0-255,108,275030,1,309920
38572,0.035301,172.31.36.0-255,66,275096,1,309920
38573,0.037245,74.125.200.0-255,5738,280834,1,309920
38574,0.037252,172.31.36.0-255,66,280900,1,309920
38575,0.039569,74.125.200.0-255,5738,286638,1,309920
38576,0.039576,172.31.36.0-255,66,286704,1,309920
38577,0.041882,74.125.200.0-255,5738,292442,1,309920
38578,0.04189,172.31.36.0-255,66,292508,1,309920
38579,0.044211,74.125.200.0-255,5738,298246,1,309920
38580,0.044217,172.31.36.0-255,66,298312,1,309920
38581,0.046533,74.125.200.0-255,5738,304050,1,309920
38582,0.046539,172.31.36.0-255,66,304116,1,309920
38583,0.048851,74.125.200.0-255,5738,309854,1,309920
38584,0.048856,172.31.36.0-255,66,309920,1,309920
38585,0.0,172.217.194.0-255,146,146,1,212256
38586,2.4e-05,172.31.36.0-255,66,212,1,212256
38587,3.2e-05,172.217.194.0-255,1484,1696,1,212256
38588,3.7e-05,172.31.36.0-255,66,1762,1,212256
38589,4.3e-05,172.217.194.0-255,2902,4664,1,212256
38590,4.5e-05,172.31.36.0-255,66,4730,1,212256
38591,5.3e-05,172.217.194.0-255,7156,11886,1,212256
38592,5.6e-05,172.31.36.0-255,66,11952,1,212256
38593,6.1e-05,172.217.194.0-255,2019,13971,1,212256
38594,6.5e-05,172.31.36.0-255,66,14037,1,212256
38595,0.000279,172.217.194.0-255,1484,15521,1,212256
38596,0.000285,172.31.36.0-255,66,15587,1,212256
38597,0.000292,172.217.194.0-255,2902,18489,1,212256
38598,0.000295,172.31.36.0-255,66,18555,1,212256
38599,0.000303,172.217.194.0-255,5738,24293,1,212256
38600,0.000305,172.31.36.0-255,66,24359,1,212256
38601,0.000308,172.217.194.0-255,1484,25843,1,212256
38602,0.00031,172.31.36.0-255,66,25909,1,212256
38603,0.000336,172.217.194.0-255,5379,31288,1,212256
38604,0.000339,172.31.36.0-255,66,31354,1,212256
38605,0.000405,172.217.194.0-255,1484,32838,1,212256
38606,0.000408,172.31.36.0-255,66,32904,1,212256
38607,0.000413,172.217.194.0-255,2902,35806,1,212256
38608,0.000415,172.31.36.0-255,66,35872,1,212256
38609,0.000421,172.217.194.0-255,2902,38774,1,212256
38610,0.000423,172.31.36.0-255,66,38840,1,212256
38611,0.000436,172.217.194.0-255,2902,41742,1,212256
38612,0.000439,172.31.36.0-255,66,41808,1,212256
38613,0.000462,172.217.194.0-255,5738,47546,1,212256
38614,0.000466,172.31.36.0-255,66,47612,1,212256
38615,0.000501,172.31.36.0-255,66,47678,1,212256
38616,0.000515,172.217.194.0-255,378,48056,1,212256
38617,0.000519,172.31.36.0-255,66,48122,1,212256
38618,0.00056,172.217.194.0-255,99,48221,1,212256
38619,0.000578,172.217.194.0-255,364,48585,1,212256
38620,0.000729,172.217.194.0-255,1484,50069,1,212256
38621,0.000733,172.217.194.0-255,1484,51553,1,212256
38622,0.000745,172.217.194.0-255,1484,53037,1,212256
38623,0.000752,172.217.194.0-255,5738,58775,1,212256
38624,0.000766,172.31.36.0-255,66,58841,1,212256
38625,0.000778,172.217.194.0-255,2902,61743,1,212256
38626,0.000791,172.31.36.0-255,66,61809,1,212256
38627,0.000811,172.31.36.0-255,66,61875,1,212256
38628,0.000874,172.217.194.0-255,1484,63359,1,212256
38629,0.000877,172.31.36.0-255,66,63425,1,212256
38630,0.000899,172.217.194.0-255,2902,66327,1,212256
38631,0.000906,172.217.194.0-255,5738,72065,1,212256
38632,0.000913,172.31.36.0-255,66,72131,1,212256
38633,0.000947,172.217.194.0-255,7156,79287,1,212256
38634,0.000954,172.31.36.0-255,66,79353,1,212256
38635,0.000972,172.217.194.0-255,3602,82955,1,212256
38636,0.000989,172.31.36.0-255,66,83021,1,212256
38637,0.001009,172.217.194.0-255,1484,84505,1,212256
38638,0.001022,172.217.194.0-255,2902,87407,1,212256
38639,0.001046,172.217.194.0-255,5738,93145,1,212256
38640,0.001118,172.217.194.0-255,7156,100301,1,212256
38641,0.001128,172.31.36.0-255,66,100367,1,212256
38642,0.001146,172.217.194.0-255,7156,107523,1,212256
38643,0.001173,172.217.194.0-255,766,108289,1,212256
38644,0.001185,172.31.36.0-255,66,108355,1,212256
38645,0.001209,172.217.194.0-255,5738,114093,1,212256
38646,0.001236,172.217.194.0-255,5738,119831,1,212256
38647,0.001241,172.217.194.0-255,4320,124151,1,212256
38648,0.001246,172.31.36.0-255,66,124217,1,212256
38649,0.001288,172.31.36.0-255,66,124283,1,212256
38650,0.001369,172.217.194.0-255,1484,125767,1,212256
38651,0.001374,172.217.194.0-255,1484,127251,1,212256
38652,0.001383,172.31.36.0-255,66,127317,1,212256
38653,0.001387,172.217.194.0-255,1484,128801,1,212256
38654,0.001392,172.217.194.0-255,5738,134539,1,212256
38655,0.001404,172.31.36.0-255,66,134605,1,212256
38656,0.001432,172.217.194.0-255,4320,138925,1,212256
38657,0.001439,172.31.36.0-255,66,138991,1,212256
38658,0.001481,172.217.194.0-255,766,139757,1,212256
38659,0.001486,172.31.36.0-255,66,139823,1,212256
38660,0.00156,172.217.194.0-255,1484,141307,1,212256
38661,0.001566,172.217.194.0-255,2902,144209,1,212256
38662,0.001569,172.217.194.0-255,1484,145693,1,212256
38663,0.001587,172.31.36.0-255,66,145759,1,212256
38664,0.001593,172.217.194.0-255,4320,150079,1,212256
38665,0.001607,172.31.36.0-255,66,150145,1,212256
38666,0.001615,172.217.194.0-255,1484,151629,1,212256
38667,0.001648,172.217.194.0-255,5738,157367,1,212256
38668,0.001662,172.31.36.0-255,66,157433,1,212256
38669,0.001679,172.31.36.0-255,66,157499,1,212256
38670,0.001706,172.217.194.0-255,5738,163237,1,212256
38671,0.001714,172.217.194.0-255,7156,170393,1,212256
38672,0.001718,172.31.36.0-255,66,170459,1,212256
38673,0.001726,172.217.194.0-255,2902,173361,1,212256
38674,0.001761,172.217.194.0-255,6438,179799,1,212256
38675,0.001803,172.31.36.0-255,66,179865,1,212256
38676,0.001816,172.217.194.0-255,5738,185603,1,212256
38677,0.001824,172.217.194.0-255,7156,192759,1,212256
38678,0.001834,172.217.194.0-255,1484,194243,1,212256
38679,0.001866,172.31.36.0-255,66,194309,1,212256
38680,0.001876,172.217.194.0-255,2902,197211,1,212256
38681,0.001882,172.217.194.0-255,5738,202949,1,212256
38682,0.001891,172.31.36.0-255,66,203015,1,212256
38683,0.001897,172.217.194.0-255,4320,207335,1,212256
38684,0.001961,172.31.36.0-255,66,207401,1,212256
38685,0.00198,172.31.36.0-255,66,207467,1,212256
38686,0.001984,172.217.194.0-255,2332,209799,1,212256
38687,0.002012,172.217.194.0-255,105,209904,1,212256
38688,0.002015,172.31.36.0-255,66,209970,1,212256
38689,0.010432,172.31.36.0-255,66,210036,1,212256
38690,0.010471,172.31.36.0-255,105,210141,1,212256
38691,0.012746,172.217.194.0-255,66,210207,1,212256
38692,0.037347,172.31.36.0-255,172,210379,1,212256
38693,0.037386,172.31.36.0-255,1113,211492,1,212256
38694,0.037445,172.31.36.0-255,566,212058,1,212256
38695,0.038888,104.244.42.0-255,66,212124,1,212256
38696,0.038919,104.244.42.0-255,66,212190,1,212256
38697,0.038968,104.244.42.0-255,66,212256,1,212256
38698,0.0,74.125.68.0-255,152,152,1,186184
38699,3.1e-05,172.31.36.0-255,66,218,1,186184
38700,3.7e-05,74.125.68.0-255,1484,1702,1,186184
38701,4.1e-05,172.31.36.0-255,66,1768,1,186184
38702,5.9e-05,74.125.68.0-255,1484,3252,1,186184
38703,6.1e-05,172.31.36.0-255,66,3318,1,186184
38704,7e-05,74.125.68.0-255,2902,6220,1,186184
38705,7.2e-05,172.31.36.0-255,66,6286,1,186184
38706,0.000106,74.125.68.0-255,4320,10606,1,186184
38707,0.000109,172.31.36.0-255,66,10672,1,186184
38708,0.00013,74.125.68.0-255,1484,12156,1,186184
38709,0.000133,172.31.36.0-255,66,12222,1,186184
38710,0.000155,74.125.68.0-255,6232,18454,1,186184
38711,0.000159,172.31.36.0-255,66,18520,1,186184
38712,0.000162,74.125.68.0-255,1484,20004,1,186184
38713,0.000163,172.31.36.0-255,66,20070,1,186184
38714,0.000203,74.125.68.0-255,7156,27226,1,186184
38715,0.000206,172.31.36.0-255,66,27292,1,186184
38716,0.000231,74.125.68.0-255,2902,30194,1,186184
38717,0.000234,172.31.36.0-255,66,30260,1,186184
38718,0.000238,74.125.68.0-255,1125,31385,1,186184
38719,0.00024,172.31.36.0-255,66,31451,1,186184
38720,0.000371,74.125.68.0-255,1484,32935,1,186184
38721,0.000375,172.31.36.0-255,66,33001,1,186184
38722,0.0004,74.125.68.0-255,2902,35903,1,186184
38723,0.000403,172.31.36.0-255,66,35969,1,186184
38724,0.000428,74.125.68.0-255,2902,38871,1,186184
38725,0.00043,172.31.36.0-255,66,38937,1,186184
38726,0.000435,74.125.68.0-255,4320,43257,1,186184
38727,0.000436,172.31.36.0-255,66,43323,1,186184
38728,0.000485,74.125.68.0-255,6797,50120,1,186184
38729,0.000488,172.31.36.0-255,66,50186,1,186184
38730,0.000496,74.125.68.0-255,7156,57342,1,186184
38731,0.000498,172.31.36.0-255,66,57408,1,186184
38732,0.000548,172.31.36.0-255,66,57474,1,186184
38733,0.000751,74.125.68.0-255,126,57600,1,186184
38734,0.000832,172.31.36.0-255,66,57666,1,186184
38735,0.002807,74.125.68.0-255,4320,61986,1,186184
38736,0.002814,172.31.36.0-255,66,62052,1,186184
38737,0.003083,74.125.68.0-255,1484,63536,1,186184
38738,0.005047,74.125.68.0-255,1484,65020,1,186184
38739,0.00505,172.31.36.0-255,66,65086,1,186184
38740,0.005077,74.125.68.0-255,2902,67988,1,186184
38741,0.00508,172.31.36.0-255,66,68054,1,186184
38742,0.007314,74.125.68.0-255,2902,70956,1,186184
38743,0.007319,172.31.36.0-255,66,71022,1,186184
38744,0.007358,74.125.68.0-255,2902,73924,1,186184
38745,0.007362,172.31.36.0-255,66,73990,1,186184
38746,0.00956,74.125.68.0-255,2902,76892,1,186184
38747,0.009569,172.31.36.0-255,66,76958,1,186184
38748,0.009609,74.125.68.0-255,2902,79860,1,186184
38749,0.009613,172.31.36.0-255,66,79926,1,186184
38750,0.011816,74.125.68.0-255,2902,82828,1,186184
38751,0.011826,172.31.36.0-255,66,82894,1,186184
38752,0.01187,74.125.68.0-255,2902,85796,1,186184
38753,0.011874,172.31.36.0-255,66,85862,1,186184
38754,0.014089,74.125.68.0-255,2902,88764,1,186184
38755,0.014101,172.31.36.0-255,66,88830,1,186184
38756,0.014155,74.125.68.0-255,2902,91732,1,186184
38757,0.014158,172.31.36.0-255,66,91798,1,186184
38758,0.01635,74.125.68.0-255,2902,94700,1,186184
38759,0.016358,172.31.36.0-255,66,94766,1,186184
38760,0.0164,74.125.68.0-255,2902,97668,1,186184
38761,0.016403,172.31.36.0-255,66,97734,1,186184
38762,0.01861,74.125.68.0-255,2902,100636,1,186184
38763,0.018619,172.31.36.0-255,66,100702,1,186184
38764,0.01865,74.125.68.0-255,2902,103604,1,186184
38765,0.018652,172.31.36.0-255,66,103670,1,186184
38766,0.02086,74.125.68.0-255,2902,106572,1,186184
38767,0.020866,172.31.36.0-255,66,106638,1,186184
38768,0.0209,74.125.68.0-255,2902,109540,1,186184
38769,0.020904,172.31.36.0-255,66,109606,1,186184
38770,0.02312,74.125.68.0-255,2902,112508,1,186184
38771,0.023129,172.31.36.0-255,66,112574,1,186184
38772,0.023158,74.125.68.0-255,2902,115476,1,186184
38773,0.023161,172.31.36.0-255,66,115542,1,186184
38774,0.025366,74.125.68.0-255,2902,118444,1,186184
38775,0.025372,172.31.36.0-255,66,118510,1,186184
38776,0.025414,74.125.68.0-255,2902,121412,1,186184
38777,0.025417,172.31.36.0-255,66,121478,1,186184
38778,0.027611,74.125.68.0-255,2902,124380,1,186184
38779,0.027615,172.31.36.0-255,66,124446,1,186184
38780,0.027646,74.125.68.0-255,2902,127348,1,186184
38781,0.027649,172.31.36.0-255,66,127414,1,186184
38782,0.029854,74.125.68.0-255,1484,128898,1,186184
38783,0.029894,74.125.68.0-255,4320,133218,1,186184
38784,0.029899,172.31.36.0-255,66,133284,1,186184
38785,0.032152,74.125.68.0-255,5738,139022,1,186184
38786,0.03216,172.31.36.0-255,66,139088,1,186184
38787,0.033588,172.31.36.0-255,182,139270,1,186184
38788,0.033618,172.31.36.0-255,1114,140384,1,186184
38789,0.033669,172.31.36.0-255,1514,141898,1,186184
38790,0.033671,172.31.36.0-255,1514,143412,1,186184
38791,0.033677,172.31.36.0-255,1514,144926,1,186184
38792,0.033678,172.31.36.0-255,1514,146440,1,186184
38793,0.033695,172.31.36.0-255,1490,147930,1,186184
38794,0.034403,74.125.68.0-255,4320,152250,1,186184
38795,0.034409,172.31.36.0-255,66,152316,1,186184
38796,0.034438,74.125.68.0-255,1484,153800,1,186184
38797,0.035165,104.244.42.0-255,66,153866,1,186184
38798,0.035183,104.244.42.0-255,66,153932,1,186184
38799,0.035241,104.244.42.0-255,66,153998,1,186184
38800,0.036656,74.125.68.0-255,4320,158318,1,186184
38801,0.036664,172.31.36.0-255,66,158384,1,186184
38802,0.038898,74.125.68.0-255,5738,164122,1,186184
38803,0.038904,172.31.36.0-255,66,164188,1,186184
38804,0.041147,74.125.68.0-255,5738,169926,1,186184
38805,0.041153,172.31.36.0-255,66,169992,1,186184
38806,0.043432,74.125.68.0-255,4320,174312,1,186184
38807,0.043437,172.31.36.0-255,66,174378,1,186184
38808,0.043462,74.125.68.0-255,1484,175862,1,186184
38809,0.045675,74.125.68.0-255,4320,180182,1,186184
38810,0.045682,172.31.36.0-255,66,180248,1,186184
38811,0.047917,74.125.68.0-255,2902,183150,1,186184
38812,0.047923,172.31.36.0-255,66,183216,1,186184
38813,0.047959,74.125.68.0-255,2902,186118,1,186184
38814,0.047962,172.31.36.0-255,66,186184,1,186184
38815,0.0,74.125.200.0-255,148,148,1,306140
38816,3.4e-05,172.31.36.0-255,66,214,1,306140
38817,4.1e-05,74.125.200.0-255,1484,1698,1,306140
38818,4.5e-05,172.31.36.0-255,66,1764,1,306140
38819,5e-05,74.125.200.0-255,2902,4666,1,306140
38820,5.2e-05,172.31.36.0-255,66,4732,1,306140
38821,6.4e-05,74.125.200.0-255,2902,7634,1,306140
38822,6.8e-05,172.31.36.0-255,66,7700,1,306140
38823,9.2e-05,74.125.200.0-255,1484,9184,1,306140
38824,9.7e-05,172.31.36.0-255,66,9250,1,306140
38825,0.000126,74.125.200.0-255,2902,12152,1,306140
38826,0.000129,172.31.36.0-255,66,12218,1,306140
38827,0.000134,74.125.200.0-255,2902,15120,1,306140
38828,0.000136,172.31.36.0-255,66,15186,1,306140
38829,0.00016,74.125.200.0-255,3458,18644,1,306140
38830,0.000164,172.31.36.0-255,66,18710,1,306140
38831,0.000177,74.125.200.0-255,7156,25866,1,306140
38832,0.000179,172.31.36.0-255,66,25932,1,306140
38833,0.000185,74.125.200.0-255,5379,31311,1,306140
38834,0.000189,172.31.36.0-255,66,31377,1,306140
38835,0.000271,74.125.200.0-255,1484,32861,1,306140
38836,0.000274,172.31.36.0-255,66,32927,1,306140
38837,0.000292,74.125.200.0-255,1484,34411,1,306140
38838,0.000294,172.31.36.0-255,66,34477,1,306140
38839,0.000321,74.125.200.0-255,1484,35961,1,306140
38840,0.000324,172.31.36.0-255,66,36027,1,306140
38841,0.000331,74.125.200.0-255,5738,41765,1,306140
38842,0.000334,172.31.36.0-255,66,41831,1,306140
38843,0.000339,74.125.200.0-255,4320,46151,1,306140
38844,0.000341,172.31.36.0-255,66,46217,1,306140
38845,0.000383,74.125.200.0-255,2902,49119,1,306140
38846,0.000387,172.31.36.0-255,66,49185,1,306140
38847,0.000399,172.31.36.0-255,66,49251,1,306140
38848,0.000404,74.125.200.0-255,4320,53571,1,306140
38849,0.000413,172.31.36.0-255,66,53637,1,306140
38850,0.000444,74.125.200.0-255,2184,55821,1,306140
38851,0.000446,74.125.200.0-255,428,56249,1,306140
38852,0.00045,172.31.36.0-255,66,56315,1,306140
38853,0.000535,74.125.200.0-255,1484,57799,1,306140
38854,0.000538,172.31.36.0-255,66,57865,1,306140
38855,0.000544,74.125.200.0-255,2902,60767,1,306140
38856,0.000547,172.31.36.0-255,66,60833,1,306140
38857,0.000559,74.125.200.0-255,5738,66571,1,306140
38858,0.000561,172.31.36.0-255,66,66637,1,306140
38859,0.000569,74.125.200.0-255,7156,73793,1,306140
38860,0.000572,172.31.36.0-255,66,73859,1,306140
38861,0.000598,74.125.200.0-255,2902,76761,1,306140
38862,0.000606,172.31.36.0-255,66,76827,1,306140
38863,0.00062,172.31.36.0-255,66,76893,1,306140
38864,0.000624,74.125.200.0-255,2184,79077,1,306140
38865,0.000627,172.31.36.0-255,66,79143,1,306140
38866,0.0009,74.125.200.0-255,1484,80627,1,306140
38867,0.000905,74.125.200.0-255,2902,83529,1,306140
38868,0.000908,172.31.36.0-255,66,83595,1,306140
38869,0.000943,74.125.200.0-255,1484,85079,1,306140
38870,0.000959,74.125.200.0-255,4320,89399,1,306140
38871,0.000962,172.31.36.0-255,66,89465,1,306140
38872,0.000968,74.125.200.0-255,7156,96621,1,306140
38873,0.00097,172.31.36.0-255,66,96687,1,306140
38874,0.000989,172.31.36.0-255,66,96753,1,306140
38875,0.00102,74.125.200.0-255,3602,100355,1,306140
38876,0.001024,172.31.36.0-255,66,100421,1,306140
38877,0.0011,74.125.200.0-255,1484,101905,1,306140
38878,0.001104,74.125.200.0-255,1484,103389,1,306140
38879,0.001107,172.31.36.0-255,66,103455,1,306140
38880,0.001138,74.125.200.0-255,1484,104939,1,306140
38881,0.001145,74.125.200.0-255,5738,110677,1,306140
38882,0.001148,172.31.36.0-255,66,110743,1,306140
38883,0.001154,74.125.200.0-255,5738,116481,1,306140
38884,0.001156,172.31.36.0-255,66,116547,1,306140
38885,0.001169,74.125.200.0-255,7156,123703,1,306140
38886,0.001171,172.31.36.0-255,66,123769,1,306140
38887,0.001208,172.31.36.0-255,66,123835,1,306140
38888,0.001361,74.125.200.0-255,1484,125319,1,306140
38889,0.001375,74.125.200.0-255,2902,128221,1,306140
38890,0.001379,172.31.36.0-255,66,128287,1,306140
38891,0.00141,74.125.200.0-255,5738,134025,1,306140
38892,0.001413,172.31.36.0-255,66,134091,1,306140
38893,0.001441,74.125.200.0-255,2902,136993,1,306140
38894,0.001446,172.31.36.0-255,66,137059,1,306140
38895,0.001474,74.125.200.0-255,5738,142797,1,306140
38896,0.001477,172.31.36.0-255,66,142863,1,306140
38897,0.001485,74.125.200.0-255,7156,150019,1,306140
38898,0.001487,172.31.36.0-255,66,150085,1,306140
38899,0.001507,74.125.200.0-255,2902,152987,1,306140
38900,0.001514,172.31.36.0-255,66,153053,1,306140
38901,0.001519,74.125.200.0-255,2902,155955,1,306140
38902,0.001521,172.31.36.0-255,66,156021,1,306140
38903,0.001525,74.125.200.0-255,2184,158205,1,306140
38904,0.001526,172.31.36.0-255,66,158271,1,306140
38905,0.00175,74.125.200.0-255,1484,159755,1,306140
38906,0.00177,74.125.200.0-255,2902,162657,1,306140
38907,0.001774,172.31.36.0-255,66,162723,1,306140
38908,0.00178,74.125.200.0-255,4320,167043,1,306140
38909,0.001783,172.31.36.0-255,66,167109,1,306140
38910,0.001801,74.125.200.0-255,1484,168593,1,306140
38911,0.001825,74.125.200.0-255,7156,175749,1,306140
38912,0.001829,172.31.36.0-255,66,175815,1,306140
38913,0.001834,74.125.200.0-255,4320,180135,1,306140
38914,0.001836,172.31.36.0-255,66,180201,1,306140
38915,0.001873,74.125.200.0-255,2902,183103,1,306140
38916,0.001876,172.31.36.0-255,66,183169,1,306140
38917,0.001907,172.31.36.0-255,66,183235,1,306140
38918,0.001951,172.31.36.0-255,66,183301,1,306140
38919,0.001975,74.125.200.0-255,1484,184785,1,306140
38920,0.001984,74.125.200.0-255,7156,191941,1,306140
38921,0.001987,172.31.36.0-255,66,192007,1,306140
38922,0.001994,74.125.200.0-255,5738,197745,1,306140
38923,0.001996,172.31.36.0-255,66,197811,1,306140
38924,0.002017,74.125.200.0-255,2184,199995,1,306140
38925,0.00202,172.31.36.0-255,66,200061,1,306140
38926,0.00206,74.125.200.0-255,1484,201545,1,306140
38927,0.002083,74.125.200.0-255,1484,203029,1,306140
38928,0.002086,172.31.36.0-255,66,203095,1,306140
38929,0.00209,74.125.200.0-255,1484,204579,1,306140
38930,0.002111,74.125.200.0-255,1484,206063,1,306140
38931,0.002114,172.31.36.0-255,66,206129,1,306140
38932,0.002121,74.125.200.0-255,5738,211867,1,306140
38933,0.002123,172.31.36.0-255,66,211933,1,306140
38934,0.002128,74.125.200.0-255,4320,216253,1,306140
38935,0.002131,172.31.36.0-255,66,216319,1,306140
38936,0.002156,74.125.200.0-255,2902,219221,1,306140
38937,0.00216,172.31.36.0-255,66,219287,1,306140
38938,0.002175,172.31.36.0-255,66,219353,1,306140
38939,0.002233,74.125.200.0-255,6438,225791,1,306140
38940,0.002237,172.31.36.0-255,66,225857,1,306140
38941,0.002272,74.125.200.0-255,1484,227341,1,306140
38942,0.002304,74.125.200.0-255,2902,230243,1,306140
38943,0.002307,172.31.36.0-255,66,230309,1,306140
38944,0.002332,74.125.200.0-255,5738,236047,1,306140
38945,0.002335,172.31.36.0-255,66,236113,1,306140
38946,0.002342,74.125.200.0-255,7156,243269,1,306140
38947,0.002346,172.31.36.0-255,66,243335,1,306140
38948,0.002372,172.31.36.0-255,66,243401,1,306140
38949,0.00241,172.31.36.0-255,66,243467,1,306140
38950,0.002445,172.31.36.0-255,66,243533,1,306140
38951,0.00245,74.125.200.0-255,4320,247853,1,306140
38952,0.002453,172.31.36.0-255,66,247919,1,306140
38953,0.002482,74.125.200.0-255,4320,252239,1,306140
38954,0.002486,172.31.36.0-255,66,252305,1,306140
38955,0.002527,172.31.36.0-255,66,252371,1,306140
38956,0.002535,74.125.200.0-255,6438,258809,1,306140
38957,0.002538,172.31.36.0-255,66,258875,1,306140
38958,0.00258,74.125.200.0-255,7156,266031,1,306140
38959,0.002585,172.31.36.0-255,66,266097,1,306140
38960,0.002589,74.125.200.0-255,2902,268999,1,306140
38961,0.002591,172.31.36.0-255,66,269065,1,306140
38962,0.005078,74.125.200.0-255,4320,273385,1,306140
38963,0.005085,172.31.36.0-255,66,273451,1,306140
38964,0.005111,74.125.200.0-255,1484,274935,1,306140
38965,0.007578,74.125.200.0-255,4320,279255,1,306140
38966,0.007584,172.31.36.0-255,66,279321,1,306140
38967,0.010094,74.125.200.0-255,4320,283641,1,306140
38968,0.010101,172.31.36.0-255,66,283707,1,306140
38969,0.010137,74.125.200.0-255,1484,285191,1,306140
38970,0.012605,74.125.200.0-255,4320,289511,1,306140
38971,0.01262,172.31.36.0-255,66,289577,1,306140
38972,0.015154,74.125.200.0-255,5738,295315,1,306140
38973,0.015171,172.31.36.0-255,66,295381,1,306140
38974,0.017819,74.125.200.0-255,5738,301119,1,306140
38975,0.017837,172.31.36.0-255,66,301185,1,306140
38976,0.020336,74.125.200.0-255,2665,303850,1,306140
38977,0.020347,172.31.36.0-255,66,303916,1,306140
38978,0.02054,172.31.36.0-255,105,304021,1,306140
38979,0.023001,74.125.200.0-255,66,304087,1,306140
38980,0.034342,172.31.36.0-255,176,304263,1,306140
38981,0.034373,172.31.36.0-255,1113,305376,1,306140
38982,0.034409,172.31.36.0-255,566,305942,1,306140
38983,0.035907,104.244.42.0-255,66,306008,1,306140
38984,0.035949,104.244.42.0-255,66,306074,1,306140
38985,0.035954,104.244.42.0-255,66,306140,1,306140
38986,0.0,172.217.194.0-255,152,152,1,218828
38987,3.2e-05,172.31.36.0-255,66,218,1,218828
38988,3.9e-05,172.217.194.0-255,1484,1702,1,218828
38989,4.3e-05,172.31.36.0-255,66,1768,1,218828
38990,4.8e-05,172.217.194.0-255,2902,4670,1,218828
38991,6e-05,172.31.36.0-255,66,4736,1,218828
38992,6.7e-05,172.217.194.0-255,5738,10474,1,218828
38993,7e-05,172.31.36.0-255,66,10540,1,218828
38994,0.000118,172.31.36.0-255,66,10606,1,218828
38995,0.000131,172.31.36.0-255,66,10672,1,218828
38996,0.000161,172.217.194.0-255,4320,14992,1,218828
38997,0.000164,172.31.36.0-255,66,15058,1,218828
38998,0.000181,172.31.36.0-255,66,15124,1,218828
38999,0.000357,172.217.194.0-255,1484,16608,1,218828
39000,0.000361,172.31.36.0-255,66,16674,1,218828
39001,0.000366,172.217.194.0-255,2902,19576,1,218828
39002,0.000369,172.31.36.0-255,66,19642,1,218828
39003,0.000397,172.217.194.0-255,5738,25380,1,218828
39004,0.000402,172.31.36.0-255,66,25446,1,218828
39005,0.000438,172.217.194.0-255,5738,31184,1,218828
39006,0.000442,172.31.36.0-255,66,31250,1,218828
39007,0.000466,172.217.194.0-255,1714,32964,1,218828
39008,0.000468,172.31.36.0-255,66,33030,1,218828
39009,0.00085,172.217.194.0-255,1484,34514,1,218828
39010,0.000854,172.31.36.0-255,66,34580,1,218828
39011,0.000859,172.217.194.0-255,2902,37482,1,218828
39012,0.000862,172.31.36.0-255,66,37548,1,218828
39013,0.000884,172.217.194.0-255,5738,43286,1,218828
39014,0.000892,172.31.36.0-255,66,43352,1,218828
39015,0.000898,172.217.194.0-255,2902,46254,1,218828
39016,0.0009,172.31.36.0-255,66,46320,1,218828
39017,0.000935,172.217.194.0-255,5738,52058,1,218828
39018,0.000938,172.31.36.0-255,66,52124,1,218828
39019,0.000949,172.31.36.0-255,66,52190,1,218828
39020,0.000961,172.217.194.0-255,5020,57210,1,218828
39021,0.000963,172.31.36.0-255,66,57276,1,218828
39022,0.000991,172.217.194.0-255,1484,58760,1,218828
39023,0.000997,172.217.194.0-255,2902,61662,1,218828
39024,0.000999,172.31.36.0-255,66,61728,1,218828
39025,0.001027,172.217.194.0-255,5738,67466,1,218828
39026,0.001031,172.31.36.0-255,66,67532,1,218828
39027,0.001036,172.217.194.0-255,4320,71852,1,218828
39028,0.001039,172.31.36.0-255,66,71918,1,218828
39029,0.001074,172.31.36.0-255,66,71984,1,218828
39030,0.00108,172.217.194.0-255,5738,77722,1,218828
39031,0.001082,172.31.36.0-255,66,77788,1,218828
39032,0.001125,172.31.36.0-255,66,77854,1,218828
39033,0.001161,172.217.194.0-255,4471,82325,1,218828
39034,0.001164,172.31.36.0-255,66,82391,1,218828
39035,0.001183,172.31.36.0-255,66,82457,1,218828
39036,0.001191,172.217.194.0-255,6438,88895,1,218828
39037,0.001193,172.31.36.0-255,66,88961,1,218828
39038,0.003457,172.217.194.0-255,5738,94699,1,218828
39039,0.003464,172.31.36.0-255,66,94765,1,218828
39040,0.005749,172.217.194.0-255,5738,100503,1,218828
39041,0.005754,172.31.36.0-255,66,100569,1,218828
39042,0.007989,172.217.194.0-255,5738,106307,1,218828
39043,0.007996,172.31.36.0-255,66,106373,1,218828
39044,0.01028,172.217.194.0-255,5738,112111,1,218828
39045,0.010342,172.31.36.0-255,66,112177,1,218828
39046,0.012638,172.217.194.0-255,5738,117915,1,218828
39047,0.012645,172.31.36.0-255,66,117981,1,218828
39048,0.014917,172.217.194.0-255,5738,123719,1,218828
39049,0.014925,172.31.36.0-255,66,123785,1,218828
39050,0.017194,172.217.194.0-255,5738,129523,1,218828
39051,0.017202,172.31.36.0-255,66,129589,1,218828
39052,0.019479,172.217.194.0-255,5738,135327,1,218828
39053,0.019488,172.31.36.0-255,66,135393,1,218828
39054,0.021731,172.217.194.0-255,5738,141131,1,218828
39055,0.021741,172.31.36.0-255,66,141197,1,218828
39056,0.023994,172.217.194.0-255,5738,146935,1,218828
39057,0.024001,172.31.36.0-255,66,147001,1,218828
39058,0.026327,172.217.194.0-255,5738,152739,1,218828
39059,0.026334,172.31.36.0-255,66,152805,1,218828
39060,0.028604,172.217.194.0-255,5738,158543,1,218828
39061,0.028612,172.31.36.0-255,66,158609,1,218828
39062,0.030875,172.217.194.0-255,5738,164347,1,218828
39063,0.030887,172.31.36.0-255,66,164413,1,218828
39064,0.033188,172.217.194.0-255,5738,170151,1,218828
39065,0.033197,172.31.36.0-255,66,170217,1,218828
39066,0.035441,172.217.194.0-255,5738,175955,1,218828
39067,0.035449,172.31.36.0-255,66,176021,1,218828
39068,0.036231,172.31.36.0-255,172,176193,1,218828
39069,0.036262,172.31.36.0-255,1115,177308,1,218828
39070,0.036317,172.31.36.0-255,1514,178822,1,218828
39071,0.036319,172.31.36.0-255,1514,180336,1,218828
39072,0.03632,172.31.36.0-255,1514,181850,1,218828
39073,0.036321,172.31.36.0-255,1514,183364,1,218828
39074,0.036351,172.31.36.0-255,1488,184852,1,218828
39075,0.037686,172.217.194.0-255,5738,190590,1,218828
39076,0.037696,172.31.36.0-255,66,190656,1,218828
39077,0.037758,104.244.42.0-255,66,190722,1,218828
39078,0.037874,104.244.42.0-255,66,190788,1,218828
39079,0.037922,104.244.42.0-255,66,190854,1,218828
39080,0.039764,104.244.42.0-255,108,190962,1,218828
39081,0.039772,172.31.36.0-255,66,191028,1,218828
39082,0.039944,172.217.194.0-255,4320,195348,1,218828
39083,0.039949,172.31.36.0-255,66,195414,1,218828
39084,0.039976,172.217.194.0-255,1484,196898,1,218828
39085,0.042186,172.217.194.0-255,4320,201218,1,218828
39086,0.042196,172.31.36.0-255,66,201284,1,218828
39087,0.044428,172.217.194.0-255,5738,207022,1,218828
39088,0.044434,172.31.36.0-255,66,207088,1,218828
39089,0.046858,172.217.194.0-255,5738,212826,1,218828
39090,0.046869,172.31.36.0-255,66,212892,1,218828
39091,0.049117,172.217.194.0-255,2902,215794,1,218828
39092,0.049123,172.31.36.0-255,66,215860,1,218828
39093,0.049159,172.217.194.0-255,2902,218762,1,218828
39094,0.049163,172.31.36.0-255,66,218828,1,218828
39095,0.0,74.125.24.0-255,153,153,1,283045
39096,1.9e-05,172.31.36.0-255,66,219,1,283045
39097,2.5e-05,74.125.24.0-255,1484,1703,1,283045
39098,3e-05,172.31.36.0-255,66,1769,1,283045
39099,3.6e-05,74.125.24.0-255,2902,4671,1,283045
39100,4.8e-05,172.31.36.0-255,66,4737,1,283045
39101,5.7e-05,74.125.24.0-255,7156,11893,1,283045
39102,6e-05,172.31.36.0-255,66,11959,1,283045
39103,6.4e-05,74.125.24.0-255,2073,14032,1,283045
39104,6.7e-05,172.31.36.0-255,66,14098,1,283045
39105,0.00022,74.125.24.0-255,1484,15582,1,283045
39106,0.000224,172.31.36.0-255,66,15648,1,283045
39107,0.00023,74.125.24.0-255,2902,18550,1,283045
39108,0.000232,172.31.36.0-255,66,18616,1,283045
39109,0.000267,74.125.24.0-255,5738,24354,1,283045
39110,0.000271,172.31.36.0-255,66,24420,1,283045
39111,0.000313,172.31.36.0-255,66,24486,1,283045
39112,0.000318,74.125.24.0-255,4320,28806,1,283045
39113,0.00032,172.31.36.0-255,66,28872,1,283045
39114,0.000347,74.125.24.0-255,1484,30356,1,283045
39115,0.00035,172.31.36.0-255,66,30422,1,283045
39116,0.000381,74.125.24.0-255,3961,34383,1,283045
39117,0.000383,172.31.36.0-255,66,34449,1,283045
39118,0.000477,74.125.24.0-255,1484,35933,1,283045
39119,0.00048,172.31.36.0-255,66,35999,1,283045
39120,0.000486,74.125.24.0-255,2902,38901,1,283045
39121,0.000489,172.31.36.0-255,66,38967,1,283045
39122,0.000521,74.125.24.0-255,1484,40451,1,283045
39123,0.000524,172.31.36.0-255,66,40517,1,283045
39124,0.000535,74.125.24.0-255,5738,46255,1,283045
39125,0.000538,172.31.36.0-255,66,46321,1,283045
39126,0.000576,74.125.24.0-255,5714,52035,1,283045
39127,0.000579,172.31.36.0-255,66,52101,1,283045
39128,0.000632,74.125.24.0-255,342,52443,1,283045
39129,0.000784,74.125.24.0-255,1484,53927,1,283045
39130,0.000788,172.31.36.0-255,66,53993,1,283045
39131,0.000794,74.125.24.0-255,2902,56895,1,283045
39132,0.000797,172.31.36.0-255,66,56961,1,283045
39133,0.000809,74.125.24.0-255,5738,62699,1,283045
39134,0.000811,172.31.36.0-255,66,62765,1,283045
39135,0.000814,74.125.24.0-255,1484,64249,1,283045
39136,0.000848,74.125.24.0-255,5379,69628,1,283045
39137,0.000852,172.31.36.0-255,66,69694,1,283045
39138,0.000867,172.31.36.0-255,66,69760,1,283045
39139,0.000872,74.125.24.0-255,2543,72303,1,283045
39140,0.000874,172.31.36.0-255,66,72369,1,283045
39141,0.00186,74.125.24.0-255,1484,73853,1,283045
39142,0.001871,74.125.24.0-255,2902,76755,1,283045
39143,0.001876,172.31.36.0-255,66,76821,1,283045
39144,0.001884,74.125.24.0-255,5738,82559,1,283045
39145,0.001887,172.31.36.0-255,66,82625,1,283045
39146,0.001898,74.125.24.0-255,5738,88363,1,283045
39147,0.001901,172.31.36.0-255,66,88429,1,283045
39148,0.001908,74.125.24.0-255,5738,94167,1,283045
39149,0.001911,172.31.36.0-255,66,94233,1,283045
39150,0.001945,74.125.24.0-255,7156,101389,1,283045
39151,0.001948,172.31.36.0-255,66,101455,1,283045
39152,0.001954,74.125.24.0-255,5020,106475,1,283045
39153,0.001956,172.31.36.0-255,66,106541,1,283045
39154,0.001993,74.125.24.0-255,1484,108025,1,283045
39155,0.002025,74.125.24.0-255,1484,109509,1,283045
39156,0.002027,172.31.36.0-255,66,109575,1,283045
39157,0.002044,74.125.24.0-255,2902,112477,1,283045
39158,0.002047,172.31.36.0-255,66,112543,1,283045
39159,0.002073,74.125.24.0-255,5738,118281,1,283045
39160,0.002076,172.31.36.0-255,66,118347,1,283045
39161,0.002109,74.125.24.0-255,5738,124085,1,283045
39162,0.002112,172.31.36.0-255,66,124151,1,283045
39163,0.002135,74.125.24.0-255,7156,131307,1,283045
39164,0.002138,172.31.36.0-255,66,131373,1,283045
39165,0.002148,172.31.36.0-255,66,131439,1,283045
39166,0.002176,74.125.24.0-255,766,132205,1,283045
39167,0.002198,74.125.24.0-255,1484,133689,1,283045
39168,0.0022,172.31.36.0-255,66,133755,1,283045
39169,0.002206,74.125.24.0-255,2902,136657,1,283045
39170,0.002209,172.31.36.0-255,66,136723,1,283045
39171,0.002212,74.125.24.0-255,1484,138207,1,283045
39172,0.002234,74.125.24.0-255,4320,142527,1,283045
39173,0.002236,172.31.36.0-255,66,142593,1,283045
39174,0.002241,74.125.24.0-255,2902,145495,1,283045
39175,0.002243,172.31.36.0-255,66,145561,1,283045
39176,0.002277,172.31.36.0-255,66,145627,1,283045
39177,0.002298,74.125.24.0-255,5738,151365,1,283045
39178,0.002301,172.31.36.0-255,66,151431,1,283045
39179,0.002327,74.125.24.0-255,6438,157869,1,283045
39180,0.002329,172.31.36.0-255,66,157935,1,283045
39181,0.004603,74.125.24.0-255,5738,163673,1,283045
39182,0.004613,172.31.36.0-255,66,163739,1,283045
39183,0.006905,74.125.24.0-255,5738,169477,1,283045
39184,0.006917,172.31.36.0-255,66,169543,1,283045
39185,0.009161,74.125.24.0-255,5738,175281,1,283045
39186,0.009175,172.31.36.0-255,66,175347,1,283045
39187,0.011469,74.125.24.0-255,5738,181085,1,283045
39188,0.011481,172.31.36.0-255,66,181151,1,283045
39189,0.013751,74.125.24.0-255,5738,186889,1,283045
39190,0.013764,172.31.36.0-255,66,186955,1,283045
39191,0.016014,74.125.24.0-255,5738,192693,1,283045
39192,0.016023,172.31.36.0-255,66,192759,1,283045
39193,0.018301,74.125.24.0-255,5738,198497,1,283045
39194,0.018309,172.31.36.0-255,66,198563,1,283045
39195,0.020628,74.125.24.0-255,5738,204301,1,283045
39196,0.02064,172.31.36.0-255,66,204367,1,283045
39197,0.022893,74.125.24.0-255,5738,210105,1,283045
39198,0.022902,172.31.36.0-255,66,210171,1,283045
39199,0.02515,74.125.24.0-255,5738,215909,1,283045
39200,0.025159,172.31.36.0-255,66,215975,1,283045
39201,0.027415,74.125.24.0-255,5738,221713,1,283045
39202,0.027428,172.31.36.0-255,66,221779,1,283045
39203,0.02975,74.125.24.0-255,5738,227517,1,283045
39204,0.029763,172.31.36.0-255,66,227583,1,283045
39205,0.032021,74.125.24.0-255,5738,233321,1,283045
39206,0.032037,172.31.36.0-255,66,233387,1,283045
39207,0.034304,74.125.24.0-255,5738,239125,1,283045
39208,0.034318,172.31.36.0-255,66,239191,1,283045
39209,0.036589,74.125.24.0-255,5738,244929,1,283045
39210,0.0366,172.31.36.0-255,66,244995,1,283045
39211,0.038892,74.125.24.0-255,5738,250733,1,283045
39212,0.038905,172.31.36.0-255,66,250799,1,283045
39213,0.040519,172.31.36.0-255,172,250971,1,283045
39214,0.040554,172.31.36.0-255,1114,252085,1,283045
39215,0.040632,172.31.36.0-255,1514,253599,1,283045
39216,0.040633,172.31.36.0-255,1514,255113,1,283045
39217,0.04064,172.31.36.0-255,1514,256627,1,283045
39218,0.040641,172.31.36.0-255,1514,258141,1,283045
39219,0.040659,172.31.36.0-255,1490,259631,1,283045
39220,0.041163,74.125.24.0-255,5738,265369,1,283045
39221,0.041175,172.31.36.0-255,66,265435,1,283045
39222,0.042047,104.244.42.0-255,66,265501,1,283045
39223,0.042103,104.244.42.0-255,66,265567,1,283045
39224,0.042202,104.244.42.0-255,66,265633,1,283045
39225,0.043442,74.125.24.0-255,5738,271371,1,283045
39226,0.043451,172.31.36.0-255,66,271437,1,283045
39227,0.045723,74.125.24.0-255,5738,277175,1,283045
39228,0.045734,172.31.36.0-255,66,277241,1,283045
39229,0.048003,74.125.24.0-255,5738,282979,1,283045
39230,0.048011,172.31.36.0-255,66,283045,1,283045
39231,0.0,74.125.68.0-255,156,156,1,192126
39232,2e-05,172.31.36.0-255,66,222,1,192126
39233,2.8e-05,74.125.68.0-255,1484,1706,1,192126
39234,3.2e-05,172.31.36.0-255,66,1772,1,192126
39235,4.2e-05,74.125.68.0-255,1484,3256,1,192126
39236,4.5e-05,172.31.36.0-255,66,3322,1,192126
39237,5.1e-05,74.125.68.0-255,2902,6224,1,192126
39238,5.5e-05,172.31.36.0-255,66,6290,1,192126
39239,0.000112,74.125.68.0-255,5738,12028,1,192126
39240,0.000116,172.31.36.0-255,66,12094,1,192126
39241,0.000218,74.125.68.0-255,1984,14078,1,192126
39242,0.000222,172.31.36.0-255,66,14144,1,192126
39243,0.000247,74.125.68.0-255,2902,17046,1,192126
39244,0.00025,172.31.36.0-255,66,17112,1,192126
39245,0.000312,74.125.68.0-255,7156,24268,1,192126
39246,0.000316,172.31.36.0-255,66,24334,1,192126
39247,0.000428,74.125.68.0-255,2902,27236,1,192126
39248,0.000432,172.31.36.0-255,66,27302,1,192126
39249,0.000491,74.125.68.0-255,1484,28786,1,192126
39250,0.000494,172.31.36.0-255,66,28852,1,192126
39251,0.000542,172.31.36.0-255,66,28918,1,192126
39252,0.000773,74.125.68.0-255,5738,34656,1,192126
39253,0.000779,172.31.36.0-255,66,34722,1,192126
39254,0.000849,172.31.36.0-255,66,34788,1,192126
39255,0.001152,74.125.68.0-255,415,35203,1,192126
39256,0.001157,172.31.36.0-255,66,35269,1,192126
39257,0.001199,74.125.68.0-255,2902,38171,1,192126
39258,0.001204,172.31.36.0-255,66,38237,1,192126
39259,0.001238,172.31.36.0-255,66,38303,1,192126
39260,0.001411,172.31.36.0-255,66,38369,1,192126
39261,0.001443,74.125.68.0-255,4320,42689,1,192126
39262,0.001465,172.31.36.0-255,66,42755,1,192126
39263,0.00168,172.31.36.0-255,66,42821,1,192126
39264,0.002429,74.125.68.0-255,1484,44305,1,192126
39265,0.002486,74.125.68.0-255,7156,51461,1,192126
39266,0.002499,74.125.68.0-255,2184,53645,1,192126
39267,0.002927,172.31.36.0-255,66,53711,1,192126
39268,0.003041,74.125.68.0-255,5738,59449,1,192126
39269,0.003063,172.31.36.0-255,66,59515,1,192126
39270,0.003087,172.31.36.0-255,66,59581,1,192126
39271,0.003387,74.125.68.0-255,7156,66737,1,192126
39272,0.003392,172.31.36.0-255,66,66803,1,192126
39273,0.003471,172.31.36.0-255,66,66869,1,192126
39274,0.0057,74.125.68.0-255,5738,72607,1,192126
39275,0.006918,172.31.36.0-255,66,72673,1,192126
39276,0.009194,74.125.68.0-255,5738,78411,1,192126
39277,0.009202,172.31.36.0-255,66,78477,1,192126
39278,0.011435,74.125.68.0-255,5738,84215,1,192126
39279,0.011443,172.31.36.0-255,66,84281,1,192126
39280,0.013682,74.125.68.0-255,5738,90019,1,192126
39281,0.01369,172.31.36.0-255,66,90085,1,192126
39282,0.015936,74.125.68.0-255,5738,95823,1,192126
39283,0.015944,172.31.36.0-255,66,95889,1,192126
39284,0.018189,74.125.68.0-255,5738,101627,1,192126
39285,0.018198,172.31.36.0-255,66,101693,1,192126
39286,0.020465,74.125.68.0-255,5738,107431,1,192126
39287,0.020475,172.31.36.0-255,66,107497,1,192126
39288,0.02272,74.125.68.0-255,5738,113235,1,192126
39289,0.022727,172.31.36.0-255,66,113301,1,192126
39290,0.024969,74.125.68.0-255,5738,119039,1,192126
39291,0.024976,172.31.36.0-255,66,119105,1,192126
39292,0.027204,74.125.68.0-255,5738,124843,1,192126
39293,0.027211,172.31.36.0-255,66,124909,1,192126
39294,0.029449,74.125.68.0-255,5738,130647,1,192126
39295,0.029457,172.31.36.0-255,66,130713,1,192126
39296,0.031697,74.125.68.0-255,5738,136451,1,192126
39297,0.031706,172.31.36.0-255,66,136517,1,192126
39298,0.033944,74.125.68.0-255,5738,142255,1,192126
39299,0.033952,172.31.36.0-255,66,142321,1,192126
39300,0.036172,172.31.36.0-255,188,142509,1,192126
39301,0.036184,74.125.68.0-255,5738,148247,1,192126
39302,0.036188,172.31.36.0-255,66,148313,1,192126
39303,0.036232,172.31.36.0-255,958,149271,1,192126
39304,0.036362,172.31.36.0-255,1514,150785,1,192126
39305,0.036365,172.31.36.0-255,1514,152299,1,192126
39306,0.036366,172.31.36.0-255,1514,153813,1,192126
39307,0.036372,172.31.36.0-255,1514,155327,1,192126
39308,0.036373,172.31.36.0-255,1514,156841,1,192126
39309,0.036374,172.31.36.0-255,197,157038,1,192126
39310,0.037706,104.244.42.0-255,66,157104,1,192126
39311,0.037786,104.244.42.0-255,66,157170,1,192126
39312,0.037937,104.244.42.0-255,66,157236,1,192126
39313,0.037944,104.244.42.0-255,66,157302,1,192126
39314,0.038435,74.125.68.0-255,5738,163040,1,192126
39315,0.038442,172.31.36.0-255,66,163106,1,192126
39316,0.040684,74.125.68.0-255,5738,168844,1,192126
39317,0.040691,172.31.36.0-255,66,168910,1,192126
39318,0.042933,74.125.68.0-255,5738,174648,1,192126
39319,0.042942,172.31.36.0-255,66,174714,1,192126
39320,0.045196,74.125.68.0-255,5738,180452,1,192126
39321,0.045203,172.31.36.0-255,66,180518,1,192126
39322,0.047454,74.125.68.0-255,5738,186256,1,192126
39323,0.047461,172.31.36.0-255,66,186322,1,192126
39324,0.049728,74.125.68.0-255,5738,192060,1,192126
39325,0.049736,172.31.36.0-255,66,192126,1,192126
39326,0.0,74.125.24.0-255,152,152,1,185588
39327,5.2e-05,172.31.36.0-255,66,218,1,185588
39328,6e-05,74.125.24.0-255,1484,1702,1,185588
39329,6.5e-05,172.31.36.0-255,66,1768,1,185588
39330,7e-05,74.125.24.0-255,2902,4670,1,185588
39331,7.2e-05,172.31.36.0-255,66,4736,1,185588
39332,7.9e-05,74.125.24.0-255,7156,11892,1,185588
39333,8.1e-05,172.31.36.0-255,66,11958,1,185588
39334,0.000178,74.125.24.0-255,5738,17696,1,185588
39335,0.000183,172.31.36.0-255,66,17762,1,185588
39336,0.000205,74.125.24.0-255,2023,19785,1,185588
39337,0.000207,172.31.36.0-255,66,19851,1,185588
39338,0.00029,74.125.24.0-255,2902,22753,1,185588
39339,0.000293,172.31.36.0-255,66,22819,1,185588
39340,0.000315,74.125.24.0-255,7156,29975,1,185588
39341,0.000319,172.31.36.0-255,66,30041,1,185588
39342,0.000439,74.125.24.0-255,7156,37197,1,185588
39343,0.000443,172.31.36.0-255,66,37263,1,185588
39344,0.000476,172.31.36.0-255,66,37329,1,185588
39345,0.000757,172.31.36.0-255,66,37395,1,185588
39346,0.000988,172.31.36.0-255,66,37461,1,185588
39347,0.001024,172.31.36.0-255,66,37527,1,185588
39348,0.001506,172.31.36.0-255,66,37593,1,185588
39349,0.001544,172.31.36.0-255,66,37659,1,185588
39350,0.001564,74.125.24.0-255,5020,42679,1,185588
39351,0.001567,172.31.36.0-255,66,42745,1,185588
39352,0.00203,74.125.24.0-255,5738,48483,1,185588
39353,0.002035,172.31.36.0-255,66,48549,1,185588
39354,0.002052,74.125.24.0-255,2902,51451,1,185588
39355,0.002054,172.31.36.0-255,66,51517,1,185588
39356,0.002156,74.125.24.0-255,7156,58673,1,185588
39357,0.002159,172.31.36.0-255,66,58739,1,185588
39358,0.002208,172.31.36.0-255,66,58805,1,185588
39359,0.002836,74.125.24.0-255,5738,64543,1,185588
39360,0.002904,74.125.24.0-255,5738,70281,1,185588
39361,0.002953,74.125.24.0-255,4320,74601,1,185588
39362,0.003837,74.125.24.0-255,2902,77503,1,185588
39363,0.004308,172.31.36.0-255,66,77569,1,185588
39364,0.006909,74.125.24.0-255,5738,83307,1,185588
39365,0.006916,172.31.36.0-255,66,83373,1,185588
39366,0.00949,74.125.24.0-255,5738,89111,1,185588
39367,0.009497,172.31.36.0-255,66,89177,1,185588
39368,0.012238,74.125.24.0-255,5738,94915,1,185588
39369,0.012302,172.31.36.0-255,66,94981,1,185588
39370,0.014871,74.125.24.0-255,5738,100719,1,185588
39371,0.014882,172.31.36.0-255,66,100785,1,185588
39372,0.017463,74.125.24.0-255,5738,106523,1,185588
39373,0.017473,172.31.36.0-255,66,106589,1,185588
39374,0.020076,74.125.24.0-255,5738,112327,1,185588
39375,0.020091,172.31.36.0-255,66,112393,1,185588
39376,0.02269,74.125.24.0-255,5738,118131,1,185588
39377,0.022702,172.31.36.0-255,66,118197,1,185588
39378,0.02525,74.125.24.0-255,5738,123935,1,185588
39379,0.025257,172.31.36.0-255,66,124001,1,185588
39380,0.027869,74.125.24.0-255,5738,129739,1,185588
39381,0.027876,172.31.36.0-255,66,129805,1,185588
39382,0.030473,74.125.24.0-255,5738,135543,1,185588
39383,0.030483,172.31.36.0-255,66,135609,1,185588
39384,0.03307,74.125.24.0-255,5738,141347,1,185588
39385,0.033079,172.31.36.0-255,66,141413,1,185588
39386,0.035652,74.125.24.0-255,5738,147151,1,185588
39387,0.035661,172.31.36.0-255,66,147217,1,185588
39388,0.038222,74.125.24.0-255,5738,152955,1,185588
39389,0.038227,172.31.36.0-255,188,153143,1,185588
39390,0.038227,172.31.36.0-255,66,153209,1,185588
39391,0.038264,172.31.36.0-255,958,154167,1,185588
39392,0.038361,172.31.36.0-255,1514,155681,1,185588
39393,0.038364,172.31.36.0-255,1514,157195,1,185588
39394,0.038365,172.31.36.0-255,1514,158709,1,185588
39395,0.038366,172.31.36.0-255,1514,160223,1,185588
39396,0.038399,172.31.36.0-255,1514,161737,1,185588
39397,0.038401,172.31.36.0-255,197,161934,1,185588
39398,0.039764,104.244.42.0-255,66,162000,1,185588
39399,0.039899,104.244.42.0-255,66,162066,1,185588
39400,0.040074,104.244.42.0-255,66,162132,1,185588
39401,0.040079,104.244.42.0-255,66,162198,1,185588
39402,0.040558,104.244.42.0-255,108,162306,1,185588
39403,0.04058,172.31.36.0-255,66,162372,1,185588
39404,0.040806,74.125.24.0-255,5738,168110,1,185588
39405,0.040826,172.31.36.0-255,66,168176,1,185588
39406,0.04339,74.125.24.0-255,5738,173914,1,185588
39407,0.043396,172.31.36.0-255,66,173980,1,185588
39408,0.045988,74.125.24.0-255,5738,179718,1,185588
39409,0.045995,172.31.36.0-255,66,179784,1,185588
39410,0.048591,74.125.24.0-255,5738,185522,1,185588
39411,0.048596,172.31.36.0-255,66,185588,1,185588
39412,0.0,74.125.130.0-255,151,151,1,300627
39413,2e-05,172.31.36.0-255,66,217,1,300627
39414,2.7e-05,74.125.130.0-255,1484,1701,1,300627
39415,3.2e-05,172.31.36.0-255,66,1767,1,300627
39416,3.5e-05,74.125.130.0-255,1484,3251,1,300627
39417,3.8e-05,172.31.36.0-255,66,3317,1,300627
39418,6.3e-05,74.125.130.0-255,2902,6219,1,300627
39419,6.5e-05,172.31.36.0-255,66,6285,1,300627
39420,7e-05,74.125.130.0-255,2902,9187,1,300627
39421,7.3e-05,172.31.36.0-255,66,9253,1,300627
39422,9.3e-05,74.125.130.0-255,2902,12155,1,300627
39423,9.5e-05,172.31.36.0-255,66,12221,1,300627
39424,0.000135,74.125.130.0-255,4320,16541,1,300627
39425,0.000137,172.31.36.0-255,66,16607,1,300627
39426,0.000155,74.125.130.0-255,2039,18646,1,300627
39427,0.000158,172.31.36.0-255,66,18712,1,300627
39428,0.000161,74.125.130.0-255,1484,20196,1,300627
39429,0.000163,172.31.36.0-255,66,20262,1,300627
39430,0.000181,74.125.130.0-255,5738,26000,1,300627
39431,0.000184,172.31.36.0-255,66,26066,1,300627
39432,0.000192,74.125.130.0-255,5379,31445,1,300627
39433,0.000195,172.31.36.0-255,66,31511,1,300627
39434,0.000421,74.125.130.0-255,1484,32995,1,300627
39435,0.000426,172.31.36.0-255,66,33061,1,300627
39436,0.000431,74.125.130.0-255,1484,34545,1,300627
39437,0.000433,172.31.36.0-255,66,34611,1,300627
39438,0.000439,74.125.130.0-255,2902,37513,1,300627
39439,0.000442,172.31.36.0-255,66,37579,1,300627
39440,0.00046,74.125.130.0-255,5738,43317,1,300627
39441,0.000462,172.31.36.0-255,66,43383,1,300627
39442,0.000513,74.125.130.0-255,4320,47703,1,300627
39443,0.000517,172.31.36.0-255,66,47769,1,300627
39444,0.00052,74.125.130.0-255,1125,48894,1,300627
39445,0.000567,74.125.130.0-255,1484,50378,1,300627
39446,0.000584,74.125.130.0-255,1484,51862,1,300627
39447,0.000589,172.31.36.0-255,66,51928,1,300627
39448,0.000602,74.125.130.0-255,2902,54830,1,300627
39449,0.000621,172.31.36.0-255,66,54896,1,300627
39450,0.000635,74.125.130.0-255,5738,60634,1,300627
39451,0.00066,172.31.36.0-255,66,60700,1,300627
39452,0.000682,74.125.130.0-255,2902,63602,1,300627
39453,0.000694,74.125.130.0-255,2833,66435,1,300627
39454,0.000701,172.31.36.0-255,66,66501,1,300627
39455,0.000758,74.125.130.0-255,365,66866,1,300627
39456,0.001019,74.125.130.0-255,1484,68350,1,300627
39457,0.001023,172.31.36.0-255,66,68416,1,300627
39458,0.001028,74.125.130.0-255,2902,71318,1,300627
39459,0.001031,172.31.36.0-255,66,71384,1,300627
39460,0.001034,74.125.130.0-255,1484,72868,1,300627
39461,0.001057,74.125.130.0-255,2902,75770,1,300627
39462,0.001059,172.31.36.0-255,66,75836,1,300627
39463,0.001066,74.125.130.0-255,4320,80156,1,300627
39464,0.001076,74.125.130.0-255,1484,81640,1,300627
39465,0.001084,172.31.36.0-255,66,81706,1,300627
39466,0.001093,74.125.130.0-255,2902,84608,1,300627
39467,0.001098,172.31.36.0-255,66,84674,1,300627
39468,0.001119,74.125.130.0-255,5738,90412,1,300627
39469,0.001126,74.125.130.0-255,7156,97568,1,300627
39470,0.001131,172.31.36.0-255,66,97634,1,300627
39471,0.00114,74.125.130.0-255,2902,100536,1,300627
39472,0.001143,74.125.130.0-255,766,101302,1,300627
39473,0.00116,74.125.130.0-255,1484,102786,1,300627
39474,0.00117,172.31.36.0-255,66,102852,1,300627
39475,0.00118,74.125.130.0-255,4320,107172,1,300627
39476,0.001185,172.31.36.0-255,66,107238,1,300627
39477,0.001198,74.125.130.0-255,1484,108722,1,300627
39478,0.001212,74.125.130.0-255,2902,111624,1,300627
39479,0.001217,172.31.36.0-255,66,111690,1,300627
39480,0.001239,74.125.130.0-255,4320,116010,1,300627
39481,0.001256,172.31.36.0-255,66,116076,1,300627
39482,0.001259,74.125.130.0-255,1484,117560,1,300627
39483,0.001263,74.125.130.0-255,2902,120462,1,300627
39484,0.001269,172.31.36.0-255,66,120528,1,300627
39485,0.001281,74.125.130.0-255,4320,124848,1,300627
39486,0.001304,74.125.130.0-255,5738,130586,1,300627
39487,0.001311,172.31.36.0-255,66,130652,1,300627
39488,0.001349,74.125.130.0-255,6438,137090,1,300627
39489,0.001384,172.31.36.0-255,66,137156,1,300627
39490,0.001402,74.125.130.0-255,7156,144312,1,300627
39491,0.001424,74.125.130.0-255,1484,145796,1,300627
39492,0.001445,74.125.130.0-255,2902,148698,1,300627
39493,0.001463,74.125.130.0-255,4320,153018,1,300627
39494,0.001526,74.125.130.0-255,4320,157338,1,300627
39495,0.001542,74.125.130.0-255,1484,158822,1,300627
39496,0.001558,74.125.130.0-255,2902,161724,1,300627
39497,0.001607,74.125.130.0-255,5738,167462,1,300627
39498,0.001643,74.125.130.0-255,2184,169646,1,300627
39499,0.007054,172.31.36.0-255,66,169712,1,300627
39500,0.009068,74.125.130.0-255,5738,175450,1,300627
39501,0.009078,172.31.36.0-255,66,175516,1,300627
39502,0.011081,74.125.130.0-255,5738,181254,1,300627
39503,0.011088,172.31.36.0-255,66,181320,1,300627
39504,0.013089,74.125.130.0-255,5738,187058,1,300627
39505,0.013096,172.31.36.0-255,66,187124,1,300627
39506,0.01511,74.125.130.0-255,5738,192862,1,300627
39507,0.015119,172.31.36.0-255,66,192928,1,300627
39508,0.017116,74.125.130.0-255,5738,198666,1,300627
39509,0.017124,172.31.36.0-255,66,198732,1,300627
39510,0.01913,74.125.130.0-255,5738,204470,1,300627
39511,0.019137,172.31.36.0-255,66,204536,1,300627
39512,0.021138,74.125.130.0-255,5738,210274,1,300627
39513,0.021147,172.31.36.0-255,66,210340,1,300627
39514,0.023142,74.125.130.0-255,5738,216078,1,300627
39515,0.023149,172.31.36.0-255,66,216144,1,300627
39516,0.025138,74.125.130.0-255,5738,221882,1,300627
39517,0.025146,172.31.36.0-255,66,221948,1,300627
39518,0.027146,74.125.130.0-255,5738,227686,1,300627
39519,0.027153,172.31.36.0-255,66,227752,1,300627
39520,0.029165,74.125.130.0-255,5738,233490,1,300627
39521,0.029171,172.31.36.0-255,66,233556,1,300627
39522,0.031165,74.125.130.0-255,5738,239294,1,300627
39523,0.031172,172.31.36.0-255,66,239360,1,300627
39524,0.033167,74.125.130.0-255,5738,245098,1,300627
39525,0.033174,172.31.36.0-255,66,245164,1,300627
39526,0.035168,74.125.130.0-255,5738,250902,1,300627
39527,0.035176,172.31.36.0-255,66,250968,1,300627
39528,0.037187,74.125.130.0-255,5738,256706,1,300627
39529,0.037196,172.31.36.0-255,66,256772,1,300627
39530,0.039206,74.125.130.0-255,5738,262510,1,300627
39531,0.039214,172.31.36.0-255,66,262576,1,300627
39532,0.041197,172.31.36.0-255,171,262747,1,300627
39533,0.041216,74.125.130.0-255,5738,268485,1,300627
39534,0.041225,172.31.36.0-255,66,268551,1,300627
39535,0.041262,172.31.36.0-255,1138,269689,1,300627
39536,0.041335,172.31.36.0-255,1514,271203,1,300627
39537,0.041338,172.31.36.0-255,1514,272717,1,300627
39538,0.041339,172.31.36.0-255,1514,274231,1,300627
39539,0.04134,172.31.36.0-255,1514,275745,1,300627
39540,0.041369,172.31.36.0-255,1468,277213,1,300627
39541,0.042687,104.244.42.0-255,66,277279,1,300627
39542,0.042742,104.244.42.0-255,66,277345,1,300627
39543,0.042868,104.244.42.0-255,66,277411,1,300627
39544,0.043224,74.125.130.0-255,5738,283149,1,300627
39545,0.04323,172.31.36.0-255,66,283215,1,300627
39546,0.045228,74.125.130.0-255,5738,288953,1,300627
39547,0.045235,172.31.36.0-255,66,289019,1,300627
39548,0.047238,74.125.130.0-255,5738,294757,1,300627
39549,0.047245,172.31.36.0-255,66,294823,1,300627
39550,0.049241,74.125.130.0-255,5738,300561,1,300627
39551,0.049248,172.31.36.0-255,66,300627,1,300627
39552,0.0,172.31.36.0-255,66,66,1,66
39553,0.0,74.125.200.0-255,153,153,1,355695
39554,3.4e-05,172.31.36.0-255,66,219,1,355695
39555,4.1e-05,74.125.200.0-255,1484,1703,1,355695
39556,4.5e-05,172.31.36.0-255,66,1769,1,355695
39557,5e-05,74.125.200.0-255,2902,4671,1,355695
39558,6.2e-05,172.31.36.0-255,66,4737,1,355695
39559,9.4e-05,74.125.200.0-255,7156,11893,1,355695
39560,9.8e-05,172.31.36.0-255,66,11959,1,355695
39561,0.000129,74.125.200.0-255,2087,14046,1,355695
39562,0.000132,172.31.36.0-255,66,14112,1,355695
39563,0.000251,74.125.200.0-255,1484,15596,1,355695
39564,0.000255,172.31.36.0-255,66,15662,1,355695
39565,0.000281,74.125.200.0-255,1484,17146,1,355695
39566,0.000284,172.31.36.0-255,66,17212,1,355695
39567,0.000289,74.125.200.0-255,2902,20114,1,355695
39568,0.000291,172.31.36.0-255,66,20180,1,355695
39569,0.000321,74.125.200.0-255,5738,25918,1,355695
39570,0.000324,172.31.36.0-255,66,25984,1,355695
39571,0.000328,74.125.200.0-255,2902,28886,1,355695
39572,0.000331,172.31.36.0-255,66,28952,1,355695
39573,0.000349,74.125.200.0-255,1484,30436,1,355695
39574,0.000352,172.31.36.0-255,66,30502,1,355695
39575,0.000373,74.125.200.0-255,2543,33045,1,355695
39576,0.000377,172.31.36.0-255,66,33111,1,355695
39577,0.000385,74.125.200.0-255,1484,34595,1,355695
39578,0.000387,172.31.36.0-255,66,34661,1,355695
39579,0.000392,74.125.200.0-255,2902,37563,1,355695
39580,0.000394,172.31.36.0-255,66,37629,1,355695
39581,0.000426,74.125.200.0-255,5738,43367,1,355695
39582,0.00043,172.31.36.0-255,66,43433,1,355695
39583,0.000433,74.125.200.0-255,1484,44917,1,355695
39584,0.000439,172.31.36.0-255,66,44983,1,355695
39585,0.000472,172.31.36.0-255,66,45049,1,355695
39586,0.000477,74.125.200.0-255,2902,47951,1,355695
39587,0.00048,172.31.36.0-255,66,48017,1,355695
39588,0.000507,74.125.200.0-255,5738,53755,1,355695
39589,0.00051,172.31.36.0-255,66,53821,1,355695
39590,0.000532,74.125.200.0-255,3958,57779,1,355695
39591,0.000535,172.31.36.0-255,66,57845,1,355695
39592,0.000622,74.125.200.0-255,1484,59329,1,355695
39593,0.000629,74.125.200.0-255,2902,62231,1,355695
39594,0.000632,74.125.200.0-255,2902,65133,1,355695
39595,0.000633,172.31.36.0-255,66,65199,1,355695
39596,0.000637,172.31.36.0-255,66,65265,1,355695
39597,0.000661,74.125.200.0-255,1484,66749,1,355695
39598,0.00068,74.125.200.0-255,4320,71069,1,355695
39599,0.000681,172.31.36.0-255,66,71135,1,355695
39600,0.000684,172.31.36.0-255,66,71201,1,355695
39601,0.000705,74.125.200.0-255,5738,76939,1,355695
39602,0.000709,172.31.36.0-255,66,77005,1,355695
39603,0.000738,74.125.200.0-255,6438,83443,1,355695
39604,0.000742,172.31.36.0-255,66,83509,1,355695
39605,0.000767,74.125.200.0-255,354,83863,1,355695
39606,0.000959,74.125.200.0-255,1484,85347,1,355695
39607,0.000963,172.31.36.0-255,66,85413,1,355695
39608,0.000969,74.125.200.0-255,2902,88315,1,355695
39609,0.000971,172.31.36.0-255,66,88381,1,355695
39610,0.000995,74.125.200.0-255,5738,94119,1,355695
39611,0.000999,172.31.36.0-255,66,94185,1,355695
39612,0.001057,74.125.200.0-255,7156,101341,1,355695
39613,0.001061,172.31.36.0-255,66,101407,1,355695
39614,0.001072,172.31.36.0-255,66,101473,1,355695
39615,0.001082,74.125.200.0-255,2902,104375,1,355695
39616,0.001084,172.31.36.0-255,66,104441,1,355695
39617,0.001126,74.125.200.0-255,5020,109461,1,355695
39618,0.001129,172.31.36.0-255,66,109527,1,355695
39619,0.001205,74.125.200.0-255,1484,111011,1,355695
39620,0.00121,74.125.200.0-255,2902,113913,1,355695
39621,0.001214,172.31.36.0-255,66,113979,1,355695
39622,0.00122,74.125.200.0-255,1484,115463,1,355695
39623,0.001223,74.125.200.0-255,1484,116947,1,355695
39624,0.001225,172.31.36.0-255,66,117013,1,355695
39625,0.001245,74.125.200.0-255,1484,118497,1,355695
39626,0.001251,74.125.200.0-255,4320,122817,1,355695
39627,0.001254,172.31.36.0-255,66,122883,1,355695
39628,0.001271,74.125.200.0-255,1484,124367,1,355695
39629,0.001276,74.125.200.0-255,2902,127269,1,355695
39630,0.001278,172.31.36.0-255,66,127335,1,355695
39631,0.001316,172.31.36.0-255,66,127401,1,355695
39632,0.001331,74.125.200.0-255,4320,131721,1,355695
39633,0.001334,172.31.36.0-255,66,131787,1,355695
39634,0.001358,74.125.200.0-255,3602,135389,1,355695
39635,0.001362,172.31.36.0-255,66,135455,1,355695
39636,0.001393,74.125.200.0-255,4320,139775,1,355695
39637,0.001396,172.31.36.0-255,66,139841,1,355695
39638,0.001427,74.125.200.0-255,5738,145579,1,355695
39639,0.001431,172.31.36.0-255,66,145645,1,355695
39640,0.001437,74.125.200.0-255,5738,151383,1,355695
39641,0.00144,172.31.36.0-255,66,151449,1,355695
39642,0.001444,74.125.200.0-255,2902,154351,1,355695
39643,0.001452,172.31.36.0-255,66,154417,1,355695
39644,0.001486,74.125.200.0-255,4320,158737,1,355695
39645,0.001489,172.31.36.0-255,66,158803,1,355695
39646,0.001508,172.31.36.0-255,66,158869,1,355695
39647,0.001539,74.125.200.0-255,7156,166025,1,355695
39648,0.001543,172.31.36.0-255,66,166091,1,355695
39649,0.001587,74.125.200.0-255,2902,168993,1,355695
39650,0.001591,172.31.36.0-255,66,169059,1,355695
39651,0.001624,74.125.200.0-255,5738,174797,1,355695
39652,0.001627,172.31.36.0-255,66,174863,1,355695
39653,0.001631,74.125.200.0-255,2902,177765,1,355695
39654,0.001633,172.31.36.0-255,66,177831,1,355695
39655,0.001654,74.125.200.0-255,2902,180733,1,355695
39656,0.001656,172.31.36.0-255,66,180799,1,355695
39657,0.001677,74.125.200.0-255,1484,182283,1,355695
39658,0.00168,74.125.200.0-255,1484,183767,1,355695
39659,0.001687,172.31.36.0-255,66,183833,1,355695
39660,0.00171,74.125.200.0-255,2902,186735,1,355695
39661,0.001713,74.125.200.0-255,1484,188219,1,355695
39662,0.001714,172.31.36.0-255,66,188285,1,355695
39663,0.001742,74.125.200.0-255,4320,192605,1,355695
39664,0.001746,172.31.36.0-255,66,192671,1,355695
39665,0.001749,74.125.200.0-255,766,193437,1,355695
39666,0.001971,74.125.200.0-255,1484,194921,1,355695
39667,0.001978,172.31.36.0-255,66,194987,1,355695
39668,0.001984,74.125.200.0-255,2902,197889,1,355695
39669,0.001986,172.31.36.0-255,66,197955,1,355695
39670,0.001993,74.125.200.0-255,5738,203693,1,355695
39671,0.002001,172.31.36.0-255,66,203759,1,355695
39672,0.002056,172.31.36.0-255,66,203825,1,355695
39673,0.002071,74.125.200.0-255,1484,205309,1,355695
39674,0.002081,74.125.200.0-255,4320,209629,1,355695
39675,0.002083,172.31.36.0-255,66,209695,1,355695
39676,0.002089,74.125.200.0-255,6438,216133,1,355695
39677,0.002091,172.31.36.0-255,66,216199,1,355695
39678,0.004118,74.125.200.0-255,5738,221937,1,355695
39679,0.004124,172.31.36.0-255,66,222003,1,355695
39680,0.006151,74.125.200.0-255,4320,226323,1,355695
39681,0.006155,172.31.36.0-255,66,226389,1,355695
39682,0.006176,74.125.200.0-255,1484,227873,1,355695
39683,0.008177,74.125.200.0-255,4320,232193,1,355695
39684,0.008183,172.31.36.0-255,66,232259,1,355695
39685,0.010224,74.125.200.0-255,5738,237997,1,355695
39686,0.01023,172.31.36.0-255,66,238063,1,355695
39687,0.012309,74.125.200.0-255,5738,243801,1,355695
39688,0.012316,172.31.36.0-255,66,243867,1,355695
39689,0.014344,74.125.200.0-255,5738,249605,1,355695
39690,0.01435,172.31.36.0-255,66,249671,1,355695
39691,0.016378,74.125.200.0-255,5738,255409,1,355695
39692,0.016384,172.31.36.0-255,66,255475,1,355695
39693,0.018427,74.125.200.0-255,5738,261213,1,355695
39694,0.018436,172.31.36.0-255,66,261279,1,355695
39695,0.020482,74.125.200.0-255,5738,267017,1,355695
39696,0.020491,172.31.36.0-255,66,267083,1,355695
39697,0.022523,74.125.200.0-255,5738,272821,1,355695
39698,0.022531,172.31.36.0-255,66,272887,1,355695
39699,0.024571,74.125.200.0-255,5738,278625,1,355695
39700,0.024577,172.31.36.0-255,66,278691,1,355695
39701,0.026612,74.125.200.0-255,5738,284429,1,355695
39702,0.026619,172.31.36.0-255,66,284495,1,355695
39703,0.02865,74.125.200.0-255,5738,290233,1,355695
39704,0.028656,172.31.36.0-255,66,290299,1,355695
39705,0.030684,74.125.200.0-255,5738,296037,1,355695
39706,0.030691,172.31.36.0-255,66,296103,1,355695
39707,0.032721,74.125.200.0-255,5738,301841,1,355695
39708,0.032728,172.31.36.0-255,66,301907,1,355695
39709,0.034074,172.31.36.0-255,171,302078,1,355695
39710,0.034097,172.31.36.0-255,1136,303214,1,355695
39711,0.034147,172.31.36.0-255,1514,304728,1,355695
39712,0.034168,172.31.36.0-255,1514,306242,1,355695
39713,0.034169,172.31.36.0-255,1514,307756,1,355695
39714,0.03419,172.31.36.0-255,1045,308801,1,355695
39715,0.034762,74.125.200.0-255,5738,314539,1,355695
39716,0.034768,172.31.36.0-255,66,314605,1,355695
39717,0.03555,104.244.42.0-255,66,314671,1,355695
39718,0.035584,104.244.42.0-255,66,314737,1,355695
39719,0.035658,104.244.42.0-255,66,314803,1,355695
39720,0.035687,104.244.42.0-255,66,314869,1,355695
39721,0.035689,104.244.42.0-255,66,314935,1,355695
39722,0.036799,74.125.200.0-255,5738,320673,1,355695
39723,0.036804,172.31.36.0-255,66,320739,1,355695
39724,0.03883,74.125.200.0-255,5738,326477,1,355695
39725,0.038835,172.31.36.0-255,66,326543,1,355695
39726,0.040854,74.125.200.0-255,5738,332281,1,355695
39727,0.040859,172.31.36.0-255,66,332347,1,355695
39728,0.042887,74.125.200.0-255,5738,338085,1,355695
39729,0.042892,172.31.36.0-255,66,338151,1,355695
39730,0.044925,74.125.200.0-255,5738,343889,1,355695
39731,0.044944,172.31.36.0-255,66,343955,1,355695
39732,0.047003,74.125.200.0-255,5738,349693,1,355695
39733,0.047008,172.31.36.0-255,66,349759,1,355695
39734,0.049025,74.125.200.0-255,2902,352661,1,355695
39735,0.04903,172.31.36.0-255,66,352727,1,355695
39736,0.049063,74.125.200.0-255,2902,355629,1,355695
39737,0.049066,172.31.36.0-255,66,355695,1,355695
39738,0.0,74.125.68.0-255,143,143,1,213457
39739,2.4e-05,172.31.36.0-255,66,209,1,213457
39740,3.1e-05,74.125.68.0-255,1484,1693,1,213457
39741,3.5e-05,172.31.36.0-255,66,1759,1,213457
39742,4e-05,74.125.68.0-255,2902,4661,1,213457
39743,4.5e-05,172.31.36.0-255,66,4727,1,213457
39744,6.5e-05,74.125.68.0-255,1484,6211,1,213457
39745,6.8e-05,172.31.36.0-255,66,6277,1,213457
39746,7.4e-05,74.125.68.0-255,2902,9179,1,213457
39747,7.7e-05,172.31.36.0-255,66,9245,1,213457
39748,0.000117,74.125.68.0-255,4846,14091,1,213457
39749,0.00012,172.31.36.0-255,66,14157,1,213457
39750,0.000461,74.125.68.0-255,1484,15641,1,213457
39751,0.000467,172.31.36.0-255,66,15707,1,213457
39752,0.000473,74.125.68.0-255,2902,18609,1,213457
39753,0.000475,172.31.36.0-255,66,18675,1,213457
39754,0.000497,74.125.68.0-255,5738,24413,1,213457
39755,0.0005,172.31.36.0-255,66,24479,1,213457
39756,0.000528,74.125.68.0-255,6797,31276,1,213457
39757,0.000533,172.31.36.0-255,66,31342,1,213457
39758,0.000631,74.125.68.0-255,1484,32826,1,213457
39759,0.000635,172.31.36.0-255,66,32892,1,213457
39760,0.000639,74.125.68.0-255,2902,35794,1,213457
39761,0.000642,172.31.36.0-255,66,35860,1,213457
39762,0.000657,74.125.68.0-255,4320,40180,1,213457
39763,0.000663,172.31.36.0-255,66,40246,1,213457
39764,0.000672,74.125.68.0-255,1484,41730,1,213457
39765,0.000675,172.31.36.0-255,66,41796,1,213457
39766,0.00068,74.125.68.0-255,2902,44698,1,213457
39767,0.000682,172.31.36.0-255,66,44764,1,213457
39768,0.000688,74.125.68.0-255,3961,48725,1,213457
39769,0.000691,172.31.36.0-255,66,48791,1,213457
39770,0.000707,74.125.68.0-255,2902,51693,1,213457
39771,0.00071,172.31.36.0-255,66,51759,1,213457
39772,0.000738,74.125.68.0-255,5738,57497,1,213457
39773,0.000741,172.31.36.0-255,66,57563,1,213457
39774,0.000746,74.125.68.0-255,4320,61883,1,213457
39775,0.000748,172.31.36.0-255,66,61949,1,213457
39776,0.000784,74.125.68.0-255,3961,65910,1,213457
39777,0.000787,172.31.36.0-255,66,65976,1,213457
39778,0.001727,74.125.68.0-255,646,66622,1,213457
39779,0.001884,74.125.68.0-255,1484,68106,1,213457
39780,0.00189,172.31.36.0-255,66,68172,1,213457
39781,0.001897,74.125.68.0-255,2902,71074,1,213457
39782,0.001899,172.31.36.0-255,66,71140,1,213457
39783,0.001952,74.125.68.0-255,5738,76878,1,213457
39784,0.001954,172.31.36.0-255,66,76944,1,213457
39785,0.001966,172.31.36.0-255,66,77010,1,213457
39786,0.001973,74.125.68.0-255,5738,82748,1,213457
39787,0.001975,172.31.36.0-255,66,82814,1,213457
39788,0.002004,74.125.68.0-255,5738,88552,1,213457
39789,0.002007,172.31.36.0-255,66,88618,1,213457
39790,0.002011,74.125.68.0-255,2184,90802,1,213457
39791,0.002014,172.31.36.0-255,66,90868,1,213457
39792,0.004324,74.125.68.0-255,5738,96606,1,213457
39793,0.004329,172.31.36.0-255,66,96672,1,213457
39794,0.006648,74.125.68.0-255,4320,100992,1,213457
39795,0.006653,172.31.36.0-255,66,101058,1,213457
39796,0.006665,74.125.68.0-255,1484,102542,1,213457
39797,0.008979,74.125.68.0-255,4320,106862,1,213457
39798,0.008985,172.31.36.0-255,66,106928,1,213457
39799,0.011318,74.125.68.0-255,5738,112666,1,213457
39800,0.011325,172.31.36.0-255,66,112732,1,213457
39801,0.01365,74.125.68.0-255,5738,118470,1,213457
39802,0.013659,172.31.36.0-255,66,118536,1,213457
39803,0.016002,74.125.68.0-255,5738,124274,1,213457
39804,0.016009,172.31.36.0-255,66,124340,1,213457
39805,0.018351,74.125.68.0-255,5738,130078,1,213457
39806,0.018361,172.31.36.0-255,66,130144,1,213457
39807,0.020694,74.125.68.0-255,5738,135882,1,213457
39808,0.020704,172.31.36.0-255,66,135948,1,213457
39809,0.023064,74.125.68.0-255,5738,141686,1,213457
39810,0.023071,172.31.36.0-255,66,141752,1,213457
39811,0.025411,74.125.68.0-255,5738,147490,1,213457
39812,0.025418,172.31.36.0-255,66,147556,1,213457
39813,0.027759,74.125.68.0-255,5738,153294,1,213457
39814,0.027767,172.31.36.0-255,66,153360,1,213457
39815,0.030098,74.125.68.0-255,5738,159098,1,213457
39816,0.030105,172.31.36.0-255,66,159164,1,213457
39817,0.032441,74.125.68.0-255,5738,164902,1,213457
39818,0.032449,172.31.36.0-255,66,164968,1,213457
39819,0.034817,74.125.68.0-255,5738,170706,1,213457
39820,0.034825,172.31.36.0-255,66,170772,1,213457
39821,0.036918,172.31.36.0-255,182,170954,1,213457
39822,0.036961,172.31.36.0-255,1113,172067,1,213457
39823,0.03703,172.31.36.0-255,1514,173581,1,213457
39824,0.037032,172.31.36.0-255,1514,175095,1,213457
39825,0.037033,172.31.36.0-255,1514,176609,1,213457
39826,0.037035,172.31.36.0-255,1514,178123,1,213457
39827,0.037069,172.31.36.0-255,1490,179613,1,213457
39828,0.037157,74.125.68.0-255,4320,183933,1,213457
39829,0.037162,172.31.36.0-255,66,183999,1,213457
39830,0.037181,74.125.68.0-255,1484,185483,1,213457
39831,0.038476,104.244.42.0-255,66,185549,1,213457
39832,0.0385,104.244.42.0-255,66,185615,1,213457
39833,0.038633,104.244.42.0-255,66,185681,1,213457
39834,0.039496,74.125.68.0-255,4320,190001,1,213457
39835,0.039504,172.31.36.0-255,66,190067,1,213457
39836,0.039617,104.244.42.0-255,108,190175,1,213457
39837,0.039622,172.31.36.0-255,66,190241,1,213457
39838,0.04184,74.125.68.0-255,5738,195979,1,213457
39839,0.041847,172.31.36.0-255,66,196045,1,213457
39840,0.044174,74.125.68.0-255,5738,201783,1,213457
39841,0.044181,172.31.36.0-255,66,201849,1,213457
39842,0.046502,74.125.68.0-255,5738,207587,1,213457
39843,0.046508,172.31.36.0-255,66,207653,1,213457
39844,0.048844,74.125.68.0-255,5738,213391,1,213457
39845,0.048855,172.31.36.0-255,66,213457,1,213457
39846,0.0,172.253.118.0-255,153,153,1,307857
39847,3.6e-05,172.31.36.0-255,66,219,1,307857
39848,4.3e-05,172.253.118.0-255,1484,1703,1,307857
39849,4.7e-05,172.31.36.0-255,66,1769,1,307857
39850,5.2e-05,172.253.118.0-255,2902,4671,1,307857
39851,5.4e-05,172.31.36.0-255,66,4737,1,307857
39852,6.2e-05,172.253.118.0-255,7156,11893,1,307857
39853,6.4e-05,172.31.36.0-255,66,11959,1,307857
39854,6.8e-05,172.253.118.0-255,1976,13935,1,307857
39855,7e-05,172.31.36.0-255,66,14001,1,307857
39856,0.0001,172.253.118.0-255,2902,16903,1,307857
39857,0.000103,172.31.36.0-255,66,16969,1,307857
39858,0.000133,172.31.36.0-255,66,17035,1,307857
39859,0.000139,172.253.118.0-255,5379,22414,1,307857
39860,0.000142,172.31.36.0-255,66,22480,1,307857
39861,0.000156,172.253.118.0-255,1484,23964,1,307857
39862,0.000159,172.31.36.0-255,66,24030,1,307857
39863,0.000162,172.253.118.0-255,1484,25514,1,307857
39864,0.000164,172.31.36.0-255,66,25580,1,307857
39865,0.000193,172.253.118.0-255,1484,27064,1,307857
39866,0.000195,172.31.36.0-255,66,27130,1,307857
39867,0.000204,172.253.118.0-255,5738,32868,1,307857
39868,0.000207,172.31.36.0-255,66,32934,1,307857
39869,0.000215,172.253.118.0-255,6797,39731,1,307857
39870,0.000218,172.31.36.0-255,66,39797,1,307857
39871,0.000586,172.253.118.0-255,1484,41281,1,307857
39872,0.000592,172.31.36.0-255,66,41347,1,307857
39873,0.000597,172.253.118.0-255,2902,44249,1,307857
39874,0.000599,172.31.36.0-255,66,44315,1,307857
39875,0.000602,172.253.118.0-255,1484,45799,1,307857
39876,0.000604,172.31.36.0-255,66,45865,1,307857
39877,0.000621,172.253.118.0-255,4320,50185,1,307857
39878,0.000624,172.31.36.0-255,66,50251,1,307857
39879,0.000657,172.253.118.0-255,2902,53153,1,307857
39880,0.000661,172.31.36.0-255,66,53219,1,307857
39881,0.00068,172.253.118.0-255,3961,57180,1,307857
39882,0.000683,172.31.36.0-255,66,57246,1,307857
39883,0.000753,172.253.118.0-255,1484,58730,1,307857
39884,0.000759,172.253.118.0-255,2902,61632,1,307857
39885,0.000762,172.31.36.0-255,66,61698,1,307857
39886,0.000788,172.253.118.0-255,5738,67436,1,307857
39887,0.00079,172.31.36.0-255,66,67502,1,307857
39888,0.000815,172.253.118.0-255,7156,74658,1,307857
39889,0.000817,172.31.36.0-255,66,74724,1,307857
39890,0.000837,172.253.118.0-255,6797,81521,1,307857
39891,0.00084,172.31.36.0-255,66,81587,1,307857
39892,0.00085,172.31.36.0-255,66,81653,1,307857
39893,0.000853,172.253.118.0-255,1125,82778,1,307857
39894,0.000921,172.253.118.0-255,1484,84262,1,307857
39895,0.000926,172.31.36.0-255,66,84328,1,307857
39896,0.000931,172.253.118.0-255,2902,87230,1,307857
39897,0.000933,172.31.36.0-255,66,87296,1,307857
39898,0.000951,172.253.118.0-255,5738,93034,1,307857
39899,0.000954,172.31.36.0-255,66,93100,1,307857
39900,0.000966,172.253.118.0-255,1484,94584,1,307857
39901,0.000986,172.31.36.0-255,66,94650,1,307857
39902,0.00102,172.253.118.0-255,4320,98970,1,307857
39903,0.001028,172.31.36.0-255,66,99036,1,307857
39904,0.001044,172.31.36.0-255,66,99102,1,307857
39905,0.001101,172.253.118.0-255,1484,100586,1,307857
39906,0.001106,172.253.118.0-255,2902,103488,1,307857
39907,0.001109,172.31.36.0-255,66,103554,1,307857
39908,0.001134,172.253.118.0-255,5738,109292,1,307857
39909,0.001137,172.31.36.0-255,66,109358,1,307857
39910,0.001166,172.31.36.0-255,66,109424,1,307857
39911,0.001173,172.253.118.0-255,4320,113744,1,307857
39912,0.001175,172.31.36.0-255,66,113810,1,307857
39913,0.001221,172.253.118.0-255,2902,116712,1,307857
39914,0.001225,172.31.36.0-255,66,116778,1,307857
39915,0.00124,172.253.118.0-255,3602,120380,1,307857
39916,0.001243,172.31.36.0-255,66,120446,1,307857
39917,0.001281,172.253.118.0-255,7156,127602,1,307857
39918,0.001285,172.31.36.0-255,66,127668,1,307857
39919,0.001296,172.31.36.0-255,66,127734,1,307857
39920,0.00132,172.253.118.0-255,4320,132054,1,307857
39921,0.001324,172.31.36.0-255,66,132120,1,307857
39922,0.001349,172.253.118.0-255,2902,135022,1,307857
39923,0.001352,172.31.36.0-255,66,135088,1,307857
39924,0.001358,172.31.36.0-255,66,135154,1,307857
39925,0.001375,172.253.118.0-255,2184,137338,1,307857
39926,0.001378,172.31.36.0-255,66,137404,1,307857
39927,0.001435,172.253.118.0-255,2902,140306,1,307857
39928,0.001439,172.31.36.0-255,66,140372,1,307857
39929,0.001446,172.253.118.0-255,7156,147528,1,307857
39930,0.001448,172.31.36.0-255,66,147594,1,307857
39931,0.001461,172.31.36.0-255,66,147660,1,307857
39932,0.001499,172.31.36.0-255,66,147726,1,307857
39933,0.001541,172.253.118.0-255,1484,149210,1,307857
39934,0.001556,172.253.118.0-255,2902,152112,1,307857
39935,0.001559,172.31.36.0-255,66,152178,1,307857
39936,0.001562,172.253.118.0-255,1484,153662,1,307857
39937,0.001579,172.253.118.0-255,4320,157982,1,307857
39938,0.001581,172.31.36.0-255,66,158048,1,307857
39939,0.001597,172.253.118.0-255,1484,159532,1,307857
39940,0.001624,172.31.36.0-255,66,159598,1,307857
39941,0.001631,172.253.118.0-255,5738,165336,1,307857
39942,0.001633,172.31.36.0-255,66,165402,1,307857
39943,0.001655,172.253.118.0-255,7156,172558,1,307857
39944,0.00166,172.31.36.0-255,66,172624,1,307857
39945,0.001668,172.253.118.0-255,766,173390,1,307857
39946,0.001697,172.253.118.0-255,1484,174874,1,307857
39947,0.001701,172.31.36.0-255,66,174940,1,307857
39948,0.001707,172.253.118.0-255,4320,179260,1,307857
39949,0.00171,172.31.36.0-255,66,179326,1,307857
39950,0.00174,172.253.118.0-255,5738,185064,1,307857
39951,0.001743,172.31.36.0-255,66,185130,1,307857
39952,0.00175,172.253.118.0-255,7156,192286,1,307857
39953,0.001752,172.31.36.0-255,66,192352,1,307857
39954,0.001778,172.31.36.0-255,66,192418,1,307857
39955,0.0018,172.253.118.0-255,1484,193902,1,307857
39956,0.001804,172.253.118.0-255,766,194668,1,307857
39957,0.001806,172.31.36.0-255,66,194734,1,307857
39958,0.001855,172.253.118.0-255,1484,196218,1,307857
39959,0.00186,172.253.118.0-255,2902,199120,1,307857
39960,0.001863,172.31.36.0-255,66,199186,1,307857
39961,0.001888,172.253.118.0-255,5738,204924,1,307857
39962,0.001892,172.31.36.0-255,66,204990,1,307857
39963,0.001899,172.253.118.0-255,7156,212146,1,307857
39964,0.001902,172.31.36.0-255,66,212212,1,307857
39965,0.001951,172.253.118.0-255,2184,214396,1,307857
39966,0.001952,172.31.36.0-255,66,214462,1,307857
39967,0.001955,172.31.36.0-255,66,214528,1,307857
39968,0.004001,172.253.118.0-255,5738,220266,1,307857
39969,0.004006,172.31.36.0-255,66,220332,1,307857
39970,0.006056,172.253.118.0-255,5738,226070,1,307857
39971,0.006059,172.31.36.0-255,66,226136,1,307857
39972,0.008109,172.253.118.0-255,5738,231874,1,307857
39973,0.008115,172.31.36.0-255,66,231940,1,307857
39974,0.010167,172.253.118.0-255,5738,237678,1,307857
39975,0.010174,172.31.36.0-255,66,237744,1,307857
39976,0.012256,172.253.118.0-255,5738,243482,1,307857
39977,0.012263,172.31.36.0-255,66,243548,1,307857
39978,0.014327,172.253.118.0-255,5738,249286,1,307857
39979,0.014333,172.31.36.0-255,66,249352,1,307857
39980,0.016391,172.253.118.0-255,5738,255090,1,307857
39981,0.016399,172.31.36.0-255,66,255156,1,307857
39982,0.018465,172.253.118.0-255,5738,260894,1,307857
39983,0.018472,172.31.36.0-255,66,260960,1,307857
39984,0.020611,172.253.118.0-255,5738,266698,1,307857
39985,0.020621,172.31.36.0-255,66,266764,1,307857
39986,0.022691,172.253.118.0-255,5738,272502,1,307857
39987,0.022697,172.31.36.0-255,66,272568,1,307857
39988,0.024753,172.253.118.0-255,5738,278306,1,307857
39989,0.024761,172.31.36.0-255,66,278372,1,307857
39990,0.026817,172.253.118.0-255,5738,284110,1,307857
39991,0.026824,172.31.36.0-255,66,284176,1,307857
39992,0.028908,172.253.118.0-255,5738,289914,1,307857
39993,0.028915,172.31.36.0-255,66,289980,1,307857
39994,0.030975,172.253.118.0-255,5738,295718,1,307857
39995,0.030983,172.31.36.0-255,66,295784,1,307857
39996,0.033051,172.253.118.0-255,2484,298268,1,307857
39997,0.033058,172.31.36.0-255,66,298334,1,307857
39998,0.033251,172.31.36.0-255,105,298439,1,307857
39999,0.035271,172.253.118.0-255,66,298505,1,307857
40000,0.041698,172.31.36.0-255,188,298693,1,307857
40001,0.04173,172.31.36.0-255,958,299651,1,307857
40002,0.041802,172.31.36.0-255,1514,301165,1,307857
40003,0.041805,172.31.36.0-255,1514,302679,1,307857
40004,0.041806,172.31.36.0-255,1514,304193,1,307857
40005,0.041807,172.31.36.0-255,1514,305707,1,307857
40006,0.04184,172.31.36.0-255,1514,307221,1,307857
40007,0.041842,172.31.36.0-255,198,307419,1,307857
40008,0.0432,104.244.42.0-255,66,307485,1,307857
40009,0.04329,104.244.42.0-255,66,307551,1,307857
40010,0.04334,104.244.42.0-255,66,307617,1,307857
40011,0.043388,104.244.42.0-255,66,307683,1,307857
40012,0.044017,104.244.42.0-255,108,307791,1,307857
40013,0.044026,172.31.36.0-255,66,307857,1,307857
40014,0.0,74.125.200.0-255,153,153,1,267092
40015,2.3e-05,172.31.36.0-255,66,219,1,267092
40016,4.3e-05,74.125.200.0-255,1484,1703,1,267092
40017,4.7e-05,172.31.36.0-255,66,1769,1,267092
40018,6.8e-05,74.125.200.0-255,2902,4671,1,267092
40019,7.1e-05,172.31.36.0-255,66,4737,1,267092
40020,0.0001,74.125.200.0-255,5738,10475,1,267092
40021,0.000103,172.31.36.0-255,66,10541,1,267092
40022,0.000137,74.125.200.0-255,3446,13987,1,267092
40023,0.00014,172.31.36.0-255,66,14053,1,267092
40024,0.000209,74.125.200.0-255,1484,15537,1,267092
40025,0.000213,172.31.36.0-255,66,15603,1,267092
40026,0.000217,74.125.200.0-255,2902,18505,1,267092
40027,0.00022,172.31.36.0-255,66,18571,1,267092
40028,0.000255,74.125.200.0-255,5738,24309,1,267092
40029,0.000259,172.31.36.0-255,66,24375,1,267092
40030,0.000264,74.125.200.0-255,4320,28695,1,267092
40031,0.000266,172.31.36.0-255,66,28761,1,267092
40032,0.0003,74.125.200.0-255,1484,30245,1,267092
40033,0.000304,172.31.36.0-255,66,30311,1,267092
40034,0.00034,172.31.36.0-255,66,30377,1,267092
40035,0.000371,74.125.200.0-255,4320,34697,1,267092
40036,0.000375,172.31.36.0-255,66,34763,1,267092
40037,0.000401,74.125.200.0-255,3961,38724,1,267092
40038,0.000404,172.31.36.0-255,66,38790,1,267092
40039,0.000685,74.125.200.0-255,1484,40274,1,267092
40040,0.000689,172.31.36.0-255,66,40340,1,267092
40041,0.000695,74.125.200.0-255,2902,43242,1,267092
40042,0.000697,172.31.36.0-255,66,43308,1,267092
40043,0.0007,74.125.200.0-255,1484,44792,1,267092
40044,0.000708,172.31.36.0-255,66,44858,1,267092
40045,0.00074,74.125.200.0-255,2902,47760,1,267092
40046,0.000743,172.31.36.0-255,66,47826,1,267092
40047,0.00075,74.125.200.0-255,4320,52146,1,267092
40048,0.000752,172.31.36.0-255,66,52212,1,267092
40049,0.000778,74.125.200.0-255,1484,53696,1,267092
40050,0.000786,74.125.200.0-255,1484,55180,1,267092
40051,0.000789,172.31.36.0-255,66,55246,1,267092
40052,0.000793,74.125.200.0-255,1705,56951,1,267092
40053,0.000795,172.31.36.0-255,66,57017,1,267092
40054,0.001013,74.125.200.0-255,1484,58501,1,267092
40055,0.001023,74.125.200.0-255,2902,61403,1,267092
40056,0.001027,172.31.36.0-255,66,61469,1,267092
40057,0.001058,74.125.200.0-255,5738,67207,1,267092
40058,0.001061,172.31.36.0-255,66,67273,1,267092
40059,0.001068,74.125.200.0-255,6797,74070,1,267092
40060,0.00107,172.31.36.0-255,66,74136,1,267092
40061,0.001104,74.125.200.0-255,7156,81292,1,267092
40062,0.001107,172.31.36.0-255,66,81358,1,267092
40063,0.001111,74.125.200.0-255,1484,82842,1,267092
40064,0.001139,74.125.200.0-255,4320,87162,1,267092
40065,0.001142,172.31.36.0-255,66,87228,1,267092
40066,0.00117,74.125.200.0-255,3961,91189,1,267092
40067,0.001172,172.31.36.0-255,66,91255,1,267092
40068,0.001825,74.125.200.0-255,1484,92739,1,267092
40069,0.001833,74.125.200.0-255,2902,95641,1,267092
40070,0.001837,172.31.36.0-255,66,95707,1,267092
40071,0.001859,74.125.200.0-255,5738,101445,1,267092
40072,0.001861,172.31.36.0-255,66,101511,1,267092
40073,0.001866,74.125.200.0-255,2902,104413,1,267092
40074,0.001867,172.31.36.0-255,66,104479,1,267092
40075,0.0019,74.125.200.0-255,4320,108799,1,267092
40076,0.001903,172.31.36.0-255,66,108865,1,267092
40077,0.001913,172.31.36.0-255,66,108931,1,267092
40078,0.001917,74.125.200.0-255,2902,111833,1,267092
40079,0.001918,172.31.36.0-255,66,111899,1,267092
40080,0.001952,74.125.200.0-255,5020,116919,1,267092
40081,0.001955,172.31.36.0-255,66,116985,1,267092
40082,0.001994,74.125.200.0-255,1484,118469,1,267092
40083,0.002008,74.125.200.0-255,1484,119953,1,267092
40084,0.00201,172.31.36.0-255,66,120019,1,267092
40085,0.003932,74.125.200.0-255,2902,122921,1,267092
40086,0.003935,172.31.36.0-255,66,122987,1,267092
40087,0.003975,74.125.200.0-255,1484,124471,1,267092
40088,0.003985,74.125.200.0-255,1484,125955,1,267092
40089,0.003987,172.31.36.0-255,66,126021,1,267092
40090,0.005902,74.125.200.0-255,1484,127505,1,267092
40091,0.005917,74.125.200.0-255,1484,128989,1,267092
40092,0.005922,172.31.36.0-255,66,129055,1,267092
40093,0.005955,74.125.200.0-255,2902,131957,1,267092
40094,0.005958,172.31.36.0-255,66,132023,1,267092
40095,0.007937,74.125.200.0-255,4320,136343,1,267092
40096,0.007943,172.31.36.0-255,66,136409,1,267092
40097,0.007977,74.125.200.0-255,1484,137893,1,267092
40098,0.00992,74.125.200.0-255,4320,142213,1,267092
40099,0.009928,172.31.36.0-255,66,142279,1,267092
40100,0.011899,74.125.200.0-255,5738,148017,1,267092
40101,0.011906,172.31.36.0-255,66,148083,1,267092
40102,0.013883,74.125.200.0-255,5738,153821,1,267092
40103,0.013893,172.31.36.0-255,66,153887,1,267092
40104,0.015885,74.125.200.0-255,5738,159625,1,267092
40105,0.015892,172.31.36.0-255,66,159691,1,267092
40106,0.017864,74.125.200.0-255,5738,165429,1,267092
40107,0.017872,172.31.36.0-255,66,165495,1,267092
40108,0.01986,74.125.200.0-255,5738,171233,1,267092
40109,0.019868,172.31.36.0-255,66,171299,1,267092
40110,0.021851,74.125.200.0-255,4320,175619,1,267092
40111,0.021858,172.31.36.0-255,66,175685,1,267092
40112,0.02189,74.125.200.0-255,1484,177169,1,267092
40113,0.02383,74.125.200.0-255,4320,181489,1,267092
40114,0.023837,172.31.36.0-255,66,181555,1,267092
40115,0.025836,74.125.200.0-255,5738,187293,1,267092
40116,0.025843,172.31.36.0-255,66,187359,1,267092
40117,0.027821,74.125.200.0-255,5738,193097,1,267092
40118,0.027829,172.31.36.0-255,66,193163,1,267092
40119,0.029798,74.125.200.0-255,5738,198901,1,267092
40120,0.029806,172.31.36.0-255,66,198967,1,267092
40121,0.031693,172.31.36.0-255,172,199139,1,267092
40122,0.031757,172.31.36.0-255,1113,200252,1,267092
40123,0.031797,74.125.200.0-255,5738,205990,1,267092
40124,0.031803,172.31.36.0-255,66,206056,1,267092
40125,0.031899,172.31.36.0-255,1514,207570,1,267092
40126,0.031901,172.31.36.0-255,1514,209084,1,267092
40127,0.031906,172.31.36.0-255,1514,210598,1,267092
40128,0.031907,172.31.36.0-255,1514,212112,1,267092
40129,0.031928,172.31.36.0-255,1490,213602,1,267092
40130,0.033205,104.244.42.0-255,66,213668,1,267092
40131,0.033264,104.244.42.0-255,66,213734,1,267092
40132,0.033498,104.244.42.0-255,66,213800,1,267092
40133,0.033773,74.125.200.0-255,5738,219538,1,267092
40134,0.033778,172.31.36.0-255,66,219604,1,267092
40135,0.035755,74.125.200.0-255,2902,222506,1,267092
40136,0.035761,172.31.36.0-255,66,222572,1,267092
40137,0.035798,74.125.200.0-255,2902,225474,1,267092
40138,0.035802,172.31.36.0-255,66,225540,1,267092
40139,0.03773,74.125.200.0-255,2902,228442,1,267092
40140,0.037736,172.31.36.0-255,66,228508,1,267092
40141,0.037768,74.125.200.0-255,2902,231410,1,267092
40142,0.037772,172.31.36.0-255,66,231476,1,267092
40143,0.039717,74.125.200.0-255,2902,234378,1,267092
40144,0.039723,172.31.36.0-255,66,234444,1,267092
40145,0.039748,74.125.200.0-255,2902,237346,1,267092
40146,0.039751,172.31.36.0-255,66,237412,1,267092
40147,0.041708,74.125.200.0-255,2902,240314,1,267092
40148,0.041715,172.31.36.0-255,66,240380,1,267092
40149,0.04176,74.125.200.0-255,2902,243282,1,267092
40150,0.041765,172.31.36.0-255,66,243348,1,267092
40151,0.043689,74.125.200.0-255,2902,246250,1,267092
40152,0.043694,172.31.36.0-255,66,246316,1,267092
40153,0.043734,74.125.200.0-255,2902,249218,1,267092
40154,0.043737,172.31.36.0-255,66,249284,1,267092
40155,0.045666,74.125.200.0-255,2902,252186,1,267092
40156,0.045671,172.31.36.0-255,66,252252,1,267092
40157,0.045718,74.125.200.0-255,2902,255154,1,267092
40158,0.045721,172.31.36.0-255,66,255220,1,267092
40159,0.047635,74.125.200.0-255,2902,258122,1,267092
40160,0.04764,172.31.36.0-255,66,258188,1,267092
40161,0.047678,74.125.200.0-255,2902,261090,1,267092
40162,0.047681,172.31.36.0-255,66,261156,1,267092
40163,0.049607,74.125.200.0-255,2902,264058,1,267092
40164,0.049612,172.31.36.0-255,66,264124,1,267092
40165,0.049644,74.125.200.0-255,2902,267026,1,267092
40166,0.049647,172.31.36.0-255,66,267092,1,267092
40167,0.0,172.217.194.0-255,298,298,1,211241
40168,1.4e-05,172.31.36.0-255,66,364,1,211241
40169,2.1e-05,172.217.194.0-255,1484,1848,1,211241
40170,2.6e-05,172.31.36.0-255,66,1914,1,211241
40171,3.2e-05,172.217.194.0-255,4320,6234,1,211241
40172,3.5e-05,172.31.36.0-255,66,6300,1,211241
40173,8.2e-05,172.31.36.0-255,66,6366,1,211241
40174,9.6e-05,172.31.36.0-255,66,6432,1,211241
40175,0.000129,172.217.194.0-255,1125,7557,1,211241
40176,0.000132,172.31.36.0-255,66,7623,1,211241
40177,0.000135,172.217.194.0-255,1484,9107,1,211241
40178,0.000137,172.31.36.0-255,66,9173,1,211241
40179,0.000141,172.217.194.0-255,2902,12075,1,211241
40180,0.000143,172.31.36.0-255,66,12141,1,211241
40181,0.000163,172.217.194.0-255,1484,13625,1,211241
40182,0.000166,172.31.36.0-255,66,13691,1,211241
40183,0.000169,172.217.194.0-255,1484,15175,1,211241
40184,0.000171,172.31.36.0-255,66,15241,1,211241
40185,0.000197,172.31.36.0-255,66,15307,1,211241
40186,0.0002,172.217.194.0-255,1125,16432,1,211241
40187,0.000202,172.31.36.0-255,66,16498,1,211241
40188,0.000458,172.217.194.0-255,1484,17982,1,211241
40189,0.000464,172.31.36.0-255,66,18048,1,211241
40190,0.00047,172.217.194.0-255,2902,20950,1,211241
40191,0.000472,172.31.36.0-255,66,21016,1,211241
40192,0.000479,172.217.194.0-255,5738,26754,1,211241
40193,0.000481,172.31.36.0-255,66,26820,1,211241
40194,0.00054,172.31.36.0-255,66,26886,1,211241
40195,0.000648,172.217.194.0-255,1484,28370,1,211241
40196,0.000654,172.217.194.0-255,2902,31272,1,211241
40197,0.000657,172.31.36.0-255,66,31338,1,211241
40198,0.000664,172.217.194.0-255,5738,37076,1,211241
40199,0.000666,172.31.36.0-255,66,37142,1,211241
40200,0.000696,172.217.194.0-255,1484,38626,1,211241
40201,0.000701,172.31.36.0-255,66,38692,1,211241
40202,0.000737,172.217.194.0-255,2902,41594,1,211241
40203,0.00074,172.31.36.0-255,66,41660,1,211241
40204,0.000764,172.217.194.0-255,6438,48098,1,211241
40205,0.000767,172.31.36.0-255,66,48164,1,211241
40206,0.000784,172.217.194.0-255,5738,53902,1,211241
40207,0.000786,172.31.36.0-255,66,53968,1,211241
40208,0.000802,172.217.194.0-255,4320,58288,1,211241
40209,0.000805,172.31.36.0-255,66,58354,1,211241
40210,0.00081,172.217.194.0-255,4320,62674,1,211241
40211,0.000813,172.31.36.0-255,66,62740,1,211241
40212,0.000836,172.217.194.0-255,7156,69896,1,211241
40213,0.000839,172.31.36.0-255,66,69962,1,211241
40214,0.000879,172.31.36.0-255,66,70028,1,211241
40215,0.000883,172.217.194.0-255,1484,71512,1,211241
40216,0.000914,172.31.36.0-255,66,71578,1,211241
40217,0.000927,172.31.36.0-255,66,71644,1,211241
40218,0.000933,172.217.194.0-255,2902,74546,1,211241
40219,0.000935,172.31.36.0-255,66,74612,1,211241
40220,0.000956,172.217.194.0-255,6438,81050,1,211241
40221,0.000959,172.31.36.0-255,66,81116,1,211241
40222,0.001008,172.217.194.0-255,1484,82600,1,211241
40223,0.001013,172.217.194.0-255,2902,85502,1,211241
40224,0.001018,172.31.36.0-255,66,85568,1,211241
40225,0.001032,172.217.194.0-255,5738,91306,1,211241
40226,0.001036,172.31.36.0-255,66,91372,1,211241
40227,0.001042,172.217.194.0-255,4320,95692,1,211241
40228,0.001044,172.31.36.0-255,66,95758,1,211241
40229,0.001064,172.217.194.0-255,1484,97242,1,211241
40230,0.001079,172.31.36.0-255,66,97308,1,211241
40231,0.001102,172.217.194.0-255,5020,102328,1,211241
40232,0.001105,172.31.36.0-255,66,102394,1,211241
40233,0.001108,172.217.194.0-255,1484,103878,1,211241
40234,0.001132,172.217.194.0-255,4320,108198,1,211241
40235,0.001135,172.31.36.0-255,66,108264,1,211241
40236,0.001185,172.31.36.0-255,66,108330,1,211241
40237,0.0012,172.217.194.0-255,4320,112650,1,211241
40238,0.001203,172.31.36.0-255,66,112716,1,211241
40239,0.001206,172.217.194.0-255,1484,114200,1,211241
40240,0.00122,172.31.36.0-255,66,114266,1,211241
40241,0.001237,172.217.194.0-255,1484,115750,1,211241
40242,0.001259,172.217.194.0-255,2902,118652,1,211241
40243,0.001262,172.31.36.0-255,66,118718,1,211241
40244,0.001268,172.217.194.0-255,5738,124456,1,211241
40245,0.001271,172.31.36.0-255,66,124522,1,211241
40246,0.001313,172.31.36.0-255,66,124588,1,211241
40247,0.00132,172.217.194.0-255,7156,131744,1,211241
40248,0.001323,172.31.36.0-255,66,131810,1,211241
40249,0.00135,172.217.194.0-255,3602,135412,1,211241
40250,0.001352,172.31.36.0-255,66,135478,1,211241
40251,0.001563,172.217.194.0-255,1484,136962,1,211241
40252,0.001568,172.217.194.0-255,1484,138446,1,211241
40253,0.001571,172.31.36.0-255,66,138512,1,211241
40254,0.001594,172.217.194.0-255,1484,139996,1,211241
40255,0.001601,172.217.194.0-255,5738,145734,1,211241
40256,0.001604,172.31.36.0-255,66,145800,1,211241
40257,0.001615,172.31.36.0-255,66,145866,1,211241
40258,0.001667,172.31.36.0-255,66,145932,1,211241
40259,0.001684,172.217.194.0-255,2184,148116,1,211241
40260,0.001687,172.31.36.0-255,66,148182,1,211241
40261,0.001729,172.217.194.0-255,1484,149666,1,211241
40262,0.001743,172.217.194.0-255,2902,152568,1,211241
40263,0.001746,172.31.36.0-255,66,152634,1,211241
40264,0.001753,172.217.194.0-255,5738,158372,1,211241
40265,0.001756,172.31.36.0-255,66,158438,1,211241
40266,0.001799,172.31.36.0-255,66,158504,1,211241
40267,0.001806,172.217.194.0-255,5738,164242,1,211241
40268,0.001808,172.31.36.0-255,66,164308,1,211241
40269,0.001835,172.217.194.0-255,6438,170746,1,211241
40270,0.001839,172.31.36.0-255,66,170812,1,211241
40271,0.001882,172.31.36.0-255,66,170878,1,211241
40272,0.001894,172.31.36.0-255,66,170944,1,211241
40273,0.00191,172.217.194.0-255,1484,172428,1,211241
40274,0.001938,172.217.194.0-255,6438,178866,1,211241
40275,0.001941,172.31.36.0-255,66,178932,1,211241
40276,0.001974,172.217.194.0-255,1484,180416,1,211241
40277,0.00199,172.217.194.0-255,2902,183318,1,211241
40278,0.001993,172.31.36.0-255,66,183384,1,211241
40279,0.002,172.217.194.0-255,5738,189122,1,211241
40280,0.002002,172.31.36.0-255,66,189188,1,211241
40281,0.002017,172.217.194.0-255,5738,194926,1,211241
40282,0.00202,172.31.36.0-255,66,194992,1,211241
40283,0.002025,172.217.194.0-255,2902,197894,1,211241
40284,0.002027,172.31.36.0-255,66,197960,1,211241
40285,0.002051,172.217.194.0-255,4320,202280,1,211241
40286,0.002054,172.31.36.0-255,66,202346,1,211241
40287,0.002109,172.31.36.0-255,66,202412,1,211241
40288,0.002134,172.217.194.0-255,6438,208850,1,211241
40289,0.002145,172.217.194.0-255,105,208955,1,211241
40290,0.002156,172.31.36.0-255,66,209021,1,211241
40291,0.012444,172.31.36.0-255,105,209126,1,211241
40292,0.014708,172.217.194.0-255,66,209192,1,211241
40293,0.043174,172.31.36.0-255,172,209364,1,211241
40294,0.043207,172.31.36.0-255,1114,210478,1,211241
40295,0.043265,172.31.36.0-255,565,211043,1,211241
40296,0.044651,104.244.42.0-255,66,211109,1,211241
40297,0.044686,104.244.42.0-255,66,211175,1,211241
40298,0.044734,104.244.42.0-255,66,211241,1,211241
40299,0.0,74.125.68.0-255,146,146,1,270060
40300,3.5e-05,172.31.36.0-255,66,212,1,270060
40301,9.4e-05,74.125.68.0-255,1484,1696,1,270060
40302,9.8e-05,172.31.36.0-255,66,1762,1,270060
40303,0.000145,74.125.68.0-255,1484,3246,1,270060
40304,0.000148,172.31.36.0-255,66,3312,1,270060
40305,0.000154,74.125.68.0-255,2902,6214,1,270060
40306,0.000157,172.31.36.0-255,66,6280,1,270060
40307,0.000187,74.125.68.0-255,5738,12018,1,270060
40308,0.000191,172.31.36.0-255,66,12084,1,270060
40309,0.000196,74.125.68.0-255,2077,14161,1,270060
40310,0.000197,172.31.36.0-255,66,14227,1,270060
40311,0.000233,74.125.68.0-255,2902,17129,1,270060
40312,0.000236,172.31.36.0-255,66,17195,1,270060
40313,0.000261,74.125.68.0-255,5738,22933,1,270060
40314,0.000263,172.31.36.0-255,66,22999,1,270060
40315,0.000311,74.125.68.0-255,7156,30155,1,270060
40316,0.000315,172.31.36.0-255,66,30221,1,270060
40317,0.000343,74.125.68.0-255,1125,31346,1,270060
40318,0.000346,172.31.36.0-255,66,31412,1,270060
40319,0.000601,74.125.68.0-255,1484,32896,1,270060
40320,0.000606,172.31.36.0-255,66,32962,1,270060
40321,0.000615,74.125.68.0-255,2902,35864,1,270060
40322,0.000617,172.31.36.0-255,66,35930,1,270060
40323,0.000662,74.125.68.0-255,5738,41668,1,270060
40324,0.000668,172.31.36.0-255,66,41734,1,270060
40325,0.000706,74.125.68.0-255,1484,43218,1,270060
40326,0.00071,172.31.36.0-255,66,43284,1,270060
40327,0.000747,74.125.68.0-255,1484,44768,1,270060
40328,0.000751,172.31.36.0-255,66,44834,1,270060
40329,0.00081,74.125.68.0-255,2902,47736,1,270060
40330,0.000814,172.31.36.0-255,66,47802,1,270060
40331,0.000871,74.125.68.0-255,1484,49286,1,270060
40332,0.000902,74.125.68.0-255,2902,52188,1,270060
40333,0.000915,172.31.36.0-255,66,52254,1,270060
40334,0.000926,74.125.68.0-255,4320,56574,1,270060
40335,0.00094,172.31.36.0-255,66,56640,1,270060
40336,0.000948,74.125.68.0-255,1484,58124,1,270060
40337,0.001013,74.125.68.0-255,1484,59608,1,270060
40338,0.001026,172.31.36.0-255,66,59674,1,270060
40339,0.001058,74.125.68.0-255,1484,61158,1,270060
40340,0.001119,74.125.68.0-255,1484,62642,1,270060
40341,0.001128,172.31.36.0-255,66,62708,1,270060
40342,0.001138,74.125.68.0-255,2902,65610,1,270060
40343,0.001141,74.125.68.0-255,766,66376,1,270060
40344,0.001146,172.31.36.0-255,66,66442,1,270060
40345,0.001523,74.125.68.0-255,359,66801,1,270060
40346,0.001531,74.125.68.0-255,134,66935,1,270060
40347,0.001586,172.31.36.0-255,66,67001,1,270060
40348,0.001761,74.125.68.0-255,1484,68485,1,270060
40349,0.001782,74.125.68.0-255,2902,71387,1,270060
40350,0.001785,74.125.68.0-255,1484,72871,1,270060
40351,0.001799,74.125.68.0-255,4320,77191,1,270060
40352,0.001802,74.125.68.0-255,1484,78675,1,270060
40353,0.001815,172.31.36.0-255,66,78741,1,270060
40354,0.00182,74.125.68.0-255,2902,81643,1,270060
40355,0.001824,172.31.36.0-255,66,81709,1,270060
40356,0.001838,74.125.68.0-255,5738,87447,1,270060
40357,0.001853,74.125.68.0-255,4320,91767,1,270060
40358,0.001878,74.125.68.0-255,7156,98923,1,270060
40359,0.001881,74.125.68.0-255,2184,101107,1,270060
40360,0.001883,172.31.36.0-255,66,101173,1,270060
40361,0.001893,172.31.36.0-255,66,101239,1,270060
40362,0.001916,74.125.68.0-255,1484,102723,1,270060
40363,0.001921,74.125.68.0-255,2902,105625,1,270060
40364,0.001935,172.31.36.0-255,66,105691,1,270060
40365,0.001952,74.125.68.0-255,1484,107175,1,270060
40366,0.001969,74.125.68.0-255,4320,111495,1,270060
40367,0.001973,74.125.68.0-255,2902,114397,1,270060
40368,0.001983,74.125.68.0-255,1484,115881,1,270060
40369,0.001993,172.31.36.0-255,66,115947,1,270060
40370,0.00202,74.125.68.0-255,2902,118849,1,270060
40371,0.002037,74.125.68.0-255,7156,126005,1,270060
40372,0.00204,172.31.36.0-255,66,126071,1,270060
40373,0.002067,172.31.36.0-255,66,126137,1,270060
40374,0.002085,172.31.36.0-255,66,126203,1,270060
40375,0.002089,74.125.68.0-255,2184,128387,1,270060
40376,0.002093,74.125.68.0-255,4320,132707,1,270060
40377,0.002126,172.31.36.0-255,66,132773,1,270060
40378,0.00214,172.31.36.0-255,66,132839,1,270060
40379,0.002155,74.125.68.0-255,7156,139995,1,270060
40380,0.002159,74.125.68.0-255,2184,142179,1,270060
40381,0.002176,172.31.36.0-255,66,142245,1,270060
40382,0.004471,74.125.68.0-255,2902,145147,1,270060
40383,0.004476,172.31.36.0-255,66,145213,1,270060
40384,0.004495,74.125.68.0-255,2902,148115,1,270060
40385,0.004514,172.31.36.0-255,66,148181,1,270060
40386,0.006784,74.125.68.0-255,2902,151083,1,270060
40387,0.006791,172.31.36.0-255,66,151149,1,270060
40388,0.006815,74.125.68.0-255,2902,154051,1,270060
40389,0.006839,172.31.36.0-255,66,154117,1,270060
40390,0.009093,74.125.68.0-255,2902,157019,1,270060
40391,0.0091,172.31.36.0-255,66,157085,1,270060
40392,0.009168,74.125.68.0-255,2902,159987,1,270060
40393,0.009203,172.31.36.0-255,66,160053,1,270060
40394,0.011397,74.125.68.0-255,2902,162955,1,270060
40395,0.011404,172.31.36.0-255,66,163021,1,270060
40396,0.01151,74.125.68.0-255,2902,165923,1,270060
40397,0.011516,172.31.36.0-255,66,165989,1,270060
40398,0.01373,74.125.68.0-255,2902,168891,1,270060
40399,0.013739,172.31.36.0-255,66,168957,1,270060
40400,0.013814,74.125.68.0-255,2902,171859,1,270060
40401,0.013848,172.31.36.0-255,66,171925,1,270060
40402,0.016043,74.125.68.0-255,2902,174827,1,270060
40403,0.01605,172.31.36.0-255,66,174893,1,270060
40404,0.016182,74.125.68.0-255,2902,177795,1,270060
40405,0.016189,172.31.36.0-255,66,177861,1,270060
40406,0.018395,74.125.68.0-255,2902,180763,1,270060
40407,0.018402,172.31.36.0-255,66,180829,1,270060
40408,0.018487,74.125.68.0-255,2902,183731,1,270060
40409,0.018524,172.31.36.0-255,66,183797,1,270060
40410,0.02072,74.125.68.0-255,2902,186699,1,270060
40411,0.020727,172.31.36.0-255,66,186765,1,270060
40412,0.020831,74.125.68.0-255,2902,189667,1,270060
40413,0.020835,172.31.36.0-255,66,189733,1,270060
40414,0.023033,74.125.68.0-255,2902,192635,1,270060
40415,0.023039,172.31.36.0-255,66,192701,1,270060
40416,0.023135,74.125.68.0-255,2902,195603,1,270060
40417,0.023153,172.31.36.0-255,66,195669,1,270060
40418,0.025347,74.125.68.0-255,2902,198571,1,270060
40419,0.025353,172.31.36.0-255,66,198637,1,270060
40420,0.025458,74.125.68.0-255,2902,201539,1,270060
40421,0.025465,172.31.36.0-255,66,201605,1,270060
40422,0.027664,74.125.68.0-255,2902,204507,1,270060
40423,0.027672,172.31.36.0-255,66,204573,1,270060
40424,0.027758,74.125.68.0-255,2902,207475,1,270060
40425,0.027762,172.31.36.0-255,66,207541,1,270060
40426,0.029986,74.125.68.0-255,2902,210443,1,270060
40427,0.030016,172.31.36.0-255,66,210509,1,270060
40428,0.030069,74.125.68.0-255,2902,213411,1,270060
40429,0.030183,172.31.36.0-255,66,213477,1,270060
40430,0.030584,172.31.36.0-255,172,213649,1,270060
40431,0.030619,172.31.36.0-255,1113,214762,1,270060
40432,0.030687,172.31.36.0-255,1514,216276,1,270060
40433,0.030689,172.31.36.0-255,1514,217790,1,270060
40434,0.030693,172.31.36.0-255,1514,219304,1,270060
40435,0.030694,172.31.36.0-255,1514,220818,1,270060
40436,0.030714,172.31.36.0-255,1490,222308,1,270060
40437,0.032127,104.244.42.0-255,66,222374,1,270060
40438,0.032166,104.244.42.0-255,66,222440,1,270060
40439,0.032237,104.244.42.0-255,66,222506,1,270060
40440,0.032242,104.244.42.0-255,66,222572,1,270060
40441,0.03233,74.125.68.0-255,2902,225474,1,270060
40442,0.032334,172.31.36.0-255,66,225540,1,270060
40443,0.03256,74.125.68.0-255,2902,228442,1,270060
40444,0.032564,172.31.36.0-255,66,228508,1,270060
40445,0.03464,74.125.68.0-255,2902,231410,1,270060
40446,0.034646,172.31.36.0-255,66,231476,1,270060
40447,0.034853,74.125.68.0-255,2902,234378,1,270060
40448,0.034858,172.31.36.0-255,66,234444,1,270060
40449,0.036951,74.125.68.0-255,2902,237346,1,270060
40450,0.036956,172.31.36.0-255,66,237412,1,270060
40451,0.037159,74.125.68.0-255,2902,240314,1,270060
40452,0.037168,172.31.36.0-255,66,240380,1,270060
40453,0.039265,74.125.68.0-255,2902,243282,1,270060
40454,0.039271,172.31.36.0-255,66,243348,1,270060
40455,0.039468,74.125.68.0-255,2902,246250,1,270060
40456,0.039474,172.31.36.0-255,66,246316,1,270060
40457,0.041572,74.125.68.0-255,2902,249218,1,270060
40458,0.041577,172.31.36.0-255,66,249284,1,270060
40459,0.041762,74.125.68.0-255,2902,252186,1,270060
40460,0.041771,172.31.36.0-255,66,252252,1,270060
40461,0.043885,74.125.68.0-255,2902,255154,1,270060
40462,0.043891,172.31.36.0-255,66,255220,1,270060
40463,0.044063,74.125.68.0-255,2902,258122,1,270060
40464,0.044068,172.31.36.0-255,66,258188,1,270060
40465,0.046189,74.125.68.0-255,2902,261090,1,270060
40466,0.046195,172.31.36.0-255,66,261156,1,270060
40467,0.046382,74.125.68.0-255,2902,264058,1,270060
40468,0.046387,172.31.36.0-255,66,264124,1,270060
40469,0.048495,74.125.68.0-255,2902,267026,1,270060
40470,0.0485,172.31.36.0-255,66,267092,1,270060
40471,0.048698,74.125.68.0-255,2902,269994,1,270060
40472,0.048703,172.31.36.0-255,66,270060,1,270060
40473,0.0,74.125.24.0-255,147,147,1,231792
40474,2.3e-05,172.31.36.0-255,66,213,1,231792
40475,3.1e-05,74.125.24.0-255,1484,1697,1,231792
40476,3.6e-05,172.31.36.0-255,66,1763,1,231792
40477,4.2e-05,74.125.24.0-255,2902,4665,1,231792
40478,4.6e-05,172.31.36.0-255,66,4731,1,231792
40479,5.4e-05,74.125.24.0-255,7156,11887,1,231792
40480,5.7e-05,172.31.36.0-255,66,11953,1,231792
40481,7.2e-05,172.31.36.0-255,66,12019,1,231792
40482,7.9e-05,74.125.24.0-255,6797,18816,1,231792
40483,8.3e-05,172.31.36.0-255,66,18882,1,231792
40484,0.000192,74.125.24.0-255,1484,20366,1,231792
40485,0.000196,172.31.36.0-255,66,20432,1,231792
40486,0.000203,74.125.24.0-255,2902,23334,1,231792
40487,0.000204,172.31.36.0-255,66,23400,1,231792
40488,0.00021,74.125.24.0-255,2902,26302,1,231792
40489,0.000212,172.31.36.0-255,66,26368,1,231792
40490,0.000234,74.125.24.0-255,2902,29270,1,231792
40491,0.000237,172.31.36.0-255,66,29336,1,231792
40492,0.000243,74.125.24.0-255,4320,33656,1,231792
40493,0.000245,172.31.36.0-255,66,33722,1,231792
40494,0.000248,74.125.24.0-255,1484,35206,1,231792
40495,0.000251,172.31.36.0-255,66,35272,1,231792
40496,0.000282,172.31.36.0-255,66,35338,1,231792
40497,0.00029,74.125.24.0-255,7106,42444,1,231792
40498,0.000292,172.31.36.0-255,66,42510,1,231792
40499,0.000382,74.125.24.0-255,110,42620,1,231792
40500,0.000386,172.31.36.0-255,66,42686,1,231792
40501,0.000547,74.125.24.0-255,1484,44170,1,231792
40502,0.000553,172.31.36.0-255,66,44236,1,231792
40503,0.000559,74.125.24.0-255,2902,47138,1,231792
40504,0.000561,172.31.36.0-255,66,47204,1,231792
40505,0.000588,74.125.24.0-255,5738,52942,1,231792
40506,0.000592,172.31.36.0-255,66,53008,1,231792
40507,0.000598,74.125.24.0-255,4320,57328,1,231792
40508,0.0006,172.31.36.0-255,66,57394,1,231792
40509,0.000613,74.125.24.0-255,2543,59937,1,231792
40510,0.000616,172.31.36.0-255,66,60003,1,231792
40511,0.000633,74.125.24.0-255,5738,65741,1,231792
40512,0.000636,172.31.36.0-255,66,65807,1,231792
40513,0.000671,172.31.36.0-255,66,65873,1,231792
40514,0.000675,74.125.24.0-255,2543,68416,1,231792
40515,0.000677,172.31.36.0-255,66,68482,1,231792
40516,0.00068,74.125.24.0-255,334,68816,1,231792
40517,0.000998,74.125.24.0-255,1484,70300,1,231792
40518,0.001003,172.31.36.0-255,66,70366,1,231792
40519,0.001009,74.125.24.0-255,2902,73268,1,231792
40520,0.001011,172.31.36.0-255,66,73334,1,231792
40521,0.001045,74.125.24.0-255,4320,77654,1,231792
40522,0.001047,172.31.36.0-255,66,77720,1,231792
40523,0.001069,74.125.24.0-255,1484,79204,1,231792
40524,0.001085,172.31.36.0-255,66,79270,1,231792
40525,0.00109,74.125.24.0-255,4320,83590,1,231792
40526,0.001092,172.31.36.0-255,66,83656,1,231792
40527,0.001119,74.125.24.0-255,6438,90094,1,231792
40528,0.001121,172.31.36.0-255,66,90160,1,231792
40529,0.002049,74.125.24.0-255,1484,91644,1,231792
40530,0.00206,74.125.24.0-255,2902,94546,1,231792
40531,0.002064,172.31.36.0-255,66,94612,1,231792
40532,0.002069,74.125.24.0-255,1484,96096,1,231792
40533,0.002091,74.125.24.0-255,4320,100416,1,231792
40534,0.002093,172.31.36.0-255,66,100482,1,231792
40535,0.002099,74.125.24.0-255,4320,104802,1,231792
40536,0.002101,172.31.36.0-255,66,104868,1,231792
40537,0.002125,74.125.24.0-255,2902,107770,1,231792
40538,0.002128,172.31.36.0-255,66,107836,1,231792
40539,0.002159,172.31.36.0-255,66,107902,1,231792
40540,0.00217,172.31.36.0-255,66,107968,1,231792
40541,0.004477,74.125.24.0-255,5738,113706,1,231792
40542,0.004485,172.31.36.0-255,66,113772,1,231792
40543,0.006785,74.125.24.0-255,4320,118092,1,231792
40544,0.006789,172.31.36.0-255,66,118158,1,231792
40545,0.006807,74.125.24.0-255,1484,119642,1,231792
40546,0.009098,74.125.24.0-255,4320,123962,1,231792
40547,0.009106,172.31.36.0-255,66,124028,1,231792
40548,0.011418,74.125.24.0-255,5738,129766,1,231792
40549,0.011427,172.31.36.0-255,66,129832,1,231792
40550,0.013733,74.125.24.0-255,5738,135570,1,231792
40551,0.013742,172.31.36.0-255,66,135636,1,231792
40552,0.016054,74.125.24.0-255,5738,141374,1,231792
40553,0.016062,172.31.36.0-255,66,141440,1,231792
40554,0.018381,74.125.24.0-255,5738,147178,1,231792
40555,0.018389,172.31.36.0-255,66,147244,1,231792
40556,0.020709,74.125.24.0-255,5738,152982,1,231792
40557,0.020716,172.31.36.0-255,66,153048,1,231792
40558,0.023039,74.125.24.0-255,5738,158786,1,231792
40559,0.023049,172.31.36.0-255,66,158852,1,231792
40560,0.02536,74.125.24.0-255,5738,164590,1,231792
40561,0.025369,172.31.36.0-255,66,164656,1,231792
40562,0.027675,74.125.24.0-255,5738,170394,1,231792
40563,0.027684,172.31.36.0-255,66,170460,1,231792
40564,0.030022,74.125.24.0-255,5738,176198,1,231792
40565,0.030028,172.31.36.0-255,66,176264,1,231792
40566,0.032355,74.125.24.0-255,5738,182002,1,231792
40567,0.032363,172.31.36.0-255,66,182068,1,231792
40568,0.034683,74.125.24.0-255,5738,187806,1,231792
40569,0.03469,172.31.36.0-255,66,187872,1,231792
40570,0.036996,74.125.24.0-255,5738,193610,1,231792
40571,0.037003,172.31.36.0-255,66,193676,1,231792
40572,0.039327,74.125.24.0-255,5738,199414,1,231792
40573,0.039335,172.31.36.0-255,66,199480,1,231792
40574,0.04165,74.125.24.0-255,5738,205218,1,231792
40575,0.04166,172.31.36.0-255,66,205284,1,231792
40576,0.043993,74.125.24.0-255,5738,211022,1,231792
40577,0.044002,172.31.36.0-255,66,211088,1,231792
40578,0.04631,74.125.24.0-255,1484,212572,1,231792
40579,0.046329,74.125.24.0-255,4320,216892,1,231792
40580,0.046335,172.31.36.0-255,66,216958,1,231792
40581,0.047833,172.31.36.0-255,172,217130,1,231792
40582,0.047864,172.31.36.0-255,1116,218246,1,231792
40583,0.047929,172.31.36.0-255,1514,219760,1,231792
40584,0.047931,172.31.36.0-255,1514,221274,1,231792
40585,0.047932,172.31.36.0-255,1514,222788,1,231792
40586,0.047937,172.31.36.0-255,1514,224302,1,231792
40587,0.047939,172.31.36.0-255,1488,225790,1,231792
40588,0.048649,74.125.24.0-255,5738,231528,1,231792
40589,0.048656,172.31.36.0-255,66,231594,1,231792
40590,0.049411,104.244.42.0-255,66,231660,1,231792
40591,0.04942,104.244.42.0-255,66,231726,1,231792
40592,0.049561,104.244.42.0-255,66,231792,1,231792
40593,0.0,172.217.194.0-255,153,153,1,265580
40594,2.8e-05,172.31.36.0-255,66,219,1,265580
40595,3.5e-05,172.217.194.0-255,1484,1703,1,265580
40596,3.9e-05,172.31.36.0-255,66,1769,1,265580
40597,4.4e-05,172.217.194.0-255,2902,4671,1,265580
40598,4.6e-05,172.31.36.0-255,66,4737,1,265580
40599,7e-05,172.217.194.0-255,2902,7639,1,265580
40600,7.4e-05,172.31.36.0-255,66,7705,1,265580
40601,9.5e-05,172.217.194.0-255,4320,12025,1,265580
40602,9.8e-05,172.31.36.0-255,66,12091,1,265580
40603,0.000101,172.217.194.0-255,1484,13575,1,265580
40604,0.000102,172.31.36.0-255,66,13641,1,265580
40605,0.000109,172.217.194.0-255,7156,20797,1,265580
40606,0.000111,172.31.36.0-255,66,20863,1,265580
40607,0.000139,172.217.194.0-255,3429,24292,1,265580
40608,0.000142,172.31.36.0-255,66,24358,1,265580
40609,0.000148,172.217.194.0-255,6797,31155,1,265580
40610,0.00015,172.31.36.0-255,66,31221,1,265580
40611,0.000196,172.217.194.0-255,1484,32705,1,265580
40612,0.0002,172.31.36.0-255,66,32771,1,265580
40613,0.000204,172.217.194.0-255,1484,34255,1,265580
40614,0.000206,172.31.36.0-255,66,34321,1,265580
40615,0.00022,172.217.194.0-255,1484,35805,1,265580
40616,0.000222,172.31.36.0-255,66,35871,1,265580
40617,0.000228,172.217.194.0-255,4320,40191,1,265580
40618,0.00023,172.31.36.0-255,66,40257,1,265580
40619,0.000244,172.217.194.0-255,1484,41741,1,265580
40620,0.000246,172.31.36.0-255,66,41807,1,265580
40621,0.00025,172.217.194.0-255,2902,44709,1,265580
40622,0.000252,172.31.36.0-255,66,44775,1,265580
40623,0.000278,172.217.194.0-255,3961,48736,1,265580
40624,0.000282,172.31.36.0-255,66,48802,1,265580
40625,0.000289,172.217.194.0-255,7156,55958,1,265580
40626,0.000292,172.217.194.0-255,1484,57442,1,265580
40627,0.000294,172.31.36.0-255,66,57508,1,265580
40628,0.000327,172.217.194.0-255,365,57873,1,265580
40629,0.000329,172.31.36.0-255,66,57939,1,265580
40630,0.000412,172.217.194.0-255,1484,59423,1,265580
40631,0.000417,172.217.194.0-255,2902,62325,1,265580
40632,0.000417,172.31.36.0-255,66,62391,1,265580
40633,0.000423,172.31.36.0-255,66,62457,1,265580
40634,0.000429,172.217.194.0-255,1484,63941,1,265580
40635,0.000451,172.217.194.0-255,4320,68261,1,265580
40636,0.000459,172.217.194.0-255,6797,75058,1,265580
40637,0.000461,172.217.194.0-255,1484,76542,1,265580
40638,0.000467,172.31.36.0-255,66,76608,1,265580
40639,0.000488,172.217.194.0-255,5738,82346,1,265580
40640,0.000494,172.31.36.0-255,66,82412,1,265580
40641,0.000502,172.217.194.0-255,4320,86732,1,265580
40642,0.000513,172.31.36.0-255,66,86798,1,265580
40643,0.000523,172.217.194.0-255,5379,92177,1,265580
40644,0.000526,172.31.36.0-255,66,92243,1,265580
40645,0.000839,172.217.194.0-255,1484,93727,1,265580
40646,0.000844,172.217.194.0-255,2902,96629,1,265580
40647,0.000847,172.31.36.0-255,66,96695,1,265580
40648,0.00085,172.217.194.0-255,1484,98179,1,265580
40649,0.000865,172.217.194.0-255,2902,101081,1,265580
40650,0.000877,172.217.194.0-255,1484,102565,1,265580
40651,0.000883,172.217.194.0-255,4320,106885,1,265580
40652,0.000888,172.31.36.0-255,66,106951,1,265580
40653,0.00092,172.31.36.0-255,66,107017,1,265580
40654,0.000959,172.31.36.0-255,66,107083,1,265580
40655,0.002065,172.217.194.0-255,1484,108567,1,265580
40656,0.002075,172.217.194.0-255,1484,110051,1,265580
40657,0.002079,172.31.36.0-255,66,110117,1,265580
40658,0.002098,172.217.194.0-255,1484,111601,1,265580
40659,0.002105,172.217.194.0-255,5738,117339,1,265580
40660,0.002109,172.217.194.0-255,2902,120241,1,265580
40661,0.002126,172.217.194.0-255,2902,123143,1,265580
40662,0.002132,172.217.194.0-255,5738,128881,1,265580
40663,0.002156,172.217.194.0-255,7156,136037,1,265580
40664,0.002158,172.217.194.0-255,1484,137521,1,265580
40665,0.002173,172.217.194.0-255,3602,141123,1,265580
40666,0.002209,172.217.194.0-255,2902,144025,1,265580
40667,0.002236,172.217.194.0-255,2902,146927,1,265580
40668,0.002344,172.217.194.0-255,4320,151247,1,265580
40669,0.002347,172.217.194.0-255,766,152013,1,265580
40670,0.005892,172.31.36.0-255,66,152079,1,265580
40671,0.008139,172.217.194.0-255,5738,157817,1,265580
40672,0.008146,172.31.36.0-255,66,157883,1,265580
40673,0.010387,172.217.194.0-255,5738,163621,1,265580
40674,0.010394,172.31.36.0-255,66,163687,1,265580
40675,0.012612,172.217.194.0-255,5738,169425,1,265580
40676,0.015059,172.31.36.0-255,66,169491,1,265580
40677,0.01731,172.217.194.0-255,5738,175229,1,265580
40678,0.01732,172.31.36.0-255,66,175295,1,265580
40679,0.019555,172.217.194.0-255,5738,181033,1,265580
40680,0.019562,172.31.36.0-255,66,181099,1,265580
40681,0.021801,172.217.194.0-255,5738,186837,1,265580
40682,0.021808,172.31.36.0-255,66,186903,1,265580
40683,0.024045,172.217.194.0-255,5738,192641,1,265580
40684,0.024053,172.31.36.0-255,66,192707,1,265580
40685,0.026294,172.217.194.0-255,5738,198445,1,265580
40686,0.026301,172.31.36.0-255,66,198511,1,265580
40687,0.028558,172.217.194.0-255,5738,204249,1,265580
40688,0.028565,172.31.36.0-255,66,204315,1,265580
40689,0.030849,172.217.194.0-255,5738,210053,1,265580
40690,0.030856,172.31.36.0-255,66,210119,1,265580
40691,0.033097,172.217.194.0-255,5738,215857,1,265580
40692,0.033103,172.31.36.0-255,66,215923,1,265580
40693,0.034858,172.31.36.0-255,172,216095,1,265580
40694,0.035381,172.217.194.0-255,5738,221833,1,265580
40695,0.035388,172.31.36.0-255,66,221899,1,265580
40696,0.035512,172.31.36.0-255,1113,223012,1,265580
40697,0.03558,172.31.36.0-255,1514,224526,1,265580
40698,0.035582,172.31.36.0-255,1514,226040,1,265580
40699,0.035583,172.31.36.0-255,1514,227554,1,265580
40700,0.035585,172.31.36.0-255,1514,229068,1,265580
40701,0.035612,172.31.36.0-255,1490,230558,1,265580
40702,0.036405,104.244.42.0-255,66,230624,1,265580
40703,0.037068,104.244.42.0-255,66,230690,1,265580
40704,0.037207,104.244.42.0-255,66,230756,1,265580
40705,0.037633,172.217.194.0-255,5738,236494,1,265580
40706,0.037639,172.31.36.0-255,66,236560,1,265580
40707,0.039898,172.217.194.0-255,5738,242298,1,265580
40708,0.039905,172.31.36.0-255,66,242364,1,265580
40709,0.042147,172.217.194.0-255,5738,248102,1,265580
40710,0.042152,172.31.36.0-255,66,248168,1,265580
40711,0.044394,172.217.194.0-255,5738,253906,1,265580
40712,0.0444,172.31.36.0-255,66,253972,1,265580
40713,0.046629,172.217.194.0-255,5738,259710,1,265580
40714,0.046634,172.31.36.0-255,66,259776,1,265580
40715,0.048877,172.217.194.0-255,5738,265514,1,265580
40716,0.048881,172.31.36.0-255,66,265580,1,265580
40717,0.0,172.253.118.0-255,142,142,1,323333
40718,1.6e-05,172.31.36.0-255,66,208,1,323333
40719,2.4e-05,172.253.118.0-255,1484,1692,1,323333
40720,2.8e-05,172.31.36.0-255,66,1758,1,323333
40721,3.2e-05,172.253.118.0-255,1484,3242,1,323333
40722,3.5e-05,172.31.36.0-255,66,3308,1,323333
40723,5e-05,172.253.118.0-255,2902,6210,1,323333
40724,5.3e-05,172.31.36.0-255,66,6276,1,323333
40725,6e-05,172.253.118.0-255,5738,12014,1,323333
40726,6.2e-05,172.31.36.0-255,66,12080,1,323333
40727,7.9e-05,172.31.36.0-255,66,12146,1,323333
40728,0.000116,172.253.118.0-255,6797,18943,1,323333
40729,0.000119,172.31.36.0-255,66,19009,1,323333
40730,0.000181,172.253.118.0-255,1484,20493,1,323333
40731,0.000184,172.31.36.0-255,66,20559,1,323333
40732,0.000204,172.253.118.0-255,2902,23461,1,323333
40733,0.000206,172.31.36.0-255,66,23527,1,323333
40734,0.000211,172.253.118.0-255,2902,26429,1,323333
40735,0.000213,172.31.36.0-255,66,26495,1,323333
40736,0.000248,172.253.118.0-255,7156,33651,1,323333
40737,0.000251,172.31.36.0-255,66,33717,1,323333
40738,0.000282,172.253.118.0-255,7156,40873,1,323333
40739,0.000285,172.31.36.0-255,66,40939,1,323333
40740,0.000305,172.253.118.0-255,3961,44900,1,323333
40741,0.000308,172.31.36.0-255,66,44966,1,323333
40742,0.000339,172.253.118.0-255,5738,50704,1,323333
40743,0.000342,172.31.36.0-255,66,50770,1,323333
40744,0.000355,172.253.118.0-255,2857,53627,1,323333
40745,0.000361,172.31.36.0-255,66,53693,1,323333
40746,0.000365,172.253.118.0-255,111,53804,1,323333
40747,0.000367,172.31.36.0-255,66,53870,1,323333
40748,0.000478,172.253.118.0-255,1484,55354,1,323333
40749,0.000494,172.253.118.0-255,2902,58256,1,323333
40750,0.000497,172.31.36.0-255,66,58322,1,323333
40751,0.000526,172.253.118.0-255,2902,61224,1,323333
40752,0.000529,172.31.36.0-255,66,61290,1,323333
40753,0.000537,172.253.118.0-255,7156,68446,1,323333
40754,0.00054,172.31.36.0-255,66,68512,1,323333
40755,0.000574,172.31.36.0-255,66,68578,1,323333
40756,0.000601,172.253.118.0-255,4320,72898,1,323333
40757,0.000603,172.31.36.0-255,66,72964,1,323333
40758,0.000631,172.253.118.0-255,5641,78605,1,323333
40759,0.000634,172.31.36.0-255,66,78671,1,323333
40760,0.001225,172.253.118.0-255,1484,80155,1,323333
40761,0.001234,172.253.118.0-255,2902,83057,1,323333
40762,0.001238,172.31.36.0-255,66,83123,1,323333
40763,0.001245,172.253.118.0-255,5738,88861,1,323333
40764,0.001247,172.31.36.0-255,66,88927,1,323333
40765,0.001288,172.31.36.0-255,66,88993,1,323333
40766,0.001295,172.253.118.0-255,7156,96149,1,323333
40767,0.001297,172.31.36.0-255,66,96215,1,323333
40768,0.001342,172.253.118.0-255,3602,99817,1,323333
40769,0.001344,172.31.36.0-255,66,99883,1,323333
40770,0.001473,172.253.118.0-255,1484,101367,1,323333
40771,0.001477,172.253.118.0-255,1484,102851,1,323333
40772,0.00148,172.31.36.0-255,66,102917,1,323333
40773,0.001509,172.253.118.0-255,1484,104401,1,323333
40774,0.001516,172.253.118.0-255,5738,110139,1,323333
40775,0.001518,172.31.36.0-255,66,110205,1,323333
40776,0.001534,172.253.118.0-255,4320,114525,1,323333
40777,0.001537,172.31.36.0-255,66,114591,1,323333
40778,0.001577,172.253.118.0-255,5738,120329,1,323333
40779,0.00158,172.31.36.0-255,66,120395,1,323333
40780,0.001598,172.31.36.0-255,66,120461,1,323333
40781,0.001602,172.253.118.0-255,2184,122645,1,323333
40782,0.001604,172.31.36.0-255,66,122711,1,323333
40783,0.001659,172.253.118.0-255,2902,125613,1,323333
40784,0.001666,172.253.118.0-255,4320,129933,1,323333
40785,0.001672,172.253.118.0-255,5738,135671,1,323333
40786,0.001676,172.31.36.0-255,66,135737,1,323333
40787,0.001679,172.31.36.0-255,66,135803,1,323333
40788,0.001682,172.31.36.0-255,66,135869,1,323333
40789,0.001692,172.253.118.0-255,2902,138771,1,323333
40790,0.001698,172.31.36.0-255,66,138837,1,323333
40791,0.001705,172.253.118.0-255,7156,145993,1,323333
40792,0.001711,172.31.36.0-255,66,146059,1,323333
40793,0.001753,172.31.36.0-255,66,146125,1,323333
40794,0.001798,172.253.118.0-255,1484,147609,1,323333
40795,0.001819,172.253.118.0-255,2902,150511,1,323333
40796,0.001823,172.253.118.0-255,2902,153413,1,323333
40797,0.001827,172.31.36.0-255,66,153479,1,323333
40798,0.001835,172.31.36.0-255,66,153545,1,323333
40799,0.001844,172.253.118.0-255,2902,156447,1,323333
40800,0.001846,172.31.36.0-255,66,156513,1,323333
40801,0.00185,172.253.118.0-255,1484,157997,1,323333
40802,0.001856,172.253.118.0-255,4320,162317,1,323333
40803,0.001858,172.31.36.0-255,66,162383,1,323333
40804,0.001891,172.253.118.0-255,4320,166703,1,323333
40805,0.001894,172.31.36.0-255,66,166769,1,323333
40806,0.001905,172.31.36.0-255,66,166835,1,323333
40807,0.001938,172.253.118.0-255,5020,171855,1,323333
40808,0.001941,172.31.36.0-255,66,171921,1,323333
40809,0.00197,172.253.118.0-255,1484,173405,1,323333
40810,0.001975,172.253.118.0-255,2902,176307,1,323333
40811,0.001977,172.31.36.0-255,66,176373,1,323333
40812,0.001983,172.253.118.0-255,5738,182111,1,323333
40813,0.001986,172.31.36.0-255,66,182177,1,323333
40814,0.001996,172.253.118.0-255,4320,186497,1,323333
40815,0.001998,172.31.36.0-255,66,186563,1,323333
40816,0.002041,172.31.36.0-255,66,186629,1,323333
40817,0.002079,172.31.36.0-255,66,186695,1,323333
40818,0.002126,172.253.118.0-255,1484,188179,1,323333
40819,0.00213,172.253.118.0-255,1484,189663,1,323333
40820,0.002132,172.31.36.0-255,66,189729,1,323333
40821,0.002156,172.253.118.0-255,1484,191213,1,323333
40822,0.002163,172.253.118.0-255,5738,196951,1,323333
40823,0.002166,172.31.36.0-255,66,197017,1,323333
40824,0.002169,172.253.118.0-255,1484,198501,1,323333
40825,0.002209,172.31.36.0-255,66,198567,1,323333
40826,0.002228,172.31.36.0-255,66,198633,1,323333
40827,0.002316,172.253.118.0-255,1484,200117,1,323333
40828,0.004503,172.253.118.0-255,4320,204437,1,323333
40829,0.00451,172.31.36.0-255,66,204503,1,323333
40830,0.006816,172.253.118.0-255,5738,210241,1,323333
40831,0.006821,172.31.36.0-255,66,210307,1,323333
40832,0.009106,172.253.118.0-255,5738,216045,1,323333
40833,0.009111,172.31.36.0-255,66,216111,1,323333
40834,0.011398,172.253.118.0-255,5738,221849,1,323333
40835,0.011406,172.31.36.0-255,66,221915,1,323333
40836,0.0137,172.253.118.0-255,5738,227653,1,323333
40837,0.013708,172.31.36.0-255,66,227719,1,323333
40838,0.016024,172.253.118.0-255,5738,233457,1,323333
40839,0.016032,172.31.36.0-255,66,233523,1,323333
40840,0.018356,172.253.118.0-255,5738,239261,1,323333
40841,0.018367,172.31.36.0-255,66,239327,1,323333
40842,0.020669,172.253.118.0-255,5738,245065,1,323333
40843,0.020677,172.31.36.0-255,66,245131,1,323333
40844,0.023024,172.253.118.0-255,5738,250869,1,323333
40845,0.023032,172.31.36.0-255,66,250935,1,323333
40846,0.025332,172.253.118.0-255,5738,256673,1,323333
40847,0.025339,172.31.36.0-255,66,256739,1,323333
40848,0.027631,172.253.118.0-255,5738,262477,1,323333
40849,0.027638,172.31.36.0-255,66,262543,1,323333
40850,0.02993,172.253.118.0-255,5738,268281,1,323333
40851,0.029938,172.31.36.0-255,66,268347,1,323333
40852,0.032235,172.253.118.0-255,5738,274085,1,323333
40853,0.032244,172.31.36.0-255,66,274151,1,323333
40854,0.034547,172.253.118.0-255,5738,279889,1,323333
40855,0.034555,172.31.36.0-255,66,279955,1,323333
40856,0.036862,172.253.118.0-255,5738,285693,1,323333
40857,0.036871,172.31.36.0-255,66,285759,1,323333
40858,0.03901,172.31.36.0-255,172,285931,1,323333
40859,0.039043,172.31.36.0-255,1114,287045,1,323333
40860,0.039129,172.31.36.0-255,1514,288559,1,323333
40861,0.03913,172.31.36.0-255,1514,290073,1,323333
40862,0.039131,172.31.36.0-255,1514,291587,1,323333
40863,0.039133,172.31.36.0-255,1514,293101,1,323333
40864,0.039164,172.253.118.0-255,5738,298839,1,323333
40865,0.039168,172.31.36.0-255,66,298905,1,323333
40866,0.039173,172.31.36.0-255,1492,300397,1,323333
40867,0.040556,104.244.42.0-255,66,300463,1,323333
40868,0.040573,104.244.42.0-255,66,300529,1,323333
40869,0.040669,104.244.42.0-255,66,300595,1,323333
40870,0.040738,104.244.42.0-255,66,300661,1,323333
40871,0.040759,104.244.42.0-255,66,300727,1,323333
40872,0.04147,172.253.118.0-255,5738,306465,1,323333
40873,0.04148,172.31.36.0-255,66,306531,1,323333
40874,0.043778,172.253.118.0-255,5738,312269,1,323333
40875,0.043785,172.31.36.0-255,66,312335,1,323333
40876,0.046103,172.253.118.0-255,5738,318073,1,323333
40877,0.04611,172.31.36.0-255,66,318139,1,323333
40878,0.048406,172.253.118.0-255,5023,323162,1,323333
40879,0.048415,172.31.36.0-255,66,323228,1,323333
40880,0.048772,172.31.36.0-255,105,323333,1,323333
40881,0.0,74.125.24.0-255,152,152,1,344161
40882,1.6e-05,172.31.36.0-255,66,218,1,344161
40883,2.3e-05,74.125.24.0-255,1484,1702,1,344161
40884,2.7e-05,172.31.36.0-255,66,1768,1,344161
40885,4.7e-05,74.125.24.0-255,2902,4670,1,344161
40886,5e-05,172.31.36.0-255,66,4736,1,344161
40887,5.5e-05,74.125.24.0-255,5738,10474,1,344161
40888,5.8e-05,172.31.36.0-255,66,10540,1,344161
40889,9.5e-05,74.125.24.0-255,3454,13994,1,344161
40890,9.9e-05,172.31.36.0-255,66,14060,1,344161
40891,0.000148,74.125.24.0-255,1484,15544,1,344161
40892,0.000153,172.31.36.0-255,66,15610,1,344161
40893,0.000173,74.125.24.0-255,2902,18512,1,344161
40894,0.000175,172.31.36.0-255,66,18578,1,344161
40895,0.00019,74.125.24.0-255,1484,20062,1,344161
40896,0.000192,172.31.36.0-255,66,20128,1,344161
40897,0.000198,74.125.24.0-255,2902,23030,1,344161
40898,0.0002,172.31.36.0-255,66,23096,1,344161
40899,0.000203,74.125.24.0-255,1484,24580,1,344161
40900,0.000205,172.31.36.0-255,66,24646,1,344161
40901,0.000227,74.125.24.0-255,4320,28966,1,344161
40902,0.000229,172.31.36.0-255,66,29032,1,344161
40903,0.000234,74.125.24.0-255,2543,31575,1,344161
40904,0.000236,172.31.36.0-255,66,31641,1,344161
40905,0.00024,74.125.24.0-255,2902,34543,1,344161
40906,0.000242,172.31.36.0-255,66,34609,1,344161
40907,0.000273,74.125.24.0-255,7156,41765,1,344161
40908,0.000277,172.31.36.0-255,66,41831,1,344161
40909,0.000282,74.125.24.0-255,2902,44733,1,344161
40910,0.000284,172.31.36.0-255,66,44799,1,344161
40911,0.000298,74.125.24.0-255,3961,48760,1,344161
40912,0.000301,172.31.36.0-255,66,48826,1,344161
40913,0.000324,74.125.24.0-255,2902,51728,1,344161
40914,0.000327,172.31.36.0-255,66,51794,1,344161
40915,0.000349,74.125.24.0-255,4320,56114,1,344161
40916,0.000352,172.31.36.0-255,66,56180,1,344161
40917,0.000357,74.125.24.0-255,4320,60500,1,344161
40918,0.00036,172.31.36.0-255,66,60566,1,344161
40919,0.0004,74.125.24.0-255,5680,66246,1,344161
40920,0.000403,172.31.36.0-255,66,66312,1,344161
40921,0.000469,74.125.24.0-255,378,66690,1,344161
40922,0.000614,74.125.24.0-255,1484,68174,1,344161
40923,0.000617,172.31.36.0-255,66,68240,1,344161
40924,0.000622,74.125.24.0-255,2902,71142,1,344161
40925,0.000624,172.31.36.0-255,66,71208,1,344161
40926,0.000627,74.125.24.0-255,1484,72692,1,344161
40927,0.000644,74.125.24.0-255,4320,77012,1,344161
40928,0.000647,172.31.36.0-255,66,77078,1,344161
40929,0.000667,74.125.24.0-255,4320,81398,1,344161
40930,0.00067,172.31.36.0-255,66,81464,1,344161
40931,0.000706,172.31.36.0-255,66,81530,1,344161
40932,0.000713,74.125.24.0-255,7156,88686,1,344161
40933,0.000715,172.31.36.0-255,66,88752,1,344161
40934,0.000737,74.125.24.0-255,2543,91295,1,344161
40935,0.000742,172.31.36.0-255,66,91361,1,344161
40936,0.001096,74.125.24.0-255,1484,92845,1,344161
40937,0.001105,74.125.24.0-255,2902,95747,1,344161
40938,0.001108,172.31.36.0-255,66,95813,1,344161
40939,0.001114,74.125.24.0-255,4320,100133,1,344161
40940,0.001116,172.31.36.0-255,66,100199,1,344161
40941,0.00113,74.125.24.0-255,1484,101683,1,344161
40942,0.001137,74.125.24.0-255,7156,108839,1,344161
40943,0.001139,172.31.36.0-255,66,108905,1,344161
40944,0.00116,74.125.24.0-255,5738,114643,1,344161
40945,0.001162,172.31.36.0-255,66,114709,1,344161
40946,0.001186,172.31.36.0-255,66,114775,1,344161
40947,0.001191,74.125.24.0-255,2184,116959,1,344161
40948,0.001193,172.31.36.0-255,66,117025,1,344161
40949,0.001237,74.125.24.0-255,2902,119927,1,344161
40950,0.001241,172.31.36.0-255,66,119993,1,344161
40951,0.001249,74.125.24.0-255,7156,127149,1,344161
40952,0.001251,172.31.36.0-255,66,127215,1,344161
40953,0.001261,172.31.36.0-255,66,127281,1,344161
40954,0.001283,74.125.24.0-255,2902,130183,1,344161
40955,0.001286,172.31.36.0-255,66,130249,1,344161
40956,0.001291,74.125.24.0-255,2902,133151,1,344161
40957,0.001293,172.31.36.0-255,66,133217,1,344161
40958,0.001318,172.31.36.0-255,66,133283,1,344161
40959,0.001336,74.125.24.0-255,1484,134767,1,344161
40960,0.001357,74.125.24.0-255,2902,137669,1,344161
40961,0.00136,172.31.36.0-255,66,137735,1,344161
40962,0.001366,74.125.24.0-255,5738,143473,1,344161
40963,0.001369,172.31.36.0-255,66,143539,1,344161
40964,0.001403,172.31.36.0-255,66,143605,1,344161
40965,0.001435,172.31.36.0-255,66,143671,1,344161
40966,0.001548,74.125.24.0-255,1484,145155,1,344161
40967,0.001555,74.125.24.0-255,2902,148057,1,344161
40968,0.001558,172.31.36.0-255,66,148123,1,344161
40969,0.001583,74.125.24.0-255,5738,153861,1,344161
40970,0.001587,172.31.36.0-255,66,153927,1,344161
40971,0.001592,74.125.24.0-255,4320,158247,1,344161
40972,0.001594,172.31.36.0-255,66,158313,1,344161
40973,0.001614,74.125.24.0-255,4320,162633,1,344161
40974,0.001617,172.31.36.0-255,66,162699,1,344161
40975,0.001634,74.125.24.0-255,7156,169855,1,344161
40976,0.001637,172.31.36.0-255,66,169921,1,344161
40977,0.001649,172.31.36.0-255,66,169987,1,344161
40978,0.001824,74.125.24.0-255,1484,171471,1,344161
40979,0.00184,74.125.24.0-255,2902,174373,1,344161
40980,0.001844,172.31.36.0-255,66,174439,1,344161
40981,0.001859,74.125.24.0-255,4320,178759,1,344161
40982,0.001862,172.31.36.0-255,66,178825,1,344161
40983,0.001881,74.125.24.0-255,1484,180309,1,344161
40984,0.001894,74.125.24.0-255,7156,187465,1,344161
40985,0.001897,172.31.36.0-255,66,187531,1,344161
40986,0.001918,74.125.24.0-255,5738,193269,1,344161
40987,0.001921,172.31.36.0-255,66,193335,1,344161
40988,0.001927,74.125.24.0-255,5738,199073,1,344161
40989,0.001929,172.31.36.0-255,66,199139,1,344161
40990,0.001946,74.125.24.0-255,4320,203459,1,344161
40991,0.001948,172.31.36.0-255,66,203525,1,344161
40992,0.001992,172.31.36.0-255,66,203591,1,344161
40993,0.003919,74.125.24.0-255,5738,209329,1,344161
40994,0.003925,172.31.36.0-255,66,209395,1,344161
40995,0.005868,74.125.24.0-255,5738,215133,1,344161
40996,0.005874,172.31.36.0-255,66,215199,1,344161
40997,0.007827,74.125.24.0-255,4320,219519,1,344161
40998,0.00783,172.31.36.0-255,66,219585,1,344161
40999,0.007846,74.125.24.0-255,1484,221069,1,344161
41000,0.009762,74.125.24.0-255,4320,225389,1,344161
41001,0.009769,172.31.36.0-255,66,225455,1,344161
41002,0.011722,74.125.24.0-255,5738,231193,1,344161
41003,0.011731,172.31.36.0-255,66,231259,1,344161
41004,0.013734,74.125.24.0-255,5738,236997,1,344161
41005,0.013742,172.31.36.0-255,66,237063,1,344161
41006,0.015712,74.125.24.0-255,5738,242801,1,344161
41007,0.015725,172.31.36.0-255,66,242867,1,344161
41008,0.017661,74.125.24.0-255,5738,248605,1,344161
41009,0.017671,172.31.36.0-255,66,248671,1,344161
41010,0.019616,74.125.24.0-255,5738,254409,1,344161
41011,0.019623,172.31.36.0-255,66,254475,1,344161
41012,0.02161,74.125.24.0-255,5738,260213,1,344161
41013,0.021618,172.31.36.0-255,66,260279,1,344161
41014,0.023577,74.125.24.0-255,5738,266017,1,344161
41015,0.023585,172.31.36.0-255,66,266083,1,344161
41016,0.025523,74.125.24.0-255,5738,271821,1,344161
41017,0.025532,172.31.36.0-255,66,271887,1,344161
41018,0.027466,74.125.24.0-255,5738,277625,1,344161
41019,0.027474,172.31.36.0-255,66,277691,1,344161
41020,0.028869,172.31.36.0-255,172,277863,1,344161
41021,0.0289,172.31.36.0-255,1113,278976,1,344161
41022,0.028967,172.31.36.0-255,1514,280490,1,344161
41023,0.028969,172.31.36.0-255,1514,282004,1,344161
41024,0.028974,172.31.36.0-255,1514,283518,1,344161
41025,0.028975,172.31.36.0-255,1514,285032,1,344161
41026,0.028994,172.31.36.0-255,1493,286525,1,344161
41027,0.029431,74.125.24.0-255,5738,292263,1,344161
41028,0.029438,172.31.36.0-255,66,292329,1,344161
41029,0.030405,104.244.42.0-255,66,292395,1,344161
41030,0.03045,104.244.42.0-255,66,292461,1,344161
41031,0.03055,104.244.42.0-255,66,292527,1,344161
41032,0.030575,104.244.42.0-255,66,292593,1,344161
41033,0.031364,74.125.24.0-255,5738,298331,1,344161
41034,0.031369,172.31.36.0-255,66,298397,1,344161
41035,0.033322,74.125.24.0-255,5738,304135,1,344161
41036,0.033327,172.31.36.0-255,66,304201,1,344161
41037,0.035286,74.125.24.0-255,5738,309939,1,344161
41038,0.035293,172.31.36.0-255,66,310005,1,344161
41039,0.037218,74.125.24.0-255,5738,315743,1,344161
41040,0.037224,172.31.36.0-255,66,315809,1,344161
41041,0.03916,74.125.24.0-255,5738,321547,1,344161
41042,0.039166,172.31.36.0-255,66,321613,1,344161
41043,0.041138,74.125.24.0-255,5738,327351,1,344161
41044,0.041145,172.31.36.0-255,66,327417,1,344161
41045,0.043094,74.125.24.0-255,5738,333155,1,344161
41046,0.0431,172.31.36.0-255,66,333221,1,344161
41047,0.045041,74.125.24.0-255,5738,338959,1,344161
41048,0.045047,172.31.36.0-255,66,339025,1,344161
41049,0.046967,74.125.24.0-255,4965,343990,1,344161
41050,0.046976,172.31.36.0-255,66,344056,1,344161
41051,0.048241,172.31.36.0-255,105,344161,1,344161
41052,0.0,172.217.194.0-255,146,146,1,181989
41053,2.9e-05,172.31.36.0-255,66,212,1,181989
41054,3.6e-05,172.217.194.0-255,1484,1696,1,181989
41055,4e-05,172.31.36.0-255,66,1762,1,181989
41056,4.5e-05,172.217.194.0-255,2902,4664,1,181989
41057,5.6e-05,172.31.36.0-255,66,4730,1,181989
41058,6.4e-05,172.217.194.0-255,7156,11886,1,181989
41059,6.7e-05,172.31.36.0-255,66,11952,1,181989
41060,7.1e-05,172.217.194.0-255,1999,13951,1,181989
41061,7.4e-05,172.31.36.0-255,66,14017,1,181989
41062,0.000106,172.217.194.0-255,2902,16919,1,181989
41063,0.00011,172.31.36.0-255,66,16985,1,181989
41064,0.000113,172.217.194.0-255,1484,18469,1,181989
41065,0.000115,172.31.36.0-255,66,18535,1,181989
41066,0.00012,172.217.194.0-255,4320,22855,1,181989
41067,0.000123,172.31.36.0-255,66,22921,1,181989
41068,0.000151,172.217.194.0-255,1484,24405,1,181989
41069,0.000154,172.31.36.0-255,66,24471,1,181989
41070,0.000162,172.217.194.0-255,7156,31627,1,181989
41071,0.000165,172.31.36.0-255,66,31693,1,181989
41072,0.0002,172.217.194.0-255,6797,38490,1,181989
41073,0.000204,172.31.36.0-255,66,38556,1,181989
41074,0.000215,172.31.36.0-255,66,38622,1,181989
41075,0.000259,172.31.36.0-255,66,38688,1,181989
41076,0.000262,172.217.194.0-255,397,39085,1,181989
41077,0.000264,172.31.36.0-255,66,39151,1,181989
41078,0.000302,172.217.194.0-255,378,39529,1,181989
41079,0.000307,172.31.36.0-255,66,39595,1,181989
41080,0.000449,172.217.194.0-255,1484,41079,1,181989
41081,0.000453,172.31.36.0-255,66,41145,1,181989
41082,0.000457,172.217.194.0-255,1484,42629,1,181989
41083,0.00046,172.31.36.0-255,66,42695,1,181989
41084,0.000485,172.217.194.0-255,1484,44179,1,181989
41085,0.000489,172.31.36.0-255,66,44245,1,181989
41086,0.000501,172.217.194.0-255,5738,49983,1,181989
41087,0.000505,172.31.36.0-255,66,50049,1,181989
41088,0.000508,172.217.194.0-255,1484,51533,1,181989
41089,0.00051,172.31.36.0-255,66,51599,1,181989
41090,0.000523,172.31.36.0-255,66,51665,1,181989
41091,0.00056,172.217.194.0-255,7156,58821,1,181989
41092,0.000564,172.31.36.0-255,66,58887,1,181989
41093,0.000589,172.217.194.0-255,2184,61071,1,181989
41094,0.000593,172.31.36.0-255,66,61137,1,181989
41095,0.000631,172.217.194.0-255,1484,62621,1,181989
41096,0.000634,172.31.36.0-255,66,62687,1,181989
41097,0.000639,172.217.194.0-255,2902,65589,1,181989
41098,0.000642,172.31.36.0-255,66,65655,1,181989
41099,0.000645,172.217.194.0-255,1484,67139,1,181989
41100,0.000647,172.31.36.0-255,66,67205,1,181989
41101,0.000677,172.217.194.0-255,4320,71525,1,181989
41102,0.000681,172.31.36.0-255,66,71591,1,181989
41103,0.000695,172.31.36.0-255,66,71657,1,181989
41104,0.000698,172.217.194.0-255,1484,73141,1,181989
41105,0.000701,172.31.36.0-255,66,73207,1,181989
41106,0.000748,172.31.36.0-255,66,73273,1,181989
41107,0.00083,172.217.194.0-255,1484,74757,1,181989
41108,0.000833,172.31.36.0-255,66,74823,1,181989
41109,0.000838,172.217.194.0-255,2902,77725,1,181989
41110,0.00084,172.31.36.0-255,66,77791,1,181989
41111,0.000868,172.217.194.0-255,5738,83529,1,181989
41112,0.000872,172.31.36.0-255,66,83595,1,181989
41113,0.000885,172.31.36.0-255,66,83661,1,181989
41114,0.000892,172.217.194.0-255,7156,90817,1,181989
41115,0.000909,172.31.36.0-255,66,90883,1,181989
41116,0.000911,172.217.194.0-255,2902,93785,1,181989
41117,0.000914,172.217.194.0-255,766,94551,1,181989
41118,0.000923,172.31.36.0-255,66,94617,1,181989
41119,0.001296,172.217.194.0-255,1484,96101,1,181989
41120,0.0013,172.31.36.0-255,66,96167,1,181989
41121,0.001306,172.217.194.0-255,2902,99069,1,181989
41122,0.001308,172.31.36.0-255,66,99135,1,181989
41123,0.00132,172.217.194.0-255,5738,104873,1,181989
41124,0.001327,172.31.36.0-255,66,104939,1,181989
41125,0.001362,172.31.36.0-255,66,105005,1,181989
41126,0.001369,172.31.36.0-255,66,105071,1,181989
41127,0.001371,172.217.194.0-255,1484,106555,1,181989
41128,0.001374,172.217.194.0-255,766,107321,1,181989
41129,0.001383,172.31.36.0-255,66,107387,1,181989
41130,0.001463,172.217.194.0-255,1484,108871,1,181989
41131,0.001467,172.217.194.0-255,1484,110355,1,181989
41132,0.001471,172.31.36.0-255,66,110421,1,181989
41133,0.00148,172.217.194.0-255,1484,111905,1,181989
41134,0.001486,172.217.194.0-255,5738,117643,1,181989
41135,0.001513,172.217.194.0-255,7156,124799,1,181989
41136,0.001513,172.31.36.0-255,66,124865,1,181989
41137,0.001518,172.217.194.0-255,4320,129185,1,181989
41138,0.001519,172.31.36.0-255,66,129251,1,181989
41139,0.00154,172.31.36.0-255,66,129317,1,181989
41140,0.00155,172.217.194.0-255,2184,131501,1,181989
41141,0.001555,172.217.194.0-255,2902,134403,1,181989
41142,0.001559,172.217.194.0-255,2902,137305,1,181989
41143,0.001563,172.31.36.0-255,66,137371,1,181989
41144,0.001588,172.217.194.0-255,4320,141691,1,181989
41145,0.001593,172.31.36.0-255,66,141757,1,181989
41146,0.001619,172.31.36.0-255,66,141823,1,181989
41147,0.001643,172.217.194.0-255,1484,143307,1,181989
41148,0.001649,172.217.194.0-255,2902,146209,1,181989
41149,0.001653,172.31.36.0-255,66,146275,1,181989
41150,0.001672,172.217.194.0-255,5738,152013,1,181989
41151,0.001679,172.31.36.0-255,66,152079,1,181989
41152,0.001751,172.31.36.0-255,66,152145,1,181989
41153,0.001756,172.217.194.0-255,1484,153629,1,181989
41154,0.001767,172.31.36.0-255,66,153695,1,181989
41155,0.001786,172.217.194.0-255,2902,156597,1,181989
41156,0.001792,172.217.194.0-255,5738,162335,1,181989
41157,0.001794,172.31.36.0-255,66,162401,1,181989
41158,0.001801,172.31.36.0-255,66,162467,1,181989
41159,0.001836,172.31.36.0-255,66,162533,1,181989
41160,0.001879,172.31.36.0-255,66,162599,1,181989
41161,0.001889,172.217.194.0-255,2184,164783,1,181989
41162,0.001894,172.31.36.0-255,66,164849,1,181989
41163,0.001905,172.217.194.0-255,2902,167751,1,181989
41164,0.00191,172.31.36.0-255,66,167817,1,181989
41165,0.001959,172.31.36.0-255,66,167883,1,181989
41166,0.001974,172.217.194.0-255,4320,172203,1,181989
41167,0.001974,172.31.36.0-255,66,172269,1,181989
41168,0.001978,172.31.36.0-255,66,172335,1,181989
41169,0.002017,172.31.36.0-255,66,172401,1,181989
41170,0.002033,172.31.36.0-255,66,172467,1,181989
41171,0.002051,172.217.194.0-255,105,172572,1,181989
41172,0.003666,172.31.36.0-255,66,172638,1,181989
41173,0.003693,172.31.36.0-255,105,172743,1,181989
41174,0.005901,172.217.194.0-255,66,172809,1,181989
41175,0.036674,172.31.36.0-255,188,172997,1,181989
41176,0.036703,172.31.36.0-255,958,173955,1,181989
41177,0.036744,172.31.36.0-255,1514,175469,1,181989
41178,0.036746,172.31.36.0-255,1514,176983,1,181989
41179,0.036751,172.31.36.0-255,1514,178497,1,181989
41180,0.036752,172.31.36.0-255,1514,180011,1,181989
41181,0.036771,172.31.36.0-255,1514,181525,1,181989
41182,0.036772,172.31.36.0-255,200,181725,1,181989
41183,0.038159,104.244.42.0-255,66,181791,1,181989
41184,0.038177,104.244.42.0-255,66,181857,1,181989
41185,0.038236,104.244.42.0-255,66,181923,1,181989
41186,0.038297,104.244.42.0-255,66,181989,1,181989
41187,0.0,74.125.24.0-255,153,153,1,195529
41188,2.3e-05,172.31.36.0-255,66,219,1,195529
41189,3.1e-05,74.125.24.0-255,1484,1703,1,195529
41190,3.5e-05,172.31.36.0-255,66,1769,1,195529
41191,4.1e-05,74.125.24.0-255,2902,4671,1,195529
41192,5.2e-05,172.31.36.0-255,66,4737,1,195529
41193,6e-05,74.125.24.0-255,7156,11893,1,195529
41194,6.4e-05,172.31.36.0-255,66,11959,1,195529
41195,6.9e-05,74.125.24.0-255,2046,14005,1,195529
41196,7.2e-05,172.31.36.0-255,66,14071,1,195529
41197,0.000137,74.125.24.0-255,1484,15555,1,195529
41198,0.00014,172.31.36.0-255,66,15621,1,195529
41199,0.00017,74.125.24.0-255,2902,18523,1,195529
41200,0.000173,172.31.36.0-255,66,18589,1,195529
41201,0.00018,74.125.24.0-255,5738,24327,1,195529
41202,0.000182,172.31.36.0-255,66,24393,1,195529
41203,0.000218,74.125.24.0-255,6797,31190,1,195529
41204,0.000221,172.31.36.0-255,66,31256,1,195529
41205,0.000354,74.125.24.0-255,1484,32740,1,195529
41206,0.000359,172.31.36.0-255,66,32806,1,195529
41207,0.000363,74.125.24.0-255,1484,34290,1,195529
41208,0.000365,172.31.36.0-255,66,34356,1,195529
41209,0.000397,74.125.24.0-255,2902,37258,1,195529
41210,0.0004,172.31.36.0-255,66,37324,1,195529
41211,0.000408,74.125.24.0-255,5738,43062,1,195529
41212,0.00041,172.31.36.0-255,66,43128,1,195529
41213,0.000421,74.125.24.0-255,4320,47448,1,195529
41214,0.000423,172.31.36.0-255,66,47514,1,195529
41215,0.000444,74.125.24.0-255,2543,50057,1,195529
41216,0.000447,172.31.36.0-255,66,50123,1,195529
41217,0.000454,74.125.24.0-255,5738,55861,1,195529
41218,0.000457,172.31.36.0-255,66,55927,1,195529
41219,0.000496,172.31.36.0-255,66,55993,1,195529
41220,0.000499,74.125.24.0-255,1437,57430,1,195529
41221,0.000503,74.125.24.0-255,375,57805,1,195529
41222,0.000505,172.31.36.0-255,66,57871,1,195529
41223,0.000684,74.125.24.0-255,1484,59355,1,195529
41224,0.000692,74.125.24.0-255,2902,62257,1,195529
41225,0.000697,172.31.36.0-255,66,62323,1,195529
41226,0.000704,74.125.24.0-255,5738,68061,1,195529
41227,0.000706,172.31.36.0-255,66,68127,1,195529
41228,0.000709,74.125.24.0-255,1484,69611,1,195529
41229,0.000754,172.31.36.0-255,66,69677,1,195529
41230,0.000761,74.125.24.0-255,7156,76833,1,195529
41231,0.000763,172.31.36.0-255,66,76899,1,195529
41232,0.000773,74.125.24.0-255,3602,80501,1,195529
41233,0.000776,172.31.36.0-255,66,80567,1,195529
41234,0.000914,74.125.24.0-255,1484,82051,1,195529
41235,0.00092,74.125.24.0-255,2902,84953,1,195529
41236,0.000923,172.31.36.0-255,66,85019,1,195529
41237,0.00093,74.125.24.0-255,5738,90757,1,195529
41238,0.000932,172.31.36.0-255,66,90823,1,195529
41239,0.000967,172.31.36.0-255,66,90889,1,195529
41240,0.000971,74.125.24.0-255,2902,93791,1,195529
41241,0.000973,172.31.36.0-255,66,93857,1,195529
41242,0.001009,172.31.36.0-255,66,93923,1,195529
41243,0.001037,74.125.24.0-255,1484,95407,1,195529
41244,0.001042,74.125.24.0-255,2902,98309,1,195529
41245,0.001044,172.31.36.0-255,66,98375,1,195529
41246,0.001065,74.125.24.0-255,5738,104113,1,195529
41247,0.001068,172.31.36.0-255,66,104179,1,195529
41248,0.001071,74.125.24.0-255,1484,105663,1,195529
41249,0.001103,172.31.36.0-255,66,105729,1,195529
41250,0.001167,172.31.36.0-255,66,105795,1,195529
41251,0.001204,74.125.24.0-255,1484,107279,1,195529
41252,0.001221,74.125.24.0-255,2902,110181,1,195529
41253,0.001224,172.31.36.0-255,66,110247,1,195529
41254,0.00123,74.125.24.0-255,5738,115985,1,195529
41255,0.001233,172.31.36.0-255,66,116051,1,195529
41256,0.001252,74.125.24.0-255,4320,120371,1,195529
41257,0.001254,172.31.36.0-255,66,120437,1,195529
41258,0.001293,172.31.36.0-255,66,120503,1,195529
41259,0.001305,172.31.36.0-255,66,120569,1,195529
41260,0.001383,74.125.24.0-255,1484,122053,1,195529
41261,0.001388,74.125.24.0-255,2902,124955,1,195529
41262,0.001392,172.31.36.0-255,66,125021,1,195529
41263,0.001418,74.125.24.0-255,5738,130759,1,195529
41264,0.001421,172.31.36.0-255,66,130825,1,195529
41265,0.001452,172.31.36.0-255,66,130891,1,195529
41266,0.001481,74.125.24.0-255,1484,132375,1,195529
41267,0.001494,172.31.36.0-255,66,132441,1,195529
41268,0.001499,74.125.24.0-255,2184,134625,1,195529
41269,0.001502,172.31.36.0-255,66,134691,1,195529
41270,0.001612,74.125.24.0-255,1484,136175,1,195529
41271,0.001636,74.125.24.0-255,2902,139077,1,195529
41272,0.001641,172.31.36.0-255,66,139143,1,195529
41273,0.001672,74.125.24.0-255,5738,144881,1,195529
41274,0.001675,172.31.36.0-255,66,144947,1,195529
41275,0.00168,74.125.24.0-255,2902,147849,1,195529
41276,0.001682,172.31.36.0-255,66,147915,1,195529
41277,0.001713,74.125.24.0-255,4320,152235,1,195529
41278,0.001716,172.31.36.0-255,66,152301,1,195529
41279,0.001722,74.125.24.0-255,4320,156621,1,195529
41280,0.001724,172.31.36.0-255,66,156687,1,195529
41281,0.001759,74.125.24.0-255,4320,161007,1,195529
41282,0.001763,172.31.36.0-255,66,161073,1,195529
41283,0.001769,74.125.24.0-255,4320,165393,1,195529
41284,0.001771,172.31.36.0-255,66,165459,1,195529
41285,0.001785,172.31.36.0-255,66,165525,1,195529
41286,0.001814,74.125.24.0-255,2184,167709,1,195529
41287,0.001828,172.31.36.0-255,66,167775,1,195529
41288,0.001836,172.31.36.0-255,66,167841,1,195529
41289,0.001854,172.31.36.0-255,66,167907,1,195529
41290,0.001882,74.125.24.0-255,1484,169391,1,195529
41291,0.001918,172.31.36.0-255,66,169457,1,195529
41292,0.001936,172.31.36.0-255,66,169523,1,195529
41293,0.001948,172.31.36.0-255,66,169589,1,195529
41294,0.002012,172.31.36.0-255,66,169655,1,195529
41295,0.002024,172.31.36.0-255,66,169721,1,195529
41296,0.00207,172.31.36.0-255,66,169787,1,195529
41297,0.002085,172.31.36.0-255,66,169853,1,195529
41298,0.002091,74.125.24.0-255,5738,175591,1,195529
41299,0.002093,172.31.36.0-255,66,175657,1,195529
41300,0.002136,172.31.36.0-255,66,175723,1,195529
41301,0.002143,74.125.24.0-255,5738,181461,1,195529
41302,0.002145,172.31.36.0-255,66,181527,1,195529
41303,0.002173,74.125.24.0-255,4483,186010,1,195529
41304,0.002176,172.31.36.0-255,66,186076,1,195529
41305,0.002179,74.125.24.0-255,105,186181,1,195529
41306,0.0118,172.31.36.0-255,66,186247,1,195529
41307,0.011846,172.31.36.0-255,105,186352,1,195529
41308,0.014145,74.125.24.0-255,66,186418,1,195529
41309,0.036522,172.31.36.0-255,172,186590,1,195529
41310,0.036566,172.31.36.0-255,1112,187702,1,195529
41311,0.036636,172.31.36.0-255,1514,189216,1,195529
41312,0.036638,172.31.36.0-255,1514,190730,1,195529
41313,0.036643,172.31.36.0-255,1514,192244,1,195529
41314,0.036644,172.31.36.0-255,1514,193758,1,195529
41315,0.036683,172.31.36.0-255,1507,195265,1,195529
41316,0.038004,104.244.42.0-255,66,195331,1,195529
41317,0.038049,104.244.42.0-255,66,195397,1,195529
41318,0.038166,104.244.42.0-255,66,195463,1,195529
41319,0.038194,104.244.42.0-255,66,195529,1,195529
41320,0.0,74.125.24.0-255,152,152,1,279078
41321,2.1e-05,172.31.36.0-255,66,218,1,279078
41322,2.8e-05,74.125.24.0-255,1484,1702,1,279078
41323,3.3e-05,172.31.36.0-255,66,1768,1,279078
41324,4e-05,74.125.24.0-255,2902,4670,1,279078
41325,4.2e-05,172.31.36.0-255,66,4736,1,279078
41326,5e-05,74.125.24.0-255,7156,11892,1,279078
41327,5.3e-05,172.31.36.0-255,66,11958,1,279078
41328,5.7e-05,74.125.24.0-255,2036,13994,1,279078
41329,6e-05,172.31.36.0-255,66,14060,1,279078
41330,0.000264,74.125.24.0-255,1484,15544,1,279078
41331,0.00027,172.31.36.0-255,66,15610,1,279078
41332,0.000289,74.125.24.0-255,2902,18512,1,279078
41333,0.000293,172.31.36.0-255,66,18578,1,279078
41334,0.000319,74.125.24.0-255,5738,24316,1,279078
41335,0.000323,172.31.36.0-255,66,24382,1,279078
41336,0.000326,74.125.24.0-255,1484,25866,1,279078
41337,0.000329,172.31.36.0-255,66,25932,1,279078
41338,0.00035,74.125.24.0-255,5379,31311,1,279078
41339,0.000353,172.31.36.0-255,66,31377,1,279078
41340,0.000597,74.125.24.0-255,1484,32861,1,279078
41341,0.000603,172.31.36.0-255,66,32927,1,279078
41342,0.000628,74.125.24.0-255,2902,35829,1,279078
41343,0.000633,172.31.36.0-255,66,35895,1,279078
41344,0.000639,74.125.24.0-255,5738,41633,1,279078
41345,0.000641,172.31.36.0-255,66,41699,1,279078
41346,0.000685,74.125.24.0-255,6797,48496,1,279078
41347,0.00069,172.31.36.0-255,66,48562,1,279078
41348,0.000723,74.125.24.0-255,1484,50046,1,279078
41349,0.000728,172.31.36.0-255,66,50112,1,279078
41350,0.00075,74.125.24.0-255,2902,53014,1,279078
41351,0.000753,172.31.36.0-255,66,53080,1,279078
41352,0.000759,74.125.24.0-255,5738,58818,1,279078
41353,0.000763,172.31.36.0-255,66,58884,1,279078
41354,0.000788,74.125.24.0-255,5738,64622,1,279078
41355,0.000791,172.31.36.0-255,66,64688,1,279078
41356,0.000808,74.125.24.0-255,1455,66143,1,279078
41357,0.000957,74.125.24.0-255,115,66258,1,279078
41358,0.000963,172.31.36.0-255,66,66324,1,279078
41359,0.000968,74.125.24.0-255,329,66653,1,279078
41360,0.001293,172.31.36.0-255,66,66719,1,279078
41361,0.001463,74.125.24.0-255,1484,68203,1,279078
41362,0.001471,74.125.24.0-255,2902,71105,1,279078
41363,0.001474,172.31.36.0-255,66,71171,1,279078
41364,0.001492,74.125.24.0-255,5738,76909,1,279078
41365,0.001494,172.31.36.0-255,66,76975,1,279078
41366,0.001585,172.31.36.0-255,66,77041,1,279078
41367,0.001602,74.125.24.0-255,2902,79943,1,279078
41368,0.001603,172.31.36.0-255,66,80009,1,279078
41369,0.001614,172.31.36.0-255,66,80075,1,279078
41370,0.001719,74.125.24.0-255,1484,81559,1,279078
41371,0.001741,74.125.24.0-255,2902,84461,1,279078
41372,0.001743,172.31.36.0-255,66,84527,1,279078
41373,0.001764,74.125.24.0-255,5738,90265,1,279078
41374,0.001766,172.31.36.0-255,66,90331,1,279078
41375,0.001771,74.125.24.0-255,4320,94651,1,279078
41376,0.001772,172.31.36.0-255,66,94717,1,279078
41377,0.001783,74.125.24.0-255,1484,96201,1,279078
41378,0.001812,74.125.24.0-255,7156,103357,1,279078
41379,0.001814,172.31.36.0-255,66,103423,1,279078
41380,0.001831,74.125.24.0-255,5738,109161,1,279078
41381,0.001833,172.31.36.0-255,66,109227,1,279078
41382,0.001838,74.125.24.0-255,5020,114247,1,279078
41383,0.00184,172.31.36.0-255,66,114313,1,279078
41384,0.001879,74.125.24.0-255,1484,115797,1,279078
41385,0.001884,74.125.24.0-255,2902,118699,1,279078
41386,0.001886,172.31.36.0-255,66,118765,1,279078
41387,0.001907,74.125.24.0-255,5738,124503,1,279078
41388,0.001909,172.31.36.0-255,66,124569,1,279078
41389,0.001932,74.125.24.0-255,7156,131725,1,279078
41390,0.001934,172.31.36.0-255,66,131791,1,279078
41391,0.001975,172.31.36.0-255,66,131857,1,279078
41392,0.001979,74.125.24.0-255,2184,134041,1,279078
41393,0.001981,172.31.36.0-255,66,134107,1,279078
41394,0.002067,74.125.24.0-255,1484,135591,1,279078
41395,0.002083,74.125.24.0-255,2902,138493,1,279078
41396,0.002085,172.31.36.0-255,66,138559,1,279078
41397,0.00209,74.125.24.0-255,4320,142879,1,279078
41398,0.002093,172.31.36.0-255,66,142945,1,279078
41399,0.002105,74.125.24.0-255,1484,144429,1,279078
41400,0.00212,74.125.24.0-255,1484,145913,1,279078
41401,0.002123,172.31.36.0-255,66,145979,1,279078
41402,0.002151,172.31.36.0-255,66,146045,1,279078
41403,0.002188,74.125.24.0-255,2902,148947,1,279078
41404,0.00219,172.31.36.0-255,66,149013,1,279078
41405,0.002214,172.31.36.0-255,66,149079,1,279078
41406,0.004501,74.125.24.0-255,5738,154817,1,279078
41407,0.004511,172.31.36.0-255,66,154883,1,279078
41408,0.006791,74.125.24.0-255,5738,160621,1,279078
41409,0.006801,172.31.36.0-255,66,160687,1,279078
41410,0.009061,74.125.24.0-255,5738,166425,1,279078
41411,0.009072,172.31.36.0-255,66,166491,1,279078
41412,0.011316,74.125.24.0-255,5738,172229,1,279078
41413,0.011328,172.31.36.0-255,66,172295,1,279078
41414,0.013565,74.125.24.0-255,5738,178033,1,279078
41415,0.013573,172.31.36.0-255,66,178099,1,279078
41416,0.015867,74.125.24.0-255,5738,183837,1,279078
41417,0.015877,172.31.36.0-255,66,183903,1,279078
41418,0.018125,74.125.24.0-255,5738,189641,1,279078
41419,0.018134,172.31.36.0-255,66,189707,1,279078
41420,0.020429,74.125.24.0-255,5738,195445,1,279078
41421,0.020436,172.31.36.0-255,66,195511,1,279078
41422,0.022697,74.125.24.0-255,5738,201249,1,279078
41423,0.022705,172.31.36.0-255,66,201315,1,279078
41424,0.024961,74.125.24.0-255,5738,207053,1,279078
41425,0.024969,172.31.36.0-255,66,207119,1,279078
41426,0.027237,74.125.24.0-255,5738,212857,1,279078
41427,0.027245,172.31.36.0-255,66,212923,1,279078
41428,0.0295,74.125.24.0-255,5738,218661,1,279078
41429,0.029508,172.31.36.0-255,66,218727,1,279078
41430,0.031691,172.31.36.0-255,172,218899,1,279078
41431,0.031746,74.125.24.0-255,5738,224637,1,279078
41432,0.031752,172.31.36.0-255,66,224703,1,279078
41433,0.031784,172.31.36.0-255,1115,225818,1,279078
41434,0.03195,172.31.36.0-255,1514,227332,1,279078
41435,0.031953,172.31.36.0-255,1514,228846,1,279078
41436,0.031954,172.31.36.0-255,1514,230360,1,279078
41437,0.031955,172.31.36.0-255,1514,231874,1,279078
41438,0.031987,172.31.36.0-255,1488,233362,1,279078
41439,0.033237,104.244.42.0-255,66,233428,1,279078
41440,0.033317,104.244.42.0-255,66,233494,1,279078
41441,0.033581,104.244.42.0-255,66,233560,1,279078
41442,0.033982,74.125.24.0-255,2902,236462,1,279078
41443,0.033988,172.31.36.0-255,66,236528,1,279078
41444,0.034009,74.125.24.0-255,2902,239430,1,279078
41445,0.034012,172.31.36.0-255,66,239496,1,279078
41446,0.035029,104.244.42.0-255,108,239604,1,279078
41447,0.035038,172.31.36.0-255,66,239670,1,279078
41448,0.036256,74.125.24.0-255,2902,242572,1,279078
41449,0.036261,172.31.36.0-255,66,242638,1,279078
41450,0.036285,74.125.24.0-255,2902,245540,1,279078
41451,0.036287,172.31.36.0-255,66,245606,1,279078
41452,0.038536,74.125.24.0-255,4320,249926,1,279078
41453,0.038544,172.31.36.0-255,66,249992,1,279078
41454,0.038563,74.125.24.0-255,1484,251476,1,279078
41455,0.040806,74.125.24.0-255,4320,255796,1,279078
41456,0.040812,172.31.36.0-255,66,255862,1,279078
41457,0.043084,74.125.24.0-255,5738,261600,1,279078
41458,0.043091,172.31.36.0-255,66,261666,1,279078
41459,0.045356,74.125.24.0-255,5738,267404,1,279078
41460,0.045363,172.31.36.0-255,66,267470,1,279078
41461,0.047611,74.125.24.0-255,5738,273208,1,279078
41462,0.047617,172.31.36.0-255,66,273274,1,279078
41463,0.049872,74.125.24.0-255,5738,279012,1,279078
41464,0.049878,172.31.36.0-255,66,279078,1,279078
41465,0.0,74.125.24.0-255,152,152,1,249095
41466,3.6e-05,172.31.36.0-255,66,218,1,249095
41467,4.3e-05,74.125.24.0-255,1484,1702,1,249095
41468,4.7e-05,172.31.36.0-255,66,1768,1,249095
41469,5.2e-05,74.125.24.0-255,2902,4670,1,249095
41470,5.6e-05,172.31.36.0-255,66,4736,1,249095
41471,6.3e-05,74.125.24.0-255,7156,11892,1,249095
41472,6.5e-05,172.31.36.0-255,66,11958,1,249095
41473,7.1e-05,74.125.24.0-255,4320,16278,1,249095
41474,7.4e-05,172.31.36.0-255,66,16344,1,249095
41475,9.6e-05,74.125.24.0-255,3472,19816,1,249095
41476,0.0001,172.31.36.0-255,66,19882,1,249095
41477,0.000109,172.31.36.0-255,66,19948,1,249095
41478,0.000143,74.125.24.0-255,2543,22491,1,249095
41479,0.000146,172.31.36.0-255,66,22557,1,249095
41480,0.000172,74.125.24.0-255,2902,25459,1,249095
41481,0.000175,172.31.36.0-255,66,25525,1,249095
41482,0.000199,74.125.24.0-255,7156,32681,1,249095
41483,0.000202,172.31.36.0-255,66,32747,1,249095
41484,0.000211,74.125.24.0-255,6797,39544,1,249095
41485,0.000213,172.31.36.0-255,66,39610,1,249095
41486,0.000252,172.31.36.0-255,66,39676,1,249095
41487,0.000255,74.125.24.0-255,1437,41113,1,249095
41488,0.000257,172.31.36.0-255,66,41179,1,249095
41489,0.000283,74.125.24.0-255,375,41554,1,249095
41490,0.000285,172.31.36.0-255,66,41620,1,249095
41491,0.0005,74.125.24.0-255,1484,43104,1,249095
41492,0.000504,172.31.36.0-255,66,43170,1,249095
41493,0.00051,74.125.24.0-255,2902,46072,1,249095
41494,0.000512,172.31.36.0-255,66,46138,1,249095
41495,0.000527,74.125.24.0-255,5738,51876,1,249095
41496,0.00054,172.31.36.0-255,66,51942,1,249095
41497,0.000551,74.125.24.0-255,4320,56262,1,249095
41498,0.000556,172.31.36.0-255,66,56328,1,249095
41499,0.000586,74.125.24.0-255,4320,60648,1,249095
41500,0.000588,172.31.36.0-255,66,60714,1,249095
41501,0.000607,172.31.36.0-255,66,60780,1,249095
41502,0.000639,74.125.24.0-255,6438,67218,1,249095
41503,0.000643,172.31.36.0-255,66,67284,1,249095
41504,0.000827,74.125.24.0-255,1484,68768,1,249095
41505,0.00084,74.125.24.0-255,2902,71670,1,249095
41506,0.000843,172.31.36.0-255,66,71736,1,249095
41507,0.000848,74.125.24.0-255,2902,74638,1,249095
41508,0.00085,172.31.36.0-255,66,74704,1,249095
41509,0.000868,74.125.24.0-255,2902,77606,1,249095
41510,0.000871,172.31.36.0-255,66,77672,1,249095
41511,0.000876,74.125.24.0-255,4320,81992,1,249095
41512,0.000885,172.31.36.0-255,66,82058,1,249095
41513,0.00091,172.31.36.0-255,66,82124,1,249095
41514,0.000946,172.31.36.0-255,66,82190,1,249095
41515,0.001035,74.125.24.0-255,1484,83674,1,249095
41516,0.001049,74.125.24.0-255,2902,86576,1,249095
41517,0.001052,172.31.36.0-255,66,86642,1,249095
41518,0.001058,74.125.24.0-255,4320,90962,1,249095
41519,0.001066,172.31.36.0-255,66,91028,1,249095
41520,0.001074,74.125.24.0-255,1484,92512,1,249095
41521,0.00108,74.125.24.0-255,5738,98250,1,249095
41522,0.001085,172.31.36.0-255,66,98316,1,249095
41523,0.001092,74.125.24.0-255,1484,99800,1,249095
41524,0.001119,172.31.36.0-255,66,99866,1,249095
41525,0.001121,74.125.24.0-255,1484,101350,1,249095
41526,0.001127,74.125.24.0-255,5020,106370,1,249095
41527,0.001133,172.31.36.0-255,66,106436,1,249095
41528,0.001168,74.125.24.0-255,1484,107920,1,249095
41529,0.001174,74.125.24.0-255,2902,110822,1,249095
41530,0.001184,172.31.36.0-255,66,110888,1,249095
41531,0.001206,74.125.24.0-255,5738,116626,1,249095
41532,0.001209,74.125.24.0-255,1484,118110,1,249095
41533,0.00121,172.31.36.0-255,66,118176,1,249095
41534,0.001248,172.31.36.0-255,66,118242,1,249095
41535,0.001253,172.31.36.0-255,66,118308,1,249095
41536,0.001439,74.125.24.0-255,1484,119792,1,249095
41537,0.001457,74.125.24.0-255,2902,122694,1,249095
41538,0.00146,172.31.36.0-255,66,122760,1,249095
41539,0.001467,74.125.24.0-255,5738,128498,1,249095
41540,0.00148,172.31.36.0-255,66,128564,1,249095
41541,0.001493,74.125.24.0-255,5738,134302,1,249095
41542,0.001505,172.31.36.0-255,66,134368,1,249095
41543,0.001508,74.125.24.0-255,2902,137270,1,249095
41544,0.001515,74.125.24.0-255,5738,143008,1,249095
41545,0.001519,172.31.36.0-255,66,143074,1,249095
41546,0.001544,74.125.24.0-255,4320,147394,1,249095
41547,0.001547,172.31.36.0-255,66,147460,1,249095
41548,0.001549,74.125.24.0-255,5020,152480,1,249095
41549,0.001567,172.31.36.0-255,66,152546,1,249095
41550,0.002245,74.125.24.0-255,1484,154030,1,249095
41551,0.002255,74.125.24.0-255,2902,156932,1,249095
41552,0.002258,172.31.36.0-255,66,156998,1,249095
41553,0.002265,74.125.24.0-255,5738,162736,1,249095
41554,0.002268,172.31.36.0-255,66,162802,1,249095
41555,0.002316,172.31.36.0-255,66,162868,1,249095
41556,0.002329,172.31.36.0-255,66,162934,1,249095
41557,0.002352,74.125.24.0-255,5738,168672,1,249095
41558,0.002354,172.31.36.0-255,66,168738,1,249095
41559,0.00248,74.125.24.0-255,1484,170222,1,249095
41560,0.002485,74.125.24.0-255,2902,173124,1,249095
41561,0.002491,74.125.24.0-255,5738,178862,1,249095
41562,0.002547,74.125.24.0-255,2184,181046,1,249095
41563,0.002567,74.125.24.0-255,1484,182530,1,249095
41564,0.002572,74.125.24.0-255,2902,185432,1,249095
41565,0.002601,74.125.24.0-255,5738,191170,1,249095
41566,0.002609,74.125.24.0-255,7156,198326,1,249095
41567,0.002636,74.125.24.0-255,5738,204064,1,249095
41568,0.002672,74.125.24.0-255,1484,205548,1,249095
41569,0.002677,74.125.24.0-255,4320,209868,1,249095
41570,0.007822,172.31.36.0-255,66,209934,1,249095
41571,0.01048,74.125.24.0-255,5738,215672,1,249095
41572,0.010489,172.31.36.0-255,66,215738,1,249095
41573,0.013143,74.125.24.0-255,5738,221476,1,249095
41574,0.013152,172.31.36.0-255,66,221542,1,249095
41575,0.015781,74.125.24.0-255,5738,227280,1,249095
41576,0.01579,172.31.36.0-255,66,227346,1,249095
41577,0.018414,74.125.24.0-255,5738,233084,1,249095
41578,0.018423,172.31.36.0-255,66,233150,1,249095
41579,0.021071,74.125.24.0-255,5738,238888,1,249095
41580,0.021084,172.31.36.0-255,66,238954,1,249095
41581,0.023711,74.125.24.0-255,806,239760,1,249095
41582,0.023959,172.31.36.0-255,66,239826,1,249095
41583,0.023992,172.31.36.0-255,105,239931,1,249095
41584,0.026592,74.125.24.0-255,66,239997,1,249095
41585,0.040376,172.31.36.0-255,172,240169,1,249095
41586,0.040408,172.31.36.0-255,1115,241284,1,249095
41587,0.040455,172.31.36.0-255,1514,242798,1,249095
41588,0.040457,172.31.36.0-255,1514,244312,1,249095
41589,0.040462,172.31.36.0-255,1514,245826,1,249095
41590,0.040464,172.31.36.0-255,1514,247340,1,249095
41591,0.040491,172.31.36.0-255,1491,248831,1,249095
41592,0.041871,104.244.42.0-255,66,248897,1,249095
41593,0.041955,104.244.42.0-255,66,248963,1,249095
41594,0.042012,104.244.42.0-255,66,249029,1,249095
41595,0.042052,104.244.42.0-255,66,249095,1,249095
41596,0.0,172.217.194.0-255,153,153,1,187906
41597,2.4e-05,172.31.36.0-255,66,219,1,187906
41598,3.1e-05,172.217.194.0-255,1484,1703,1,187906
41599,3.4e-05,172.31.36.0-255,66,1769,1,187906
41600,4e-05,172.217.194.0-255,2902,4671,1,187906
41601,4.4e-05,172.31.36.0-255,66,4737,1,187906
41602,6.9e-05,172.217.194.0-255,4320,9057,1,187906
41603,7.2e-05,172.31.36.0-255,66,9123,1,187906
41604,0.000115,172.217.194.0-255,4911,14034,1,187906
41605,0.000118,172.31.36.0-255,66,14100,1,187906
41606,0.000405,172.217.194.0-255,1484,15584,1,187906
41607,0.000411,172.31.36.0-255,66,15650,1,187906
41608,0.000427,172.217.194.0-255,2902,18552,1,187906
41609,0.00043,172.31.36.0-255,66,18618,1,187906
41610,0.000446,172.217.194.0-255,5738,24356,1,187906
41611,0.000449,172.31.36.0-255,66,24422,1,187906
41612,0.000476,172.217.194.0-255,6797,31219,1,187906
41613,0.000479,172.31.36.0-255,66,31285,1,187906
41614,0.001699,172.217.194.0-255,1484,32769,1,187906
41615,0.001706,172.31.36.0-255,66,32835,1,187906
41616,0.001745,172.217.194.0-255,2902,35737,1,187906
41617,0.001748,172.31.36.0-255,66,35803,1,187906
41618,0.001755,172.217.194.0-255,5738,41541,1,187906
41619,0.001757,172.31.36.0-255,66,41607,1,187906
41620,0.001774,172.217.194.0-255,1484,43091,1,187906
41621,0.001776,172.31.36.0-255,66,43157,1,187906
41622,0.001789,172.217.194.0-255,2902,46059,1,187906
41623,0.001791,172.31.36.0-255,66,46125,1,187906
41624,0.001852,172.217.194.0-255,7156,53281,1,187906
41625,0.001854,172.31.36.0-255,66,53347,1,187906
41626,0.001885,172.31.36.0-255,66,53413,1,187906
41627,0.00189,172.217.194.0-255,3122,56535,1,187906
41628,0.00381,172.217.194.0-255,1484,58019,1,187906
41629,0.005629,172.31.36.0-255,66,58085,1,187906
41630,0.007623,172.217.194.0-255,5738,63823,1,187906
41631,0.007631,172.31.36.0-255,66,63889,1,187906
41632,0.009601,172.217.194.0-255,5738,69627,1,187906
41633,0.00961,172.31.36.0-255,66,69693,1,187906
41634,0.011583,172.217.194.0-255,5738,75431,1,187906
41635,0.011593,172.31.36.0-255,66,75497,1,187906
41636,0.013591,172.217.194.0-255,5738,81235,1,187906
41637,0.013602,172.31.36.0-255,66,81301,1,187906
41638,0.015592,172.217.194.0-255,5738,87039,1,187906
41639,0.0156,172.31.36.0-255,66,87105,1,187906
41640,0.017595,172.217.194.0-255,5738,92843,1,187906
41641,0.017602,172.31.36.0-255,66,92909,1,187906
41642,0.019607,172.217.194.0-255,5738,98647,1,187906
41643,0.019614,172.31.36.0-255,66,98713,1,187906
41644,0.021641,172.217.194.0-255,5738,104451,1,187906
41645,0.021648,172.31.36.0-255,66,104517,1,187906
41646,0.023599,172.217.194.0-255,5738,110255,1,187906
41647,0.023607,172.31.36.0-255,66,110321,1,187906
41648,0.025607,172.217.194.0-255,5738,116059,1,187906
41649,0.025614,172.31.36.0-255,66,116125,1,187906
41650,0.027601,172.217.194.0-255,5738,121863,1,187906
41651,0.027609,172.31.36.0-255,66,121929,1,187906
41652,0.02905,172.31.36.0-255,190,122119,1,187906
41653,0.02908,172.31.36.0-255,1114,123233,1,187906
41654,0.029137,172.31.36.0-255,565,123798,1,187906
41655,0.029577,172.217.194.0-255,1484,125282,1,187906
41656,0.029607,172.217.194.0-255,4320,129602,1,187906
41657,0.029612,172.31.36.0-255,66,129668,1,187906
41658,0.030577,104.244.42.0-255,66,129734,1,187906
41659,0.030622,104.244.42.0-255,66,129800,1,187906
41660,0.030666,104.244.42.0-255,66,129866,1,187906
41661,0.031582,172.217.194.0-255,5738,135604,1,187906
41662,0.03159,172.31.36.0-255,66,135670,1,187906
41663,0.033618,172.217.194.0-255,5738,141408,1,187906
41664,0.033624,172.31.36.0-255,66,141474,1,187906
41665,0.035605,172.217.194.0-255,5738,147212,1,187906
41666,0.035612,172.31.36.0-255,66,147278,1,187906
41667,0.037577,172.217.194.0-255,5738,153016,1,187906
41668,0.037583,172.31.36.0-255,66,153082,1,187906
41669,0.03958,172.217.194.0-255,5738,158820,1,187906
41670,0.039587,172.31.36.0-255,66,158886,1,187906
41671,0.041536,172.217.194.0-255,5738,164624,1,187906
41672,0.041542,172.31.36.0-255,66,164690,1,187906
41673,0.043541,172.217.194.0-255,5738,170428,1,187906
41674,0.043547,172.31.36.0-255,66,170494,1,187906
41675,0.045546,172.217.194.0-255,5738,176232,1,187906
41676,0.045553,172.31.36.0-255,66,176298,1,187906
41677,0.047527,172.217.194.0-255,5738,182036,1,187906
41678,0.047533,172.31.36.0-255,66,182102,1,187906
41679,0.049546,172.217.194.0-255,5738,187840,1,187906
41680,0.049552,172.31.36.0-255,66,187906,1,187906
41681,0.0,74.125.200.0-255,153,153,1,316703
41682,3.3e-05,172.31.36.0-255,66,219,1,316703
41683,4e-05,74.125.200.0-255,1484,1703,1,316703
41684,4.5e-05,172.31.36.0-255,66,1769,1,316703
41685,4.9e-05,74.125.200.0-255,2902,4671,1,316703
41686,5.2e-05,172.31.36.0-255,66,4737,1,316703
41687,5.6e-05,74.125.200.0-255,2902,7639,1,316703
41688,5.8e-05,172.31.36.0-255,66,7705,1,316703
41689,6.3e-05,74.125.200.0-255,4320,12025,1,316703
41690,6.5e-05,172.31.36.0-255,66,12091,1,316703
41691,0.000103,172.31.36.0-255,66,12157,1,316703
41692,0.000108,74.125.200.0-255,4320,16477,1,316703
41693,0.00011,172.31.36.0-255,66,16543,1,316703
41694,0.00013,74.125.200.0-255,1484,18027,1,316703
41695,0.000133,172.31.36.0-255,66,18093,1,316703
41696,0.000167,172.31.36.0-255,66,18159,1,316703
41697,0.000175,74.125.200.0-255,6438,24597,1,316703
41698,0.000177,172.31.36.0-255,66,24663,1,316703
41699,0.000199,74.125.200.0-255,1484,26147,1,316703
41700,0.000202,172.31.36.0-255,66,26213,1,316703
41701,0.000207,74.125.200.0-255,2902,29115,1,316703
41702,0.00021,172.31.36.0-255,66,29181,1,316703
41703,0.000241,74.125.200.0-255,5738,34919,1,316703
41704,0.000245,172.31.36.0-255,66,34985,1,316703
41705,0.000251,74.125.200.0-255,4320,39305,1,316703
41706,0.000254,172.31.36.0-255,66,39371,1,316703
41707,0.000274,74.125.200.0-255,3133,42504,1,316703
41708,0.000277,172.31.36.0-255,66,42570,1,316703
41709,0.000527,74.125.200.0-255,1484,44054,1,316703
41710,0.000531,172.31.36.0-255,66,44120,1,316703
41711,0.000536,74.125.200.0-255,2902,47022,1,316703
41712,0.000538,172.31.36.0-255,66,47088,1,316703
41713,0.000551,74.125.200.0-255,2902,49990,1,316703
41714,0.000553,172.31.36.0-255,66,50056,1,316703
41715,0.000578,74.125.200.0-255,1484,51540,1,316703
41716,0.000585,74.125.200.0-255,5738,57278,1,316703
41717,0.000591,172.31.36.0-255,66,57344,1,316703
41718,0.000602,74.125.200.0-255,4320,61664,1,316703
41719,0.000604,172.31.36.0-255,66,61730,1,316703
41720,0.000631,74.125.200.0-255,7156,68886,1,316703
41721,0.000634,172.31.36.0-255,66,68952,1,316703
41722,0.000639,74.125.200.0-255,4320,73272,1,316703
41723,0.000641,172.31.36.0-255,66,73338,1,316703
41724,0.000658,74.125.200.0-255,3602,76940,1,316703
41725,0.00066,172.31.36.0-255,66,77006,1,316703
41726,0.000941,74.125.200.0-255,1484,78490,1,316703
41727,0.000947,74.125.200.0-255,2902,81392,1,316703
41728,0.000951,172.31.36.0-255,66,81458,1,316703
41729,0.000955,74.125.200.0-255,1484,82942,1,316703
41730,0.000968,74.125.200.0-255,2902,85844,1,316703
41731,0.000971,172.31.36.0-255,66,85910,1,316703
41732,0.000996,74.125.200.0-255,1484,87394,1,316703
41733,0.001003,74.125.200.0-255,7156,94550,1,316703
41734,0.001005,172.31.36.0-255,66,94616,1,316703
41735,0.001008,74.125.200.0-255,1484,96100,1,316703
41736,0.00103,172.31.36.0-255,66,96166,1,316703
41737,0.001053,74.125.200.0-255,4320,100486,1,316703
41738,0.001056,172.31.36.0-255,66,100552,1,316703
41739,0.001061,74.125.200.0-255,2184,102736,1,316703
41740,0.001063,172.31.36.0-255,66,102802,1,316703
41741,0.00109,74.125.200.0-255,1484,104286,1,316703
41742,0.001144,172.31.36.0-255,66,104352,1,316703
41743,0.001165,74.125.200.0-255,4320,108672,1,316703
41744,0.001168,172.31.36.0-255,66,108738,1,316703
41745,0.001199,172.31.36.0-255,66,108804,1,316703
41746,0.001203,74.125.200.0-255,2902,111706,1,316703
41747,0.001206,172.31.36.0-255,66,111772,1,316703
41748,0.001236,74.125.200.0-255,7156,118928,1,316703
41749,0.001242,172.31.36.0-255,66,118994,1,316703
41750,0.001248,172.31.36.0-255,66,119060,1,316703
41751,0.00126,172.31.36.0-255,66,119126,1,316703
41752,0.001282,74.125.200.0-255,5738,124864,1,316703
41753,0.001284,172.31.36.0-255,66,124930,1,316703
41754,0.001303,74.125.200.0-255,3602,128532,1,316703
41755,0.001305,172.31.36.0-255,66,128598,1,316703
41756,0.001312,74.125.200.0-255,7156,135754,1,316703
41757,0.001314,172.31.36.0-255,66,135820,1,316703
41758,0.001327,74.125.200.0-255,2902,138722,1,316703
41759,0.00133,172.31.36.0-255,66,138788,1,316703
41760,0.001336,74.125.200.0-255,4320,143108,1,316703
41761,0.001338,172.31.36.0-255,66,143174,1,316703
41762,0.00136,74.125.200.0-255,5738,148912,1,316703
41763,0.001364,172.31.36.0-255,66,148978,1,316703
41764,0.00138,74.125.200.0-255,5738,154716,1,316703
41765,0.001383,172.31.36.0-255,66,154782,1,316703
41766,0.001409,74.125.200.0-255,5020,159802,1,316703
41767,0.001412,172.31.36.0-255,66,159868,1,316703
41768,0.001418,74.125.200.0-255,4320,164188,1,316703
41769,0.00142,172.31.36.0-255,66,164254,1,316703
41770,0.001426,74.125.200.0-255,5738,169992,1,316703
41771,0.001428,172.31.36.0-255,66,170058,1,316703
41772,0.001471,172.31.36.0-255,66,170124,1,316703
41773,0.001475,74.125.200.0-255,2902,173026,1,316703
41774,0.001477,172.31.36.0-255,66,173092,1,316703
41775,0.001482,74.125.200.0-255,3602,176694,1,316703
41776,0.001485,172.31.36.0-255,66,176760,1,316703
41777,0.001609,74.125.200.0-255,1484,178244,1,316703
41778,0.001634,74.125.200.0-255,2902,181146,1,316703
41779,0.001638,172.31.36.0-255,66,181212,1,316703
41780,0.001641,74.125.200.0-255,1484,182696,1,316703
41781,0.001646,74.125.200.0-255,2902,185598,1,316703
41782,0.001648,172.31.36.0-255,66,185664,1,316703
41783,0.001652,74.125.200.0-255,2902,188566,1,316703
41784,0.001655,172.31.36.0-255,66,188632,1,316703
41785,0.00167,74.125.200.0-255,2902,191534,1,316703
41786,0.001672,172.31.36.0-255,66,191600,1,316703
41787,0.001676,74.125.200.0-255,1484,193084,1,316703
41788,0.001702,172.31.36.0-255,66,193150,1,316703
41789,0.00174,74.125.200.0-255,4320,197470,1,316703
41790,0.001743,172.31.36.0-255,66,197536,1,316703
41791,0.001765,74.125.200.0-255,2184,199720,1,316703
41792,0.001768,172.31.36.0-255,66,199786,1,316703
41793,0.002079,172.31.36.0-255,101,199887,1,316703
41794,0.00369,74.125.200.0-255,2902,202789,1,316703
41795,0.003697,172.31.36.0-255,66,202855,1,316703
41796,0.003728,74.125.200.0-255,2902,205757,1,316703
41797,0.00373,172.31.36.0-255,66,205823,1,316703
41798,0.003982,74.125.200.0-255,66,205889,1,316703
41799,0.005641,74.125.200.0-255,2902,208791,1,316703
41800,0.005644,172.31.36.0-255,66,208857,1,316703
41801,0.005665,74.125.200.0-255,1484,210341,1,316703
41802,0.005676,74.125.200.0-255,1484,211825,1,316703
41803,0.005678,172.31.36.0-255,66,211891,1,316703
41804,0.007586,74.125.200.0-255,2902,214793,1,316703
41805,0.007589,172.31.36.0-255,66,214859,1,316703
41806,0.007618,74.125.200.0-255,1484,216343,1,316703
41807,0.007632,74.125.200.0-255,1484,217827,1,316703
41808,0.007634,172.31.36.0-255,66,217893,1,316703
41809,0.009536,74.125.200.0-255,2902,220795,1,316703
41810,0.009543,172.31.36.0-255,66,220861,1,316703
41811,0.009581,74.125.200.0-255,2902,223763,1,316703
41812,0.009585,172.31.36.0-255,66,223829,1,316703
41813,0.011535,74.125.200.0-255,2902,226731,1,316703
41814,0.011542,172.31.36.0-255,66,226797,1,316703
41815,0.011561,74.125.200.0-255,2902,229699,1,316703
41816,0.011564,172.31.36.0-255,66,229765,1,316703
41817,0.013497,74.125.200.0-255,4320,234085,1,316703
41818,0.013505,172.31.36.0-255,66,234151,1,316703
41819,0.013521,74.125.200.0-255,1484,235635,1,316703
41820,0.015465,74.125.200.0-255,4320,239955,1,316703
41821,0.015474,172.31.36.0-255,66,240021,1,316703
41822,0.017433,74.125.200.0-255,5738,245759,1,316703
41823,0.01744,172.31.36.0-255,66,245825,1,316703
41824,0.0194,74.125.200.0-255,5738,251563,1,316703
41825,0.019407,172.31.36.0-255,66,251629,1,316703
41826,0.021361,74.125.200.0-255,5738,257367,1,316703
41827,0.021368,172.31.36.0-255,66,257433,1,316703
41828,0.023329,74.125.200.0-255,5738,263171,1,316703
41829,0.023336,172.31.36.0-255,66,263237,1,316703
41830,0.025282,74.125.200.0-255,5738,268975,1,316703
41831,0.025289,172.31.36.0-255,66,269041,1,316703
41832,0.027267,74.125.200.0-255,5738,274779,1,316703
41833,0.027274,172.31.36.0-255,66,274845,1,316703
41834,0.029233,74.125.200.0-255,4320,279165,1,316703
41835,0.029241,172.31.36.0-255,66,279231,1,316703
41836,0.02927,74.125.200.0-255,1484,280715,1,316703
41837,0.031194,74.125.200.0-255,4320,285035,1,316703
41838,0.031201,172.31.36.0-255,66,285101,1,316703
41839,0.033163,74.125.200.0-255,5738,290839,1,316703
41840,0.03317,172.31.36.0-255,66,290905,1,316703
41841,0.035144,74.125.200.0-255,5738,296643,1,316703
41842,0.03515,172.31.36.0-255,66,296709,1,316703
41843,0.036184,172.31.36.0-255,172,296881,1,316703
41844,0.036214,172.31.36.0-255,1113,297994,1,316703
41845,0.036252,172.31.36.0-255,566,298560,1,316703
41846,0.0371,74.125.200.0-255,5738,304298,1,316703
41847,0.037107,172.31.36.0-255,66,304364,1,316703
41848,0.037718,104.244.42.0-255,66,304430,1,316703
41849,0.037754,104.244.42.0-255,66,304496,1,316703
41850,0.037798,104.244.42.0-255,66,304562,1,316703
41851,0.039065,74.125.200.0-255,5738,310300,1,316703
41852,0.039071,172.31.36.0-255,66,310366,1,316703
41853,0.041031,74.125.200.0-255,5738,316104,1,316703
41854,0.041036,172.31.36.0-255,66,316170,1,316703
41855,0.042963,74.125.200.0-255,362,316532,1,316703
41856,0.043129,172.31.36.0-255,105,316637,1,316703
41857,0.049202,74.125.200.0-255,66,316703,1,316703
41858,0.0,74.125.130.0-255,153,153,1,269980
41859,2.2e-05,172.31.36.0-255,66,219,1,269980
41860,2.9e-05,74.125.130.0-255,1484,1703,1,269980
41861,3.4e-05,172.31.36.0-255,66,1769,1,269980
41862,3.9e-05,74.125.130.0-255,2902,4671,1,269980
41863,4.3e-05,172.31.36.0-255,66,4737,1,269980
41864,5.1e-05,74.125.130.0-255,5738,10475,1,269980
41865,5.5e-05,172.31.36.0-255,66,10541,1,269980
41866,7.2e-05,74.125.130.0-255,4320,14861,1,269980
41867,7.5e-05,172.31.36.0-255,66,14927,1,269980
41868,0.000101,74.125.130.0-255,2067,16994,1,269980
41869,0.000104,172.31.36.0-255,66,17060,1,269980
41870,0.000112,74.125.130.0-255,7156,24216,1,269980
41871,0.000114,172.31.36.0-255,66,24282,1,269980
41872,0.000133,74.125.130.0-255,4320,28602,1,269980
41873,0.000136,172.31.36.0-255,66,28668,1,269980
41874,0.000157,74.125.130.0-255,2543,31211,1,269980
41875,0.000159,172.31.36.0-255,66,31277,1,269980
41876,0.000393,74.125.130.0-255,1484,32761,1,269980
41877,0.000398,172.31.36.0-255,66,32827,1,269980
41878,0.000405,74.125.130.0-255,2902,35729,1,269980
41879,0.000407,172.31.36.0-255,66,35795,1,269980
41880,0.00043,74.125.130.0-255,5738,41533,1,269980
41881,0.000432,172.31.36.0-255,66,41599,1,269980
41882,0.000435,74.125.130.0-255,1484,43083,1,269980
41883,0.000437,172.31.36.0-255,66,43149,1,269980
41884,0.000463,74.125.130.0-255,1484,44633,1,269980
41885,0.000466,172.31.36.0-255,66,44699,1,269980
41886,0.000471,74.125.130.0-255,3961,48660,1,269980
41887,0.000474,172.31.36.0-255,66,48726,1,269980
41888,0.000491,74.125.130.0-255,7156,55882,1,269980
41889,0.000493,172.31.36.0-255,66,55948,1,269980
41890,0.000511,74.125.130.0-255,5738,61686,1,269980
41891,0.000513,172.31.36.0-255,66,61752,1,269980
41892,0.000537,74.125.130.0-255,2902,64654,1,269980
41893,0.000539,172.31.36.0-255,66,64720,1,269980
41894,0.000542,74.125.130.0-255,1415,66135,1,269980
41895,0.000776,74.125.130.0-255,365,66500,1,269980
41896,0.00078,172.31.36.0-255,66,66566,1,269980
41897,0.000982,74.125.130.0-255,1484,68050,1,269980
41898,0.001023,74.125.130.0-255,2902,70952,1,269980
41899,0.001026,172.31.36.0-255,66,71018,1,269980
41900,0.001044,74.125.130.0-255,1484,72502,1,269980
41901,0.001094,74.125.130.0-255,1484,73986,1,269980
41902,0.001097,172.31.36.0-255,66,74052,1,269980
41903,0.001115,74.125.130.0-255,2902,76954,1,269980
41904,0.001117,172.31.36.0-255,66,77020,1,269980
41905,0.001144,74.125.130.0-255,4320,81340,1,269980
41906,0.001147,172.31.36.0-255,66,81406,1,269980
41907,0.001181,74.125.130.0-255,5379,86785,1,269980
41908,0.001184,172.31.36.0-255,66,86851,1,269980
41909,0.001187,74.125.130.0-255,1484,88335,1,269980
41910,0.001206,74.125.130.0-255,2902,91237,1,269980
41911,0.001211,172.31.36.0-255,66,91303,1,269980
41912,0.001223,74.125.130.0-255,2902,94205,1,269980
41913,0.001225,172.31.36.0-255,66,94271,1,269980
41914,0.001244,74.125.130.0-255,2902,97173,1,269980
41915,0.001246,172.31.36.0-255,66,97239,1,269980
41916,0.00125,74.125.130.0-255,1484,98723,1,269980
41917,0.001254,74.125.130.0-255,2543,101266,1,269980
41918,0.001256,172.31.36.0-255,66,101332,1,269980
41919,0.001566,74.125.130.0-255,1484,102816,1,269980
41920,0.001585,74.125.130.0-255,2902,105718,1,269980
41921,0.00159,172.31.36.0-255,66,105784,1,269980
41922,0.001596,74.125.130.0-255,2902,108686,1,269980
41923,0.001598,172.31.36.0-255,66,108752,1,269980
41924,0.001603,74.125.130.0-255,4320,113072,1,269980
41925,0.001606,172.31.36.0-255,66,113138,1,269980
41926,0.001633,172.31.36.0-255,66,113204,1,269980
41927,0.001637,74.125.130.0-255,2902,116106,1,269980
41928,0.001639,172.31.36.0-255,66,116172,1,269980
41929,0.001657,74.125.130.0-255,4320,120492,1,269980
41930,0.00166,172.31.36.0-255,66,120558,1,269980
41931,0.001698,74.125.130.0-255,4320,124878,1,269980
41932,0.001701,172.31.36.0-255,66,124944,1,269980
41933,0.001715,74.125.130.0-255,2184,127128,1,269980
41934,0.001717,172.31.36.0-255,66,127194,1,269980
41935,0.002247,74.125.130.0-255,1484,128678,1,269980
41936,0.002257,74.125.130.0-255,2902,131580,1,269980
41937,0.002261,172.31.36.0-255,66,131646,1,269980
41938,0.002288,74.125.130.0-255,5738,137384,1,269980
41939,0.00229,172.31.36.0-255,66,137450,1,269980
41940,0.002295,74.125.130.0-255,2902,140352,1,269980
41941,0.002297,172.31.36.0-255,66,140418,1,269980
41942,0.002314,74.125.130.0-255,4320,144738,1,269980
41943,0.002316,172.31.36.0-255,66,144804,1,269980
41944,0.00232,74.125.130.0-255,1484,146288,1,269980
41945,0.004607,74.125.130.0-255,4320,150608,1,269980
41946,0.004612,172.31.36.0-255,66,150674,1,269980
41947,0.00693,74.125.130.0-255,5738,156412,1,269980
41948,0.006934,172.31.36.0-255,66,156478,1,269980
41949,0.009243,74.125.130.0-255,5738,162216,1,269980
41950,0.009254,172.31.36.0-255,66,162282,1,269980
41951,0.011568,74.125.130.0-255,5738,168020,1,269980
41952,0.011582,172.31.36.0-255,66,168086,1,269980
41953,0.013905,74.125.130.0-255,5738,173824,1,269980
41954,0.013919,172.31.36.0-255,66,173890,1,269980
41955,0.016245,74.125.130.0-255,5738,179628,1,269980
41956,0.016261,172.31.36.0-255,66,179694,1,269980
41957,0.018596,74.125.130.0-255,5738,185432,1,269980
41958,0.018614,172.31.36.0-255,66,185498,1,269980
41959,0.020992,74.125.130.0-255,5738,191236,1,269980
41960,0.02101,172.31.36.0-255,66,191302,1,269980
41961,0.023341,74.125.130.0-255,5738,197040,1,269980
41962,0.023356,172.31.36.0-255,66,197106,1,269980
41963,0.025674,74.125.130.0-255,5738,202844,1,269980
41964,0.025688,172.31.36.0-255,66,202910,1,269980
41965,0.027998,74.125.130.0-255,5738,208648,1,269980
41966,0.028013,172.31.36.0-255,66,208714,1,269980
41967,0.03032,74.125.130.0-255,5738,214452,1,269980
41968,0.030333,172.31.36.0-255,66,214518,1,269980
41969,0.032658,74.125.130.0-255,5738,220256,1,269980
41970,0.032673,172.31.36.0-255,66,220322,1,269980
41971,0.035002,74.125.130.0-255,5738,226060,1,269980
41972,0.035016,172.31.36.0-255,66,226126,1,269980
41973,0.037314,74.125.130.0-255,5738,231864,1,269980
41974,0.03732,172.31.36.0-255,66,231930,1,269980
41975,0.037797,172.31.36.0-255,172,232102,1,269980
41976,0.03783,172.31.36.0-255,1114,233216,1,269980
41977,0.037901,172.31.36.0-255,1514,234730,1,269980
41978,0.037902,172.31.36.0-255,1514,236244,1,269980
41979,0.037903,172.31.36.0-255,1514,237758,1,269980
41980,0.037904,172.31.36.0-255,1514,239272,1,269980
41981,0.037931,172.31.36.0-255,1490,240762,1,269980
41982,0.039338,104.244.42.0-255,66,240828,1,269980
41983,0.039387,104.244.42.0-255,66,240894,1,269980
41984,0.039525,104.244.42.0-255,66,240960,1,269980
41985,0.039636,74.125.130.0-255,5738,246698,1,269980
41986,0.039644,172.31.36.0-255,66,246764,1,269980
41987,0.041957,74.125.130.0-255,5738,252502,1,269980
41988,0.041963,172.31.36.0-255,66,252568,1,269980
41989,0.044269,74.125.130.0-255,5738,258306,1,269980
41990,0.044276,172.31.36.0-255,66,258372,1,269980
41991,0.046595,74.125.130.0-255,5738,264110,1,269980
41992,0.046601,172.31.36.0-255,66,264176,1,269980
41993,0.048919,74.125.130.0-255,5738,269914,1,269980
41994,0.048927,172.31.36.0-255,66,269980,1,269980
41995,0.0,74.125.24.0-255,153,153,1,254140
41996,1.8e-05,172.31.36.0-255,66,219,1,254140
41997,2.4e-05,74.125.24.0-255,1484,1703,1,254140
41998,3e-05,172.31.36.0-255,66,1769,1,254140
41999,4.6e-05,74.125.24.0-255,2902,4671,1,254140
42000,4.9e-05,172.31.36.0-255,66,4737,1,254140
42001,5.4e-05,74.125.24.0-255,2902,7639,1,254140
42002,5.7e-05,172.31.36.0-255,66,7705,1,254140
42003,8.8e-05,74.125.24.0-255,4320,12025,1,254140
42004,9.2e-05,172.31.36.0-255,66,12091,1,254140
42005,9.7e-05,74.125.24.0-255,2092,14183,1,254140
42006,9.9e-05,172.31.36.0-255,66,14249,1,254140
42007,0.000105,74.125.24.0-255,5738,19987,1,254140
42008,0.000108,172.31.36.0-255,66,20053,1,254140
42009,0.000138,74.125.24.0-255,5738,25791,1,254140
42010,0.000141,172.31.36.0-255,66,25857,1,254140
42011,0.000147,74.125.24.0-255,5379,31236,1,254140
42012,0.00015,172.31.36.0-255,66,31302,1,254140
42013,0.000491,74.125.24.0-255,1484,32786,1,254140
42014,0.000498,172.31.36.0-255,66,32852,1,254140
42015,0.000504,74.125.24.0-255,2902,35754,1,254140
42016,0.000506,172.31.36.0-255,66,35820,1,254140
42017,0.000511,74.125.24.0-255,2902,38722,1,254140
42018,0.000518,172.31.36.0-255,66,38788,1,254140
42019,0.000554,74.125.24.0-255,2902,41690,1,254140
42020,0.000557,172.31.36.0-255,66,41756,1,254140
42021,0.000572,172.31.36.0-255,66,41822,1,254140
42022,0.000608,74.125.24.0-255,1484,43306,1,254140
42023,0.000611,172.31.36.0-255,66,43372,1,254140
42024,0.000652,172.31.36.0-255,66,43438,1,254140
42025,0.000682,74.125.24.0-255,1484,44922,1,254140
42026,0.000719,172.31.36.0-255,66,44988,1,254140
42027,0.000738,172.31.36.0-255,66,45054,1,254140
42028,0.000751,172.31.36.0-255,66,45120,1,254140
42029,0.001355,74.125.24.0-255,1484,46604,1,254140
42030,0.001384,74.125.24.0-255,2902,49506,1,254140
42031,0.001388,172.31.36.0-255,66,49572,1,254140
42032,0.001395,74.125.24.0-255,5738,55310,1,254140
42033,0.001397,172.31.36.0-255,66,55376,1,254140
42034,0.001429,74.125.24.0-255,5738,61114,1,254140
42035,0.001431,172.31.36.0-255,66,61180,1,254140
42036,0.001459,74.125.24.0-255,7156,68336,1,254140
42037,0.001461,172.31.36.0-255,66,68402,1,254140
42038,0.001475,172.31.36.0-255,66,68468,1,254140
42039,0.001477,74.125.24.0-255,1484,69952,1,254140
42040,0.001501,74.125.24.0-255,2902,72854,1,254140
42041,0.001503,172.31.36.0-255,66,72920,1,254140
42042,0.001508,74.125.24.0-255,4320,77240,1,254140
42043,0.00151,172.31.36.0-255,66,77306,1,254140
42044,0.001535,74.125.24.0-255,1484,78790,1,254140
42045,0.001546,172.31.36.0-255,66,78856,1,254140
42046,0.001577,74.125.24.0-255,4320,83176,1,254140
42047,0.001582,172.31.36.0-255,66,83242,1,254140
42048,0.001625,172.31.36.0-255,66,83308,1,254140
42049,0.001705,74.125.24.0-255,1484,84792,1,254140
42050,0.00171,74.125.24.0-255,2902,87694,1,254140
42051,0.001712,172.31.36.0-255,66,87760,1,254140
42052,0.001718,74.125.24.0-255,2902,90662,1,254140
42053,0.00172,172.31.36.0-255,66,90728,1,254140
42054,0.001741,74.125.24.0-255,2902,93630,1,254140
42055,0.001748,172.31.36.0-255,66,93696,1,254140
42056,0.001754,74.125.24.0-255,4320,98016,1,254140
42057,0.001756,172.31.36.0-255,66,98082,1,254140
42058,0.00176,74.125.24.0-255,2902,100984,1,254140
42059,0.001763,172.31.36.0-255,66,101050,1,254140
42060,0.001783,172.31.36.0-255,66,101116,1,254140
42061,0.001799,172.31.36.0-255,66,101182,1,254140
42062,0.00202,74.125.24.0-255,1484,102666,1,254140
42063,0.002028,74.125.24.0-255,2902,105568,1,254140
42064,0.002032,172.31.36.0-255,66,105634,1,254140
42065,0.002082,74.125.24.0-255,5738,111372,1,254140
42066,0.002085,172.31.36.0-255,66,111438,1,254140
42067,0.002099,172.31.36.0-255,66,111504,1,254140
42068,0.002111,172.31.36.0-255,66,111570,1,254140
42069,0.002158,74.125.24.0-255,2184,113754,1,254140
42070,0.00216,172.31.36.0-255,66,113820,1,254140
42071,0.002202,74.125.24.0-255,1484,115304,1,254140
42072,0.002222,74.125.24.0-255,2902,118206,1,254140
42073,0.002229,74.125.24.0-255,5738,123944,1,254140
42074,0.002253,74.125.24.0-255,5738,129682,1,254140
42075,0.002304,74.125.24.0-255,5020,134702,1,254140
42076,0.002348,74.125.24.0-255,2902,137604,1,254140
42077,0.002403,74.125.24.0-255,2902,140506,1,254140
42078,0.006301,172.31.36.0-255,66,140572,1,254140
42079,0.008681,74.125.24.0-255,5738,146310,1,254140
42080,0.008688,172.31.36.0-255,66,146376,1,254140
42081,0.011049,74.125.24.0-255,5738,152114,1,254140
42082,0.011057,172.31.36.0-255,66,152180,1,254140
42083,0.013379,74.125.24.0-255,5738,157918,1,254140
42084,0.013388,172.31.36.0-255,66,157984,1,254140
42085,0.015761,74.125.24.0-255,5738,163722,1,254140
42086,0.015768,172.31.36.0-255,66,163788,1,254140
42087,0.018124,74.125.24.0-255,5738,169526,1,254140
42088,0.018131,172.31.36.0-255,66,169592,1,254140
42089,0.020494,74.125.24.0-255,5738,175330,1,254140
42090,0.020503,172.31.36.0-255,66,175396,1,254140
42091,0.022976,74.125.24.0-255,5738,181134,1,254140
42092,0.022988,172.31.36.0-255,66,181200,1,254140
42093,0.025384,74.125.24.0-255,5738,186938,1,254140
42094,0.025393,172.31.36.0-255,66,187004,1,254140
42095,0.027756,74.125.24.0-255,5738,192742,1,254140
42096,0.027764,172.31.36.0-255,66,192808,1,254140
42097,0.030149,74.125.24.0-255,5738,198546,1,254140
42098,0.030156,172.31.36.0-255,66,198612,1,254140
42099,0.032483,74.125.24.0-255,5738,204350,1,254140
42100,0.03249,172.31.36.0-255,66,204416,1,254140
42101,0.034821,74.125.24.0-255,5738,210154,1,254140
42102,0.034829,172.31.36.0-255,66,210220,1,254140
42103,0.037201,74.125.24.0-255,5738,215958,1,254140
42104,0.037209,172.31.36.0-255,66,216024,1,254140
42105,0.038944,172.31.36.0-255,172,216196,1,254140
42106,0.038977,172.31.36.0-255,1115,217311,1,254140
42107,0.03905,172.31.36.0-255,1514,218825,1,254140
42108,0.039052,172.31.36.0-255,1514,220339,1,254140
42109,0.039053,172.31.36.0-255,1514,221853,1,254140
42110,0.039054,172.31.36.0-255,1514,223367,1,254140
42111,0.039084,172.31.36.0-255,1489,224856,1,254140
42112,0.039541,74.125.24.0-255,5738,230594,1,254140
42113,0.039548,172.31.36.0-255,66,230660,1,254140
42114,0.040507,104.244.42.0-255,66,230726,1,254140
42115,0.040557,104.244.42.0-255,66,230792,1,254140
42116,0.040617,104.244.42.0-255,66,230858,1,254140
42117,0.040666,104.244.42.0-255,66,230924,1,254140
42118,0.041923,74.125.24.0-255,5738,236662,1,254140
42119,0.041933,172.31.36.0-255,66,236728,1,254140
42120,0.044302,74.125.24.0-255,5738,242466,1,254140
42121,0.044309,172.31.36.0-255,66,242532,1,254140
42122,0.046687,74.125.24.0-255,5738,248270,1,254140
42123,0.046694,172.31.36.0-255,66,248336,1,254140
42124,0.049017,74.125.24.0-255,5738,254074,1,254140
42125,0.049023,172.31.36.0-255,66,254140,1,254140
42126,0.0,74.125.200.0-255,296,296,1,232739
42127,2.7e-05,172.31.36.0-255,66,362,1,232739
42128,3.4e-05,74.125.200.0-255,1484,1846,1,232739
42129,3.9e-05,172.31.36.0-255,66,1912,1,232739
42130,4.3e-05,74.125.200.0-255,2902,4814,1,232739
42131,4.6e-05,172.31.36.0-255,66,4880,1,232739
42132,6.1e-05,74.125.200.0-255,5738,10618,1,232739
42133,6.3e-05,172.31.36.0-255,66,10684,1,232739
42134,9.5e-05,74.125.200.0-255,3251,13935,1,232739
42135,9.8e-05,172.31.36.0-255,66,14001,1,232739
42136,0.000128,74.125.200.0-255,1484,15485,1,232739
42137,0.000132,172.31.36.0-255,66,15551,1,232739
42138,0.000137,74.125.200.0-255,2902,18453,1,232739
42139,0.000139,172.31.36.0-255,66,18519,1,232739
42140,0.000166,74.125.200.0-255,5738,24257,1,232739
42141,0.000169,172.31.36.0-255,66,24323,1,232739
42142,0.000174,74.125.200.0-255,2902,27225,1,232739
42143,0.000176,172.31.36.0-255,66,27291,1,232739
42144,0.000201,74.125.200.0-255,3961,31252,1,232739
42145,0.000205,172.31.36.0-255,66,31318,1,232739
42146,0.00021,74.125.200.0-255,4320,35638,1,232739
42147,0.000213,172.31.36.0-255,66,35704,1,232739
42148,0.000225,74.125.200.0-255,2902,38606,1,232739
42149,0.000227,172.31.36.0-255,66,38672,1,232739
42150,0.000233,74.125.200.0-255,4320,42992,1,232739
42151,0.000235,172.31.36.0-255,66,43058,1,232739
42152,0.000266,74.125.200.0-255,1484,44542,1,232739
42153,0.000269,172.31.36.0-255,66,44608,1,232739
42154,0.000295,74.125.200.0-255,3961,48569,1,232739
42155,0.000299,172.31.36.0-255,66,48635,1,232739
42156,0.000359,74.125.200.0-255,1484,50119,1,232739
42157,0.000363,172.31.36.0-255,66,50185,1,232739
42158,0.000368,74.125.200.0-255,2902,53087,1,232739
42159,0.000371,172.31.36.0-255,66,53153,1,232739
42160,0.000398,74.125.200.0-255,4320,57473,1,232739
42161,0.000402,172.31.36.0-255,66,57539,1,232739
42162,0.00044,74.125.200.0-255,4320,61859,1,232739
42163,0.000445,172.31.36.0-255,66,61925,1,232739
42164,0.000466,74.125.200.0-255,3961,65886,1,232739
42165,0.000468,74.125.200.0-255,396,66282,1,232739
42166,0.000469,172.31.36.0-255,66,66348,1,232739
42167,0.000569,74.125.200.0-255,117,66465,1,232739
42168,0.000583,74.125.200.0-255,329,66794,1,232739
42169,0.000847,172.31.36.0-255,66,66860,1,232739
42170,0.001004,74.125.200.0-255,1484,68344,1,232739
42171,0.001015,74.125.200.0-255,2902,71246,1,232739
42172,0.001018,172.31.36.0-255,66,71312,1,232739
42173,0.001026,74.125.200.0-255,4320,75632,1,232739
42174,0.001028,172.31.36.0-255,66,75698,1,232739
42175,0.001045,74.125.200.0-255,1484,77182,1,232739
42176,0.001055,74.125.200.0-255,2902,80084,1,232739
42177,0.001058,172.31.36.0-255,66,80150,1,232739
42178,0.001064,74.125.200.0-255,4320,84470,1,232739
42179,0.001066,172.31.36.0-255,66,84536,1,232739
42180,0.001069,74.125.200.0-255,1484,86020,1,232739
42181,0.001099,74.125.200.0-255,7156,93176,1,232739
42182,0.001103,172.31.36.0-255,66,93242,1,232739
42183,0.001109,74.125.200.0-255,4320,97562,1,232739
42184,0.001112,172.31.36.0-255,66,97628,1,232739
42185,0.001156,74.125.200.0-255,3602,101230,1,232739
42186,0.00116,172.31.36.0-255,66,101296,1,232739
42187,0.002313,74.125.200.0-255,1484,102780,1,232739
42188,0.002321,74.125.200.0-255,2902,105682,1,232739
42189,0.002325,172.31.36.0-255,66,105748,1,232739
42190,0.00233,74.125.200.0-255,1484,107232,1,232739
42191,0.002354,74.125.200.0-255,2902,110134,1,232739
42192,0.002357,172.31.36.0-255,66,110200,1,232739
42193,0.004633,74.125.200.0-255,1484,111684,1,232739
42194,0.004653,74.125.200.0-255,2902,114586,1,232739
42195,0.004657,172.31.36.0-255,66,114652,1,232739
42196,0.004683,74.125.200.0-255,1484,116136,1,232739
42197,0.006967,74.125.200.0-255,4320,120456,1,232739
42198,0.00697,172.31.36.0-255,66,120522,1,232739
42199,0.009289,74.125.200.0-255,5738,126260,1,232739
42200,0.009296,172.31.36.0-255,66,126326,1,232739
42201,0.011612,74.125.200.0-255,5738,132064,1,232739
42202,0.011619,172.31.36.0-255,66,132130,1,232739
42203,0.013987,74.125.200.0-255,5738,137868,1,232739
42204,0.013997,172.31.36.0-255,66,137934,1,232739
42205,0.016318,74.125.200.0-255,5738,143672,1,232739
42206,0.016327,172.31.36.0-255,66,143738,1,232739
42207,0.01864,74.125.200.0-255,5738,149476,1,232739
42208,0.018648,172.31.36.0-255,66,149542,1,232739
42209,0.020974,74.125.200.0-255,5738,155280,1,232739
42210,0.020984,172.31.36.0-255,66,155346,1,232739
42211,0.023318,74.125.200.0-255,5738,161084,1,232739
42212,0.023326,172.31.36.0-255,66,161150,1,232739
42213,0.025649,74.125.200.0-255,5738,166888,1,232739
42214,0.025657,172.31.36.0-255,66,166954,1,232739
42215,0.027969,74.125.200.0-255,5738,172692,1,232739
42216,0.027976,172.31.36.0-255,66,172758,1,232739
42217,0.030291,74.125.200.0-255,5738,178496,1,232739
42218,0.030298,172.31.36.0-255,66,178562,1,232739
42219,0.032634,74.125.200.0-255,5738,184300,1,232739
42220,0.032643,172.31.36.0-255,66,184366,1,232739
42221,0.03482,172.31.36.0-255,172,184538,1,232739
42222,0.03485,172.31.36.0-255,1113,185651,1,232739
42223,0.034896,172.31.36.0-255,1514,187165,1,232739
42224,0.034897,172.31.36.0-255,1514,188679,1,232739
42225,0.034903,172.31.36.0-255,1514,190193,1,232739
42226,0.034904,172.31.36.0-255,1514,191707,1,232739
42227,0.034922,172.31.36.0-255,1492,193199,1,232739
42228,0.034957,74.125.200.0-255,5738,198937,1,232739
42229,0.034962,172.31.36.0-255,66,199003,1,232739
42230,0.036406,104.244.42.0-255,66,199069,1,232739
42231,0.036415,104.244.42.0-255,66,199135,1,232739
42232,0.036448,104.244.42.0-255,66,199201,1,232739
42233,0.036598,104.244.42.0-255,66,199267,1,232739
42234,0.037291,74.125.200.0-255,5738,205005,1,232739
42235,0.037298,172.31.36.0-255,66,205071,1,232739
42236,0.039615,74.125.200.0-255,4320,209391,1,232739
42237,0.039621,172.31.36.0-255,66,209457,1,232739
42238,0.039651,74.125.200.0-255,1484,210941,1,232739
42239,0.041951,74.125.200.0-255,4320,215261,1,232739
42240,0.041956,172.31.36.0-255,66,215327,1,232739
42241,0.044286,74.125.200.0-255,5738,221065,1,232739
42242,0.044292,172.31.36.0-255,66,221131,1,232739
42243,0.046605,74.125.200.0-255,5738,226869,1,232739
42244,0.046611,172.31.36.0-255,66,226935,1,232739
42245,0.048928,74.125.200.0-255,5738,232673,1,232739
42246,0.048933,172.31.36.0-255,66,232739,1,232739
42247,0.0,74.125.24.0-255,298,298,1,296905
42248,2.4e-05,172.31.36.0-255,66,364,1,296905
42249,3e-05,74.125.24.0-255,1484,1848,1,296905
42250,3.5e-05,172.31.36.0-255,66,1914,1,296905
42251,4.3e-05,74.125.24.0-255,4320,6234,1,296905
42252,4.6e-05,172.31.36.0-255,66,6300,1,296905
42253,5.7e-05,172.31.36.0-255,66,6366,1,296905
42254,6.4e-05,74.125.24.0-255,7156,13522,1,296905
42255,6.7e-05,172.31.36.0-255,66,13588,1,296905
42256,9.9e-05,74.125.24.0-255,7156,20744,1,296905
42257,0.000102,172.31.36.0-255,66,20810,1,296905
42258,0.000107,74.125.24.0-255,2543,23353,1,296905
42259,0.000109,172.31.36.0-255,66,23419,1,296905
42260,0.000139,74.125.24.0-255,1484,24903,1,296905
42261,0.000142,172.31.36.0-255,66,24969,1,296905
42262,0.000163,74.125.24.0-255,2902,27871,1,296905
42263,0.000165,172.31.36.0-255,66,27937,1,296905
42264,0.000169,74.125.24.0-255,2902,30839,1,296905
42265,0.000172,172.31.36.0-255,66,30905,1,296905
42266,0.000185,74.125.24.0-255,2902,33807,1,296905
42267,0.000187,172.31.36.0-255,66,33873,1,296905
42268,0.000198,74.125.24.0-255,1484,35357,1,296905
42269,0.0002,172.31.36.0-255,66,35423,1,296905
42270,0.000229,172.31.36.0-255,66,35489,1,296905
42271,0.000237,74.125.24.0-255,7156,42645,1,296905
42272,0.000239,172.31.36.0-255,66,42711,1,296905
42273,0.000266,74.125.24.0-255,5738,48449,1,296905
42274,0.000269,172.31.36.0-255,66,48515,1,296905
42275,0.000272,74.125.24.0-255,766,49281,1,296905
42276,0.000274,172.31.36.0-255,66,49347,1,296905
42277,0.000311,74.125.24.0-255,677,50024,1,296905
42278,0.000544,74.125.24.0-255,1484,51508,1,296905
42279,0.000549,74.125.24.0-255,2902,54410,1,296905
42280,0.000559,172.31.36.0-255,66,54476,1,296905
42281,0.000565,172.31.36.0-255,66,54542,1,296905
42282,0.000572,74.125.24.0-255,5738,60280,1,296905
42283,0.000574,172.31.36.0-255,66,60346,1,296905
42284,0.000597,74.125.24.0-255,1484,61830,1,296905
42285,0.000612,74.125.24.0-255,5738,67568,1,296905
42286,0.000615,172.31.36.0-255,66,67634,1,296905
42287,0.000634,74.125.24.0-255,2902,70536,1,296905
42288,0.000637,172.31.36.0-255,66,70602,1,296905
42289,0.000643,74.125.24.0-255,4320,74922,1,296905
42290,0.000645,172.31.36.0-255,66,74988,1,296905
42291,0.000673,74.125.24.0-255,7156,82144,1,296905
42292,0.000676,172.31.36.0-255,66,82210,1,296905
42293,0.000681,74.125.24.0-255,1635,83845,1,296905
42294,0.000683,172.31.36.0-255,66,83911,1,296905
42295,0.001441,74.125.24.0-255,1484,85395,1,296905
42296,0.001448,74.125.24.0-255,1484,86879,1,296905
42297,0.001452,172.31.36.0-255,66,86945,1,296905
42298,0.001476,74.125.24.0-255,2902,89847,1,296905
42299,0.001478,172.31.36.0-255,66,89913,1,296905
42300,0.001504,74.125.24.0-255,1484,91397,1,296905
42301,0.001524,74.125.24.0-255,4320,95717,1,296905
42302,0.001527,172.31.36.0-255,66,95783,1,296905
42303,0.001534,74.125.24.0-255,7156,102939,1,296905
42304,0.001536,172.31.36.0-255,66,103005,1,296905
42305,0.001549,172.31.36.0-255,66,103071,1,296905
42306,0.001571,74.125.24.0-255,2902,105973,1,296905
42307,0.001574,172.31.36.0-255,66,106039,1,296905
42308,0.001577,74.125.24.0-255,766,106805,1,296905
42309,0.001989,74.125.24.0-255,1484,108289,1,296905
42310,0.001996,172.31.36.0-255,66,108355,1,296905
42311,0.002003,74.125.24.0-255,2902,111257,1,296905
42312,0.002005,172.31.36.0-255,66,111323,1,296905
42313,0.002031,74.125.24.0-255,2902,114225,1,296905
42314,0.002033,172.31.36.0-255,66,114291,1,296905
42315,0.002039,74.125.24.0-255,4320,118611,1,296905
42316,0.002041,172.31.36.0-255,66,118677,1,296905
42317,0.002046,74.125.24.0-255,2902,121579,1,296905
42318,0.002049,172.31.36.0-255,66,121645,1,296905
42319,0.002078,74.125.24.0-255,5738,127383,1,296905
42320,0.00208,172.31.36.0-255,66,127449,1,296905
42321,0.002088,74.125.24.0-255,7156,134605,1,296905
42322,0.00209,172.31.36.0-255,66,134671,1,296905
42323,0.00211,74.125.24.0-255,6438,141109,1,296905
42324,0.002112,172.31.36.0-255,66,141175,1,296905
42325,0.002128,172.31.36.0-255,66,141241,1,296905
42326,0.002139,172.31.36.0-255,66,141307,1,296905
42327,0.002162,74.125.24.0-255,2902,144209,1,296905
42328,0.002165,172.31.36.0-255,66,144275,1,296905
42329,0.00217,74.125.24.0-255,4320,148595,1,296905
42330,0.002172,172.31.36.0-255,66,148661,1,296905
42331,0.002198,74.125.24.0-255,3602,152263,1,296905
42332,0.0022,172.31.36.0-255,66,152329,1,296905
42333,0.002224,74.125.24.0-255,5738,158067,1,296905
42334,0.002227,172.31.36.0-255,66,158133,1,296905
42335,0.002257,74.125.24.0-255,2902,161035,1,296905
42336,0.00226,172.31.36.0-255,66,161101,1,296905
42337,0.002272,172.31.36.0-255,66,161167,1,296905
42338,0.002319,172.31.36.0-255,66,161233,1,296905
42339,0.002326,74.125.24.0-255,7156,168389,1,296905
42340,0.002329,172.31.36.0-255,66,168455,1,296905
42341,0.002365,172.31.36.0-255,66,168521,1,296905
42342,0.002375,74.125.24.0-255,4320,172841,1,296905
42343,0.002378,172.31.36.0-255,66,172907,1,296905
42344,0.002409,172.31.36.0-255,66,172973,1,296905
42345,0.004779,74.125.24.0-255,5738,178711,1,296905
42346,0.004789,172.31.36.0-255,66,178777,1,296905
42347,0.007148,74.125.24.0-255,5738,184515,1,296905
42348,0.007154,172.31.36.0-255,66,184581,1,296905
42349,0.009503,74.125.24.0-255,5738,190319,1,296905
42350,0.009511,172.31.36.0-255,66,190385,1,296905
42351,0.01186,74.125.24.0-255,4320,194705,1,296905
42352,0.011867,172.31.36.0-255,66,194771,1,296905
42353,0.011883,74.125.24.0-255,1484,196255,1,296905
42354,0.014192,74.125.24.0-255,4320,200575,1,296905
42355,0.014202,172.31.36.0-255,66,200641,1,296905
42356,0.016572,74.125.24.0-255,5738,206379,1,296905
42357,0.016581,172.31.36.0-255,66,206445,1,296905
42358,0.01893,74.125.24.0-255,5738,212183,1,296905
42359,0.018942,172.31.36.0-255,66,212249,1,296905
42360,0.021271,74.125.24.0-255,5738,217987,1,296905
42361,0.02128,172.31.36.0-255,66,218053,1,296905
42362,0.023631,74.125.24.0-255,5738,223791,1,296905
42363,0.023638,172.31.36.0-255,66,223857,1,296905
42364,0.025997,74.125.24.0-255,5738,229595,1,296905
42365,0.026005,172.31.36.0-255,66,229661,1,296905
42366,0.028379,74.125.24.0-255,5738,235399,1,296905
42367,0.028386,172.31.36.0-255,66,235465,1,296905
42368,0.03075,74.125.24.0-255,5738,241203,1,296905
42369,0.030759,172.31.36.0-255,66,241269,1,296905
42370,0.033143,74.125.24.0-255,5738,247007,1,296905
42371,0.033152,172.31.36.0-255,66,247073,1,296905
42372,0.035497,74.125.24.0-255,5738,252811,1,296905
42373,0.035505,172.31.36.0-255,66,252877,1,296905
42374,0.037851,74.125.24.0-255,5738,258615,1,296905
42375,0.03786,172.31.36.0-255,66,258681,1,296905
42376,0.040209,74.125.24.0-255,5738,264419,1,296905
42377,0.040218,172.31.36.0-255,66,264485,1,296905
42378,0.041038,172.31.36.0-255,172,264657,1,296905
42379,0.041074,172.31.36.0-255,1115,265772,1,296905
42380,0.041147,172.31.36.0-255,1514,267286,1,296905
42381,0.041149,172.31.36.0-255,1514,268800,1,296905
42382,0.041151,172.31.36.0-255,1514,270314,1,296905
42383,0.041152,172.31.36.0-255,1514,271828,1,296905
42384,0.041178,172.31.36.0-255,1489,273317,1,296905
42385,0.042554,74.125.24.0-255,5738,279055,1,296905
42386,0.042562,172.31.36.0-255,66,279121,1,296905
42387,0.042719,104.244.42.0-255,66,279187,1,296905
42388,0.042727,104.244.42.0-255,66,279253,1,296905
42389,0.04283,104.244.42.0-255,66,279319,1,296905
42390,0.044499,104.244.42.0-255,108,279427,1,296905
42391,0.044509,172.31.36.0-255,66,279493,1,296905
42392,0.044895,74.125.24.0-255,5738,285231,1,296905
42393,0.0449,172.31.36.0-255,66,285297,1,296905
42394,0.047214,74.125.24.0-255,5738,291035,1,296905
42395,0.04722,172.31.36.0-255,66,291101,1,296905
42396,0.049573,74.125.24.0-255,5738,296839,1,296905
42397,0.049579,172.31.36.0-255,66,296905,1,296905
42398,0.0,74.125.24.0-255,153,153,1,281161
42399,2.3e-05,172.31.36.0-255,66,219,1,281161
42400,3.1e-05,74.125.24.0-255,1484,1703,1,281161
42401,3.5e-05,172.31.36.0-255,66,1769,1,281161
42402,4.2e-05,74.125.24.0-255,2902,4671,1,281161
42403,4.6e-05,172.31.36.0-255,66,4737,1,281161
42404,5.4e-05,74.125.24.0-255,7156,11893,1,281161
42405,5.7e-05,172.31.36.0-255,66,11959,1,281161
42406,6.1e-05,74.125.24.0-255,1977,13936,1,281161
42407,6.4e-05,172.31.36.0-255,66,14002,1,281161
42408,0.000148,74.125.24.0-255,1484,15486,1,281161
42409,0.000152,172.31.36.0-255,66,15552,1,281161
42410,0.000158,74.125.24.0-255,2902,18454,1,281161
42411,0.000161,172.31.36.0-255,66,18520,1,281161
42412,0.000169,74.125.24.0-255,5738,24258,1,281161
42413,0.000172,172.31.36.0-255,66,24324,1,281161
42414,0.000207,74.125.24.0-255,6797,31121,1,281161
42415,0.00021,172.31.36.0-255,66,31187,1,281161
42416,0.000299,74.125.24.0-255,1484,32671,1,281161
42417,0.000302,172.31.36.0-255,66,32737,1,281161
42418,0.000309,74.125.24.0-255,2902,35639,1,281161
42419,0.000311,172.31.36.0-255,66,35705,1,281161
42420,0.000318,74.125.24.0-255,5738,41443,1,281161
42421,0.000321,172.31.36.0-255,66,41509,1,281161
42422,0.000358,74.125.24.0-255,5738,47247,1,281161
42423,0.000362,172.31.36.0-255,66,47313,1,281161
42424,0.000391,172.31.36.0-255,66,47379,1,281161
42425,0.000398,74.125.24.0-255,7156,54535,1,281161
42426,0.000401,172.31.36.0-255,66,54601,1,281161
42427,0.000419,74.125.24.0-255,2543,57144,1,281161
42428,0.000421,172.31.36.0-255,66,57210,1,281161
42429,0.000424,74.125.24.0-255,399,57609,1,281161
42430,0.000562,74.125.24.0-255,109,57718,1,281161
42431,0.000593,74.125.24.0-255,334,58052,1,281161
42432,0.000926,74.125.24.0-255,1484,59536,1,281161
42433,0.000931,172.31.36.0-255,66,59602,1,281161
42434,0.000936,74.125.24.0-255,2902,62504,1,281161
42435,0.000938,172.31.36.0-255,66,62570,1,281161
42436,0.000945,74.125.24.0-255,5738,68308,1,281161
42437,0.000947,172.31.36.0-255,66,68374,1,281161
42438,0.000966,74.125.24.0-255,4320,72694,1,281161
42439,0.000969,172.31.36.0-255,66,72760,1,281161
42440,0.001005,172.31.36.0-255,66,72826,1,281161
42441,0.001012,74.125.24.0-255,5738,78564,1,281161
42442,0.001014,172.31.36.0-255,66,78630,1,281161
42443,0.00102,74.125.24.0-255,5020,83650,1,281161
42444,0.001022,172.31.36.0-255,66,83716,1,281161
42445,0.001538,74.125.24.0-255,1484,85200,1,281161
42446,0.001548,74.125.24.0-255,2902,88102,1,281161
42447,0.001552,172.31.36.0-255,66,88168,1,281161
42448,0.001558,74.125.24.0-255,2902,91070,1,281161
42449,0.00156,172.31.36.0-255,66,91136,1,281161
42450,0.001575,74.125.24.0-255,2902,94038,1,281161
42451,0.001577,172.31.36.0-255,66,94104,1,281161
42452,0.001585,74.125.24.0-255,7156,101260,1,281161
42453,0.001587,172.31.36.0-255,66,101326,1,281161
42454,0.001602,74.125.24.0-255,1484,102810,1,281161
42455,0.001619,74.125.24.0-255,7156,109966,1,281161
42456,0.001622,172.31.36.0-255,66,110032,1,281161
42457,0.001644,74.125.24.0-255,5738,115770,1,281161
42458,0.001646,172.31.36.0-255,66,115836,1,281161
42459,0.001651,74.125.24.0-255,2184,118020,1,281161
42460,0.001653,172.31.36.0-255,66,118086,1,281161
42461,0.001694,74.125.24.0-255,1484,119570,1,281161
42462,0.001699,74.125.24.0-255,2902,122472,1,281161
42463,0.001701,172.31.36.0-255,66,122538,1,281161
42464,0.001708,74.125.24.0-255,5738,128276,1,281161
42465,0.00171,172.31.36.0-255,66,128342,1,281161
42466,0.001759,172.31.36.0-255,66,128408,1,281161
42467,0.001773,172.31.36.0-255,66,128474,1,281161
42468,0.001836,74.125.24.0-255,1484,129958,1,281161
42469,0.001843,74.125.24.0-255,2902,132860,1,281161
42470,0.001847,172.31.36.0-255,66,132926,1,281161
42471,0.001853,74.125.24.0-255,4320,137246,1,281161
42472,0.001856,172.31.36.0-255,66,137312,1,281161
42473,0.00187,74.125.24.0-255,1484,138796,1,281161
42474,0.001883,172.31.36.0-255,66,138862,1,281161
42475,0.001925,74.125.24.0-255,5738,144600,1,281161
42476,0.001929,172.31.36.0-255,66,144666,1,281161
42477,0.001956,172.31.36.0-255,66,144732,1,281161
42478,0.002105,74.125.24.0-255,1484,146216,1,281161
42479,0.002111,74.125.24.0-255,2902,149118,1,281161
42480,0.002115,172.31.36.0-255,66,149184,1,281161
42481,0.00212,74.125.24.0-255,2902,152086,1,281161
42482,0.002123,172.31.36.0-255,66,152152,1,281161
42483,0.002137,74.125.24.0-255,1484,153636,1,281161
42484,0.002149,172.31.36.0-255,66,153702,1,281161
42485,0.002184,74.125.24.0-255,5738,159440,1,281161
42486,0.002187,172.31.36.0-255,66,159506,1,281161
42487,0.002222,172.31.36.0-255,66,159572,1,281161
42488,0.002244,172.31.36.0-255,66,159638,1,281161
42489,0.002265,74.125.24.0-255,5738,165376,1,281161
42490,0.002268,172.31.36.0-255,66,165442,1,281161
42491,0.002281,172.31.36.0-255,66,165508,1,281161
42492,0.00232,172.31.36.0-255,66,165574,1,281161
42493,0.002349,172.31.36.0-255,66,165640,1,281161
42494,0.002366,74.125.24.0-255,1484,167124,1,281161
42495,0.002372,74.125.24.0-255,3602,170726,1,281161
42496,0.002374,172.31.36.0-255,66,170792,1,281161
42497,0.004629,74.125.24.0-255,4320,175112,1,281161
42498,0.004636,172.31.36.0-255,66,175178,1,281161
42499,0.004655,74.125.24.0-255,1484,176662,1,281161
42500,0.006882,74.125.24.0-255,4320,180982,1,281161
42501,0.006891,172.31.36.0-255,66,181048,1,281161
42502,0.009225,74.125.24.0-255,5738,186786,1,281161
42503,0.009248,172.31.36.0-255,66,186852,1,281161
42504,0.01151,74.125.24.0-255,5738,192590,1,281161
42505,0.011517,172.31.36.0-255,66,192656,1,281161
42506,0.013812,74.125.24.0-255,5738,198394,1,281161
42507,0.013828,172.31.36.0-255,66,198460,1,281161
42508,0.016111,74.125.24.0-255,5738,204198,1,281161
42509,0.016117,172.31.36.0-255,66,204264,1,281161
42510,0.018401,74.125.24.0-255,5738,210002,1,281161
42511,0.018417,172.31.36.0-255,66,210068,1,281161
42512,0.020686,74.125.24.0-255,5738,215806,1,281161
42513,0.020694,172.31.36.0-255,66,215872,1,281161
42514,0.02297,74.125.24.0-255,5738,221610,1,281161
42515,0.022978,172.31.36.0-255,66,221676,1,281161
42516,0.02525,74.125.24.0-255,5738,227414,1,281161
42517,0.025258,172.31.36.0-255,66,227480,1,281161
42518,0.027539,74.125.24.0-255,5738,233218,1,281161
42519,0.02755,172.31.36.0-255,66,233284,1,281161
42520,0.029793,74.125.24.0-255,5738,239022,1,281161
42521,0.029801,172.31.36.0-255,66,239088,1,281161
42522,0.032098,74.125.24.0-255,5738,244826,1,281161
42523,0.032105,172.31.36.0-255,66,244892,1,281161
42524,0.034373,74.125.24.0-255,5738,250630,1,281161
42525,0.03438,172.31.36.0-255,66,250696,1,281161
42526,0.036664,74.125.24.0-255,5738,256434,1,281161
42527,0.036671,172.31.36.0-255,66,256500,1,281161
42528,0.038945,74.125.24.0-255,5738,262238,1,281161
42529,0.038952,172.31.36.0-255,66,262304,1,281161
42530,0.041221,74.125.24.0-255,5738,268042,1,281161
42531,0.041228,172.31.36.0-255,66,268108,1,281161
42532,0.043503,74.125.24.0-255,5738,273846,1,281161
42533,0.043515,172.31.36.0-255,66,273912,1,281161
42534,0.045802,74.125.24.0-255,5738,279650,1,281161
42535,0.045814,172.31.36.0-255,66,279716,1,281161
42536,0.048067,74.125.24.0-255,1274,280990,1,281161
42537,0.048218,172.31.36.0-255,66,281056,1,281161
42538,0.048258,172.31.36.0-255,105,281161,1,281161
42539,0.0,172.217.194.0-255,308,308,1,200585
42540,1.7e-05,172.31.36.0-255,66,374,1,200585
42541,2.3e-05,172.217.194.0-255,1484,1858,1,200585
42542,2.6e-05,172.31.36.0-255,66,1924,1,200585
42543,3.3e-05,172.217.194.0-255,4320,6244,1,200585
42544,3.5e-05,172.31.36.0-255,66,6310,1,200585
42545,6.9e-05,172.31.36.0-255,66,6376,1,200585
42546,7.5e-05,172.217.194.0-255,7156,13532,1,200585
42547,7.7e-05,172.31.36.0-255,66,13598,1,200585
42548,9.2e-05,172.217.194.0-255,5738,19336,1,200585
42549,9.4e-05,172.31.36.0-255,66,19402,1,200585
42550,0.00011,172.217.194.0-255,2543,21945,1,200585
42551,0.000113,172.31.36.0-255,66,22011,1,200585
42552,0.00016,172.217.194.0-255,1484,23495,1,200585
42553,0.000162,172.31.36.0-255,66,23561,1,200585
42554,0.000167,172.217.194.0-255,2902,26463,1,200585
42555,0.000169,172.31.36.0-255,66,26529,1,200585
42556,0.000207,172.217.194.0-255,5738,32267,1,200585
42557,0.00021,172.31.36.0-255,66,32333,1,200585
42558,0.000215,172.217.194.0-255,4320,36653,1,200585
42559,0.000217,172.31.36.0-255,66,36719,1,200585
42560,0.000238,172.31.36.0-255,66,36785,1,200585
42561,0.000271,172.217.194.0-255,5738,42523,1,200585
42562,0.000273,172.31.36.0-255,66,42589,1,200585
42563,0.00029,172.217.194.0-255,4271,46860,1,200585
42564,0.000293,172.31.36.0-255,66,46926,1,200585
42565,0.000334,172.217.194.0-255,1484,48410,1,200585
42566,0.000337,172.31.36.0-255,66,48476,1,200585
42567,0.000341,172.217.194.0-255,2902,51378,1,200585
42568,0.000344,172.31.36.0-255,66,51444,1,200585
42569,0.000347,172.217.194.0-255,1484,52928,1,200585
42570,0.000375,172.217.194.0-255,4320,57248,1,200585
42571,0.000377,172.31.36.0-255,66,57314,1,200585
42572,0.000383,172.217.194.0-255,5738,63052,1,200585
42573,0.000385,172.31.36.0-255,66,63118,1,200585
42574,0.000419,172.31.36.0-255,66,63184,1,200585
42575,0.000424,172.217.194.0-255,4272,67456,1,200585
42576,0.000427,172.31.36.0-255,66,67522,1,200585
42577,0.000589,172.217.194.0-255,1484,69006,1,200585
42578,0.000594,172.217.194.0-255,2902,71908,1,200585
42579,0.000597,172.31.36.0-255,66,71974,1,200585
42580,0.000619,172.217.194.0-255,5738,77712,1,200585
42581,0.000623,172.31.36.0-255,66,77778,1,200585
42582,0.000628,172.217.194.0-255,4320,82098,1,200585
42583,0.00063,172.31.36.0-255,66,82164,1,200585
42584,0.000633,172.217.194.0-255,1484,83648,1,200585
42585,0.000663,172.31.36.0-255,66,83714,1,200585
42586,0.000666,172.217.194.0-255,1484,85198,1,200585
42587,0.000693,172.31.36.0-255,66,85264,1,200585
42588,0.000706,172.31.36.0-255,66,85330,1,200585
42589,0.000731,172.217.194.0-255,4320,89650,1,200585
42590,0.000735,172.31.36.0-255,66,89716,1,200585
42591,0.000769,172.31.36.0-255,66,89782,1,200585
42592,0.000773,172.217.194.0-255,2902,92684,1,200585
42593,0.000775,172.31.36.0-255,66,92750,1,200585
42594,0.000778,172.217.194.0-255,1484,94234,1,200585
42595,0.000793,172.217.194.0-255,2902,97136,1,200585
42596,0.000795,172.31.36.0-255,66,97202,1,200585
42597,0.000811,172.217.194.0-255,4320,101522,1,200585
42598,0.000814,172.31.36.0-255,66,101588,1,200585
42599,0.000835,172.217.194.0-255,4320,105908,1,200585
42600,0.000838,172.31.36.0-255,66,105974,1,200585
42601,0.000854,172.31.36.0-255,66,106040,1,200585
42602,0.000877,172.217.194.0-255,1484,107524,1,200585
42603,0.00088,172.217.194.0-255,766,108290,1,200585
42604,0.000882,172.31.36.0-255,66,108356,1,200585
42605,0.001046,172.217.194.0-255,1484,109840,1,200585
42606,0.001052,172.217.194.0-255,2902,112742,1,200585
42607,0.001055,172.31.36.0-255,66,112808,1,200585
42608,0.001059,172.217.194.0-255,1484,114292,1,200585
42609,0.001077,172.217.194.0-255,4320,118612,1,200585
42610,0.00108,172.31.36.0-255,66,118678,1,200585
42611,0.001086,172.217.194.0-255,5738,124416,1,200585
42612,0.001089,172.31.36.0-255,66,124482,1,200585
42613,0.001154,172.31.36.0-255,66,124548,1,200585
42614,0.001174,172.217.194.0-255,1484,126032,1,200585
42615,0.001181,172.217.194.0-255,5020,131052,1,200585
42616,0.001183,172.31.36.0-255,66,131118,1,200585
42617,0.00153,172.217.194.0-255,1484,132602,1,200585
42618,0.001537,172.217.194.0-255,2902,135504,1,200585
42619,0.001542,172.31.36.0-255,66,135570,1,200585
42620,0.001554,172.217.194.0-255,5738,141308,1,200585
42621,0.001556,172.31.36.0-255,66,141374,1,200585
42622,0.001575,172.217.194.0-255,2902,144276,1,200585
42623,0.001578,172.31.36.0-255,66,144342,1,200585
42624,0.00162,172.31.36.0-255,66,144408,1,200585
42625,0.001633,172.31.36.0-255,66,144474,1,200585
42626,0.001892,172.217.194.0-255,1484,145958,1,200585
42627,0.001899,172.217.194.0-255,2902,148860,1,200585
42628,0.001903,172.31.36.0-255,66,148926,1,200585
42629,0.001909,172.217.194.0-255,4320,153246,1,200585
42630,0.001912,172.31.36.0-255,66,153312,1,200585
42631,0.001932,172.217.194.0-255,1484,154796,1,200585
42632,0.001946,172.217.194.0-255,1484,156280,1,200585
42633,0.001964,172.217.194.0-255,7156,163436,1,200585
42634,0.001987,172.217.194.0-255,2184,165620,1,200585
42635,0.002029,172.217.194.0-255,2902,168522,1,200585
42636,0.002054,172.217.194.0-255,4320,172842,1,200585
42637,0.002104,172.217.194.0-255,4320,177162,1,200585
42638,0.002155,172.217.194.0-255,4320,181482,1,200585
42639,0.002182,172.217.194.0-255,4320,185802,1,200585
42640,0.002202,172.217.194.0-255,5738,191540,1,200585
42641,0.002254,172.217.194.0-255,2902,194442,1,200585
42642,0.002338,172.217.194.0-255,1825,196267,1,200585
42643,0.002342,172.217.194.0-255,105,196372,1,200585
42644,0.002344,172.217.194.0-255,129,196501,1,200585
42645,0.006497,172.31.36.0-255,66,196567,1,200585
42646,0.009081,172.31.36.0-255,105,196672,1,200585
42647,0.009106,172.31.36.0-255,105,196777,1,200585
42648,0.009277,172.31.36.0-255,90,196867,1,200585
42649,0.009286,172.31.36.0-255,66,196933,1,200585
42650,0.011657,172.217.194.0-255,66,196999,1,200585
42651,0.011666,172.217.194.0-255,66,197065,1,200585
42652,0.011812,172.217.194.0-255,66,197131,1,200585
42653,0.011841,172.217.194.0-255,66,197197,1,200585
42654,0.011847,172.31.36.0-255,66,197263,1,200585
42655,0.030992,172.31.36.0-255,167,197430,1,200585
42656,0.031023,172.31.36.0-255,1114,198544,1,200585
42657,0.031064,172.31.36.0-255,1514,200058,1,200585
42658,0.031066,172.31.36.0-255,329,200387,1,200585
42659,0.032483,104.244.42.0-255,66,200453,1,200585
42660,0.032501,104.244.42.0-255,66,200519,1,200585
42661,0.032558,104.244.42.0-255,66,200585,1,200585
42662,0.0,74.125.130.0-255,153,153,1,223651
42663,3.3e-05,172.31.36.0-255,66,219,1,223651
42664,4e-05,74.125.130.0-255,1484,1703,1,223651
42665,4.4e-05,172.31.36.0-255,66,1769,1,223651
42666,4.9e-05,74.125.130.0-255,2902,4671,1,223651
42667,5.2e-05,172.31.36.0-255,66,4737,1,223651
42668,5.9e-05,74.125.130.0-255,7156,11893,1,223651
42669,6.1e-05,172.31.36.0-255,66,11959,1,223651
42670,6.6e-05,74.125.130.0-255,2084,14043,1,223651
42671,6.8e-05,172.31.36.0-255,66,14109,1,223651
42672,0.000218,74.125.130.0-255,1484,15593,1,223651
42673,0.000223,172.31.36.0-255,66,15659,1,223651
42674,0.000242,74.125.130.0-255,2902,18561,1,223651
42675,0.000245,172.31.36.0-255,66,18627,1,223651
42676,0.000282,74.125.130.0-255,4320,22947,1,223651
42677,0.000286,172.31.36.0-255,66,23013,1,223651
42678,0.000314,172.31.36.0-255,66,23079,1,223651
42679,0.001283,74.125.130.0-255,1484,24563,1,223651
42680,0.001289,172.31.36.0-255,66,24629,1,223651
42681,0.001299,74.125.130.0-255,2902,27531,1,223651
42682,0.001301,172.31.36.0-255,66,27597,1,223651
42683,0.001307,74.125.130.0-255,4320,31917,1,223651
42684,0.001309,172.31.36.0-255,66,31983,1,223651
42685,0.001347,74.125.130.0-255,4320,36303,1,223651
42686,0.001349,172.31.36.0-255,66,36369,1,223651
42687,0.001367,74.125.130.0-255,3961,40330,1,223651
42688,0.001369,172.31.36.0-255,66,40396,1,223651
42689,0.001374,74.125.130.0-255,4320,44716,1,223651
42690,0.001376,172.31.36.0-255,66,44782,1,223651
42691,0.001397,74.125.130.0-255,4320,49102,1,223651
42692,0.001399,172.31.36.0-255,66,49168,1,223651
42693,0.001405,74.125.130.0-255,5738,54906,1,223651
42694,0.001408,172.31.36.0-255,66,54972,1,223651
42695,0.001446,74.125.130.0-255,2795,57767,1,223651
42696,0.001448,172.31.36.0-255,66,57833,1,223651
42697,0.001464,74.125.130.0-255,118,57951,1,223651
42698,0.001496,74.125.130.0-255,382,58333,1,223651
42699,0.001791,74.125.130.0-255,1484,59817,1,223651
42700,0.001794,172.31.36.0-255,66,59883,1,223651
42701,0.001797,74.125.130.0-255,1484,61367,1,223651
42702,0.001809,74.125.130.0-255,1484,62851,1,223651
42703,0.001811,172.31.36.0-255,66,62917,1,223651
42704,0.001842,74.125.130.0-255,5738,68655,1,223651
42705,0.001845,172.31.36.0-255,66,68721,1,223651
42706,0.00185,74.125.130.0-255,4320,73041,1,223651
42707,0.001853,172.31.36.0-255,66,73107,1,223651
42708,0.001874,74.125.130.0-255,5738,78845,1,223651
42709,0.001876,172.31.36.0-255,66,78911,1,223651
42710,0.001886,74.125.130.0-255,1484,80395,1,223651
42711,0.001914,172.31.36.0-255,66,80461,1,223651
42712,0.001918,74.125.130.0-255,2184,82645,1,223651
42713,0.00192,172.31.36.0-255,66,82711,1,223651
42714,0.00395,74.125.130.0-255,2902,85613,1,223651
42715,0.003954,172.31.36.0-255,66,85679,1,223651
42716,0.003971,74.125.130.0-255,2902,88581,1,223651
42717,0.003973,172.31.36.0-255,66,88647,1,223651
42718,0.005983,74.125.130.0-255,2902,91549,1,223651
42719,0.00599,172.31.36.0-255,66,91615,1,223651
42720,0.006009,74.125.130.0-255,2902,94517,1,223651
42721,0.006014,172.31.36.0-255,66,94583,1,223651
42722,0.008014,74.125.130.0-255,2902,97485,1,223651
42723,0.008021,172.31.36.0-255,66,97551,1,223651
42724,0.008044,74.125.130.0-255,2902,100453,1,223651
42725,0.008047,172.31.36.0-255,66,100519,1,223651
42726,0.010057,74.125.130.0-255,2902,103421,1,223651
42727,0.010065,172.31.36.0-255,66,103487,1,223651
42728,0.010088,74.125.130.0-255,2902,106389,1,223651
42729,0.010091,172.31.36.0-255,66,106455,1,223651
42730,0.012097,74.125.130.0-255,2902,109357,1,223651
42731,0.012105,172.31.36.0-255,66,109423,1,223651
42732,0.012137,74.125.130.0-255,2902,112325,1,223651
42733,0.012141,172.31.36.0-255,66,112391,1,223651
42734,0.014148,74.125.130.0-255,2902,115293,1,223651
42735,0.014156,172.31.36.0-255,66,115359,1,223651
42736,0.014194,74.125.130.0-255,2902,118261,1,223651
42737,0.014198,172.31.36.0-255,66,118327,1,223651
42738,0.016194,74.125.130.0-255,2902,121229,1,223651
42739,0.016202,172.31.36.0-255,66,121295,1,223651
42740,0.016235,74.125.130.0-255,2902,124197,1,223651
42741,0.016238,172.31.36.0-255,66,124263,1,223651
42742,0.01823,74.125.130.0-255,2902,127165,1,223651
42743,0.018236,172.31.36.0-255,66,127231,1,223651
42744,0.018269,74.125.130.0-255,2902,130133,1,223651
42745,0.018273,172.31.36.0-255,66,130199,1,223651
42746,0.020279,74.125.130.0-255,4320,134519,1,223651
42747,0.020285,172.31.36.0-255,66,134585,1,223651
42748,0.020321,74.125.130.0-255,1484,136069,1,223651
42749,0.022325,74.125.130.0-255,4320,140389,1,223651
42750,0.022337,172.31.36.0-255,66,140455,1,223651
42751,0.024376,74.125.130.0-255,5738,146193,1,223651
42752,0.024384,172.31.36.0-255,66,146259,1,223651
42753,0.026411,74.125.130.0-255,5738,151997,1,223651
42754,0.02642,172.31.36.0-255,66,152063,1,223651
42755,0.028452,74.125.130.0-255,5738,157801,1,223651
42756,0.02846,172.31.36.0-255,66,157867,1,223651
42757,0.030504,74.125.130.0-255,5738,163605,1,223651
42758,0.030511,172.31.36.0-255,66,163671,1,223651
42759,0.031449,172.31.36.0-255,172,163843,1,223651
42760,0.031479,172.31.36.0-255,1115,164958,1,223651
42761,0.031534,172.31.36.0-255,1514,166472,1,223651
42762,0.031535,172.31.36.0-255,1514,167986,1,223651
42763,0.031537,172.31.36.0-255,1514,169500,1,223651
42764,0.031541,172.31.36.0-255,1514,171014,1,223651
42765,0.031542,172.31.36.0-255,1489,172503,1,223651
42766,0.03255,74.125.130.0-255,5738,178241,1,223651
42767,0.032556,172.31.36.0-255,66,178307,1,223651
42768,0.033051,104.244.42.0-255,66,178373,1,223651
42769,0.033058,104.244.42.0-255,66,178439,1,223651
42770,0.033199,104.244.42.0-255,66,178505,1,223651
42771,0.034594,74.125.130.0-255,5738,184243,1,223651
42772,0.034599,172.31.36.0-255,66,184309,1,223651
42773,0.036658,74.125.130.0-255,5738,190047,1,223651
42774,0.036664,172.31.36.0-255,66,190113,1,223651
42775,0.038711,74.125.130.0-255,5738,195851,1,223651
42776,0.038717,172.31.36.0-255,66,195917,1,223651
42777,0.040754,74.125.130.0-255,5738,201655,1,223651
42778,0.04076,172.31.36.0-255,66,201721,1,223651
42779,0.042797,74.125.130.0-255,4320,206041,1,223651
42780,0.042803,172.31.36.0-255,66,206107,1,223651
42781,0.042832,74.125.130.0-255,1484,207591,1,223651
42782,0.044849,74.125.130.0-255,4320,211911,1,223651
42783,0.044854,172.31.36.0-255,66,211977,1,223651
42784,0.046882,74.125.130.0-255,1484,213461,1,223651
42785,0.046912,74.125.130.0-255,4320,217781,1,223651
42786,0.046917,172.31.36.0-255,66,217847,1,223651
42787,0.048953,74.125.130.0-255,5738,223585,1,223651
42788,0.048958,172.31.36.0-255,66,223651,1,223651
42789,0.0,172.31.36.0-255,74,74,1,74
42790,0.0,172.217.194.0-255,146,146,1,278805
42791,3.6e-05,172.31.36.0-255,66,212,1,278805
42792,4.4e-05,172.217.194.0-255,1484,1696,1,278805
42793,4.8e-05,172.31.36.0-255,66,1762,1,278805
42794,6e-05,172.217.194.0-255,2902,4664,1,278805
42795,6.3e-05,172.31.36.0-255,66,4730,1,278805
42796,6.9e-05,172.217.194.0-255,4320,9050,1,278805
42797,7.1e-05,172.31.36.0-255,66,9116,1,278805
42798,8.3e-05,172.31.36.0-255,66,9182,1,278805
42799,8.6e-05,172.217.194.0-255,1484,10666,1,278805
42800,8.8e-05,172.31.36.0-255,66,10732,1,278805
42801,0.000134,172.31.36.0-255,66,10798,1,278805
42802,0.000162,172.217.194.0-255,1484,12282,1,278805
42803,0.000165,172.31.36.0-255,66,12348,1,278805
42804,0.00017,172.217.194.0-255,2902,15250,1,278805
42805,0.000172,172.31.36.0-255,66,15316,1,278805
42806,0.000197,172.217.194.0-255,5738,21054,1,278805
42807,0.000201,172.31.36.0-255,66,21120,1,278805
42808,0.000244,172.31.36.0-255,66,21186,1,278805
42809,0.00026,172.217.194.0-255,5379,26565,1,278805
42810,0.000263,172.31.36.0-255,66,26631,1,278805
42811,0.000279,172.31.36.0-255,66,26697,1,278805
42812,0.000281,172.217.194.0-255,367,27064,1,278805
42813,0.000285,172.31.36.0-255,66,27130,1,278805
42814,0.000521,172.217.194.0-255,1484,28614,1,278805
42815,0.000526,172.217.194.0-255,2902,31516,1,278805
42816,0.000526,172.31.36.0-255,66,31582,1,278805
42817,0.00053,172.31.36.0-255,66,31648,1,278805
42818,0.000537,172.217.194.0-255,1484,33132,1,278805
42819,0.00054,172.31.36.0-255,66,33198,1,278805
42820,0.000574,172.217.194.0-255,4320,37518,1,278805
42821,0.000578,172.31.36.0-255,66,37584,1,278805
42822,0.000585,172.217.194.0-255,7156,44740,1,278805
42823,0.000587,172.31.36.0-255,66,44806,1,278805
42824,0.000609,172.31.36.0-255,66,44872,1,278805
42825,0.000613,172.217.194.0-255,2184,47056,1,278805
42826,0.000616,172.31.36.0-255,66,47122,1,278805
42827,0.001043,172.217.194.0-255,1484,48606,1,278805
42828,0.001051,172.217.194.0-255,2902,51508,1,278805
42829,0.001055,172.31.36.0-255,66,51574,1,278805
42830,0.001079,172.217.194.0-255,5738,57312,1,278805
42831,0.001082,172.31.36.0-255,66,57378,1,278805
42832,0.001089,172.217.194.0-255,5738,63116,1,278805
42833,0.001091,172.31.36.0-255,66,63182,1,278805
42834,0.001124,172.217.194.0-255,7156,70338,1,278805
42835,0.001127,172.31.36.0-255,66,70404,1,278805
42836,0.001145,172.31.36.0-255,66,70470,1,278805
42837,0.001214,172.217.194.0-255,1484,71954,1,278805
42838,0.00122,172.217.194.0-255,2902,74856,1,278805
42839,0.001223,172.31.36.0-255,66,74922,1,278805
42840,0.001226,172.217.194.0-255,1484,76406,1,278805
42841,0.00125,172.217.194.0-255,4320,80726,1,278805
42842,0.001253,172.31.36.0-255,66,80792,1,278805
42843,0.001261,172.217.194.0-255,7156,87948,1,278805
42844,0.001263,172.31.36.0-255,66,88014,1,278805
42845,0.001294,172.217.194.0-255,5738,93752,1,278805
42846,0.001297,172.31.36.0-255,66,93818,1,278805
42847,0.00131,172.31.36.0-255,66,93884,1,278805
42848,0.001545,172.217.194.0-255,1484,95368,1,278805
42849,0.001551,172.217.194.0-255,2902,98270,1,278805
42850,0.001554,172.31.36.0-255,66,98336,1,278805
42851,0.001561,172.217.194.0-255,5738,104074,1,278805
42852,0.001564,172.31.36.0-255,66,104140,1,278805
42853,0.001599,172.217.194.0-255,7156,111296,1,278805
42854,0.001602,172.31.36.0-255,66,111362,1,278805
42855,0.001615,172.31.36.0-255,66,111428,1,278805
42856,0.001646,172.217.194.0-255,2902,114330,1,278805
42857,0.001649,172.31.36.0-255,66,114396,1,278805
42858,0.001654,172.217.194.0-255,2184,116580,1,278805
42859,0.001656,172.31.36.0-255,66,116646,1,278805
42860,0.001809,172.217.194.0-255,1484,118130,1,278805
42861,0.001814,172.217.194.0-255,1484,119614,1,278805
42862,0.001818,172.31.36.0-255,66,119680,1,278805
42863,0.001836,172.217.194.0-255,1484,121164,1,278805
42864,0.001843,172.217.194.0-255,5738,126902,1,278805
42865,0.001846,172.31.36.0-255,66,126968,1,278805
42866,0.001854,172.217.194.0-255,7156,134124,1,278805
42867,0.001857,172.31.36.0-255,66,134190,1,278805
42868,0.001886,172.217.194.0-255,5738,139928,1,278805
42869,0.001889,172.31.36.0-255,66,139994,1,278805
42870,0.001907,172.31.36.0-255,66,140060,1,278805
42871,0.00213,172.217.194.0-255,1484,141544,1,278805
42872,0.002136,172.217.194.0-255,2902,144446,1,278805
42873,0.002139,172.31.36.0-255,66,144512,1,278805
42874,0.00216,172.217.194.0-255,5738,150250,1,278805
42875,0.002163,172.31.36.0-255,66,150316,1,278805
42876,0.002225,172.31.36.0-255,66,150382,1,278805
42877,0.002242,172.31.36.0-255,66,150448,1,278805
42878,0.004481,172.217.194.0-255,5738,156186,1,278805
42879,0.004488,172.31.36.0-255,66,156252,1,278805
42880,0.006739,172.217.194.0-255,4320,160572,1,278805
42881,0.006742,172.31.36.0-255,66,160638,1,278805
42882,0.006768,172.217.194.0-255,1484,162122,1,278805
42883,0.008986,172.217.194.0-255,4320,166442,1,278805
42884,0.008993,172.31.36.0-255,66,166508,1,278805
42885,0.011244,172.217.194.0-255,5738,172246,1,278805
42886,0.011252,172.31.36.0-255,66,172312,1,278805
42887,0.013506,172.217.194.0-255,5738,178050,1,278805
42888,0.013513,172.31.36.0-255,66,178116,1,278805
42889,0.015778,172.217.194.0-255,5738,183854,1,278805
42890,0.015785,172.31.36.0-255,66,183920,1,278805
42891,0.018046,172.217.194.0-255,5738,189658,1,278805
42892,0.018057,172.31.36.0-255,66,189724,1,278805
42893,0.020309,172.217.194.0-255,5738,195462,1,278805
42894,0.020316,172.31.36.0-255,66,195528,1,278805
42895,0.022566,172.217.194.0-255,5738,201266,1,278805
42896,0.022573,172.31.36.0-255,66,201332,1,278805
42897,0.024842,172.217.194.0-255,5738,207070,1,278805
42898,0.02485,172.31.36.0-255,66,207136,1,278805
42899,0.027103,172.217.194.0-255,5738,212874,1,278805
42900,0.027111,172.31.36.0-255,66,212940,1,278805
42901,0.029366,172.217.194.0-255,5738,218678,1,278805
42902,0.029373,172.31.36.0-255,66,218744,1,278805
42903,0.031634,172.217.194.0-255,5738,224482,1,278805
42904,0.031642,172.31.36.0-255,66,224548,1,278805
42905,0.033894,172.217.194.0-255,5738,230286,1,278805
42906,0.033903,172.31.36.0-255,66,230352,1,278805
42907,0.036164,172.217.194.0-255,5738,236090,1,278805
42908,0.036172,172.31.36.0-255,66,236156,1,278805
42909,0.037027,172.31.36.0-255,188,236344,1,278805
42910,0.037059,172.31.36.0-255,958,237302,1,278805
42911,0.037126,172.31.36.0-255,1514,238816,1,278805
42912,0.037128,172.31.36.0-255,1514,240330,1,278805
42913,0.037134,172.31.36.0-255,1514,241844,1,278805
42914,0.037135,172.31.36.0-255,1514,243358,1,278805
42915,0.037157,172.31.36.0-255,1514,244872,1,278805
42916,0.037158,172.31.36.0-255,197,245069,1,278805
42917,0.038427,172.217.194.0-255,5738,250807,1,278805
42918,0.038434,172.31.36.0-255,66,250873,1,278805
42919,0.038574,104.244.42.0-255,66,250939,1,278805
42920,0.03862,104.244.42.0-255,66,251005,1,278805
42921,0.03874,104.244.42.0-255,66,251071,1,278805
42922,0.038746,104.244.42.0-255,66,251137,1,278805
42923,0.040686,172.217.194.0-255,5738,256875,1,278805
42924,0.040692,172.31.36.0-255,66,256941,1,278805
42925,0.042957,172.217.194.0-255,4320,261261,1,278805
42926,0.042978,172.31.36.0-255,66,261327,1,278805
42927,0.043005,172.217.194.0-255,1484,262811,1,278805
42928,0.0452,172.217.194.0-255,4320,267131,1,278805
42929,0.045206,172.31.36.0-255,66,267197,1,278805
42930,0.047461,172.217.194.0-255,5738,272935,1,278805
42931,0.047466,172.31.36.0-255,66,273001,1,278805
42932,0.049723,172.217.194.0-255,5738,278739,1,278805
42933,0.04973,172.31.36.0-255,66,278805,1,278805
42934,0.0,74.125.200.0-255,150,150,1,314456
42935,2.3e-05,172.31.36.0-255,66,216,1,314456
42936,3e-05,74.125.200.0-255,1484,1700,1,314456
42937,3.5e-05,172.31.36.0-255,66,1766,1,314456
42938,3.8e-05,74.125.200.0-255,1484,3250,1,314456
42939,4.8e-05,172.31.36.0-255,66,3316,1,314456
42940,5.4e-05,74.125.200.0-255,2902,6218,1,314456
42941,5.7e-05,172.31.36.0-255,66,6284,1,314456
42942,6.4e-05,74.125.200.0-255,5738,12022,1,314456
42943,6.8e-05,172.31.36.0-255,66,12088,1,314456
42944,8.9e-05,74.125.200.0-255,2022,14110,1,314456
42945,9.2e-05,172.31.36.0-255,66,14176,1,314456
42946,0.000297,74.125.200.0-255,1484,15660,1,314456
42947,0.000304,172.31.36.0-255,66,15726,1,314456
42948,0.000309,74.125.200.0-255,2902,18628,1,314456
42949,0.000312,172.31.36.0-255,66,18694,1,314456
42950,0.000345,74.125.200.0-255,5738,24432,1,314456
42951,0.000348,172.31.36.0-255,66,24498,1,314456
42952,0.000374,74.125.200.0-255,4320,28818,1,314456
42953,0.000377,172.31.36.0-255,66,28884,1,314456
42954,0.000404,74.125.200.0-255,2543,31427,1,314456
42955,0.000407,172.31.36.0-255,66,31493,1,314456
42956,0.000411,74.125.200.0-255,1484,32977,1,314456
42957,0.000412,172.31.36.0-255,66,33043,1,314456
42958,0.000417,74.125.200.0-255,2902,35945,1,314456
42959,0.00042,172.31.36.0-255,66,36011,1,314456
42960,0.000426,74.125.200.0-255,5738,41749,1,314456
42961,0.000428,172.31.36.0-255,66,41815,1,314456
42962,0.000465,74.125.200.0-255,7156,48971,1,314456
42963,0.000468,172.31.36.0-255,66,49037,1,314456
42964,0.000478,172.31.36.0-255,66,49103,1,314456
42965,0.000539,172.31.36.0-255,66,49169,1,314456
42966,0.000542,74.125.200.0-255,410,49579,1,314456
42967,0.00078,74.125.200.0-255,1484,51063,1,314456
42968,0.000786,172.31.36.0-255,66,51129,1,314456
42969,0.000803,74.125.200.0-255,2902,54031,1,314456
42970,0.000806,172.31.36.0-255,66,54097,1,314456
42971,0.00081,74.125.200.0-255,1484,55581,1,314456
42972,0.000818,74.125.200.0-255,5738,61319,1,314456
42973,0.000821,172.31.36.0-255,66,61385,1,314456
42974,0.000853,172.31.36.0-255,66,61451,1,314456
42975,0.000875,74.125.200.0-255,1484,62935,1,314456
42976,0.000881,74.125.200.0-255,4320,67255,1,314456
42977,0.000883,172.31.36.0-255,66,67321,1,314456
42978,0.000904,74.125.200.0-255,2902,70223,1,314456
42979,0.000907,172.31.36.0-255,66,70289,1,314456
42980,0.000934,74.125.200.0-255,2452,72741,1,314456
42981,0.000937,172.31.36.0-255,66,72807,1,314456
42982,0.001123,74.125.200.0-255,1484,74291,1,314456
42983,0.00113,74.125.200.0-255,2902,77193,1,314456
42984,0.001134,172.31.36.0-255,66,77259,1,314456
42985,0.001163,74.125.200.0-255,5738,82997,1,314456
42986,0.001166,172.31.36.0-255,66,83063,1,314456
42987,0.001175,74.125.200.0-255,7156,90219,1,314456
42988,0.001178,172.31.36.0-255,66,90285,1,314456
42989,0.001209,74.125.200.0-255,4320,94605,1,314456
42990,0.001212,172.31.36.0-255,66,94671,1,314456
42991,0.001247,172.31.36.0-255,66,94737,1,314456
42992,0.001251,74.125.200.0-255,2184,96921,1,314456
42993,0.001253,172.31.36.0-255,66,96987,1,314456
42994,0.001332,74.125.200.0-255,1484,98471,1,314456
42995,0.001347,74.125.200.0-255,2902,101373,1,314456
42996,0.00135,172.31.36.0-255,66,101439,1,314456
42997,0.001355,74.125.200.0-255,2902,104341,1,314456
42998,0.001357,172.31.36.0-255,66,104407,1,314456
42999,0.001379,74.125.200.0-255,4320,108727,1,314456
43000,0.001381,172.31.36.0-255,66,108793,1,314456
43001,0.001387,74.125.200.0-255,4320,113113,1,314456
43002,0.001389,172.31.36.0-255,66,113179,1,314456
43003,0.00142,74.125.200.0-255,4320,117499,1,314456
43004,0.001423,172.31.36.0-255,66,117565,1,314456
43005,0.001427,74.125.200.0-255,1484,119049,1,314456
43006,0.001431,74.125.200.0-255,2902,121951,1,314456
43007,0.001433,172.31.36.0-255,66,122017,1,314456
43008,0.00147,74.125.200.0-255,5738,127755,1,314456
43009,0.001474,172.31.36.0-255,66,127821,1,314456
43010,0.001476,74.125.200.0-255,1484,129305,1,314456
43011,0.001514,74.125.200.0-255,2184,131489,1,314456
43012,0.001517,172.31.36.0-255,66,131555,1,314456
43013,0.001561,74.125.200.0-255,2902,134457,1,314456
43014,0.001565,172.31.36.0-255,66,134523,1,314456
43015,0.001593,74.125.200.0-255,4320,138843,1,314456
43016,0.001597,172.31.36.0-255,66,138909,1,314456
43017,0.001608,172.31.36.0-255,66,138975,1,314456
43018,0.001634,74.125.200.0-255,1484,140459,1,314456
43019,0.001638,74.125.200.0-255,1484,141943,1,314456
43020,0.00164,172.31.36.0-255,66,142009,1,314456
43021,0.001672,74.125.200.0-255,1484,143493,1,314456
43022,0.001678,74.125.200.0-255,5738,149231,1,314456
43023,0.001681,172.31.36.0-255,66,149297,1,314456
43024,0.001687,74.125.200.0-255,4320,153617,1,314456
43025,0.001689,172.31.36.0-255,66,153683,1,314456
43026,0.001715,74.125.200.0-255,2902,156585,1,314456
43027,0.001717,172.31.36.0-255,66,156651,1,314456
43028,0.00172,74.125.200.0-255,766,157417,1,314456
43029,0.001817,74.125.200.0-255,1484,158901,1,314456
43030,0.001822,172.31.36.0-255,66,158967,1,314456
43031,0.001827,74.125.200.0-255,2902,161869,1,314456
43032,0.00183,172.31.36.0-255,66,161935,1,314456
43033,0.001836,74.125.200.0-255,4320,166255,1,314456
43034,0.001842,172.31.36.0-255,66,166321,1,314456
43035,0.001873,74.125.200.0-255,1484,167805,1,314456
43036,0.001888,172.31.36.0-255,66,167871,1,314456
43037,0.001913,74.125.200.0-255,2902,170773,1,314456
43038,0.001915,172.31.36.0-255,66,170839,1,314456
43039,0.00195,172.31.36.0-255,66,170905,1,314456
43040,0.001975,172.31.36.0-255,66,170971,1,314456
43041,0.002013,74.125.200.0-255,2902,173873,1,314456
43042,0.002015,172.31.36.0-255,66,173939,1,314456
43043,0.002057,74.125.200.0-255,7156,181095,1,314456
43044,0.002062,172.31.36.0-255,66,181161,1,314456
43045,0.002075,172.31.36.0-255,66,181227,1,314456
43046,0.00208,74.125.200.0-255,2184,183411,1,314456
43047,0.002082,172.31.36.0-255,66,183477,1,314456
43048,0.004311,74.125.200.0-255,5738,189215,1,314456
43049,0.004318,172.31.36.0-255,66,189281,1,314456
43050,0.00656,74.125.200.0-255,5738,195019,1,314456
43051,0.006565,172.31.36.0-255,66,195085,1,314456
43052,0.008822,74.125.200.0-255,5738,200823,1,314456
43053,0.008829,172.31.36.0-255,66,200889,1,314456
43054,0.01108,74.125.200.0-255,5738,206627,1,314456
43055,0.011088,172.31.36.0-255,66,206693,1,314456
43056,0.013336,74.125.200.0-255,5738,212431,1,314456
43057,0.013344,172.31.36.0-255,66,212497,1,314456
43058,0.015595,74.125.200.0-255,5738,218235,1,314456
43059,0.015606,172.31.36.0-255,66,218301,1,314456
43060,0.01787,74.125.200.0-255,5738,224039,1,314456
43061,0.017879,172.31.36.0-255,66,224105,1,314456
43062,0.020119,74.125.200.0-255,5738,229843,1,314456
43063,0.020126,172.31.36.0-255,66,229909,1,314456
43064,0.022364,74.125.200.0-255,5738,235647,1,314456
43065,0.022371,172.31.36.0-255,66,235713,1,314456
43066,0.024621,74.125.200.0-255,5738,241451,1,314456
43067,0.024629,172.31.36.0-255,66,241517,1,314456
43068,0.026914,74.125.200.0-255,5738,247255,1,314456
43069,0.026922,172.31.36.0-255,66,247321,1,314456
43070,0.029166,74.125.200.0-255,5738,253059,1,314456
43071,0.029174,172.31.36.0-255,66,253125,1,314456
43072,0.031426,74.125.200.0-255,5738,258863,1,314456
43073,0.031433,172.31.36.0-255,66,258929,1,314456
43074,0.033686,74.125.200.0-255,5738,264667,1,314456
43075,0.033694,172.31.36.0-255,66,264733,1,314456
43076,0.035944,74.125.200.0-255,5738,270471,1,314456
43077,0.035952,172.31.36.0-255,66,270537,1,314456
43078,0.038204,74.125.200.0-255,5738,276275,1,314456
43079,0.038212,172.31.36.0-255,66,276341,1,314456
43080,0.039329,172.31.36.0-255,172,276513,1,314456
43081,0.039362,172.31.36.0-255,1113,277626,1,314456
43082,0.039429,172.31.36.0-255,1514,279140,1,314456
43083,0.039431,172.31.36.0-255,1514,280654,1,314456
43084,0.039433,172.31.36.0-255,1514,282168,1,314456
43085,0.039434,172.31.36.0-255,1514,283682,1,314456
43086,0.039462,172.31.36.0-255,1490,285172,1,314456
43087,0.040452,74.125.200.0-255,5738,290910,1,314456
43088,0.04046,172.31.36.0-255,66,290976,1,314456
43089,0.040882,104.244.42.0-255,66,291042,1,314456
43090,0.040924,104.244.42.0-255,66,291108,1,314456
43091,0.040974,104.244.42.0-255,66,291174,1,314456
43092,0.041025,104.244.42.0-255,66,291240,1,314456
43093,0.042731,74.125.200.0-255,5738,296978,1,314456
43094,0.04274,172.31.36.0-255,66,297044,1,314456
43095,0.04499,74.125.200.0-255,5738,302782,1,314456
43096,0.044996,172.31.36.0-255,66,302848,1,314456
43097,0.047238,74.125.200.0-255,5738,308586,1,314456
43098,0.047245,172.31.36.0-255,66,308652,1,314456
43099,0.049513,74.125.200.0-255,5738,314390,1,314456
43100,0.04952,172.31.36.0-255,66,314456,1,314456
43101,0.0,172.217.194.0-255,153,153,1,219484
43102,2.3e-05,172.31.36.0-255,66,219,1,219484
43103,3e-05,172.217.194.0-255,1484,1703,1,219484
43104,3.5e-05,172.31.36.0-255,66,1769,1,219484
43105,4.2e-05,172.217.194.0-255,2902,4671,1,219484
43106,4.6e-05,172.31.36.0-255,66,4737,1,219484
43107,5.2e-05,172.217.194.0-255,4320,9057,1,219484
43108,5.5e-05,172.31.36.0-255,66,9123,1,219484
43109,7.9e-05,172.217.194.0-255,2902,12025,1,219484
43110,8.2e-05,172.31.36.0-255,66,12091,1,219484
43111,8.7e-05,172.217.194.0-255,2040,14131,1,219484
43112,9e-05,172.31.36.0-255,66,14197,1,219484
43113,0.000301,172.217.194.0-255,1484,15681,1,219484
43114,0.000307,172.31.36.0-255,66,15747,1,219484
43115,0.000314,172.217.194.0-255,2902,18649,1,219484
43116,0.000317,172.31.36.0-255,66,18715,1,219484
43117,0.000323,172.217.194.0-255,4320,23035,1,219484
43118,0.000325,172.31.36.0-255,66,23101,1,219484
43119,0.000348,172.217.194.0-255,1484,24585,1,219484
43120,0.00035,172.31.36.0-255,66,24651,1,219484
43121,0.000353,172.217.194.0-255,1484,26135,1,219484
43122,0.000355,172.31.36.0-255,66,26201,1,219484
43123,0.00038,172.217.194.0-255,2902,29103,1,219484
43124,0.000383,172.31.36.0-255,66,29169,1,219484
43125,0.000395,172.217.194.0-255,2543,31712,1,219484
43126,0.000398,172.31.36.0-255,66,31778,1,219484
43127,0.000782,172.217.194.0-255,1484,33262,1,219484
43128,0.000787,172.31.36.0-255,66,33328,1,219484
43129,0.000793,172.217.194.0-255,2902,36230,1,219484
43130,0.000795,172.31.36.0-255,66,36296,1,219484
43131,0.0008,172.217.194.0-255,2902,39198,1,219484
43132,0.000803,172.31.36.0-255,66,39264,1,219484
43133,0.000824,172.217.194.0-255,2902,42166,1,219484
43134,0.000826,172.31.36.0-255,66,42232,1,219484
43135,0.000834,172.217.194.0-255,7156,49388,1,219484
43136,0.000836,172.31.36.0-255,66,49454,1,219484
43137,0.00086,172.217.194.0-255,6797,56251,1,219484
43138,0.000862,172.31.36.0-255,66,56317,1,219484
43139,0.000883,172.217.194.0-255,5738,62055,1,219484
43140,0.000886,172.31.36.0-255,66,62121,1,219484
43141,0.000902,172.217.194.0-255,3961,66082,1,219484
43142,0.000905,172.31.36.0-255,66,66148,1,219484
43143,0.001473,172.217.194.0-255,647,66795,1,219484
43144,0.001547,172.217.194.0-255,1484,68279,1,219484
43145,0.001552,172.31.36.0-255,66,68345,1,219484
43146,0.001557,172.217.194.0-255,1484,69829,1,219484
43147,0.001573,172.217.194.0-255,1484,71313,1,219484
43148,0.001575,172.31.36.0-255,66,71379,1,219484
43149,0.001592,172.217.194.0-255,4320,75699,1,219484
43150,0.001595,172.31.36.0-255,66,75765,1,219484
43151,0.001609,172.217.194.0-255,1484,77249,1,219484
43152,0.001616,172.217.194.0-255,4320,81569,1,219484
43153,0.001618,172.31.36.0-255,66,81635,1,219484
43154,0.001643,172.217.194.0-255,5738,87373,1,219484
43155,0.001645,172.31.36.0-255,66,87439,1,219484
43156,0.001657,172.31.36.0-255,66,87505,1,219484
43157,0.001676,172.217.194.0-255,5020,92525,1,219484
43158,0.001678,172.31.36.0-255,66,92591,1,219484
43159,0.001734,172.217.194.0-255,1484,94075,1,219484
43160,0.001739,172.217.194.0-255,2902,96977,1,219484
43161,0.001742,172.31.36.0-255,66,97043,1,219484
43162,0.001769,172.217.194.0-255,5738,102781,1,219484
43163,0.001772,172.31.36.0-255,66,102847,1,219484
43164,0.001777,172.217.194.0-255,2902,105749,1,219484
43165,0.001779,172.31.36.0-255,66,105815,1,219484
43166,0.0018,172.31.36.0-255,66,105881,1,219484
43167,0.001804,172.217.194.0-255,1484,107365,1,219484
43168,0.001833,172.31.36.0-255,66,107431,1,219484
43169,0.001852,172.217.194.0-255,1484,108915,1,219484
43170,0.001869,172.217.194.0-255,1484,110399,1,219484
43171,0.001871,172.31.36.0-255,66,110465,1,219484
43172,0.001888,172.217.194.0-255,1484,111949,1,219484
43173,0.001937,172.217.194.0-255,4320,116269,1,219484
43174,0.00194,172.31.36.0-255,66,116335,1,219484
43175,0.00196,172.217.194.0-255,1484,117819,1,219484
43176,0.001966,172.217.194.0-255,5738,123557,1,219484
43177,0.001968,172.31.36.0-255,66,123623,1,219484
43178,0.001976,172.217.194.0-255,7156,130779,1,219484
43179,0.001979,172.31.36.0-255,66,130845,1,219484
43180,0.001992,172.31.36.0-255,66,130911,1,219484
43181,0.002526,172.217.194.0-255,1484,132395,1,219484
43182,0.002533,172.217.194.0-255,2902,135297,1,219484
43183,0.002537,172.31.36.0-255,66,135363,1,219484
43184,0.002543,172.217.194.0-255,2902,138265,1,219484
43185,0.002545,172.31.36.0-255,66,138331,1,219484
43186,0.002559,172.217.194.0-255,2902,141233,1,219484
43187,0.002561,172.31.36.0-255,66,141299,1,219484
43188,0.002564,172.217.194.0-255,1484,142783,1,219484
43189,0.002591,172.217.194.0-255,7156,149939,1,219484
43190,0.002593,172.31.36.0-255,66,150005,1,219484
43191,0.002615,172.217.194.0-255,4320,154325,1,219484
43192,0.002618,172.31.36.0-255,66,154391,1,219484
43193,0.002629,172.31.36.0-255,66,154457,1,219484
43194,0.002634,172.217.194.0-255,2184,156641,1,219484
43195,0.002636,172.31.36.0-255,66,156707,1,219484
43196,0.002787,172.217.194.0-255,1484,158191,1,219484
43197,0.002792,172.217.194.0-255,2902,161093,1,219484
43198,0.002795,172.31.36.0-255,66,161159,1,219484
43199,0.002817,172.217.194.0-255,5738,166897,1,219484
43200,0.00282,172.31.36.0-255,66,166963,1,219484
43201,0.002851,172.31.36.0-255,66,167029,1,219484
43202,0.002858,172.217.194.0-255,7156,174185,1,219484
43203,0.00286,172.31.36.0-255,66,174251,1,219484
43204,0.002874,172.217.194.0-255,2902,177153,1,219484
43205,0.002877,172.31.36.0-255,66,177219,1,219484
43206,0.002919,172.31.36.0-255,66,177285,1,219484
43207,0.002959,172.31.36.0-255,66,177351,1,219484
43208,0.00297,172.31.36.0-255,66,177417,1,219484
43209,0.002976,172.217.194.0-255,5738,183155,1,219484
43210,0.002979,172.31.36.0-255,66,183221,1,219484
43211,0.003008,172.31.36.0-255,66,183287,1,219484
43212,0.003019,172.31.36.0-255,66,183353,1,219484
43213,0.003024,172.217.194.0-255,4320,187673,1,219484
43214,0.003026,172.31.36.0-255,66,187739,1,219484
43215,0.003047,172.31.36.0-255,66,187805,1,219484
43216,0.003067,172.217.194.0-255,6438,194243,1,219484
43217,0.003069,172.31.36.0-255,66,194309,1,219484
43218,0.00308,172.31.36.0-255,66,194375,1,219484
43219,0.003084,172.217.194.0-255,1484,195859,1,219484
43220,0.003097,172.31.36.0-255,66,195925,1,219484
43221,0.003146,172.217.194.0-255,2902,198827,1,219484
43222,0.003148,172.31.36.0-255,66,198893,1,219484
43223,0.003163,172.217.194.0-255,1484,200377,1,219484
43224,0.00318,172.31.36.0-255,66,200443,1,219484
43225,0.003191,172.31.36.0-255,66,200509,1,219484
43226,0.003196,172.217.194.0-255,3602,204111,1,219484
43227,0.003198,172.31.36.0-255,66,204177,1,219484
43228,0.003219,172.31.36.0-255,66,204243,1,219484
43229,0.003226,172.217.194.0-255,5738,209981,1,219484
43230,0.003229,172.31.36.0-255,66,210047,1,219484
43231,0.003274,172.31.36.0-255,66,210113,1,219484
43232,0.003277,172.217.194.0-255,105,210218,1,219484
43233,0.009973,172.31.36.0-255,66,210284,1,219484
43234,0.010012,172.31.36.0-255,105,210389,1,219484
43235,0.012607,172.217.194.0-255,66,210455,1,219484
43236,0.040263,172.31.36.0-255,172,210627,1,219484
43237,0.040309,172.31.36.0-255,1113,211740,1,219484
43238,0.040388,172.31.36.0-255,1514,213254,1,219484
43239,0.040389,172.31.36.0-255,1514,214768,1,219484
43240,0.04039,172.31.36.0-255,1514,216282,1,219484
43241,0.040395,172.31.36.0-255,1514,217796,1,219484
43242,0.040396,172.31.36.0-255,1490,219286,1,219484
43243,0.041792,104.244.42.0-255,66,219352,1,219484
43244,0.041926,104.244.42.0-255,66,219418,1,219484
43245,0.041981,104.244.42.0-255,66,219484,1,219484
43246,0.0,74.125.24.0-255,153,153,1,250136
43247,2.6e-05,172.31.36.0-255,66,219,1,250136
43248,4.4e-05,74.125.24.0-255,1484,1703,1,250136
43249,5.5e-05,172.31.36.0-255,66,1769,1,250136
43250,6.1e-05,74.125.24.0-255,2902,4671,1,250136
43251,6.3e-05,172.31.36.0-255,66,4737,1,250136
43252,0.000102,74.125.24.0-255,5738,10475,1,250136
43253,0.000105,172.31.36.0-255,66,10541,1,250136
43254,0.000111,74.125.24.0-255,3495,14036,1,250136
43255,0.000113,172.31.36.0-255,66,14102,1,250136
43256,0.000152,172.31.36.0-255,66,14168,1,250136
43257,0.000158,74.125.24.0-255,5379,19547,1,250136
43258,0.000161,172.31.36.0-255,66,19613,1,250136
43259,0.000287,74.125.24.0-255,1484,21097,1,250136
43260,0.000291,172.31.36.0-255,66,21163,1,250136
43261,0.000297,74.125.24.0-255,2902,24065,1,250136
43262,0.0003,172.31.36.0-255,66,24131,1,250136
43263,0.000336,74.125.24.0-255,5738,29869,1,250136
43264,0.00034,172.31.36.0-255,66,29935,1,250136
43265,0.000367,172.31.36.0-255,66,30001,1,250136
43266,0.000397,74.125.24.0-255,2543,32544,1,250136
43267,0.0004,172.31.36.0-255,66,32610,1,250136
43268,0.000411,172.31.36.0-255,66,32676,1,250136
43269,0.000441,74.125.24.0-255,131,32807,1,250136
43270,0.000444,172.31.36.0-255,66,32873,1,250136
43271,0.000527,74.125.24.0-255,1484,34357,1,250136
43272,0.000532,172.31.36.0-255,66,34423,1,250136
43273,0.000541,74.125.24.0-255,2902,37325,1,250136
43274,0.000544,172.31.36.0-255,66,37391,1,250136
43275,0.000555,74.125.24.0-255,5738,43129,1,250136
43276,0.000559,172.31.36.0-255,66,43195,1,250136
43277,0.000609,172.31.36.0-255,66,43261,1,250136
43278,0.00062,172.31.36.0-255,66,43327,1,250136
43279,0.000679,74.125.24.0-255,4220,47547,1,250136
43280,0.000683,172.31.36.0-255,66,47613,1,250136
43281,0.000705,74.125.24.0-255,4320,51933,1,250136
43282,0.000709,172.31.36.0-255,66,51999,1,250136
43283,0.000715,74.125.24.0-255,5738,57737,1,250136
43284,0.000719,172.31.36.0-255,66,57803,1,250136
43285,0.000765,172.31.36.0-255,66,57869,1,250136
43286,0.000785,172.31.36.0-255,66,57935,1,250136
43287,0.000963,74.125.24.0-255,1484,59419,1,250136
43288,0.00097,74.125.24.0-255,2902,62321,1,250136
43289,0.000973,172.31.36.0-255,66,62387,1,250136
43290,0.001006,74.125.24.0-255,5738,68125,1,250136
43291,0.001009,172.31.36.0-255,66,68191,1,250136
43292,0.001016,74.125.24.0-255,5738,73929,1,250136
43293,0.001018,172.31.36.0-255,66,73995,1,250136
43294,0.001022,74.125.24.0-255,2902,76897,1,250136
43295,0.001032,172.31.36.0-255,66,76963,1,250136
43296,0.001074,172.31.36.0-255,66,77029,1,250136
43297,0.001081,74.125.24.0-255,5020,82049,1,250136
43298,0.001083,172.31.36.0-255,66,82115,1,250136
43299,0.001159,74.125.24.0-255,1484,83599,1,250136
43300,0.001164,74.125.24.0-255,2902,86501,1,250136
43301,0.001168,172.31.36.0-255,66,86567,1,250136
43302,0.001199,74.125.24.0-255,5738,92305,1,250136
43303,0.001202,172.31.36.0-255,66,92371,1,250136
43304,0.001214,172.31.36.0-255,66,92437,1,250136
43305,0.001238,74.125.24.0-255,2902,95339,1,250136
43306,0.001241,172.31.36.0-255,66,95405,1,250136
43307,0.001246,74.125.24.0-255,4320,99725,1,250136
43308,0.001248,172.31.36.0-255,66,99791,1,250136
43309,0.001272,74.125.24.0-255,6438,106229,1,250136
43310,0.001276,172.31.36.0-255,66,106295,1,250136
43311,0.001327,74.125.24.0-255,1484,107779,1,250136
43312,0.001332,74.125.24.0-255,2902,110681,1,250136
43313,0.001335,172.31.36.0-255,66,110747,1,250136
43314,0.001361,74.125.24.0-255,5738,116485,1,250136
43315,0.001364,172.31.36.0-255,66,116551,1,250136
43316,0.001367,74.125.24.0-255,1484,118035,1,250136
43317,0.001392,74.125.24.0-255,4320,122355,1,250136
43318,0.001395,172.31.36.0-255,66,122421,1,250136
43319,0.00142,74.125.24.0-255,7156,129577,1,250136
43320,0.001424,172.31.36.0-255,66,129643,1,250136
43321,0.001449,74.125.24.0-255,1484,131127,1,250136
43322,0.001462,172.31.36.0-255,66,131193,1,250136
43323,0.001582,74.125.24.0-255,1484,132677,1,250136
43324,0.001588,74.125.24.0-255,2902,135579,1,250136
43325,0.001591,172.31.36.0-255,66,135645,1,250136
43326,0.001595,74.125.24.0-255,1484,137129,1,250136
43327,0.001623,74.125.24.0-255,4320,141449,1,250136
43328,0.001626,172.31.36.0-255,66,141515,1,250136
43329,0.001629,74.125.24.0-255,1484,142999,1,250136
43330,0.001632,74.125.24.0-255,1484,144483,1,250136
43331,0.001634,172.31.36.0-255,66,144549,1,250136
43332,0.001674,74.125.24.0-255,7156,151705,1,250136
43333,0.001678,172.31.36.0-255,66,151771,1,250136
43334,0.001697,172.31.36.0-255,66,151837,1,250136
43335,0.001714,74.125.24.0-255,2184,154021,1,250136
43336,0.001717,172.31.36.0-255,66,154087,1,250136
43337,0.00179,74.125.24.0-255,1484,155571,1,250136
43338,0.001815,74.125.24.0-255,1484,157055,1,250136
43339,0.001818,172.31.36.0-255,66,157121,1,250136
43340,0.001843,74.125.24.0-255,1484,158605,1,250136
43341,0.001849,74.125.24.0-255,5738,164343,1,250136
43342,0.001852,172.31.36.0-255,66,164409,1,250136
43343,0.001857,74.125.24.0-255,4320,168729,1,250136
43344,0.00186,172.31.36.0-255,66,168795,1,250136
43345,0.001875,172.31.36.0-255,66,168861,1,250136
43346,0.001887,172.31.36.0-255,66,168927,1,250136
43347,0.001965,172.31.36.0-255,66,168993,1,250136
43348,0.001971,74.125.24.0-255,5738,174731,1,250136
43349,0.001974,172.31.36.0-255,66,174797,1,250136
43350,0.001981,74.125.24.0-255,7156,181953,1,250136
43351,0.00199,172.31.36.0-255,66,182019,1,250136
43352,0.002003,172.31.36.0-255,66,182085,1,250136
43353,0.00201,74.125.24.0-255,7156,189241,1,250136
43354,0.002013,172.31.36.0-255,66,189307,1,250136
43355,0.002042,74.125.24.0-255,5738,195045,1,250136
43356,0.002046,172.31.36.0-255,66,195111,1,250136
43357,0.00207,172.31.36.0-255,66,195177,1,250136
43358,0.004069,74.125.24.0-255,5738,200915,1,250136
43359,0.004077,172.31.36.0-255,66,200981,1,250136
43360,0.006084,74.125.24.0-255,5738,206719,1,250136
43361,0.00609,172.31.36.0-255,66,206785,1,250136
43362,0.008113,74.125.24.0-255,5738,212523,1,250136
43363,0.008121,172.31.36.0-255,66,212589,1,250136
43364,0.010134,74.125.24.0-255,5738,218327,1,250136
43365,0.01014,172.31.36.0-255,66,218393,1,250136
43366,0.012153,74.125.24.0-255,5738,224131,1,250136
43367,0.01216,172.31.36.0-255,66,224197,1,250136
43368,0.014157,74.125.24.0-255,5738,229935,1,250136
43369,0.014165,172.31.36.0-255,66,230001,1,250136
43370,0.016159,74.125.24.0-255,5738,235739,1,250136
43371,0.016166,172.31.36.0-255,66,235805,1,250136
43372,0.018186,74.125.24.0-255,5060,240865,1,250136
43373,0.018195,172.31.36.0-255,66,240931,1,250136
43374,0.019588,172.31.36.0-255,105,241036,1,250136
43375,0.021554,74.125.24.0-255,66,241102,1,250136
43376,0.036533,172.31.36.0-255,176,241278,1,250136
43377,0.036565,172.31.36.0-255,1114,242392,1,250136
43378,0.036619,172.31.36.0-255,1514,243906,1,250136
43379,0.036621,172.31.36.0-255,1514,245420,1,250136
43380,0.036622,172.31.36.0-255,1514,246934,1,250136
43381,0.036627,172.31.36.0-255,1514,248448,1,250136
43382,0.036629,172.31.36.0-255,1490,249938,1,250136
43383,0.038099,104.244.42.0-255,66,250004,1,250136
43384,0.038109,104.244.42.0-255,66,250070,1,250136
43385,0.038255,104.244.42.0-255,66,250136,1,250136
43386,0.0,74.125.24.0-255,152,152,1,150968
43387,1.6e-05,172.31.36.0-255,66,218,1,150968
43388,2.2e-05,74.125.24.0-255,1484,1702,1,150968
43389,2.6e-05,172.31.36.0-255,66,1768,1,150968
43390,3e-05,74.125.24.0-255,2902,4670,1,150968
43391,4.1e-05,172.31.36.0-255,66,4736,1,150968
43392,4.8e-05,74.125.24.0-255,5738,10474,1,150968
43393,5e-05,172.31.36.0-255,66,10540,1,150968
43394,8.5e-05,74.125.24.0-255,3510,14050,1,150968
43395,8.7e-05,172.31.36.0-255,66,14116,1,150968
43396,0.000291,74.125.24.0-255,1484,15600,1,150968
43397,0.000297,172.31.36.0-255,66,15666,1,150968
43398,0.000303,74.125.24.0-255,2902,18568,1,150968
43399,0.000305,172.31.36.0-255,66,18634,1,150968
43400,0.000317,74.125.24.0-255,5738,24372,1,150968
43401,0.00032,172.31.36.0-255,66,24438,1,150968
43402,0.000343,74.125.24.0-255,4320,28758,1,150968
43403,0.000344,172.31.36.0-255,66,28824,1,150968
43404,0.000378,172.31.36.0-255,66,28890,1,150968
43405,0.000387,172.31.36.0-255,66,28956,1,150968
43406,0.000437,172.31.36.0-255,66,29022,1,150968
43407,0.002254,74.125.24.0-255,362,29384,1,150968
43408,0.002261,172.31.36.0-255,66,29450,1,150968
43409,0.002267,74.125.24.0-255,381,29831,1,150968
43410,0.002268,172.31.36.0-255,66,29897,1,150968
43411,0.003461,74.125.24.0-255,1484,31381,1,150968
43412,0.003465,172.31.36.0-255,66,31447,1,150968
43413,0.003472,74.125.24.0-255,2902,34349,1,150968
43414,0.003474,172.31.36.0-255,66,34415,1,150968
43415,0.003486,74.125.24.0-255,5738,40153,1,150968
43416,0.003488,172.31.36.0-255,66,40219,1,150968
43417,0.003506,74.125.24.0-255,5738,45957,1,150968
43418,0.003509,172.31.36.0-255,66,46023,1,150968
43419,0.00354,74.125.24.0-255,7156,53179,1,150968
43420,0.003542,172.31.36.0-255,66,53245,1,150968
43421,0.003553,172.31.36.0-255,66,53311,1,150968
43422,0.004039,74.125.24.0-255,1484,54795,1,150968
43423,0.004046,74.125.24.0-255,1484,56279,1,150968
43424,0.004049,172.31.36.0-255,66,56345,1,150968
43425,0.004079,74.125.24.0-255,1484,57829,1,150968
43426,0.004086,74.125.24.0-255,5738,63567,1,150968
43427,0.004088,172.31.36.0-255,66,63633,1,150968
43428,0.004107,74.125.24.0-255,5738,69371,1,150968
43429,0.004111,172.31.36.0-255,66,69437,1,150968
43430,0.004143,74.125.24.0-255,4320,73757,1,150968
43431,0.004145,172.31.36.0-255,66,73823,1,150968
43432,0.004157,172.31.36.0-255,66,73889,1,150968
43433,0.004166,74.125.24.0-255,3602,77491,1,150968
43434,0.004168,172.31.36.0-255,66,77557,1,150968
43435,0.004173,74.125.24.0-255,4320,81877,1,150968
43436,0.004174,172.31.36.0-255,66,81943,1,150968
43437,0.004186,172.31.36.0-255,66,82009,1,150968
43438,0.004239,172.31.36.0-255,66,82075,1,150968
43439,0.004289,74.125.24.0-255,1484,83559,1,150968
43440,0.004302,74.125.24.0-255,2902,86461,1,150968
43441,0.004305,172.31.36.0-255,66,86527,1,150968
43442,0.004311,74.125.24.0-255,4320,90847,1,150968
43443,0.004313,172.31.36.0-255,66,90913,1,150968
43444,0.004342,74.125.24.0-255,1484,92397,1,150968
43445,0.004356,172.31.36.0-255,66,92463,1,150968
43446,0.004361,74.125.24.0-255,2902,95365,1,150968
43447,0.004363,172.31.36.0-255,66,95431,1,150968
43448,0.004398,74.125.24.0-255,1484,96915,1,150968
43449,0.004401,172.31.36.0-255,66,96981,1,150968
43450,0.004413,74.125.24.0-255,2902,99883,1,150968
43451,0.004416,172.31.36.0-255,66,99949,1,150968
43452,0.004425,74.125.24.0-255,5738,105687,1,150968
43453,0.004428,172.31.36.0-255,66,105753,1,150968
43454,0.004464,172.31.36.0-255,66,105819,1,150968
43455,0.004474,172.31.36.0-255,66,105885,1,150968
43456,0.004478,74.125.24.0-255,2902,108787,1,150968
43457,0.004479,172.31.36.0-255,66,108853,1,150968
43458,0.004507,74.125.24.0-255,2184,111037,1,150968
43459,0.00452,74.125.24.0-255,1484,112521,1,150968
43460,0.004536,172.31.36.0-255,66,112587,1,150968
43461,0.00454,172.31.36.0-255,66,112653,1,150968
43462,0.004562,172.31.36.0-255,66,112719,1,150968
43463,0.004593,74.125.24.0-255,7156,119875,1,150968
43464,0.004596,172.31.36.0-255,66,119941,1,150968
43465,0.004599,74.125.24.0-255,766,120707,1,150968
43466,0.004605,74.125.24.0-255,5738,126445,1,150968
43467,0.004607,172.31.36.0-255,66,126511,1,150968
43468,0.004649,172.31.36.0-255,66,126577,1,150968
43469,0.004689,172.31.36.0-255,66,126643,1,150968
43470,0.004694,74.125.24.0-255,5020,131663,1,150968
43471,0.004696,172.31.36.0-255,66,131729,1,150968
43472,0.004715,172.31.36.0-255,66,131795,1,150968
43473,0.004753,172.31.36.0-255,66,131861,1,150968
43474,0.004776,172.31.36.0-255,66,131927,1,150968
43475,0.004804,172.31.36.0-255,66,131993,1,150968
43476,0.004808,74.125.24.0-255,2184,134177,1,150968
43477,0.004809,172.31.36.0-255,66,134243,1,150968
43478,0.004816,74.125.24.0-255,7156,141399,1,150968
43479,0.004819,172.31.36.0-255,66,141465,1,150968
43480,0.004865,172.31.36.0-255,66,141531,1,150968
43481,0.004877,172.31.36.0-255,66,141597,1,150968
43482,0.004879,74.125.24.0-255,105,141702,1,150968
43483,0.00756,172.31.36.0-255,66,141768,1,150968
43484,0.00761,172.31.36.0-255,105,141873,1,150968
43485,0.009797,74.125.24.0-255,66,141939,1,150968
43486,0.03247,172.31.36.0-255,172,142111,1,150968
43487,0.0325,172.31.36.0-255,1115,143226,1,150968
43488,0.032566,172.31.36.0-255,1514,144740,1,150968
43489,0.032568,172.31.36.0-255,1514,146254,1,150968
43490,0.032573,172.31.36.0-255,1514,147768,1,150968
43491,0.032574,172.31.36.0-255,1514,149282,1,150968
43492,0.032592,172.31.36.0-255,1488,150770,1,150968
43493,0.034047,104.244.42.0-255,66,150836,1,150968
43494,0.034055,104.244.42.0-255,66,150902,1,150968
43495,0.034172,104.244.42.0-255,66,150968,1,150968
43496,0.0,74.125.24.0-255,66,66,1,66
43497,0.0,172.217.194.0-255,153,153,1,258532
43498,3.8e-05,172.31.36.0-255,66,219,1,258532
43499,4.6e-05,172.217.194.0-255,1484,1703,1,258532
43500,5.1e-05,172.31.36.0-255,66,1769,1,258532
43501,6.3e-05,172.217.194.0-255,2902,4671,1,258532
43502,6.5e-05,172.31.36.0-255,66,4737,1,258532
43503,7.4e-05,172.217.194.0-255,7156,11893,1,258532
43504,7.7e-05,172.31.36.0-255,66,11959,1,258532
43505,8.1e-05,172.217.194.0-255,2039,13998,1,258532
43506,8.3e-05,172.31.36.0-255,66,14064,1,258532
43507,0.000508,172.217.194.0-255,1484,15548,1,258532
43508,0.000514,172.31.36.0-255,66,15614,1,258532
43509,0.000524,172.217.194.0-255,2902,18516,1,258532
43510,0.000527,172.31.36.0-255,66,18582,1,258532
43511,0.000541,172.217.194.0-255,5738,24320,1,258532
43512,0.000544,172.31.36.0-255,66,24386,1,258532
43513,0.00055,172.217.194.0-255,4320,28706,1,258532
43514,0.000552,172.31.36.0-255,66,28772,1,258532
43515,0.000579,172.217.194.0-255,2543,31315,1,258532
43516,0.000584,172.31.36.0-255,66,31381,1,258532
43517,0.000592,172.217.194.0-255,7156,38537,1,258532
43518,0.000595,172.31.36.0-255,66,38603,1,258532
43519,0.000601,172.217.194.0-255,5738,44341,1,258532
43520,0.000604,172.31.36.0-255,66,44407,1,258532
43521,0.000639,172.217.194.0-255,3961,48368,1,258532
43522,0.000643,172.31.36.0-255,66,48434,1,258532
43523,0.00065,172.217.194.0-255,7156,55590,1,258532
43524,0.000652,172.31.36.0-255,66,55656,1,258532
43525,0.000717,172.31.36.0-255,66,55722,1,258532
43526,0.00072,172.217.194.0-255,1380,57102,1,258532
43527,0.000722,172.31.36.0-255,66,57168,1,258532
43528,0.000725,172.217.194.0-255,117,57285,1,258532
43529,0.000878,172.217.194.0-255,1484,58769,1,258532
43530,0.000883,172.217.194.0-255,2902,61671,1,258532
43531,0.000894,172.31.36.0-255,66,61737,1,258532
43532,0.000899,172.31.36.0-255,66,61803,1,258532
43533,0.000905,172.217.194.0-255,5738,67541,1,258532
43534,0.000907,172.31.36.0-255,66,67607,1,258532
43535,0.000957,172.31.36.0-255,66,67673,1,258532
43536,0.000969,172.31.36.0-255,66,67739,1,258532
43537,0.001753,172.217.194.0-255,1484,69223,1,258532
43538,0.001762,172.217.194.0-255,2902,72125,1,258532
43539,0.001765,172.31.36.0-255,66,72191,1,258532
43540,0.00177,172.217.194.0-255,1484,73675,1,258532
43541,0.001799,172.217.194.0-255,4320,77995,1,258532
43542,0.001801,172.31.36.0-255,66,78061,1,258532
43543,0.001834,172.31.36.0-255,66,78127,1,258532
43544,0.00186,172.217.194.0-255,2902,81029,1,258532
43545,0.001863,172.31.36.0-255,66,81095,1,258532
43546,0.001877,172.31.36.0-255,66,81161,1,258532
43547,0.002056,172.217.194.0-255,1484,82645,1,258532
43548,0.002061,172.217.194.0-255,1484,84129,1,258532
43549,0.002064,172.31.36.0-255,66,84195,1,258532
43550,0.00209,172.217.194.0-255,1484,85679,1,258532
43551,0.002096,172.217.194.0-255,5738,91417,1,258532
43552,0.002098,172.31.36.0-255,66,91483,1,258532
43553,0.002123,172.217.194.0-255,2902,94385,1,258532
43554,0.002126,172.31.36.0-255,66,94451,1,258532
43555,0.002153,172.217.194.0-255,7156,101607,1,258532
43556,0.002155,172.31.36.0-255,66,101673,1,258532
43557,0.00218,172.217.194.0-255,2902,104575,1,258532
43558,0.002182,172.31.36.0-255,66,104641,1,258532
43559,0.002186,172.217.194.0-255,2902,107543,1,258532
43560,0.002188,172.31.36.0-255,66,107609,1,258532
43561,0.002225,172.31.36.0-255,66,107675,1,258532
43562,0.002253,172.31.36.0-255,66,107741,1,258532
43563,0.002288,172.31.36.0-255,66,107807,1,258532
43564,0.002365,172.217.194.0-255,2902,110709,1,258532
43565,0.002368,172.31.36.0-255,66,110775,1,258532
43566,0.002401,172.31.36.0-255,66,110841,1,258532
43567,0.002428,172.217.194.0-255,1484,112325,1,258532
43568,0.002446,172.217.194.0-255,2902,115227,1,258532
43569,0.002448,172.31.36.0-255,66,115293,1,258532
43570,0.002466,172.217.194.0-255,5738,121031,1,258532
43571,0.002468,172.31.36.0-255,66,121097,1,258532
43572,0.002493,172.217.194.0-255,2902,123999,1,258532
43573,0.002496,172.31.36.0-255,66,124065,1,258532
43574,0.00252,172.217.194.0-255,5738,129803,1,258532
43575,0.002522,172.31.36.0-255,66,129869,1,258532
43576,0.002565,172.31.36.0-255,66,129935,1,258532
43577,0.0026,172.31.36.0-255,66,130001,1,258532
43578,0.002655,172.217.194.0-255,7156,137157,1,258532
43579,0.002658,172.31.36.0-255,66,137223,1,258532
43580,0.002661,172.217.194.0-255,1484,138707,1,258532
43581,0.0027,172.217.194.0-255,4320,143027,1,258532
43582,0.002704,172.31.36.0-255,66,143093,1,258532
43583,0.004977,172.217.194.0-255,5738,148831,1,258532
43584,0.004985,172.31.36.0-255,66,148897,1,258532
43585,0.007364,172.217.194.0-255,5738,154635,1,258532
43586,0.007373,172.31.36.0-255,66,154701,1,258532
43587,0.009616,172.217.194.0-255,5738,160439,1,258532
43588,0.009623,172.31.36.0-255,66,160505,1,258532
43589,0.011915,172.217.194.0-255,5738,166243,1,258532
43590,0.011921,172.31.36.0-255,66,166309,1,258532
43591,0.014193,172.217.194.0-255,5738,172047,1,258532
43592,0.014198,172.31.36.0-255,66,172113,1,258532
43593,0.016472,172.217.194.0-255,5738,177851,1,258532
43594,0.016483,172.31.36.0-255,66,177917,1,258532
43595,0.018756,172.217.194.0-255,5738,183655,1,258532
43596,0.018763,172.31.36.0-255,66,183721,1,258532
43597,0.021009,172.217.194.0-255,5738,189459,1,258532
43598,0.021016,172.31.36.0-255,66,189525,1,258532
43599,0.023285,172.217.194.0-255,5738,195263,1,258532
43600,0.023292,172.31.36.0-255,66,195329,1,258532
43601,0.025539,172.217.194.0-255,5738,201067,1,258532
43602,0.025547,172.31.36.0-255,66,201133,1,258532
43603,0.026691,172.31.36.0-255,187,201320,1,258532
43604,0.026732,172.31.36.0-255,982,202302,1,258532
43605,0.0268,172.31.36.0-255,696,202998,1,258532
43606,0.027806,172.217.194.0-255,5738,208736,1,258532
43607,0.027813,172.31.36.0-255,66,208802,1,258532
43608,0.028249,104.244.42.0-255,66,208868,1,258532
43609,0.028279,104.244.42.0-255,66,208934,1,258532
43610,0.028333,104.244.42.0-255,66,209000,1,258532
43611,0.030058,172.217.194.0-255,4320,213320,1,258532
43612,0.030063,172.31.36.0-255,66,213386,1,258532
43613,0.030095,172.217.194.0-255,1484,214870,1,258532
43614,0.032298,172.217.194.0-255,4320,219190,1,258532
43615,0.032303,172.31.36.0-255,66,219256,1,258532
43616,0.034547,172.217.194.0-255,5738,224994,1,258532
43617,0.034552,172.31.36.0-255,66,225060,1,258532
43618,0.036811,172.217.194.0-255,5738,230798,1,258532
43619,0.036816,172.31.36.0-255,66,230864,1,258532
43620,0.039084,172.217.194.0-255,5738,236602,1,258532
43621,0.039089,172.31.36.0-255,66,236668,1,258532
43622,0.041325,172.217.194.0-255,4320,240988,1,258532
43623,0.04133,172.31.36.0-255,66,241054,1,258532
43624,0.041363,172.217.194.0-255,1484,242538,1,258532
43625,0.04358,172.217.194.0-255,4320,246858,1,258532
43626,0.043585,172.31.36.0-255,66,246924,1,258532
43627,0.045837,172.217.194.0-255,5738,252662,1,258532
43628,0.045843,172.31.36.0-255,66,252728,1,258532
43629,0.048103,172.217.194.0-255,5738,258466,1,258532
43630,0.048109,172.31.36.0-255,66,258532,1,258532
43631,0.0,74.125.24.0-255,143,143,1,194991
43632,2.2e-05,172.31.36.0-255,66,209,1,194991
43633,2.9e-05,74.125.24.0-255,1484,1693,1,194991
43634,3.3e-05,172.31.36.0-255,66,1759,1,194991
43635,3.9e-05,74.125.24.0-255,2902,4661,1,194991
43636,4.2e-05,172.31.36.0-255,66,4727,1,194991
43637,5.2e-05,74.125.24.0-255,7156,11883,1,194991
43638,5.6e-05,172.31.36.0-255,66,11949,1,194991
43639,8.3e-05,74.125.24.0-255,2040,13989,1,194991
43640,8.6e-05,172.31.36.0-255,66,14055,1,194991
43641,0.000361,74.125.24.0-255,1484,15539,1,194991
43642,0.000366,172.31.36.0-255,66,15605,1,194991
43643,0.000373,74.125.24.0-255,2902,18507,1,194991
43644,0.000376,172.31.36.0-255,66,18573,1,194991
43645,0.000382,74.125.24.0-255,5738,24311,1,194991
43646,0.000384,172.31.36.0-255,66,24377,1,194991
43647,0.000387,74.125.24.0-255,1484,25861,1,194991
43648,0.000389,172.31.36.0-255,66,25927,1,194991
43649,0.000416,74.125.24.0-255,5379,31306,1,194991
43650,0.00042,172.31.36.0-255,66,31372,1,194991
43651,0.000428,74.125.24.0-255,7156,38528,1,194991
43652,0.00043,172.31.36.0-255,66,38594,1,194991
43653,0.000433,74.125.24.0-255,1484,40078,1,194991
43654,0.000435,172.31.36.0-255,66,40144,1,194991
43655,0.000471,172.31.36.0-255,66,40210,1,194991
43656,0.000499,74.125.24.0-255,1484,41694,1,194991
43657,0.000502,172.31.36.0-255,66,41760,1,194991
43658,0.000507,74.125.24.0-255,2902,44662,1,194991
43659,0.000509,172.31.36.0-255,66,44728,1,194991
43660,0.000514,74.125.24.0-255,4320,49048,1,194991
43661,0.000517,172.31.36.0-255,66,49114,1,194991
43662,0.000532,74.125.24.0-255,1484,50598,1,194991
43663,0.000549,74.125.24.0-255,6797,57395,1,194991
43664,0.000553,172.31.36.0-255,66,57461,1,194991
43665,0.000966,74.125.24.0-255,412,57873,1,194991
43666,0.00103,74.125.24.0-255,333,58206,1,194991
43667,0.001069,172.31.36.0-255,66,58272,1,194991
43668,0.002751,74.125.24.0-255,2902,61174,1,194991
43669,0.00276,172.31.36.0-255,66,61240,1,194991
43670,0.003301,74.125.24.0-255,2902,64142,1,194991
43671,0.003304,172.31.36.0-255,66,64208,1,194991
43672,0.004957,74.125.24.0-255,2902,67110,1,194991
43673,0.004959,172.31.36.0-255,66,67176,1,194991
43674,0.005516,74.125.24.0-255,2902,70078,1,194991
43675,0.005519,172.31.36.0-255,66,70144,1,194991
43676,0.00716,74.125.24.0-255,2902,73046,1,194991
43677,0.007169,172.31.36.0-255,66,73112,1,194991
43678,0.007733,74.125.24.0-255,2902,76014,1,194991
43679,0.00774,172.31.36.0-255,66,76080,1,194991
43680,0.009401,74.125.24.0-255,2902,78982,1,194991
43681,0.009408,172.31.36.0-255,66,79048,1,194991
43682,0.009953,74.125.24.0-255,2902,81950,1,194991
43683,0.009961,172.31.36.0-255,66,82016,1,194991
43684,0.011633,74.125.24.0-255,2902,84918,1,194991
43685,0.011642,172.31.36.0-255,66,84984,1,194991
43686,0.012184,74.125.24.0-255,2902,87886,1,194991
43687,0.012191,172.31.36.0-255,66,87952,1,194991
43688,0.013866,74.125.24.0-255,2902,90854,1,194991
43689,0.013874,172.31.36.0-255,66,90920,1,194991
43690,0.014425,74.125.24.0-255,2902,93822,1,194991
43691,0.014432,172.31.36.0-255,66,93888,1,194991
43692,0.016108,74.125.24.0-255,2902,96790,1,194991
43693,0.016116,172.31.36.0-255,66,96856,1,194991
43694,0.016621,74.125.24.0-255,2902,99758,1,194991
43695,0.016626,172.31.36.0-255,66,99824,1,194991
43696,0.018302,74.125.24.0-255,2902,102726,1,194991
43697,0.018309,172.31.36.0-255,66,102792,1,194991
43698,0.018854,74.125.24.0-255,2902,105694,1,194991
43699,0.018861,172.31.36.0-255,66,105760,1,194991
43700,0.020503,74.125.24.0-255,2902,108662,1,194991
43701,0.02051,172.31.36.0-255,66,108728,1,194991
43702,0.021156,74.125.24.0-255,2902,111630,1,194991
43703,0.021162,172.31.36.0-255,66,111696,1,194991
43704,0.022752,74.125.24.0-255,2902,114598,1,194991
43705,0.022759,172.31.36.0-255,66,114664,1,194991
43706,0.023424,74.125.24.0-255,2902,117566,1,194991
43707,0.02343,172.31.36.0-255,66,117632,1,194991
43708,0.025027,74.125.24.0-255,2902,120534,1,194991
43709,0.025034,172.31.36.0-255,66,120600,1,194991
43710,0.025625,74.125.24.0-255,2902,123502,1,194991
43711,0.025631,172.31.36.0-255,66,123568,1,194991
43712,0.027251,74.125.24.0-255,2902,126470,1,194991
43713,0.027258,172.31.36.0-255,66,126536,1,194991
43714,0.02787,74.125.24.0-255,2902,129438,1,194991
43715,0.027877,172.31.36.0-255,66,129504,1,194991
43716,0.029521,74.125.24.0-255,2902,132406,1,194991
43717,0.029528,172.31.36.0-255,66,132472,1,194991
43718,0.030124,74.125.24.0-255,2902,135374,1,194991
43719,0.030131,172.31.36.0-255,66,135440,1,194991
43720,0.031707,74.125.24.0-255,2902,138342,1,194991
43721,0.031713,172.31.36.0-255,66,138408,1,194991
43722,0.032323,74.125.24.0-255,2902,141310,1,194991
43723,0.03233,172.31.36.0-255,66,141376,1,194991
43724,0.033844,172.31.36.0-255,172,141548,1,194991
43725,0.033881,172.31.36.0-255,1113,142661,1,194991
43726,0.033956,172.31.36.0-255,1514,144175,1,194991
43727,0.033957,172.31.36.0-255,1514,145689,1,194991
43728,0.033959,172.31.36.0-255,1514,147203,1,194991
43729,0.03396,172.31.36.0-255,1514,148717,1,194991
43730,0.033967,74.125.24.0-255,2902,151619,1,194991
43731,0.033971,172.31.36.0-255,66,151685,1,194991
43732,0.033998,172.31.36.0-255,1490,153175,1,194991
43733,0.034571,74.125.24.0-255,2902,156077,1,194991
43734,0.034577,172.31.36.0-255,66,156143,1,194991
43735,0.035421,104.244.42.0-255,66,156209,1,194991
43736,0.035429,104.244.42.0-255,66,156275,1,194991
43737,0.035555,104.244.42.0-255,66,156341,1,194991
43738,0.035602,104.244.42.0-255,66,156407,1,194991
43739,0.036196,74.125.24.0-255,2902,159309,1,194991
43740,0.036203,172.31.36.0-255,66,159375,1,194991
43741,0.036802,74.125.24.0-255,2902,162277,1,194991
43742,0.036808,172.31.36.0-255,66,162343,1,194991
43743,0.038446,74.125.24.0-255,2902,165245,1,194991
43744,0.038454,172.31.36.0-255,66,165311,1,194991
43745,0.038991,74.125.24.0-255,2902,168213,1,194991
43746,0.039,172.31.36.0-255,66,168279,1,194991
43747,0.040724,74.125.24.0-255,2902,171181,1,194991
43748,0.040731,172.31.36.0-255,66,171247,1,194991
43749,0.0412,74.125.24.0-255,2902,174149,1,194991
43750,0.041207,172.31.36.0-255,66,174215,1,194991
43751,0.042958,74.125.24.0-255,2902,177117,1,194991
43752,0.042965,172.31.36.0-255,66,177183,1,194991
43753,0.043434,74.125.24.0-255,2902,180085,1,194991
43754,0.043441,172.31.36.0-255,66,180151,1,194991
43755,0.045214,74.125.24.0-255,2902,183053,1,194991
43756,0.04522,172.31.36.0-255,66,183119,1,194991
43757,0.045685,74.125.24.0-255,2902,186021,1,194991
43758,0.045691,172.31.36.0-255,66,186087,1,194991
43759,0.047454,74.125.24.0-255,2902,188989,1,194991
43760,0.047461,172.31.36.0-255,66,189055,1,194991
43761,0.047921,74.125.24.0-255,2902,191957,1,194991
43762,0.047927,172.31.36.0-255,66,192023,1,194991
43763,0.049679,74.125.24.0-255,2902,194925,1,194991
43764,0.049686,172.31.36.0-255,66,194991,1,194991
43765,0.0,172.217.160.0-255,153,153,1,329424
43766,3.3e-05,172.31.36.0-255,66,219,1,329424
43767,3.9e-05,172.217.160.0-255,1484,1703,1,329424
43768,4.3e-05,172.31.36.0-255,66,1769,1,329424
43769,4.8e-05,172.217.160.0-255,2902,4671,1,329424
43770,5.2e-05,172.31.36.0-255,66,4737,1,329424
43771,6.1e-05,172.217.160.0-255,7156,11893,1,329424
43772,6.4e-05,172.31.36.0-255,66,11959,1,329424
43773,7.9e-05,172.31.36.0-255,66,12025,1,329424
43774,0.00012,172.217.160.0-255,5379,17404,1,329424
43775,0.000124,172.31.36.0-255,66,17470,1,329424
43776,0.000171,172.217.160.0-255,1484,18954,1,329424
43777,0.000174,172.31.36.0-255,66,19020,1,329424
43778,0.000179,172.217.160.0-255,2902,21922,1,329424
43779,0.000182,172.31.36.0-255,66,21988,1,329424
43780,0.000188,172.217.160.0-255,5738,27726,1,329424
43781,0.00019,172.31.36.0-255,66,27792,1,329424
43782,0.000219,172.217.160.0-255,6797,34589,1,329424
43783,0.000222,172.31.36.0-255,66,34655,1,329424
43784,0.000301,172.217.160.0-255,1484,36139,1,329424
43785,0.000305,172.31.36.0-255,66,36205,1,329424
43786,0.00031,172.217.160.0-255,2902,39107,1,329424
43787,0.000313,172.31.36.0-255,66,39173,1,329424
43788,0.000318,172.217.160.0-255,4320,43493,1,329424
43789,0.000321,172.31.36.0-255,66,43559,1,329424
43790,0.000333,172.217.160.0-255,1484,45043,1,329424
43791,0.000339,172.31.36.0-255,66,45109,1,329424
43792,0.000358,172.217.160.0-255,2902,48011,1,329424
43793,0.000362,172.31.36.0-255,66,48077,1,329424
43794,0.00038,172.217.160.0-255,4234,52311,1,329424
43795,0.000383,172.31.36.0-255,66,52377,1,329424
43796,0.000621,172.217.160.0-255,123,52500,1,329424
43797,0.000713,172.217.160.0-255,1484,53984,1,329424
43798,0.000717,172.31.36.0-255,66,54050,1,329424
43799,0.000722,172.217.160.0-255,2902,56952,1,329424
43800,0.000725,172.31.36.0-255,66,57018,1,329424
43801,0.00073,172.217.160.0-255,2902,59920,1,329424
43802,0.000732,172.31.36.0-255,66,59986,1,329424
43803,0.000746,172.217.160.0-255,2902,62888,1,329424
43804,0.000749,172.31.36.0-255,66,62954,1,329424
43805,0.000767,172.217.160.0-255,5738,68692,1,329424
43806,0.000769,172.31.36.0-255,66,68758,1,329424
43807,0.000789,172.217.160.0-255,2543,71301,1,329424
43808,0.000792,172.31.36.0-255,66,71367,1,329424
43809,0.000802,172.31.36.0-255,66,71433,1,329424
43810,0.00083,172.217.160.0-255,7108,78541,1,329424
43811,0.000833,172.31.36.0-255,66,78607,1,329424
43812,0.001102,172.217.160.0-255,1484,80091,1,329424
43813,0.001107,172.217.160.0-255,2902,82993,1,329424
43814,0.00111,172.31.36.0-255,66,83059,1,329424
43815,0.001115,172.217.160.0-255,2902,85961,1,329424
43816,0.001117,172.31.36.0-255,66,86027,1,329424
43817,0.001133,172.217.160.0-255,2902,88929,1,329424
43818,0.001135,172.31.36.0-255,66,88995,1,329424
43819,0.001142,172.217.160.0-255,7156,96151,1,329424
43820,0.001144,172.31.36.0-255,66,96217,1,329424
43821,0.001172,172.217.160.0-255,5738,101955,1,329424
43822,0.001175,172.31.36.0-255,66,102021,1,329424
43823,0.001188,172.31.36.0-255,66,102087,1,329424
43824,0.001398,172.217.160.0-255,1484,103571,1,329424
43825,0.001402,172.217.160.0-255,1484,105055,1,329424
43826,0.001405,172.31.36.0-255,66,105121,1,329424
43827,0.001424,172.217.160.0-255,1484,106605,1,329424
43828,0.001429,172.217.160.0-255,5738,112343,1,329424
43829,0.001432,172.31.36.0-255,66,112409,1,329424
43830,0.00144,172.217.160.0-255,7156,119565,1,329424
43831,0.001442,172.31.36.0-255,66,119631,1,329424
43832,0.00151,172.31.36.0-255,66,119697,1,329424
43833,0.001514,172.217.160.0-255,2184,121881,1,329424
43834,0.001516,172.31.36.0-255,66,121947,1,329424
43835,0.001521,172.217.160.0-255,2902,124849,1,329424
43836,0.001525,172.31.36.0-255,66,124915,1,329424
43837,0.001527,172.217.160.0-255,7156,132071,1,329424
43838,0.00153,172.31.36.0-255,66,132137,1,329424
43839,0.00153,172.217.160.0-255,2902,135039,1,329424
43840,0.001533,172.31.36.0-255,66,135105,1,329424
43841,0.00157,172.31.36.0-255,66,135171,1,329424
43842,0.00158,172.31.36.0-255,66,135237,1,329424
43843,0.001631,172.217.160.0-255,1484,136721,1,329424
43844,0.001636,172.217.160.0-255,2902,139623,1,329424
43845,0.001639,172.31.36.0-255,66,139689,1,329424
43846,0.001644,172.217.160.0-255,2902,142591,1,329424
43847,0.001647,172.31.36.0-255,66,142657,1,329424
43848,0.001661,172.217.160.0-255,2902,145559,1,329424
43849,0.001664,172.31.36.0-255,66,145625,1,329424
43850,0.00167,172.217.160.0-255,4320,149945,1,329424
43851,0.001672,172.31.36.0-255,66,150011,1,329424
43852,0.00329,172.217.160.0-255,5738,155749,1,329424
43853,0.003296,172.31.36.0-255,66,155815,1,329424
43854,0.004915,172.217.160.0-255,2902,158717,1,329424
43855,0.004919,172.31.36.0-255,66,158783,1,329424
43856,0.004936,172.217.160.0-255,2902,161685,1,329424
43857,0.004937,172.31.36.0-255,66,161751,1,329424
43858,0.006543,172.217.160.0-255,2902,164653,1,329424
43859,0.006548,172.31.36.0-255,66,164719,1,329424
43860,0.006582,172.217.160.0-255,2902,167621,1,329424
43861,0.006586,172.31.36.0-255,66,167687,1,329424
43862,0.00818,172.217.160.0-255,2902,170589,1,329424
43863,0.008186,172.31.36.0-255,66,170655,1,329424
43864,0.008205,172.217.160.0-255,2902,173557,1,329424
43865,0.008209,172.31.36.0-255,66,173623,1,329424
43866,0.009812,172.217.160.0-255,2902,176525,1,329424
43867,0.009819,172.31.36.0-255,66,176591,1,329424
43868,0.00984,172.217.160.0-255,2902,179493,1,329424
43869,0.009844,172.31.36.0-255,66,179559,1,329424
43870,0.01144,172.217.160.0-255,2902,182461,1,329424
43871,0.011448,172.31.36.0-255,66,182527,1,329424
43872,0.011487,172.217.160.0-255,2902,185429,1,329424
43873,0.011491,172.31.36.0-255,66,185495,1,329424
43874,0.01308,172.217.160.0-255,2902,188397,1,329424
43875,0.013086,172.31.36.0-255,66,188463,1,329424
43876,0.013108,172.217.160.0-255,2902,191365,1,329424
43877,0.01311,172.31.36.0-255,66,191431,1,329424
43878,0.01473,172.217.160.0-255,5738,197169,1,329424
43879,0.014737,172.31.36.0-255,66,197235,1,329424
43880,0.016366,172.217.160.0-255,5738,202973,1,329424
43881,0.016373,172.31.36.0-255,66,203039,1,329424
43882,0.018003,172.217.160.0-255,5738,208777,1,329424
43883,0.018011,172.31.36.0-255,66,208843,1,329424
43884,0.019645,172.217.160.0-255,5738,214581,1,329424
43885,0.019653,172.31.36.0-255,66,214647,1,329424
43886,0.021285,172.217.160.0-255,5738,220385,1,329424
43887,0.021292,172.31.36.0-255,66,220451,1,329424
43888,0.022925,172.217.160.0-255,5738,226189,1,329424
43889,0.022932,172.31.36.0-255,66,226255,1,329424
43890,0.024568,172.217.160.0-255,5738,231993,1,329424
43891,0.024575,172.31.36.0-255,66,232059,1,329424
43892,0.026206,172.217.160.0-255,5738,237797,1,329424
43893,0.026213,172.31.36.0-255,66,237863,1,329424
43894,0.027845,172.217.160.0-255,5738,243601,1,329424
43895,0.027853,172.31.36.0-255,66,243667,1,329424
43896,0.029478,172.217.160.0-255,5738,249405,1,329424
43897,0.029485,172.31.36.0-255,66,249471,1,329424
43898,0.031114,172.217.160.0-255,5738,255209,1,329424
43899,0.031121,172.31.36.0-255,66,255275,1,329424
43900,0.032773,172.217.160.0-255,5738,261013,1,329424
43901,0.03278,172.31.36.0-255,66,261079,1,329424
43902,0.034412,172.217.160.0-255,5738,266817,1,329424
43903,0.034419,172.31.36.0-255,66,266883,1,329424
43904,0.035593,172.31.36.0-255,193,267076,1,329424
43905,0.035622,172.31.36.0-255,1115,268191,1,329424
43906,0.03567,172.31.36.0-255,1514,269705,1,329424
43907,0.035671,172.31.36.0-255,1514,271219,1,329424
43908,0.035673,172.31.36.0-255,1514,272733,1,329424
43909,0.035678,172.31.36.0-255,1514,274247,1,329424
43910,0.035679,172.31.36.0-255,1489,275736,1,329424
43911,0.036099,172.217.160.0-255,2902,278638,1,329424
43912,0.036106,172.31.36.0-255,66,278704,1,329424
43913,0.036136,172.217.160.0-255,2902,281606,1,329424
43914,0.03614,172.31.36.0-255,66,281672,1,329424
43915,0.037132,104.244.42.0-255,66,281738,1,329424
43916,0.037189,104.244.42.0-255,66,281804,1,329424
43917,0.037291,104.244.42.0-255,66,281870,1,329424
43918,0.037725,172.217.160.0-255,2902,284772,1,329424
43919,0.037732,172.31.36.0-255,66,284838,1,329424
43920,0.037752,172.217.160.0-255,1484,286322,1,329424
43921,0.037764,172.217.160.0-255,1484,287806,1,329424
43922,0.037767,172.31.36.0-255,66,287872,1,329424
43923,0.039356,172.217.160.0-255,2902,290774,1,329424
43924,0.039362,172.31.36.0-255,66,290840,1,329424
43925,0.039392,172.217.160.0-255,2902,293742,1,329424
43926,0.039394,172.31.36.0-255,66,293808,1,329424
43927,0.040982,172.217.160.0-255,2902,296710,1,329424
43928,0.040987,172.31.36.0-255,66,296776,1,329424
43929,0.041023,172.217.160.0-255,2902,299678,1,329424
43930,0.041026,172.31.36.0-255,66,299744,1,329424
43931,0.042613,172.217.160.0-255,2902,302646,1,329424
43932,0.042618,172.31.36.0-255,66,302712,1,329424
43933,0.042654,172.217.160.0-255,2902,305614,1,329424
43934,0.042657,172.31.36.0-255,66,305680,1,329424
43935,0.044233,172.217.160.0-255,2902,308582,1,329424
43936,0.044239,172.31.36.0-255,66,308648,1,329424
43937,0.044274,172.217.160.0-255,2902,311550,1,329424
43938,0.044277,172.31.36.0-255,66,311616,1,329424
43939,0.045947,172.217.160.0-255,2902,314518,1,329424
43940,0.045952,172.31.36.0-255,66,314584,1,329424
43941,0.045982,172.217.160.0-255,2902,317486,1,329424
43942,0.045985,172.31.36.0-255,66,317552,1,329424
43943,0.047573,172.217.160.0-255,2902,320454,1,329424
43944,0.047578,172.31.36.0-255,66,320520,1,329424
43945,0.04761,172.217.160.0-255,2902,323422,1,329424
43946,0.047613,172.31.36.0-255,66,323488,1,329424
43947,0.049202,172.217.160.0-255,2902,326390,1,329424
43948,0.049207,172.31.36.0-255,66,326456,1,329424
43949,0.049242,172.217.160.0-255,2902,329358,1,329424
43950,0.049245,172.31.36.0-255,66,329424,1,329424
43951,0.0,172.217.26.0-255,150,150,1,209747
43952,2.7e-05,172.31.36.0-255,66,216,1,209747
43953,3.4e-05,172.217.26.0-255,1484,1700,1,209747
43954,3.8e-05,172.31.36.0-255,66,1766,1,209747
43955,4.1e-05,172.217.26.0-255,1484,3250,1,209747
43956,4.3e-05,172.31.36.0-255,66,3316,1,209747
43957,4.8e-05,172.217.26.0-255,2902,6218,1,209747
43958,5e-05,172.31.36.0-255,66,6284,1,209747
43959,7.8e-05,172.217.26.0-255,5738,12022,1,209747
43960,8e-05,172.217.26.0-255,1484,13506,1,209747
43961,8.2e-05,172.31.36.0-255,66,13572,1,209747
43962,8.6e-05,172.31.36.0-255,66,13638,1,209747
43963,9.3e-05,172.217.26.0-255,619,14257,1,209747
43964,9.6e-05,172.31.36.0-255,66,14323,1,209747
43965,0.000101,172.217.26.0-255,2902,17225,1,209747
43966,0.000103,172.31.36.0-255,66,17291,1,209747
43967,0.000107,172.217.26.0-255,1484,18775,1,209747
43968,0.000109,172.31.36.0-255,66,18841,1,209747
43969,0.000133,172.217.26.0-255,5738,24579,1,209747
43970,0.000136,172.31.36.0-255,66,24645,1,209747
43971,0.000143,172.217.26.0-255,6797,31442,1,209747
43972,0.000146,172.31.36.0-255,66,31508,1,209747
43973,0.000312,172.217.26.0-255,1484,32992,1,209747
43974,0.000317,172.31.36.0-255,66,33058,1,209747
43975,0.000341,172.217.26.0-255,2902,35960,1,209747
43976,0.000345,172.31.36.0-255,66,36026,1,209747
43977,0.000351,172.217.26.0-255,5738,41764,1,209747
43978,0.000353,172.31.36.0-255,66,41830,1,209747
43979,0.000358,172.217.26.0-255,2902,44732,1,209747
43980,0.00036,172.31.36.0-255,66,44798,1,209747
43981,0.000381,172.217.26.0-255,3961,48759,1,209747
43982,0.000385,172.31.36.0-255,66,48825,1,209747
43983,0.000391,172.217.26.0-255,4320,53145,1,209747
43984,0.000393,172.31.36.0-255,66,53211,1,209747
43985,0.000419,172.217.26.0-255,2902,56113,1,209747
43986,0.000422,172.31.36.0-255,66,56179,1,209747
43987,0.000434,172.31.36.0-255,66,56245,1,209747
43988,0.000437,172.217.26.0-255,1434,57679,1,209747
43989,0.000808,172.31.36.0-255,66,57745,1,209747
43990,0.001929,172.217.26.0-255,115,57860,1,209747
43991,0.002361,172.217.26.0-255,2902,60762,1,209747
43992,0.002365,172.31.36.0-255,66,60828,1,209747
43993,0.002742,172.217.26.0-255,1484,62312,1,209747
43994,0.004292,172.217.26.0-255,4320,66632,1,209747
43995,0.004296,172.31.36.0-255,66,66698,1,209747
43996,0.006228,172.217.26.0-255,5738,72436,1,209747
43997,0.006235,172.31.36.0-255,66,72502,1,209747
43998,0.008173,172.217.26.0-255,5738,78240,1,209747
43999,0.00818,172.31.36.0-255,66,78306,1,209747
44000,0.010139,172.217.26.0-255,5738,84044,1,209747
44001,0.010146,172.31.36.0-255,66,84110,1,209747
44002,0.012084,172.217.26.0-255,5738,89848,1,209747
44003,0.012093,172.31.36.0-255,66,89914,1,209747
44004,0.014057,172.217.26.0-255,5738,95652,1,209747
44005,0.014064,172.31.36.0-255,66,95718,1,209747
44006,0.016004,172.217.26.0-255,5738,101456,1,209747
44007,0.016011,172.31.36.0-255,66,101522,1,209747
44008,0.017956,172.217.26.0-255,5738,107260,1,209747
44009,0.017965,172.31.36.0-255,66,107326,1,209747
44010,0.019906,172.217.26.0-255,5738,113064,1,209747
44011,0.019915,172.31.36.0-255,66,113130,1,209747
44012,0.021851,172.217.26.0-255,5738,118868,1,209747
44013,0.021858,172.31.36.0-255,66,118934,1,209747
44014,0.023802,172.217.26.0-255,5738,124672,1,209747
44015,0.023809,172.31.36.0-255,66,124738,1,209747
44016,0.025747,172.217.26.0-255,5738,130476,1,209747
44017,0.025754,172.31.36.0-255,66,130542,1,209747
44018,0.027691,172.217.26.0-255,5738,136280,1,209747
44019,0.027698,172.31.36.0-255,66,136346,1,209747
44020,0.029625,172.217.26.0-255,5738,142084,1,209747
44021,0.029631,172.31.36.0-255,66,142150,1,209747
44022,0.031573,172.217.26.0-255,5738,147888,1,209747
44023,0.031579,172.31.36.0-255,66,147954,1,209747
44024,0.032576,172.31.36.0-255,172,148126,1,209747
44025,0.032609,172.31.36.0-255,1113,149239,1,209747
44026,0.032643,172.31.36.0-255,1514,150753,1,209747
44027,0.032644,172.31.36.0-255,1514,152267,1,209747
44028,0.032645,172.31.36.0-255,1514,153781,1,209747
44029,0.032646,172.31.36.0-255,1514,155295,1,209747
44030,0.032674,172.31.36.0-255,1490,156785,1,209747
44031,0.033508,172.217.26.0-255,5738,162523,1,209747
44032,0.033514,172.31.36.0-255,66,162589,1,209747
44033,0.034085,104.244.42.0-255,66,162655,1,209747
44034,0.034178,104.244.42.0-255,66,162721,1,209747
44035,0.034238,104.244.42.0-255,66,162787,1,209747
44036,0.035451,172.217.26.0-255,5738,168525,1,209747
44037,0.035456,172.31.36.0-255,66,168591,1,209747
44038,0.037386,172.217.26.0-255,5738,174329,1,209747
44039,0.037391,172.31.36.0-255,66,174395,1,209747
44040,0.039323,172.217.26.0-255,5738,180133,1,209747
44041,0.03933,172.31.36.0-255,66,180199,1,209747
44042,0.041259,172.217.26.0-255,5738,185937,1,209747
44043,0.041284,172.31.36.0-255,66,186003,1,209747
44044,0.04325,172.217.26.0-255,2902,188905,1,209747
44045,0.043256,172.31.36.0-255,66,188971,1,209747
44046,0.04329,172.217.26.0-255,2902,191873,1,209747
44047,0.043293,172.31.36.0-255,66,191939,1,209747
44048,0.045178,172.217.26.0-255,2902,194841,1,209747
44049,0.045184,172.31.36.0-255,66,194907,1,209747
44050,0.045213,172.217.26.0-255,2902,197809,1,209747
44051,0.045216,172.31.36.0-255,66,197875,1,209747
44052,0.047117,172.217.26.0-255,2902,200777,1,209747
44053,0.047121,172.31.36.0-255,66,200843,1,209747
44054,0.04715,172.217.26.0-255,2902,203745,1,209747
44055,0.047152,172.31.36.0-255,66,203811,1,209747
44056,0.049067,172.217.26.0-255,2902,206713,1,209747
44057,0.049072,172.31.36.0-255,66,206779,1,209747
44058,0.049101,172.217.26.0-255,2902,209681,1,209747
44059,0.049103,172.31.36.0-255,66,209747,1,209747
44060,0.0,172.217.194.0-255,453,453,1,250644
44061,1.5e-05,172.31.36.0-255,66,519,1,250644
44062,2.2e-05,172.217.194.0-255,1484,2003,1,250644
44063,2.6e-05,172.31.36.0-255,66,2069,1,250644
44064,3.3e-05,172.217.194.0-255,4320,6389,1,250644
44065,4.3e-05,172.31.36.0-255,66,6455,1,250644
44066,5.5e-05,172.31.36.0-255,66,6521,1,250644
44067,7.1e-05,172.31.36.0-255,66,6587,1,250644
44068,0.000113,172.217.194.0-255,1484,8071,1,250644
44069,0.000116,172.31.36.0-255,66,8137,1,250644
44070,0.000121,172.217.194.0-255,2902,11039,1,250644
44071,0.000123,172.31.36.0-255,66,11105,1,250644
44072,0.000127,172.217.194.0-255,1484,12589,1,250644
44073,0.000128,172.31.36.0-255,66,12655,1,250644
44074,0.000165,172.217.194.0-255,4320,16975,1,250644
44075,0.000168,172.31.36.0-255,66,17041,1,250644
44076,0.000178,172.31.36.0-255,66,17107,1,250644
44077,0.000205,172.217.194.0-255,5379,22486,1,250644
44078,0.000208,172.31.36.0-255,66,22552,1,250644
44079,0.000243,172.217.194.0-255,5738,28290,1,250644
44080,0.000245,172.31.36.0-255,66,28356,1,250644
44081,0.000272,172.217.194.0-255,4213,32569,1,250644
44082,0.000274,172.31.36.0-255,66,32635,1,250644
44083,0.000281,172.217.194.0-255,434,33069,1,250644
44084,0.000284,172.31.36.0-255,66,33135,1,250644
44085,0.000387,172.217.194.0-255,1484,34619,1,250644
44086,0.00039,172.31.36.0-255,66,34685,1,250644
44087,0.000397,172.217.194.0-255,2902,37587,1,250644
44088,0.0004,172.31.36.0-255,66,37653,1,250644
44089,0.00043,172.217.194.0-255,5738,43391,1,250644
44090,0.000433,172.31.36.0-255,66,43457,1,250644
44091,0.000474,172.31.36.0-255,66,43523,1,250644
44092,0.000514,172.31.36.0-255,66,43589,1,250644
44093,0.001062,172.217.194.0-255,1484,45073,1,250644
44094,0.001069,172.217.194.0-255,2902,47975,1,250644
44095,0.001072,172.31.36.0-255,66,48041,1,250644
44096,0.001108,172.217.194.0-255,5738,53779,1,250644
44097,0.001121,172.217.194.0-255,1484,55263,1,250644
44098,0.001127,172.31.36.0-255,66,55329,1,250644
44099,0.00113,172.31.36.0-255,66,55395,1,250644
44100,0.001171,172.217.194.0-255,4320,59715,1,250644
44101,0.001174,172.31.36.0-255,66,59781,1,250644
44102,0.001202,172.217.194.0-255,5020,64801,1,250644
44103,0.001205,172.31.36.0-255,66,64867,1,250644
44104,0.001222,172.217.194.0-255,1484,66351,1,250644
44105,0.001227,172.217.194.0-255,2902,69253,1,250644
44106,0.001229,172.31.36.0-255,66,69319,1,250644
44107,0.001233,172.217.194.0-255,1484,70803,1,250644
44108,0.001256,172.217.194.0-255,4320,75123,1,250644
44109,0.001258,172.31.36.0-255,66,75189,1,250644
44110,0.001266,172.217.194.0-255,5738,80927,1,250644
44111,0.001269,172.31.36.0-255,66,80993,1,250644
44112,0.001289,172.217.194.0-255,1484,82477,1,250644
44113,0.001307,172.31.36.0-255,66,82543,1,250644
44114,0.001343,172.31.36.0-255,66,82609,1,250644
44115,0.001643,172.217.194.0-255,1484,84093,1,250644
44116,0.001648,172.217.194.0-255,1484,85577,1,250644
44117,0.001651,172.31.36.0-255,66,85643,1,250644
44118,0.001679,172.217.194.0-255,1484,87127,1,250644
44119,0.001686,172.217.194.0-255,5738,92865,1,250644
44120,0.001688,172.31.36.0-255,66,92931,1,250644
44121,0.001694,172.217.194.0-255,4320,97251,1,250644
44122,0.001696,172.31.36.0-255,66,97317,1,250644
44123,0.001736,172.31.36.0-255,66,97383,1,250644
44124,0.001753,172.31.36.0-255,66,97449,1,250644
44125,0.001773,172.217.194.0-255,1484,98933,1,250644
44126,0.001781,172.217.194.0-255,2902,101835,1,250644
44127,0.001784,172.31.36.0-255,66,101901,1,250644
44128,0.00179,172.217.194.0-255,5738,107639,1,250644
44129,0.001793,172.31.36.0-255,66,107705,1,250644
44130,0.001807,172.217.194.0-255,4320,112025,1,250644
44131,0.00181,172.31.36.0-255,66,112091,1,250644
44132,0.001852,172.31.36.0-255,66,112157,1,250644
44133,0.001863,172.31.36.0-255,66,112223,1,250644
44134,0.001906,172.217.194.0-255,2184,114407,1,250644
44135,0.001908,172.31.36.0-255,66,114473,1,250644
44136,0.001913,172.217.194.0-255,2902,117375,1,250644
44137,0.001915,172.31.36.0-255,66,117441,1,250644
44138,0.001919,172.217.194.0-255,2902,120343,1,250644
44139,0.001921,172.31.36.0-255,66,120409,1,250644
44140,0.001953,172.217.194.0-255,4320,124729,1,250644
44141,0.001956,172.31.36.0-255,66,124795,1,250644
44142,0.001973,172.31.36.0-255,66,124861,1,250644
44143,0.002013,172.217.194.0-255,1484,126345,1,250644
44144,0.002046,172.31.36.0-255,66,126411,1,250644
44145,0.002075,172.217.194.0-255,1484,127895,1,250644
44146,0.002098,172.217.194.0-255,2902,130797,1,250644
44147,0.002101,172.31.36.0-255,66,130863,1,250644
44148,0.002109,172.217.194.0-255,5738,136601,1,250644
44149,0.002112,172.31.36.0-255,66,136667,1,250644
44150,0.002153,172.31.36.0-255,66,136733,1,250644
44151,0.002195,172.31.36.0-255,66,136799,1,250644
44152,0.002251,172.217.194.0-255,1484,138283,1,250644
44153,0.002269,172.217.194.0-255,2902,141185,1,250644
44154,0.002272,172.31.36.0-255,66,141251,1,250644
44155,0.002276,172.217.194.0-255,1484,142735,1,250644
44156,0.00231,172.31.36.0-255,66,142801,1,250644
44157,0.004568,172.217.194.0-255,5738,148539,1,250644
44158,0.004575,172.31.36.0-255,66,148605,1,250644
44159,0.006864,172.217.194.0-255,5738,154343,1,250644
44160,0.006872,172.31.36.0-255,66,154409,1,250644
44161,0.009149,172.217.194.0-255,5738,160147,1,250644
44162,0.009156,172.31.36.0-255,66,160213,1,250644
44163,0.011404,172.217.194.0-255,5738,165951,1,250644
44164,0.01141,172.31.36.0-255,66,166017,1,250644
44165,0.013719,172.217.194.0-255,5738,171755,1,250644
44166,0.013727,172.31.36.0-255,66,171821,1,250644
44167,0.016014,172.217.194.0-255,5738,177559,1,250644
44168,0.016022,172.31.36.0-255,66,177625,1,250644
44169,0.018283,172.217.194.0-255,5738,183363,1,250644
44170,0.018291,172.31.36.0-255,66,183429,1,250644
44171,0.020557,172.217.194.0-255,5738,189167,1,250644
44172,0.020566,172.31.36.0-255,66,189233,1,250644
44173,0.022871,172.217.194.0-255,5738,194971,1,250644
44174,0.022879,172.31.36.0-255,66,195037,1,250644
44175,0.025162,172.217.194.0-255,5738,200775,1,250644
44176,0.025169,172.31.36.0-255,66,200841,1,250644
44177,0.027424,172.217.194.0-255,5738,206579,1,250644
44178,0.027431,172.31.36.0-255,66,206645,1,250644
44179,0.029698,172.217.194.0-255,5738,212383,1,250644
44180,0.029705,172.31.36.0-255,66,212449,1,250644
44181,0.031984,172.217.194.0-255,5738,218187,1,250644
44182,0.031993,172.31.36.0-255,66,218253,1,250644
44183,0.034274,172.217.194.0-255,5738,223991,1,250644
44184,0.034281,172.31.36.0-255,66,224057,1,250644
44185,0.036603,172.217.194.0-255,5738,229795,1,250644
44186,0.036611,172.31.36.0-255,66,229861,1,250644
44187,0.038951,172.217.194.0-255,5738,235599,1,250644
44188,0.038963,172.31.36.0-255,66,235665,1,250644
44189,0.039806,172.31.36.0-255,172,235837,1,250644
44190,0.039838,172.31.36.0-255,1113,236950,1,250644
44191,0.039938,172.31.36.0-255,1514,238464,1,250644
44192,0.03994,172.31.36.0-255,1514,239978,1,250644
44193,0.039941,172.31.36.0-255,1514,241492,1,250644
44194,0.039942,172.31.36.0-255,1514,243006,1,250644
44195,0.039972,172.31.36.0-255,1490,244496,1,250644
44196,0.041253,172.217.194.0-255,5713,250209,1,250644
44197,0.04126,172.31.36.0-255,66,250275,1,250644
44198,0.041358,104.244.42.0-255,66,250341,1,250644
44199,0.041386,104.244.42.0-255,66,250407,1,250644
44200,0.041497,172.31.36.0-255,105,250512,1,250644
44201,0.04155,104.244.42.0-255,66,250578,1,250644
44202,0.043754,172.217.194.0-255,66,250644,1,250644
44203,0.0,216.58.203.0-255,152,152,1,266838
44204,1.9e-05,172.31.36.0-255,66,218,1,266838
44205,2.7e-05,216.58.203.0-255,1484,1702,1,266838
44206,3.1e-05,172.31.36.0-255,66,1768,1,266838
44207,3.5e-05,216.58.203.0-255,1484,3252,1,266838
44208,3.8e-05,172.31.36.0-255,66,3318,1,266838
44209,5.2e-05,216.58.203.0-255,2902,6220,1,266838
44210,5.5e-05,172.31.36.0-255,66,6286,1,266838
44211,6.2e-05,216.58.203.0-255,5738,12024,1,266838
44212,6.5e-05,172.31.36.0-255,66,12090,1,266838
44213,7.1e-05,216.58.203.0-255,2040,14130,1,266838
44214,7.4e-05,172.31.36.0-255,66,14196,1,266838
44215,7.9e-05,216.58.203.0-255,2902,17098,1,266838
44216,8.2e-05,172.31.36.0-255,66,17164,1,266838
44217,0.000113,216.58.203.0-255,7156,24320,1,266838
44218,0.000116,172.31.36.0-255,66,24386,1,266838
44219,0.000121,216.58.203.0-255,4320,28706,1,266838
44220,0.000124,172.31.36.0-255,66,28772,1,266838
44221,0.000153,216.58.203.0-255,2543,31315,1,266838
44222,0.000156,172.31.36.0-255,66,31381,1,266838
44223,0.000282,216.58.203.0-255,1484,32865,1,266838
44224,0.000287,172.31.36.0-255,66,32931,1,266838
44225,0.000293,216.58.203.0-255,2902,35833,1,266838
44226,0.000296,172.31.36.0-255,66,35899,1,266838
44227,0.000307,216.58.203.0-255,5738,41637,1,266838
44228,0.00031,172.31.36.0-255,66,41703,1,266838
44229,0.000314,216.58.203.0-255,2902,44605,1,266838
44230,0.000316,172.31.36.0-255,66,44671,1,266838
44231,0.000346,216.58.203.0-255,2902,47573,1,266838
44232,0.000349,172.31.36.0-255,66,47639,1,266838
44233,0.000357,216.58.203.0-255,6797,54436,1,266838
44234,0.000359,172.31.36.0-255,66,54502,1,266838
44235,0.000404,172.31.36.0-255,66,54568,1,266838
44236,0.000752,216.58.203.0-255,388,54956,1,266838
44237,0.000894,216.58.203.0-255,1484,56440,1,266838
44238,0.000899,216.58.203.0-255,2902,59342,1,266838
44239,0.000908,172.31.36.0-255,66,59408,1,266838
44240,0.000913,172.31.36.0-255,66,59474,1,266838
44241,0.00092,216.58.203.0-255,5738,65212,1,266838
44242,0.000922,172.31.36.0-255,66,65278,1,266838
44243,0.000963,216.58.203.0-255,6797,72075,1,266838
44244,0.000967,172.31.36.0-255,66,72141,1,266838
44245,0.001001,216.58.203.0-255,1484,73625,1,266838
44246,0.001017,216.58.203.0-255,2902,76527,1,266838
44247,0.00102,172.31.36.0-255,66,76593,1,266838
44248,0.001026,216.58.203.0-255,4320,80913,1,266838
44249,0.001028,172.31.36.0-255,66,80979,1,266838
44250,0.001047,216.58.203.0-255,1484,82463,1,266838
44251,0.00109,216.58.203.0-255,6797,89260,1,266838
44252,0.001093,172.31.36.0-255,66,89326,1,266838
44253,0.002751,216.58.203.0-255,5738,95064,1,266838
44254,0.002758,172.31.36.0-255,66,95130,1,266838
44255,0.0044,216.58.203.0-255,5738,100868,1,266838
44256,0.004405,172.31.36.0-255,66,100934,1,266838
44257,0.006037,216.58.203.0-255,5738,106672,1,266838
44258,0.006041,172.31.36.0-255,66,106738,1,266838
44259,0.007686,216.58.203.0-255,5738,112476,1,266838
44260,0.007694,172.31.36.0-255,66,112542,1,266838
44261,0.00934,216.58.203.0-255,5738,118280,1,266838
44262,0.009348,172.31.36.0-255,66,118346,1,266838
44263,0.011037,216.58.203.0-255,5738,124084,1,266838
44264,0.011044,172.31.36.0-255,66,124150,1,266838
44265,0.012689,216.58.203.0-255,5738,129888,1,266838
44266,0.012696,172.31.36.0-255,66,129954,1,266838
44267,0.014344,216.58.203.0-255,5738,135692,1,266838
44268,0.014351,172.31.36.0-255,66,135758,1,266838
44269,0.016011,216.58.203.0-255,5738,141496,1,266838
44270,0.016019,172.31.36.0-255,66,141562,1,266838
44271,0.017668,216.58.203.0-255,5738,147300,1,266838
44272,0.017676,172.31.36.0-255,66,147366,1,266838
44273,0.01932,216.58.203.0-255,5738,153104,1,266838
44274,0.019327,172.31.36.0-255,66,153170,1,266838
44275,0.020982,216.58.203.0-255,5738,158908,1,266838
44276,0.020992,172.31.36.0-255,66,158974,1,266838
44277,0.02265,216.58.203.0-255,5738,164712,1,266838
44278,0.022658,172.31.36.0-255,66,164778,1,266838
44279,0.024301,216.58.203.0-255,5738,170516,1,266838
44280,0.024308,172.31.36.0-255,66,170582,1,266838
44281,0.025957,216.58.203.0-255,5738,176320,1,266838
44282,0.025964,172.31.36.0-255,66,176386,1,266838
44283,0.027602,216.58.203.0-255,5738,182124,1,266838
44284,0.02761,172.31.36.0-255,66,182190,1,266838
44285,0.029259,216.58.203.0-255,5738,187928,1,266838
44286,0.029267,172.31.36.0-255,66,187994,1,266838
44287,0.030913,216.58.203.0-255,5738,193732,1,266838
44288,0.03092,172.31.36.0-255,66,193798,1,266838
44289,0.032586,216.58.203.0-255,5738,199536,1,266838
44290,0.032593,172.31.36.0-255,66,199602,1,266838
44291,0.034233,216.58.203.0-255,5738,205340,1,266838
44292,0.03424,172.31.36.0-255,66,205406,1,266838
44293,0.035884,216.58.203.0-255,5738,211144,1,266838
44294,0.03589,172.31.36.0-255,66,211210,1,266838
44295,0.037539,216.58.203.0-255,5738,216948,1,266838
44296,0.037546,172.31.36.0-255,66,217014,1,266838
44297,0.039188,216.58.203.0-255,5738,222752,1,266838
44298,0.039194,172.31.36.0-255,66,222818,1,266838
44299,0.039891,172.31.36.0-255,172,222990,1,266838
44300,0.039918,172.31.36.0-255,1113,224103,1,266838
44301,0.039976,172.31.36.0-255,1514,225617,1,266838
44302,0.039978,172.31.36.0-255,1514,227131,1,266838
44303,0.039982,172.31.36.0-255,1514,228645,1,266838
44304,0.039983,172.31.36.0-255,1514,230159,1,266838
44305,0.04,172.31.36.0-255,1490,231649,1,266838
44306,0.040842,216.58.203.0-255,5738,237387,1,266838
44307,0.040848,172.31.36.0-255,66,237453,1,266838
44308,0.040951,172.31.36.0-255,101,237554,1,266838
44309,0.041443,104.244.42.0-255,66,237620,1,266838
44310,0.04148,104.244.42.0-255,66,237686,1,266838
44311,0.041567,104.244.42.0-255,66,237752,1,266838
44312,0.042515,216.58.203.0-255,5738,243490,1,266838
44313,0.042524,172.31.36.0-255,66,243556,1,266838
44314,0.042554,216.58.203.0-255,66,243622,1,266838
44315,0.044175,216.58.203.0-255,5738,249360,1,266838
44316,0.044182,172.31.36.0-255,66,249426,1,266838
44317,0.045822,216.58.203.0-255,5738,255164,1,266838
44318,0.045829,172.31.36.0-255,66,255230,1,266838
44319,0.047488,216.58.203.0-255,5738,260968,1,266838
44320,0.047494,172.31.36.0-255,66,261034,1,266838
44321,0.049139,216.58.203.0-255,5738,266772,1,266838
44322,0.049146,172.31.36.0-255,66,266838,1,266838
44323,0.0,172.217.194.0-255,290,290,1,130041
44324,2.3e-05,172.31.36.0-255,66,356,1,130041
44325,3e-05,172.217.194.0-255,1484,1840,1,130041
44326,3.5e-05,172.31.36.0-255,66,1906,1,130041
44327,4.2e-05,172.217.194.0-255,4320,6226,1,130041
44328,5.4e-05,172.31.36.0-255,66,6292,1,130041
44329,6.5e-05,172.31.36.0-255,66,6358,1,130041
44330,8.4e-05,172.217.194.0-255,4320,10678,1,130041
44331,8.6e-05,172.31.36.0-255,66,10744,1,130041
44332,0.000131,172.31.36.0-255,66,10810,1,130041
44333,0.000149,172.31.36.0-255,66,10876,1,130041
44334,0.00016,172.31.36.0-255,66,10942,1,130041
44335,0.000189,172.217.194.0-255,5738,16680,1,130041
44336,0.000192,172.31.36.0-255,66,16746,1,130041
44337,0.000216,172.217.194.0-255,1484,18230,1,130041
44338,0.000219,172.31.36.0-255,66,18296,1,130041
44339,0.000235,172.31.36.0-255,66,18362,1,130041
44340,0.000263,172.217.194.0-255,1381,19743,1,130041
44341,0.000265,172.31.36.0-255,66,19809,1,130041
44342,0.000566,172.217.194.0-255,121,19930,1,130041
44343,0.000571,172.31.36.0-255,66,19996,1,130041
44344,0.000644,172.217.194.0-255,1484,21480,1,130041
44345,0.000648,172.31.36.0-255,66,21546,1,130041
44346,0.000674,172.217.194.0-255,2902,24448,1,130041
44347,0.000678,172.31.36.0-255,66,24514,1,130041
44348,0.000685,172.217.194.0-255,5738,30252,1,130041
44349,0.000687,172.31.36.0-255,66,30318,1,130041
44350,0.000698,172.217.194.0-255,5738,36056,1,130041
44351,0.000701,172.31.36.0-255,66,36122,1,130041
44352,0.000734,172.217.194.0-255,1125,37247,1,130041
44353,0.000739,172.217.194.0-255,1484,38731,1,130041
44354,0.000742,172.31.36.0-255,66,38797,1,130041
44355,0.00078,172.31.36.0-255,66,38863,1,130041
44356,0.000801,172.217.194.0-255,5379,44242,1,130041
44357,0.000804,172.31.36.0-255,66,44308,1,130041
44358,0.001323,172.217.194.0-255,1484,45792,1,130041
44359,0.00133,172.217.194.0-255,2902,48694,1,130041
44360,0.001333,172.31.36.0-255,66,48760,1,130041
44361,0.00134,172.217.194.0-255,4320,53080,1,130041
44362,0.001342,172.31.36.0-255,66,53146,1,130041
44363,0.00138,172.217.194.0-255,1484,54630,1,130041
44364,0.001392,172.31.36.0-255,66,54696,1,130041
44365,0.001426,172.31.36.0-255,66,54762,1,130041
44366,0.00145,172.217.194.0-255,766,55528,1,130041
44367,0.001469,172.217.194.0-255,1484,57012,1,130041
44368,0.001471,172.31.36.0-255,66,57078,1,130041
44369,0.001477,172.217.194.0-255,2902,59980,1,130041
44370,0.00148,172.31.36.0-255,66,60046,1,130041
44371,0.001491,172.217.194.0-255,5738,65784,1,130041
44372,0.001493,172.31.36.0-255,66,65850,1,130041
44373,0.001497,172.217.194.0-255,2902,68752,1,130041
44374,0.001499,172.31.36.0-255,66,68818,1,130041
44375,0.001542,172.31.36.0-255,66,68884,1,130041
44376,0.001553,172.31.36.0-255,66,68950,1,130041
44377,0.001556,172.217.194.0-255,766,69716,1,130041
44378,0.00162,172.217.194.0-255,1484,71200,1,130041
44379,0.001623,172.31.36.0-255,66,71266,1,130041
44380,0.001626,172.217.194.0-255,1484,72750,1,130041
44381,0.001648,172.217.194.0-255,1484,74234,1,130041
44382,0.001651,172.31.36.0-255,66,74300,1,130041
44383,0.001658,172.217.194.0-255,5738,80038,1,130041
44384,0.00166,172.31.36.0-255,66,80104,1,130041
44385,0.001679,172.31.36.0-255,66,80170,1,130041
44386,0.001691,172.31.36.0-255,66,80236,1,130041
44387,0.00172,172.217.194.0-255,1484,81720,1,130041
44388,0.001751,172.217.194.0-255,6438,88158,1,130041
44389,0.001754,172.31.36.0-255,66,88224,1,130041
44390,0.001765,172.31.36.0-255,66,88290,1,130041
44391,0.001774,172.217.194.0-255,1484,89774,1,130041
44392,0.001813,172.31.36.0-255,66,89840,1,130041
44393,0.001815,172.217.194.0-255,766,90606,1,130041
44394,0.001819,172.217.194.0-255,1484,92090,1,130041
44395,0.001821,172.31.36.0-255,66,92156,1,130041
44396,0.001871,172.31.36.0-255,66,92222,1,130041
44397,0.001885,172.31.36.0-255,66,92288,1,130041
44398,0.001897,172.217.194.0-255,7156,99444,1,130041
44399,0.0019,172.31.36.0-255,66,99510,1,130041
44400,0.001912,172.31.36.0-255,66,99576,1,130041
44401,0.00196,172.31.36.0-255,66,99642,1,130041
44402,0.001963,172.217.194.0-255,766,100408,1,130041
44403,0.002058,172.217.194.0-255,1484,101892,1,130041
44404,0.002062,172.31.36.0-255,66,101958,1,130041
44405,0.002068,172.217.194.0-255,2902,104860,1,130041
44406,0.00207,172.31.36.0-255,66,104926,1,130041
44407,0.002077,172.217.194.0-255,5738,110664,1,130041
44408,0.002086,172.31.36.0-255,66,110730,1,130041
44409,0.002092,172.217.194.0-255,5738,116468,1,130041
44410,0.002094,172.31.36.0-255,66,116534,1,130041
44411,0.002139,172.31.36.0-255,66,116600,1,130041
44412,0.002171,172.31.36.0-255,66,116666,1,130041
44413,0.002199,172.31.36.0-255,66,116732,1,130041
44414,0.002216,172.31.36.0-255,66,116798,1,130041
44415,0.002323,172.217.194.0-255,3557,120355,1,130041
44416,0.002326,172.217.194.0-255,105,120460,1,130041
44417,0.00771,172.31.36.0-255,66,120526,1,130041
44418,0.00788,172.31.36.0-255,101,120627,1,130041
44419,0.010528,172.217.194.0-255,66,120693,1,130041
44420,0.01061,172.31.36.0-255,105,120798,1,130041
44421,0.013203,172.217.194.0-255,66,120864,1,130041
44422,0.041396,172.31.36.0-255,172,121036,1,130041
44423,0.041432,172.31.36.0-255,1112,122148,1,130041
44424,0.041499,172.31.36.0-255,1514,123662,1,130041
44425,0.041501,172.31.36.0-255,1514,125176,1,130041
44426,0.041507,172.31.36.0-255,1514,126690,1,130041
44427,0.041508,172.31.36.0-255,1514,128204,1,130041
44428,0.041542,172.31.36.0-255,1507,129711,1,130041
44429,0.042954,104.244.42.0-255,66,129777,1,130041
44430,0.042968,104.244.42.0-255,66,129843,1,130041
44431,0.043066,104.244.42.0-255,66,129909,1,130041
44432,0.04311,104.244.42.0-255,66,129975,1,130041
44433,0.043115,104.244.42.0-255,66,130041,1,130041
44434,0.0,74.125.68.0-255,153,153,1,206893
44435,3.3e-05,172.31.36.0-255,66,219,1,206893
44436,4e-05,74.125.68.0-255,1484,1703,1,206893
44437,4.4e-05,172.31.36.0-255,66,1769,1,206893
44438,5e-05,74.125.68.0-255,2902,4671,1,206893
44439,5.4e-05,172.31.36.0-255,66,4737,1,206893
44440,5.8e-05,74.125.68.0-255,2902,7639,1,206893
44441,6.1e-05,172.31.36.0-255,66,7705,1,206893
44442,9.6e-05,172.31.36.0-255,66,7771,1,206893
44443,0.000105,74.125.68.0-255,7156,14927,1,206893
44444,0.000108,172.31.36.0-255,66,14993,1,206893
44445,0.000124,74.125.68.0-255,1484,16477,1,206893
44446,0.000126,172.31.36.0-255,66,16543,1,206893
44447,0.000153,74.125.68.0-255,6797,23340,1,206893
44448,0.000157,172.31.36.0-255,66,23406,1,206893
44449,0.000429,74.125.68.0-255,1484,24890,1,206893
44450,0.000434,172.31.36.0-255,66,24956,1,206893
44451,0.00044,74.125.68.0-255,2902,27858,1,206893
44452,0.000443,172.31.36.0-255,66,27924,1,206893
44453,0.000449,74.125.68.0-255,4320,32244,1,206893
44454,0.000452,172.31.36.0-255,66,32310,1,206893
44455,0.000474,74.125.68.0-255,1484,33794,1,206893
44456,0.000477,172.31.36.0-255,66,33860,1,206893
44457,0.000485,74.125.68.0-255,6797,40657,1,206893
44458,0.000487,172.31.36.0-255,66,40723,1,206893
44459,0.001132,74.125.68.0-255,1484,42207,1,206893
44460,0.00114,172.31.36.0-255,66,42273,1,206893
44461,0.001149,74.125.68.0-255,2902,45175,1,206893
44462,0.001152,172.31.36.0-255,66,45241,1,206893
44463,0.001176,74.125.68.0-255,5738,50979,1,206893
44464,0.001178,172.31.36.0-255,66,51045,1,206893
44465,0.001182,74.125.68.0-255,1484,52529,1,206893
44466,0.001208,74.125.68.0-255,1484,54013,1,206893
44467,0.001211,172.31.36.0-255,66,54079,1,206893
44468,0.001233,74.125.68.0-255,4292,58371,1,206893
44469,0.001236,172.31.36.0-255,66,58437,1,206893
44470,0.001294,74.125.68.0-255,112,58549,1,206893
44471,0.00156,74.125.68.0-255,1484,60033,1,206893
44472,0.001564,172.31.36.0-255,66,60099,1,206893
44473,0.001582,74.125.68.0-255,1484,61583,1,206893
44474,0.001596,74.125.68.0-255,1484,63067,1,206893
44475,0.001598,172.31.36.0-255,66,63133,1,206893
44476,0.001653,74.125.68.0-255,2902,66035,1,206893
44477,0.001655,172.31.36.0-255,66,66101,1,206893
44478,0.001674,74.125.68.0-255,2902,69003,1,206893
44479,0.001676,172.31.36.0-255,66,69069,1,206893
44480,0.00168,74.125.68.0-255,1484,70553,1,206893
44481,0.001684,74.125.68.0-255,2902,73455,1,206893
44482,0.001686,172.31.36.0-255,66,73521,1,206893
44483,0.001709,74.125.68.0-255,2543,76064,1,206893
44484,0.001711,172.31.36.0-255,66,76130,1,206893
44485,0.001715,74.125.68.0-255,2902,79032,1,206893
44486,0.001717,172.31.36.0-255,66,79098,1,206893
44487,0.00176,74.125.68.0-255,1484,80582,1,206893
44488,0.001775,74.125.68.0-255,2902,83484,1,206893
44489,0.001777,172.31.36.0-255,66,83550,1,206893
44490,0.001793,74.125.68.0-255,1484,85034,1,206893
44491,0.001821,74.125.68.0-255,1484,86518,1,206893
44492,0.001823,172.31.36.0-255,66,86584,1,206893
44493,0.001839,74.125.68.0-255,4320,90904,1,206893
44494,0.001841,172.31.36.0-255,66,90970,1,206893
44495,0.00186,74.125.68.0-255,1484,92454,1,206893
44496,0.001862,74.125.68.0-255,1125,93579,1,206893
44497,0.001864,172.31.36.0-255,66,93645,1,206893
44498,0.004343,74.125.68.0-255,2902,96547,1,206893
44499,0.004349,172.31.36.0-255,66,96613,1,206893
44500,0.004382,74.125.68.0-255,2902,99515,1,206893
44501,0.004387,172.31.36.0-255,66,99581,1,206893
44502,0.006868,74.125.68.0-255,2902,102483,1,206893
44503,0.006874,172.31.36.0-255,66,102549,1,206893
44504,0.006914,74.125.68.0-255,2902,105451,1,206893
44505,0.006919,172.31.36.0-255,66,105517,1,206893
44506,0.009393,74.125.68.0-255,2902,108419,1,206893
44507,0.009403,172.31.36.0-255,66,108485,1,206893
44508,0.009441,74.125.68.0-255,2902,111387,1,206893
44509,0.009444,172.31.36.0-255,66,111453,1,206893
44510,0.011943,74.125.68.0-255,5738,117191,1,206893
44511,0.011956,172.31.36.0-255,66,117257,1,206893
44512,0.014484,74.125.68.0-255,5738,122995,1,206893
44513,0.0145,172.31.36.0-255,66,123061,1,206893
44514,0.017033,74.125.68.0-255,5738,128799,1,206893
44515,0.01704,172.31.36.0-255,66,128865,1,206893
44516,0.01956,74.125.68.0-255,5738,134603,1,206893
44517,0.01957,172.31.36.0-255,66,134669,1,206893
44518,0.022108,74.125.68.0-255,5738,140407,1,206893
44519,0.022117,172.31.36.0-255,66,140473,1,206893
44520,0.024651,74.125.68.0-255,5738,146211,1,206893
44521,0.024662,172.31.36.0-255,66,146277,1,206893
44522,0.027184,74.125.68.0-255,5738,152015,1,206893
44523,0.027194,172.31.36.0-255,66,152081,1,206893
44524,0.029718,74.125.68.0-255,5738,157819,1,206893
44525,0.029727,172.31.36.0-255,66,157885,1,206893
44526,0.032249,74.125.68.0-255,5738,163623,1,206893
44527,0.032258,172.31.36.0-255,66,163689,1,206893
44528,0.034839,74.125.68.0-255,5738,169427,1,206893
44529,0.034846,172.31.36.0-255,66,169493,1,206893
44530,0.035144,172.31.36.0-255,172,169665,1,206893
44531,0.035179,172.31.36.0-255,1115,170780,1,206893
44532,0.035227,172.31.36.0-255,1514,172294,1,206893
44533,0.035229,172.31.36.0-255,1514,173808,1,206893
44534,0.03523,172.31.36.0-255,1514,175322,1,206893
44535,0.035231,172.31.36.0-255,1514,176836,1,206893
44536,0.035258,172.31.36.0-255,1489,178325,1,206893
44537,0.036704,104.244.42.0-255,66,178391,1,206893
44538,0.036763,104.244.42.0-255,66,178457,1,206893
44539,0.036795,104.244.42.0-255,66,178523,1,206893
44540,0.037362,74.125.68.0-255,1484,180007,1,206893
44541,0.037393,74.125.68.0-255,4320,184327,1,206893
44542,0.037398,172.31.36.0-255,66,184393,1,206893
44543,0.038307,104.244.42.0-255,108,184501,1,206893
44544,0.038312,172.31.36.0-255,66,184567,1,206893
44545,0.039911,74.125.68.0-255,4320,188887,1,206893
44546,0.039916,172.31.36.0-255,66,188953,1,206893
44547,0.039941,74.125.68.0-255,1484,190437,1,206893
44548,0.04243,74.125.68.0-255,1484,191921,1,206893
44549,0.042436,172.31.36.0-255,66,191987,1,206893
44550,0.042468,74.125.68.0-255,2902,194889,1,206893
44551,0.042472,172.31.36.0-255,66,194955,1,206893
44552,0.044968,74.125.68.0-255,2902,197857,1,206893
44553,0.044973,172.31.36.0-255,66,197923,1,206893
44554,0.045005,74.125.68.0-255,2902,200825,1,206893
44555,0.045008,172.31.36.0-255,66,200891,1,206893
44556,0.04749,74.125.68.0-255,2902,203793,1,206893
44557,0.047496,172.31.36.0-255,66,203859,1,206893
44558,0.047525,74.125.68.0-255,1484,205343,1,206893
44559,0.047542,74.125.68.0-255,1484,206827,1,206893
44560,0.047546,172.31.36.0-255,66,206893,1,206893
44561,0.0,172.31.36.0-255,66,66,1,66
44562,0.0,74.125.24.0-255,149,149,1,268501
44563,3.4e-05,172.31.36.0-255,66,215,1,268501
44564,4.2e-05,74.125.24.0-255,1484,1699,1,268501
44565,4.7e-05,172.31.36.0-255,66,1765,1,268501
44566,5.2e-05,74.125.24.0-255,2902,4667,1,268501
44567,5.4e-05,172.31.36.0-255,66,4733,1,268501
44568,6.9e-05,74.125.24.0-255,7156,11889,1,268501
44569,7.1e-05,172.31.36.0-255,66,11955,1,268501
44570,7.7e-05,74.125.24.0-255,3523,15478,1,268501
44571,7.8e-05,172.31.36.0-255,66,15544,1,268501
44572,8.3e-05,74.125.24.0-255,2902,18446,1,268501
44573,8.5e-05,172.31.36.0-255,66,18512,1,268501
44574,0.000134,172.31.36.0-255,66,18578,1,268501
44575,0.000138,74.125.24.0-255,2543,21121,1,268501
44576,0.00014,172.31.36.0-255,66,21187,1,268501
44577,0.000178,74.125.24.0-255,1484,22671,1,268501
44578,0.000181,172.31.36.0-255,66,22737,1,268501
44579,0.000212,74.125.24.0-255,2902,25639,1,268501
44580,0.000215,172.31.36.0-255,66,25705,1,268501
44581,0.000219,74.125.24.0-255,2902,28607,1,268501
44582,0.000222,172.31.36.0-255,66,28673,1,268501
44583,0.000235,74.125.24.0-255,4320,32993,1,268501
44584,0.000237,172.31.36.0-255,66,33059,1,268501
44585,0.000277,172.31.36.0-255,66,33125,1,268501
44586,0.000285,74.125.24.0-255,7156,40281,1,268501
44587,0.000287,172.31.36.0-255,66,40347,1,268501
44588,0.000345,74.125.24.0-255,4320,44667,1,268501
44589,0.00035,172.31.36.0-255,66,44733,1,268501
44590,0.000369,74.125.24.0-255,1125,45858,1,268501
44591,0.000373,172.31.36.0-255,66,45924,1,268501
44592,0.000523,74.125.24.0-255,645,46569,1,268501
44593,0.000569,74.125.24.0-255,1484,48053,1,268501
44594,0.000573,172.31.36.0-255,66,48119,1,268501
44595,0.000578,74.125.24.0-255,2902,51021,1,268501
44596,0.000581,172.31.36.0-255,66,51087,1,268501
44597,0.000611,74.125.24.0-255,4320,55407,1,268501
44598,0.000615,172.31.36.0-255,66,55473,1,268501
44599,0.000644,74.125.24.0-255,1484,56957,1,268501
44600,0.00065,74.125.24.0-255,4320,61277,1,268501
44601,0.000653,172.31.36.0-255,66,61343,1,268501
44602,0.000664,172.31.36.0-255,66,61409,1,268501
44603,0.000685,74.125.24.0-255,1484,62893,1,268501
44604,0.000702,172.31.36.0-255,66,62959,1,268501
44605,0.000731,74.125.24.0-255,1484,64443,1,268501
44606,0.000737,74.125.24.0-255,2902,67345,1,268501
44607,0.000739,172.31.36.0-255,66,67411,1,268501
44608,0.000743,74.125.24.0-255,1484,68895,1,268501
44609,0.000775,74.125.24.0-255,4320,73215,1,268501
44610,0.000779,172.31.36.0-255,66,73281,1,268501
44611,0.000786,74.125.24.0-255,6249,79530,1,268501
44612,0.000789,172.31.36.0-255,66,79596,1,268501
44613,0.000839,74.125.24.0-255,7156,86752,1,268501
44614,0.000844,172.31.36.0-255,66,86818,1,268501
44615,0.000847,74.125.24.0-255,1484,88302,1,268501
44616,0.000873,74.125.24.0-255,2902,91204,1,268501
44617,0.000876,172.31.36.0-255,66,91270,1,268501
44618,0.000905,74.125.24.0-255,5379,96649,1,268501
44619,0.000909,172.31.36.0-255,66,96715,1,268501
44620,0.001173,74.125.24.0-255,1484,98199,1,268501
44621,0.001176,74.125.24.0-255,1484,99683,1,268501
44622,0.001179,172.31.36.0-255,66,99749,1,268501
44623,0.001196,74.125.24.0-255,1484,101233,1,268501
44624,0.001203,74.125.24.0-255,5738,106971,1,268501
44625,0.001206,172.31.36.0-255,66,107037,1,268501
44626,0.00124,74.125.24.0-255,7156,114193,1,268501
44627,0.001243,172.31.36.0-255,66,114259,1,268501
44628,0.001247,74.125.24.0-255,2902,117161,1,268501
44629,0.001249,172.31.36.0-255,66,117227,1,268501
44630,0.001286,172.31.36.0-255,66,117293,1,268501
44631,0.00129,74.125.24.0-255,2184,119477,1,268501
44632,0.001292,172.31.36.0-255,66,119543,1,268501
44633,0.001805,74.125.24.0-255,1484,121027,1,268501
44634,0.001816,74.125.24.0-255,2902,123929,1,268501
44635,0.00182,172.31.36.0-255,66,123995,1,268501
44636,0.001826,74.125.24.0-255,1484,125479,1,268501
44637,0.001851,74.125.24.0-255,4320,129799,1,268501
44638,0.001856,172.31.36.0-255,66,129865,1,268501
44639,0.001859,74.125.24.0-255,1484,131349,1,268501
44640,0.001899,172.31.36.0-255,66,131415,1,268501
44641,0.001931,74.125.24.0-255,2902,134317,1,268501
44642,0.001935,172.31.36.0-255,66,134383,1,268501
44643,0.001947,172.31.36.0-255,66,134449,1,268501
44644,0.001955,74.125.24.0-255,1484,135933,1,268501
44645,0.001959,74.125.24.0-255,2902,138835,1,268501
44646,0.001963,172.31.36.0-255,66,138901,1,268501
44647,0.001966,74.125.24.0-255,1484,140385,1,268501
44648,0.002001,74.125.24.0-255,4320,144705,1,268501
44649,0.002005,172.31.36.0-255,66,144771,1,268501
44650,0.002013,74.125.24.0-255,7156,151927,1,268501
44651,0.002015,172.31.36.0-255,66,151993,1,268501
44652,0.002031,172.31.36.0-255,66,152059,1,268501
44653,0.002042,172.31.36.0-255,66,152125,1,268501
44654,0.002132,74.125.24.0-255,1484,153609,1,268501
44655,0.002139,74.125.24.0-255,2902,156511,1,268501
44656,0.002144,172.31.36.0-255,66,156577,1,268501
44657,0.002152,74.125.24.0-255,5738,162315,1,268501
44658,0.002154,172.31.36.0-255,66,162381,1,268501
44659,0.002204,172.31.36.0-255,66,162447,1,268501
44660,0.002216,172.31.36.0-255,66,162513,1,268501
44661,0.002342,74.125.24.0-255,1484,163997,1,268501
44662,0.002349,74.125.24.0-255,2902,166899,1,268501
44663,0.002353,172.31.36.0-255,66,166965,1,268501
44664,0.002357,74.125.24.0-255,1484,168449,1,268501
44665,0.002391,74.125.24.0-255,4320,172769,1,268501
44666,0.002395,172.31.36.0-255,66,172835,1,268501
44667,0.002409,172.31.36.0-255,66,172901,1,268501
44668,0.002426,172.31.36.0-255,66,172967,1,268501
44669,0.002454,74.125.24.0-255,4320,177287,1,268501
44670,0.002457,172.31.36.0-255,66,177353,1,268501
44671,0.002482,172.31.36.0-255,66,177419,1,268501
44672,0.002521,172.31.36.0-255,66,177485,1,268501
44673,0.00253,172.31.36.0-255,66,177551,1,268501
44674,0.005182,74.125.24.0-255,5738,183289,1,268501
44675,0.005188,172.31.36.0-255,66,183355,1,268501
44676,0.007826,74.125.24.0-255,5738,189093,1,268501
44677,0.007833,172.31.36.0-255,66,189159,1,268501
44678,0.010517,74.125.24.0-255,5738,194897,1,268501
44679,0.010529,172.31.36.0-255,66,194963,1,268501
44680,0.013208,74.125.24.0-255,5738,200701,1,268501
44681,0.013217,172.31.36.0-255,66,200767,1,268501
44682,0.015897,74.125.24.0-255,5738,206505,1,268501
44683,0.01591,172.31.36.0-255,66,206571,1,268501
44684,0.018578,74.125.24.0-255,5738,212309,1,268501
44685,0.018588,172.31.36.0-255,66,212375,1,268501
44686,0.021234,74.125.24.0-255,5738,218113,1,268501
44687,0.021242,172.31.36.0-255,66,218179,1,268501
44688,0.023891,74.125.24.0-255,5738,223917,1,268501
44689,0.023897,172.31.36.0-255,66,223983,1,268501
44690,0.02654,74.125.24.0-255,5738,229721,1,268501
44691,0.026548,172.31.36.0-255,66,229787,1,268501
44692,0.029252,74.125.24.0-255,5738,235525,1,268501
44693,0.029262,172.31.36.0-255,66,235591,1,268501
44694,0.031888,74.125.24.0-255,5738,241329,1,268501
44695,0.031895,172.31.36.0-255,66,241395,1,268501
44696,0.034517,74.125.24.0-255,5738,247133,1,268501
44697,0.034525,172.31.36.0-255,66,247199,1,268501
44698,0.035731,172.31.36.0-255,172,247371,1,268501
44699,0.035774,172.31.36.0-255,1114,248485,1,268501
44700,0.03586,172.31.36.0-255,1514,249999,1,268501
44701,0.035863,172.31.36.0-255,1514,251513,1,268501
44702,0.035865,172.31.36.0-255,1514,253027,1,268501
44703,0.035866,172.31.36.0-255,1514,254541,1,268501
44704,0.035895,172.31.36.0-255,1489,256030,1,268501
44705,0.037193,74.125.24.0-255,5738,261768,1,268501
44706,0.037202,172.31.36.0-255,66,261834,1,268501
44707,0.037253,104.244.42.0-255,66,261900,1,268501
44708,0.037363,104.244.42.0-255,66,261966,1,268501
44709,0.037474,104.244.42.0-255,66,262032,1,268501
44710,0.039834,74.125.24.0-255,5738,267770,1,268501
44711,0.039842,172.31.36.0-255,66,267836,1,268501
44712,0.042419,74.125.24.0-255,428,268264,1,268501
44713,0.043073,172.31.36.0-255,66,268330,1,268501
44714,0.043106,172.31.36.0-255,105,268435,1,268501
44715,0.045699,74.125.24.0-255,66,268501,1,268501
44716,0.0,172.217.194.0-255,152,152,1,265735
44717,2.4e-05,172.31.36.0-255,66,218,1,265735
44718,3.1e-05,172.217.194.0-255,1484,1702,1,265735
44719,3.6e-05,172.31.36.0-255,66,1768,1,265735
44720,4.1e-05,172.217.194.0-255,2902,4670,1,265735
44721,4.3e-05,172.31.36.0-255,66,4736,1,265735
44722,5.8e-05,172.217.194.0-255,7156,11892,1,265735
44723,6.1e-05,172.31.36.0-255,66,11958,1,265735
44724,6.5e-05,172.217.194.0-255,2032,13990,1,265735
44725,6.8e-05,172.31.36.0-255,66,14056,1,265735
44726,0.000404,172.217.194.0-255,1484,15540,1,265735
44727,0.00041,172.31.36.0-255,66,15606,1,265735
44728,0.000417,172.217.194.0-255,2902,18508,1,265735
44729,0.000419,172.31.36.0-255,66,18574,1,265735
44730,0.000432,172.217.194.0-255,5738,24312,1,265735
44731,0.000434,172.31.36.0-255,66,24378,1,265735
44732,0.000462,172.217.194.0-255,5738,30116,1,265735
44733,0.000469,172.31.36.0-255,66,30182,1,265735
44734,0.000495,172.217.194.0-255,1125,31307,1,265735
44735,0.000498,172.31.36.0-255,66,31373,1,265735
44736,0.00062,172.217.194.0-255,1484,32857,1,265735
44737,0.000624,172.31.36.0-255,66,32923,1,265735
44738,0.00063,172.217.194.0-255,2902,35825,1,265735
44739,0.000632,172.31.36.0-255,66,35891,1,265735
44740,0.000643,172.217.194.0-255,5738,41629,1,265735
44741,0.000646,172.31.36.0-255,66,41695,1,265735
44742,0.000682,172.217.194.0-255,6797,48492,1,265735
44743,0.000685,172.31.36.0-255,66,48558,1,265735
44744,0.000696,172.217.194.0-255,5738,54296,1,265735
44745,0.000698,172.31.36.0-255,66,54362,1,265735
44746,0.000719,172.217.194.0-255,1484,55846,1,265735
44747,0.000726,172.31.36.0-255,66,55912,1,265735
44748,0.000772,172.31.36.0-255,66,55978,1,265735
44749,0.000798,172.217.194.0-255,647,56625,1,265735
44750,0.001051,172.31.36.0-255,101,56726,1,265735
44751,0.00116,172.217.194.0-255,1484,58210,1,265735
44752,0.001193,172.217.194.0-255,1484,59694,1,265735
44753,0.001197,172.31.36.0-255,66,59760,1,265735
44754,0.001209,172.217.194.0-255,2902,62662,1,265735
44755,0.001215,172.31.36.0-255,66,62728,1,265735
44756,0.001222,172.217.194.0-255,5738,68466,1,265735
44757,0.001224,172.31.36.0-255,66,68532,1,265735
44758,0.00129,172.31.36.0-255,66,68598,1,265735
44759,0.001646,172.217.194.0-255,1484,70082,1,265735
44760,0.001664,172.217.194.0-255,2902,72984,1,265735
44761,0.001667,172.31.36.0-255,66,73050,1,265735
44762,0.001673,172.217.194.0-255,2902,75952,1,265735
44763,0.001675,172.31.36.0-255,66,76018,1,265735
44764,0.001708,172.217.194.0-255,2902,78920,1,265735
44765,0.00171,172.31.36.0-255,66,78986,1,265735
44766,0.001727,172.31.36.0-255,66,79052,1,265735
44767,0.001732,172.217.194.0-255,2902,81954,1,265735
44768,0.001734,172.31.36.0-255,66,82020,1,265735
44769,0.001775,172.31.36.0-255,66,82086,1,265735
44770,0.001827,172.217.194.0-255,4320,86406,1,265735
44771,0.00184,172.217.194.0-255,4320,90726,1,265735
44772,0.001845,172.217.194.0-255,4320,95046,1,265735
44773,0.001883,172.217.194.0-255,2902,97948,1,265735
44774,0.001918,172.217.194.0-255,2902,100850,1,265735
44775,0.001957,172.217.194.0-255,3602,104452,1,265735
44776,0.001997,172.217.194.0-255,1484,105936,1,265735
44777,0.002016,172.217.194.0-255,2902,108838,1,265735
44778,0.002024,172.217.194.0-255,5738,114576,1,265735
44779,0.00205,172.217.194.0-255,7156,121732,1,265735
44780,0.002084,172.217.194.0-255,7156,128888,1,265735
44781,0.002105,172.217.194.0-255,7156,136044,1,265735
44782,0.00211,172.217.194.0-255,2184,138228,1,265735
44783,0.002141,172.217.194.0-255,1484,139712,1,265735
44784,0.002162,172.217.194.0-255,2902,142614,1,265735
44785,0.002183,172.217.194.0-255,5738,148352,1,265735
44786,0.002209,172.217.194.0-255,7156,155508,1,265735
44787,0.00222,172.217.194.0-255,4320,159828,1,265735
44788,0.002245,172.217.194.0-255,2184,162012,1,265735
44789,0.002249,172.217.194.0-255,2902,164914,1,265735
44790,0.002252,172.217.194.0-255,1484,166398,1,265735
44791,0.002278,172.217.194.0-255,5738,172136,1,265735
44792,0.002325,172.217.194.0-255,4320,176456,1,265735
44793,0.002924,172.217.194.0-255,1484,177940,1,265735
44794,0.002934,172.217.194.0-255,2902,180842,1,265735
44795,0.002957,172.217.194.0-255,5738,186580,1,265735
44796,0.003011,172.217.194.0-255,2902,189482,1,265735
44797,0.003015,172.217.194.0-255,1484,190966,1,265735
44798,0.003098,172.217.194.0-255,5738,196704,1,265735
44799,0.003118,172.217.194.0-255,3602,200306,1,265735
44800,0.003121,172.217.194.0-255,1484,201790,1,265735
44801,0.003126,172.217.194.0-255,2902,204692,1,265735
44802,0.003142,172.217.194.0-255,1484,206176,1,265735
44803,0.003164,172.217.194.0-255,2902,209078,1,265735
44804,0.003198,172.217.194.0-255,4320,213398,1,265735
44805,0.003211,172.217.194.0-255,5738,219136,1,265735
44806,0.003217,172.217.194.0-255,4320,223456,1,265735
44807,0.003241,172.217.194.0-255,7156,230612,1,265735
44808,0.003247,172.217.194.0-255,3602,234214,1,265735
44809,0.003287,172.217.194.0-255,4320,238534,1,265735
44810,0.003307,172.217.194.0-255,4320,242854,1,265735
44811,0.003377,172.217.194.0-255,3602,246456,1,265735
44812,0.003384,172.217.194.0-255,4320,250776,1,265735
44813,0.003408,172.217.194.0-255,5347,256123,1,265735
44814,0.003412,172.217.194.0-255,66,256189,1,265735
44815,0.003416,172.217.194.0-255,105,256294,1,265735
44816,0.005231,172.31.36.0-255,66,256360,1,265735
44817,0.011559,172.31.36.0-255,105,256465,1,265735
44818,0.018016,172.217.194.0-255,66,256531,1,265735
44819,0.043086,172.31.36.0-255,172,256703,1,265735
44820,0.043121,172.31.36.0-255,1113,257816,1,265735
44821,0.043206,172.31.36.0-255,1514,259330,1,265735
44822,0.043208,172.31.36.0-255,1514,260844,1,265735
44823,0.043209,172.31.36.0-255,1514,262358,1,265735
44824,0.04321,172.31.36.0-255,1514,263872,1,265735
44825,0.043238,172.31.36.0-255,1491,265363,1,265735
44826,0.044616,104.244.42.0-255,66,265429,1,265735
44827,0.044664,104.244.42.0-255,66,265495,1,265735
44828,0.044767,104.244.42.0-255,66,265561,1,265735
44829,0.045454,104.244.42.0-255,108,265669,1,265735
44830,0.045465,172.31.36.0-255,66,265735,1,265735
44831,0.0,172.253.118.0-255,66,66,1,66
44832,0.0,172.217.194.0-255,153,153,1,209611
44833,3.1e-05,172.31.36.0-255,66,219,1,209611
44834,3.8e-05,172.217.194.0-255,1484,1703,1,209611
44835,4.2e-05,172.31.36.0-255,66,1769,1,209611
44836,4.6e-05,172.217.194.0-255,2902,4671,1,209611
44837,4.9e-05,172.31.36.0-255,66,4737,1,209611
44838,6.3e-05,172.217.194.0-255,5738,10475,1,209611
44839,6.6e-05,172.31.36.0-255,66,10541,1,209611
44840,0.000101,172.217.194.0-255,3419,13960,1,209611
44841,0.000105,172.31.36.0-255,66,14026,1,209611
44842,0.000369,172.217.194.0-255,1484,15510,1,209611
44843,0.000375,172.217.194.0-255,2902,18412,1,209611
44844,0.000378,172.31.36.0-255,66,18478,1,209611
44845,0.000383,172.31.36.0-255,66,18544,1,209611
44846,0.000391,172.217.194.0-255,2902,21446,1,209611
44847,0.000398,172.31.36.0-255,66,21512,1,209611
44848,0.000427,172.217.194.0-255,2902,24414,1,209611
44849,0.000431,172.31.36.0-255,66,24480,1,209611
44850,0.000458,172.31.36.0-255,66,24546,1,209611
44851,0.00048,172.217.194.0-255,5379,29925,1,209611
44852,0.000484,172.31.36.0-255,66,29991,1,209611
44853,0.000487,172.217.194.0-255,1484,31475,1,209611
44854,0.000489,172.31.36.0-255,66,31541,1,209611
44855,0.000501,172.31.36.0-255,66,31607,1,209611
44856,0.000539,172.31.36.0-255,66,31673,1,209611
44857,0.000542,172.217.194.0-255,1484,33157,1,209611
44858,0.000548,172.31.36.0-255,66,33223,1,209611
44859,0.000549,172.217.194.0-255,6438,39661,1,209611
44860,0.000551,172.31.36.0-255,66,39727,1,209611
44861,0.000564,172.217.194.0-255,412,40139,1,209611
44862,0.000593,172.217.194.0-255,1484,41623,1,209611
44863,0.000597,172.31.36.0-255,66,41689,1,209611
44864,0.000625,172.217.194.0-255,4320,46009,1,209611
44865,0.000628,172.31.36.0-255,66,46075,1,209611
44866,0.000661,172.217.194.0-255,5738,51813,1,209611
44867,0.000664,172.31.36.0-255,66,51879,1,209611
44868,0.000672,172.217.194.0-255,7156,59035,1,209611
44869,0.000675,172.31.36.0-255,66,59101,1,209611
44870,0.000694,172.31.36.0-255,66,59167,1,209611
44871,0.00072,172.217.194.0-255,4320,63487,1,209611
44872,0.000722,172.217.194.0-255,766,64253,1,209611
44873,0.000724,172.31.36.0-255,66,64319,1,209611
44874,0.000736,172.217.194.0-255,1484,65803,1,209611
44875,0.000738,172.31.36.0-255,66,65869,1,209611
44876,0.000749,172.217.194.0-255,2902,68771,1,209611
44877,0.000752,172.31.36.0-255,66,68837,1,209611
44878,0.000758,172.217.194.0-255,5738,74575,1,209611
44879,0.00076,172.31.36.0-255,66,74641,1,209611
44880,0.000828,172.31.36.0-255,66,74707,1,209611
44881,0.00084,172.31.36.0-255,66,74773,1,209611
44882,0.000868,172.217.194.0-255,2184,76957,1,209611
44883,0.000871,172.31.36.0-255,66,77023,1,209611
44884,0.000875,172.217.194.0-255,2902,79925,1,209611
44885,0.000878,172.31.36.0-255,66,79991,1,209611
44886,0.000881,172.217.194.0-255,1484,81475,1,209611
44887,0.000914,172.217.194.0-255,5738,87213,1,209611
44888,0.000918,172.31.36.0-255,66,87279,1,209611
44889,0.000932,172.31.36.0-255,66,87345,1,209611
44890,0.000979,172.31.36.0-255,66,87411,1,209611
44891,0.000995,172.217.194.0-255,766,88177,1,209611
44892,0.001064,172.217.194.0-255,1484,89661,1,209611
44893,0.001067,172.31.36.0-255,66,89727,1,209611
44894,0.001071,172.217.194.0-255,1484,91211,1,209611
44895,0.001086,172.217.194.0-255,1484,92695,1,209611
44896,0.001089,172.31.36.0-255,66,92761,1,209611
44897,0.001096,172.217.194.0-255,5738,98499,1,209611
44898,0.001099,172.31.36.0-255,66,98565,1,209611
44899,0.001119,172.217.194.0-255,4320,102885,1,209611
44900,0.001122,172.31.36.0-255,66,102951,1,209611
44901,0.001151,172.217.194.0-255,7156,110107,1,209611
44902,0.001154,172.31.36.0-255,66,110173,1,209611
44903,0.001195,172.31.36.0-255,66,110239,1,209611
44904,0.001202,172.217.194.0-255,5738,115977,1,209611
44905,0.001204,172.31.36.0-255,66,116043,1,209611
44906,0.001248,172.31.36.0-255,66,116109,1,209611
44907,0.001254,172.217.194.0-255,6438,122547,1,209611
44908,0.001257,172.31.36.0-255,66,122613,1,209611
44909,0.001331,172.217.194.0-255,1484,124097,1,209611
44910,0.001349,172.217.194.0-255,2902,126999,1,209611
44911,0.001352,172.31.36.0-255,66,127065,1,209611
44912,0.001378,172.217.194.0-255,5738,132803,1,209611
44913,0.001381,172.31.36.0-255,66,132869,1,209611
44914,0.001386,172.217.194.0-255,2902,135771,1,209611
44915,0.001388,172.31.36.0-255,66,135837,1,209611
44916,0.00142,172.217.194.0-255,7156,142993,1,209611
44917,0.001424,172.31.36.0-255,66,143059,1,209611
44918,0.001436,172.31.36.0-255,66,143125,1,209611
44919,0.001464,172.217.194.0-255,3602,146727,1,209611
44920,0.001468,172.31.36.0-255,66,146793,1,209611
44921,0.00154,172.217.194.0-255,1484,148277,1,209611
44922,0.001546,172.217.194.0-255,2902,151179,1,209611
44923,0.001548,172.31.36.0-255,66,151245,1,209611
44924,0.001577,172.217.194.0-255,5738,156983,1,209611
44925,0.00158,172.31.36.0-255,66,157049,1,209611
44926,0.001584,172.217.194.0-255,1484,158533,1,209611
44927,0.001588,172.217.194.0-255,2902,161435,1,209611
44928,0.00159,172.31.36.0-255,66,161501,1,209611
44929,0.001626,172.217.194.0-255,5738,167239,1,209611
44930,0.001629,172.31.36.0-255,66,167305,1,209611
44931,0.001669,172.217.194.0-255,5738,173043,1,209611
44932,0.001672,172.31.36.0-255,66,173109,1,209611
44933,0.001706,172.31.36.0-255,66,173175,1,209611
44934,0.001716,172.31.36.0-255,66,173241,1,209611
44935,0.001721,172.217.194.0-255,4320,177561,1,209611
44936,0.001724,172.31.36.0-255,66,177627,1,209611
44937,0.001772,172.31.36.0-255,66,177693,1,209611
44938,0.001788,172.31.36.0-255,66,177759,1,209611
44939,0.001824,172.217.194.0-255,2902,180661,1,209611
44940,0.001827,172.31.36.0-255,66,180727,1,209611
44941,0.001839,172.31.36.0-255,66,180793,1,209611
44942,0.001845,172.217.194.0-255,5738,186531,1,209611
44943,0.001847,172.31.36.0-255,66,186597,1,209611
44944,0.001886,172.31.36.0-255,66,186663,1,209611
44945,0.001891,172.31.36.0-255,66,186729,1,209611
44946,0.001925,172.217.194.0-255,7156,193885,1,209611
44947,0.001932,172.217.194.0-255,5738,199623,1,209611
44948,0.001933,172.31.36.0-255,66,199689,1,209611
44949,0.001939,172.31.36.0-255,66,199755,1,209611
44950,0.001971,172.31.36.0-255,66,199821,1,209611
44951,0.001974,172.217.194.0-255,97,199918,1,209611
44952,0.001976,172.217.194.0-255,105,200023,1,209611
44953,0.00771,172.31.36.0-255,66,200089,1,209611
44954,0.007734,172.31.36.0-255,105,200194,1,209611
44955,0.009917,172.217.194.0-255,66,200260,1,209611
44956,0.038173,172.31.36.0-255,188,200448,1,209611
44957,0.038221,172.31.36.0-255,958,201406,1,209611
44958,0.038253,172.31.36.0-255,1514,202920,1,209611
44959,0.038255,172.31.36.0-255,1514,204434,1,209611
44960,0.03826,172.31.36.0-255,1514,205948,1,209611
44961,0.038261,172.31.36.0-255,1514,207462,1,209611
44962,0.038285,172.31.36.0-255,1514,208976,1,209611
44963,0.03829,172.31.36.0-255,197,209173,1,209611
44964,0.039716,104.244.42.0-255,66,209239,1,209611
44965,0.039736,104.244.42.0-255,66,209305,1,209611
44966,0.039804,104.244.42.0-255,66,209371,1,209611
44967,0.039828,104.244.42.0-255,66,209437,1,209611
44968,0.040537,104.244.42.0-255,108,209545,1,209611
44969,0.040559,172.31.36.0-255,66,209611,1,209611
44970,0.0,74.125.24.0-255,150,150,1,264955
44971,2.4e-05,172.31.36.0-255,66,216,1,264955
44972,3.1e-05,74.125.24.0-255,1484,1700,1,264955
44973,3.5e-05,172.31.36.0-255,66,1766,1,264955
44974,4e-05,74.125.24.0-255,2902,4668,1,264955
44975,5.2e-05,172.31.36.0-255,66,4734,1,264955
44976,6e-05,74.125.24.0-255,7156,11890,1,264955
44977,6.3e-05,172.31.36.0-255,66,11956,1,264955
44978,9e-05,74.125.24.0-255,2080,14036,1,264955
44979,9.9e-05,172.31.36.0-255,66,14102,1,264955
44980,0.000224,74.125.24.0-255,1484,15586,1,264955
44981,0.000229,172.31.36.0-255,66,15652,1,264955
44982,0.000235,74.125.24.0-255,2902,18554,1,264955
44983,0.000238,172.31.36.0-255,66,18620,1,264955
44984,0.00025,74.125.24.0-255,5738,24358,1,264955
44985,0.000252,172.31.36.0-255,66,24424,1,264955
44986,0.000297,74.125.24.0-255,6797,31221,1,264955
44987,0.000301,172.31.36.0-255,66,31287,1,264955
44988,0.000308,74.125.24.0-255,7156,38443,1,264955
44989,0.000311,172.31.36.0-255,66,38509,1,264955
44990,0.000361,172.31.36.0-255,66,38575,1,264955
44991,0.000373,172.31.36.0-255,66,38641,1,264955
44992,0.000379,74.125.24.0-255,5020,43661,1,264955
44993,0.000383,172.31.36.0-255,66,43727,1,264955
44994,0.000411,74.125.24.0-255,404,44131,1,264955
44995,0.000415,172.31.36.0-255,66,44197,1,264955
44996,0.00064,74.125.24.0-255,1484,45681,1,264955
44997,0.000646,172.31.36.0-255,66,45747,1,264955
44998,0.000652,74.125.24.0-255,2902,48649,1,264955
44999,0.000655,172.31.36.0-255,66,48715,1,264955
45000,0.000669,74.125.24.0-255,5738,54453,1,264955
45001,0.000672,172.31.36.0-255,66,54519,1,264955
45002,0.00068,74.125.24.0-255,7156,61675,1,264955
45003,0.000682,172.31.36.0-255,66,61741,1,264955
45004,0.000719,74.125.24.0-255,5738,67479,1,264955
45005,0.000723,172.31.36.0-255,66,67545,1,264955
45006,0.000729,74.125.24.0-255,4320,71865,1,264955
45007,0.000731,172.31.36.0-255,66,71931,1,264955
45008,0.000759,74.125.24.0-255,6712,78643,1,264955
45009,0.000763,172.31.36.0-255,66,78709,1,264955
45010,0.000936,74.125.24.0-255,1484,80193,1,264955
45011,0.000945,74.125.24.0-255,2902,83095,1,264955
45012,0.000948,172.31.36.0-255,66,83161,1,264955
45013,0.000952,74.125.24.0-255,1484,84645,1,264955
45014,0.000982,74.125.24.0-255,4320,88965,1,264955
45015,0.000986,172.31.36.0-255,66,89031,1,264955
45016,0.001,172.31.36.0-255,66,89097,1,264955
45017,0.001041,172.31.36.0-255,66,89163,1,264955
45018,0.001096,74.125.24.0-255,1484,90647,1,264955
45019,0.001101,74.125.24.0-255,2902,93549,1,264955
45020,0.001104,172.31.36.0-255,66,93615,1,264955
45021,0.00111,74.125.24.0-255,4320,97935,1,264955
45022,0.001113,172.31.36.0-255,66,98001,1,264955
45023,0.001148,74.125.24.0-255,1484,99485,1,264955
45024,0.001155,74.125.24.0-255,5738,105223,1,264955
45025,0.001159,172.31.36.0-255,66,105289,1,264955
45026,0.001172,172.31.36.0-255,66,105355,1,264955
45027,0.001214,172.31.36.0-255,66,105421,1,264955
45028,0.001227,172.31.36.0-255,66,105487,1,264955
45029,0.001242,74.125.24.0-255,1484,106971,1,264955
45030,0.001263,172.31.36.0-255,66,107037,1,264955
45031,0.001276,172.31.36.0-255,66,107103,1,264955
45032,0.001282,74.125.24.0-255,5738,112841,1,264955
45033,0.001285,172.31.36.0-255,66,112907,1,264955
45034,0.001331,172.31.36.0-255,66,112973,1,264955
45035,0.001335,74.125.24.0-255,2184,115157,1,264955
45036,0.001337,172.31.36.0-255,66,115223,1,264955
45037,0.001411,74.125.24.0-255,1484,116707,1,264955
45038,0.001432,74.125.24.0-255,2902,119609,1,264955
45039,0.001435,172.31.36.0-255,66,119675,1,264955
45040,0.001441,74.125.24.0-255,5738,125413,1,264955
45041,0.001444,172.31.36.0-255,66,125479,1,264955
45042,0.001453,74.125.24.0-255,4320,129799,1,264955
45043,0.001456,172.31.36.0-255,66,129865,1,264955
45044,0.0015,172.31.36.0-255,66,129931,1,264955
45045,0.001512,172.31.36.0-255,66,129997,1,264955
45046,0.001954,74.125.24.0-255,1484,131481,1,264955
45047,0.00196,74.125.24.0-255,2902,134383,1,264955
45048,0.001964,172.31.36.0-255,66,134449,1,264955
45049,0.001996,74.125.24.0-255,5738,140187,1,264955
45050,0.002001,74.125.24.0-255,4320,144507,1,264955
45051,0.002005,74.125.24.0-255,4320,148827,1,264955
45052,0.002014,172.31.36.0-255,66,148893,1,264955
45053,0.002017,172.31.36.0-255,66,148959,1,264955
45054,0.002019,172.31.36.0-255,66,149025,1,264955
45055,0.002031,74.125.24.0-255,7156,156181,1,264955
45056,0.002033,172.31.36.0-255,66,156247,1,264955
45057,0.002065,172.31.36.0-255,66,156313,1,264955
45058,0.002213,74.125.24.0-255,1484,157797,1,264955
45059,0.002231,74.125.24.0-255,2902,160699,1,264955
45060,0.002234,172.31.36.0-255,66,160765,1,264955
45061,0.00224,74.125.24.0-255,4320,165085,1,264955
45062,0.002241,172.31.36.0-255,66,165151,1,264955
45063,0.002281,172.31.36.0-255,66,165217,1,264955
45064,0.004534,74.125.24.0-255,5738,170955,1,264955
45065,0.004541,172.31.36.0-255,66,171021,1,264955
45066,0.006799,74.125.24.0-255,5738,176759,1,264955
45067,0.006807,172.31.36.0-255,66,176825,1,264955
45068,0.009042,74.125.24.0-255,5738,182563,1,264955
45069,0.009052,172.31.36.0-255,66,182629,1,264955
45070,0.011343,74.125.24.0-255,5738,188367,1,264955
45071,0.01135,172.31.36.0-255,66,188433,1,264955
45072,0.013633,74.125.24.0-255,5738,194171,1,264955
45073,0.013639,172.31.36.0-255,66,194237,1,264955
45074,0.015891,74.125.24.0-255,5738,199975,1,264955
45075,0.015899,172.31.36.0-255,66,200041,1,264955
45076,0.018163,74.125.24.0-255,5738,205779,1,264955
45077,0.018173,172.31.36.0-255,66,205845,1,264955
45078,0.020418,74.125.24.0-255,5738,211583,1,264955
45079,0.020426,172.31.36.0-255,66,211649,1,264955
45080,0.022678,74.125.24.0-255,5738,217387,1,264955
45081,0.022685,172.31.36.0-255,66,217453,1,264955
45082,0.02424,172.31.36.0-255,184,217637,1,264955
45083,0.024285,172.31.36.0-255,1145,218782,1,264955
45084,0.024436,172.31.36.0-255,1514,220296,1,264955
45085,0.024439,172.31.36.0-255,1256,221552,1,264955
45086,0.024936,74.125.24.0-255,5738,227290,1,264955
45087,0.024943,172.31.36.0-255,66,227356,1,264955
45088,0.025751,104.244.42.0-255,66,227422,1,264955
45089,0.02584,104.244.42.0-255,66,227488,1,264955
45090,0.025992,104.244.42.0-255,66,227554,1,264955
45091,0.027151,74.125.24.0-255,2902,230456,1,264955
45092,0.027158,172.31.36.0-255,66,230522,1,264955
45093,0.027187,74.125.24.0-255,2902,233424,1,264955
45094,0.027191,172.31.36.0-255,66,233490,1,264955
45095,0.029434,74.125.24.0-255,5738,239228,1,264955
45096,0.029443,172.31.36.0-255,66,239294,1,264955
45097,0.031703,74.125.24.0-255,5738,245032,1,264955
45098,0.03171,172.31.36.0-255,66,245098,1,264955
45099,0.033939,74.125.24.0-255,5738,250836,1,264955
45100,0.033946,172.31.36.0-255,66,250902,1,264955
45101,0.036204,74.125.24.0-255,5738,256640,1,264955
45102,0.03621,172.31.36.0-255,66,256706,1,264955
45103,0.038462,74.125.24.0-255,5738,262444,1,264955
45104,0.038468,172.31.36.0-255,66,262510,1,264955
45105,0.0407,74.125.24.0-255,2208,264718,1,264955
45106,0.040707,172.31.36.0-255,66,264784,1,264955
45107,0.040875,172.31.36.0-255,105,264889,1,264955
45108,0.043096,74.125.24.0-255,66,264955,1,264955
45109,0.0,172.217.160.0-255,153,153,1,226016
45110,3.3e-05,172.31.36.0-255,66,219,1,226016
45111,4e-05,172.217.160.0-255,1484,1703,1,226016
45112,4.5e-05,172.31.36.0-255,66,1769,1,226016
45113,5.5e-05,172.217.160.0-255,1484,3253,1,226016
45114,5.8e-05,172.31.36.0-255,66,3319,1,226016
45115,6.5e-05,172.217.160.0-255,4320,7639,1,226016
45116,6.7e-05,172.31.36.0-255,66,7705,1,226016
45117,9.7e-05,172.217.160.0-255,6296,14001,1,226016
45118,0.000101,172.31.36.0-255,66,14067,1,226016
45119,0.000356,172.217.160.0-255,1484,15551,1,226016
45120,0.000361,172.31.36.0-255,66,15617,1,226016
45121,0.000367,172.217.160.0-255,2902,18519,1,226016
45122,0.000369,172.31.36.0-255,66,18585,1,226016
45123,0.000375,172.217.160.0-255,5738,24323,1,226016
45124,0.000384,172.31.36.0-255,66,24389,1,226016
45125,0.000407,172.217.160.0-255,1484,25873,1,226016
45126,0.00041,172.31.36.0-255,66,25939,1,226016
45127,0.000442,172.217.160.0-255,2902,28841,1,226016
45128,0.000445,172.31.36.0-255,66,28907,1,226016
45129,0.00045,172.217.160.0-255,2543,31450,1,226016
45130,0.000452,172.31.36.0-255,66,31516,1,226016
45131,0.000485,172.217.160.0-255,1484,33000,1,226016
45132,0.000487,172.31.36.0-255,66,33066,1,226016
45133,0.000492,172.217.160.0-255,1484,34550,1,226016
45134,0.000494,172.31.36.0-255,66,34616,1,226016
45135,0.000521,172.217.160.0-255,1484,36100,1,226016
45136,0.000523,172.31.36.0-255,66,36166,1,226016
45137,0.00053,172.217.160.0-255,5738,41904,1,226016
45138,0.000532,172.31.36.0-255,66,41970,1,226016
45139,0.000547,172.217.160.0-255,6797,48767,1,226016
45140,0.00055,172.31.36.0-255,66,48833,1,226016
45141,0.000565,172.31.36.0-255,66,48899,1,226016
45142,0.000605,172.217.160.0-255,5738,54637,1,226016
45143,0.000614,172.31.36.0-255,66,54703,1,226016
45144,0.000618,172.217.160.0-255,2849,57552,1,226016
45145,0.000633,172.31.36.0-255,66,57618,1,226016
45146,0.001565,172.217.160.0-255,104,57722,1,226016
45147,0.001659,172.217.160.0-255,1484,59206,1,226016
45148,0.001664,172.31.36.0-255,66,59272,1,226016
45149,0.00167,172.217.160.0-255,2902,62174,1,226016
45150,0.001673,172.217.160.0-255,1484,63658,1,226016
45151,0.001693,172.217.160.0-255,4320,67978,1,226016
45152,0.001697,172.217.160.0-255,2902,70880,1,226016
45153,0.001713,172.217.160.0-255,4320,75200,1,226016
45154,0.001737,172.217.160.0-255,6797,81997,1,226016
45155,0.001743,172.217.160.0-255,7156,89153,1,226016
45156,0.001759,172.217.160.0-255,2543,91696,1,226016
45157,0.005713,172.31.36.0-255,66,91762,1,226016
45158,0.007689,172.217.160.0-255,5738,97500,1,226016
45159,0.007695,172.31.36.0-255,66,97566,1,226016
45160,0.009678,172.217.160.0-255,5738,103304,1,226016
45161,0.009686,172.31.36.0-255,66,103370,1,226016
45162,0.011668,172.217.160.0-255,5738,109108,1,226016
45163,0.011674,172.31.36.0-255,66,109174,1,226016
45164,0.01365,172.217.160.0-255,5738,114912,1,226016
45165,0.013657,172.31.36.0-255,66,114978,1,226016
45166,0.015629,172.217.160.0-255,5738,120716,1,226016
45167,0.015635,172.31.36.0-255,66,120782,1,226016
45168,0.017609,172.217.160.0-255,5738,126520,1,226016
45169,0.017617,172.31.36.0-255,66,126586,1,226016
45170,0.019607,172.217.160.0-255,5738,132324,1,226016
45171,0.019617,172.31.36.0-255,66,132390,1,226016
45172,0.021585,172.217.160.0-255,5738,138128,1,226016
45173,0.021592,172.31.36.0-255,66,138194,1,226016
45174,0.023563,172.217.160.0-255,5738,143932,1,226016
45175,0.023571,172.31.36.0-255,66,143998,1,226016
45176,0.025552,172.217.160.0-255,5738,149736,1,226016
45177,0.025561,172.31.36.0-255,66,149802,1,226016
45178,0.027538,172.217.160.0-255,5738,155540,1,226016
45179,0.027546,172.31.36.0-255,66,155606,1,226016
45180,0.029521,172.217.160.0-255,5738,161344,1,226016
45181,0.029529,172.31.36.0-255,66,161410,1,226016
45182,0.031109,172.31.36.0-255,172,161582,1,226016
45183,0.031143,172.31.36.0-255,1115,162697,1,226016
45184,0.031187,172.31.36.0-255,1514,164211,1,226016
45185,0.031189,172.31.36.0-255,1514,165725,1,226016
45186,0.03119,172.31.36.0-255,1514,167239,1,226016
45187,0.031191,172.31.36.0-255,1514,168753,1,226016
45188,0.031217,172.31.36.0-255,1489,170242,1,226016
45189,0.031511,172.217.160.0-255,5738,175980,1,226016
45190,0.031516,172.31.36.0-255,66,176046,1,226016
45191,0.032657,104.244.42.0-255,66,176112,1,226016
45192,0.03278,104.244.42.0-255,66,176178,1,226016
45193,0.032782,104.244.42.0-255,66,176244,1,226016
45194,0.032879,104.244.42.0-255,66,176310,1,226016
45195,0.033403,104.244.42.0-255,108,176418,1,226016
45196,0.033425,172.31.36.0-255,66,176484,1,226016
45197,0.033483,172.217.160.0-255,4320,180804,1,226016
45198,0.033487,172.31.36.0-255,66,180870,1,226016
45199,0.033514,172.217.160.0-255,1484,182354,1,226016
45200,0.035449,172.217.160.0-255,4320,186674,1,226016
45201,0.035455,172.31.36.0-255,66,186740,1,226016
45202,0.037428,172.217.160.0-255,5738,192478,1,226016
45203,0.037478,172.31.36.0-255,66,192544,1,226016
45204,0.039448,172.217.160.0-255,5738,198282,1,226016
45205,0.039454,172.31.36.0-255,66,198348,1,226016
45206,0.041422,172.217.160.0-255,5738,204086,1,226016
45207,0.041427,172.31.36.0-255,66,204152,1,226016
45208,0.043399,172.217.160.0-255,5738,209890,1,226016
45209,0.043404,172.31.36.0-255,66,209956,1,226016
45210,0.045399,172.217.160.0-255,5738,215694,1,226016
45211,0.045404,172.31.36.0-255,66,215760,1,226016
45212,0.047369,172.217.160.0-255,4320,220080,1,226016
45213,0.047374,172.31.36.0-255,66,220146,1,226016
45214,0.047403,172.217.160.0-255,1484,221630,1,226016
45215,0.049345,172.217.160.0-255,4320,225950,1,226016
45216,0.049351,172.31.36.0-255,66,226016,1,226016
45217,0.0,172.217.194.0-255,152,152,1,288972
45218,3.4e-05,172.31.36.0-255,66,218,1,288972
45219,4e-05,172.217.194.0-255,1484,1702,1,288972
45220,4.4e-05,172.31.36.0-255,66,1768,1,288972
45221,4.9e-05,172.217.194.0-255,2902,4670,1,288972
45222,5.1e-05,172.31.36.0-255,66,4736,1,288972
45223,5.4e-05,172.217.194.0-255,1484,6220,1,288972
45224,5.6e-05,172.31.36.0-255,66,6286,1,288972
45225,8.3e-05,172.217.194.0-255,1484,7770,1,288972
45226,8.9e-05,172.31.36.0-255,66,7836,1,288972
45227,9.6e-05,172.31.36.0-255,66,7902,1,288972
45228,0.00015,172.31.36.0-255,66,7968,1,288972
45229,0.000231,172.217.194.0-255,1484,9452,1,288972
45230,0.000235,172.31.36.0-255,66,9518,1,288972
45231,0.00024,172.217.194.0-255,2902,12420,1,288972
45232,0.000243,172.31.36.0-255,66,12486,1,288972
45233,0.000248,172.217.194.0-255,2902,15388,1,288972
45234,0.00025,172.31.36.0-255,66,15454,1,288972
45235,0.000273,172.217.194.0-255,2902,18356,1,288972
45236,0.000276,172.31.36.0-255,66,18422,1,288972
45237,0.000282,172.217.194.0-255,5738,24160,1,288972
45238,0.000284,172.31.36.0-255,66,24226,1,288972
45239,0.000317,172.31.36.0-255,66,24292,1,288972
45240,0.000322,172.217.194.0-255,4211,28503,1,288972
45241,0.000324,172.31.36.0-255,66,28569,1,288972
45242,0.000343,172.217.194.0-255,115,28684,1,288972
45243,0.000346,172.31.36.0-255,66,28750,1,288972
45244,0.000541,172.217.194.0-255,387,29137,1,288972
45245,0.000545,172.31.36.0-255,66,29203,1,288972
45246,0.000664,172.217.194.0-255,1484,30687,1,288972
45247,0.00067,172.217.194.0-255,2902,33589,1,288972
45248,0.000673,172.31.36.0-255,66,33655,1,288972
45249,0.000696,172.217.194.0-255,1484,35139,1,288972
45250,0.000712,172.217.194.0-255,4320,39459,1,288972
45251,0.000715,172.31.36.0-255,66,39525,1,288972
45252,0.00073,172.31.36.0-255,66,39591,1,288972
45253,0.000734,172.217.194.0-255,2902,42493,1,288972
45254,0.000736,172.31.36.0-255,66,42559,1,288972
45255,0.000764,172.217.194.0-255,6248,48807,1,288972
45256,0.000767,172.31.36.0-255,66,48873,1,288972
45257,0.000785,172.217.194.0-255,1484,50357,1,288972
45258,0.0008,172.217.194.0-255,7156,57513,1,288972
45259,0.000803,172.31.36.0-255,66,57579,1,288972
45260,0.000844,172.217.194.0-255,4320,61899,1,288972
45261,0.000847,172.31.36.0-255,66,61965,1,288972
45262,0.000862,172.217.194.0-255,3961,65926,1,288972
45263,0.000865,172.31.36.0-255,66,65992,1,288972
45264,0.000904,172.217.194.0-255,1484,67476,1,288972
45265,0.000909,172.217.194.0-255,2902,70378,1,288972
45266,0.000912,172.31.36.0-255,66,70444,1,288972
45267,0.000919,172.217.194.0-255,5738,76182,1,288972
45268,0.000921,172.31.36.0-255,66,76248,1,288972
45269,0.000948,172.217.194.0-255,6797,83045,1,288972
45270,0.000969,172.31.36.0-255,66,83111,1,288972
45271,0.000996,172.217.194.0-255,1484,84595,1,288972
45272,0.001002,172.217.194.0-255,2902,87497,1,288972
45273,0.001005,172.31.36.0-255,66,87563,1,288972
45274,0.001008,172.217.194.0-255,1484,89047,1,288972
45275,0.001027,172.217.194.0-255,4320,93367,1,288972
45276,0.00103,172.31.36.0-255,66,93433,1,288972
45277,0.001061,172.217.194.0-255,6797,100230,1,288972
45278,0.001066,172.31.36.0-255,66,100296,1,288972
45279,0.001085,172.217.194.0-255,2902,103198,1,288972
45280,0.001087,172.31.36.0-255,66,103264,1,288972
45281,0.001112,172.31.36.0-255,66,103330,1,288972
45282,0.001131,172.217.194.0-255,2902,106232,1,288972
45283,0.001135,172.31.36.0-255,66,106298,1,288972
45284,0.001152,172.217.194.0-255,1125,107423,1,288972
45285,0.00141,172.217.194.0-255,1484,108907,1,288972
45286,0.001414,172.31.36.0-255,66,108973,1,288972
45287,0.001419,172.217.194.0-255,2902,111875,1,288972
45288,0.001421,172.31.36.0-255,66,111941,1,288972
45289,0.00145,172.217.194.0-255,5738,117679,1,288972
45290,0.001453,172.31.36.0-255,66,117745,1,288972
45291,0.001459,172.217.194.0-255,5738,123483,1,288972
45292,0.001461,172.31.36.0-255,66,123549,1,288972
45293,0.00148,172.217.194.0-255,5738,129287,1,288972
45294,0.001483,172.31.36.0-255,66,129353,1,288972
45295,0.001507,172.31.36.0-255,66,129419,1,288972
45296,0.001513,172.217.194.0-255,3961,133380,1,288972
45297,0.001515,172.31.36.0-255,66,133446,1,288972
45298,0.00171,172.217.194.0-255,1484,134930,1,288972
45299,0.001715,172.217.194.0-255,2902,137832,1,288972
45300,0.001718,172.31.36.0-255,66,137898,1,288972
45301,0.001741,172.217.194.0-255,5738,143636,1,288972
45302,0.001744,172.31.36.0-255,66,143702,1,288972
45303,0.001749,172.217.194.0-255,4320,148022,1,288972
45304,0.001751,172.31.36.0-255,66,148088,1,288972
45305,0.001778,172.31.36.0-255,66,148154,1,288972
45306,0.001785,172.217.194.0-255,5738,153892,1,288972
45307,0.001787,172.31.36.0-255,66,153958,1,288972
45308,0.001802,172.217.194.0-255,4320,158278,1,288972
45309,0.001804,172.31.36.0-255,66,158344,1,288972
45310,0.001807,172.217.194.0-255,766,159110,1,288972
45311,0.00213,172.217.194.0-255,1484,160594,1,288972
45312,0.00214,172.31.36.0-255,66,160660,1,288972
45313,0.002145,172.217.194.0-255,2902,163562,1,288972
45314,0.002148,172.31.36.0-255,66,163628,1,288972
45315,0.002176,172.217.194.0-255,5738,169366,1,288972
45316,0.002179,172.31.36.0-255,66,169432,1,288972
45317,0.002182,172.217.194.0-255,2902,172334,1,288972
45318,0.002184,172.31.36.0-255,66,172400,1,288972
45319,0.002243,172.217.194.0-255,3961,176361,1,288972
45320,0.002247,172.31.36.0-255,66,176427,1,288972
45321,0.004806,172.217.194.0-255,1484,177911,1,288972
45322,0.004827,172.217.194.0-255,4320,182231,1,288972
45323,0.004831,172.31.36.0-255,66,182297,1,288972
45324,0.007378,172.217.194.0-255,5738,188035,1,288972
45325,0.007383,172.31.36.0-255,66,188101,1,288972
45326,0.009972,172.217.194.0-255,5738,193839,1,288972
45327,0.009979,172.31.36.0-255,66,193905,1,288972
45328,0.012551,172.217.194.0-255,5738,199643,1,288972
45329,0.012568,172.31.36.0-255,66,199709,1,288972
45330,0.015191,172.217.194.0-255,5738,205447,1,288972
45331,0.015204,172.31.36.0-255,66,205513,1,288972
45332,0.017843,172.217.194.0-255,5738,211251,1,288972
45333,0.017853,172.31.36.0-255,66,211317,1,288972
45334,0.020427,172.217.194.0-255,5738,217055,1,288972
45335,0.020434,172.31.36.0-255,66,217121,1,288972
45336,0.023029,172.217.194.0-255,5738,222859,1,288972
45337,0.023036,172.31.36.0-255,66,222925,1,288972
45338,0.025621,172.217.194.0-255,5738,228663,1,288972
45339,0.025629,172.31.36.0-255,66,228729,1,288972
45340,0.02818,172.217.194.0-255,5738,234467,1,288972
45341,0.028189,172.31.36.0-255,66,234533,1,288972
45342,0.030815,172.217.194.0-255,5738,240271,1,288972
45343,0.030823,172.31.36.0-255,66,240337,1,288972
45344,0.032374,172.31.36.0-255,172,240509,1,288972
45345,0.032406,172.31.36.0-255,1113,241622,1,288972
45346,0.032452,172.31.36.0-255,1514,243136,1,288972
45347,0.032454,172.31.36.0-255,1514,244650,1,288972
45348,0.032455,172.31.36.0-255,1514,246164,1,288972
45349,0.032456,172.31.36.0-255,1514,247678,1,288972
45350,0.032481,172.31.36.0-255,1490,249168,1,288972
45351,0.033405,172.217.194.0-255,5738,254906,1,288972
45352,0.033412,172.31.36.0-255,66,254972,1,288972
45353,0.033925,104.244.42.0-255,66,255038,1,288972
45354,0.033967,104.244.42.0-255,66,255104,1,288972
45355,0.034021,104.244.42.0-255,66,255170,1,288972
45356,0.034173,104.244.42.0-255,66,255236,1,288972
45357,0.035983,172.217.194.0-255,5738,260974,1,288972
45358,0.03599,172.31.36.0-255,66,261040,1,288972
45359,0.038567,172.217.194.0-255,5738,266778,1,288972
45360,0.038572,172.31.36.0-255,66,266844,1,288972
45361,0.041155,172.217.194.0-255,4320,271164,1,288972
45362,0.041176,172.31.36.0-255,66,271230,1,288972
45363,0.041194,172.217.194.0-255,1484,272714,1,288972
45364,0.043759,172.217.194.0-255,4320,277034,1,288972
45365,0.043764,172.31.36.0-255,66,277100,1,288972
45366,0.046338,172.217.194.0-255,2902,280002,1,288972
45367,0.046343,172.31.36.0-255,66,280068,1,288972
45368,0.046371,172.217.194.0-255,2902,282970,1,288972
45369,0.046374,172.31.36.0-255,66,283036,1,288972
45370,0.04891,172.217.194.0-255,2902,285938,1,288972
45371,0.048917,172.31.36.0-255,66,286004,1,288972
45372,0.048948,172.217.194.0-255,2902,288906,1,288972
45373,0.048964,172.31.36.0-255,66,288972,1,288972
45374,0.0,74.125.130.0-255,298,298,1,237593
45375,2.7e-05,172.31.36.0-255,66,364,1,237593
45376,4.5e-05,74.125.130.0-255,1484,1848,1,237593
45377,4.9e-05,172.31.36.0-255,66,1914,1,237593
45378,5.2e-05,74.125.130.0-255,1484,3398,1,237593
45379,5.5e-05,172.31.36.0-255,66,3464,1,237593
45380,6.9e-05,74.125.130.0-255,1484,4948,1,237593
45381,7.1e-05,172.31.36.0-255,66,5014,1,237593
45382,8.5e-05,74.125.130.0-255,2902,7916,1,237593
45383,8.8e-05,172.31.36.0-255,66,7982,1,237593
45384,0.000107,74.125.130.0-255,2902,10884,1,237593
45385,0.00011,172.31.36.0-255,66,10950,1,237593
45386,0.000134,74.125.130.0-255,3319,14269,1,237593
45387,0.000139,172.31.36.0-255,66,14335,1,237593
45388,0.000218,74.125.130.0-255,1484,15819,1,237593
45389,0.000221,172.31.36.0-255,66,15885,1,237593
45390,0.000238,74.125.130.0-255,1484,17369,1,237593
45391,0.00024,172.31.36.0-255,66,17435,1,237593
45392,0.000243,74.125.130.0-255,1484,18919,1,237593
45393,0.000246,172.31.36.0-255,66,18985,1,237593
45394,0.000262,74.125.130.0-255,1484,20469,1,237593
45395,0.000265,172.31.36.0-255,66,20535,1,237593
45396,0.000301,74.125.130.0-255,5738,26273,1,237593
45397,0.000303,74.125.130.0-255,1484,27757,1,237593
45398,0.000306,172.31.36.0-255,66,27823,1,237593
45399,0.000307,74.125.130.0-255,2902,30725,1,237593
45400,0.00031,172.31.36.0-255,66,30791,1,237593
45401,0.000314,172.31.36.0-255,66,30857,1,237593
45402,0.000326,74.125.130.0-255,1125,31982,1,237593
45403,0.000329,172.31.36.0-255,66,32048,1,237593
45404,0.000507,74.125.130.0-255,1484,33532,1,237593
45405,0.00051,172.31.36.0-255,66,33598,1,237593
45406,0.000528,74.125.130.0-255,2902,36500,1,237593
45407,0.000531,172.31.36.0-255,66,36566,1,237593
45408,0.000553,74.125.130.0-255,2902,39468,1,237593
45409,0.000557,172.31.36.0-255,66,39534,1,237593
45410,0.000575,74.125.130.0-255,4320,43854,1,237593
45411,0.000577,172.31.36.0-255,66,43920,1,237593
45412,0.000609,172.31.36.0-255,66,43986,1,237593
45413,0.000614,74.125.130.0-255,2902,46888,1,237593
45414,0.000616,172.31.36.0-255,66,46954,1,237593
45415,0.000661,74.125.130.0-255,4320,51274,1,237593
45416,0.000664,172.31.36.0-255,66,51340,1,237593
45417,0.000686,74.125.130.0-255,5636,56976,1,237593
45418,0.000689,172.31.36.0-255,66,57042,1,237593
45419,0.000692,74.125.130.0-255,116,57158,1,237593
45420,0.000839,74.125.130.0-255,378,57536,1,237593
45421,0.000845,172.31.36.0-255,66,57602,1,237593
45422,0.000864,172.31.36.0-255,66,57668,1,237593
45423,0.001729,74.125.130.0-255,1484,59152,1,237593
45424,0.001738,74.125.130.0-255,2902,62054,1,237593
45425,0.001743,172.31.36.0-255,66,62120,1,237593
45426,0.001768,74.125.130.0-255,5738,67858,1,237593
45427,0.001772,172.31.36.0-255,66,67924,1,237593
45428,0.001794,74.125.130.0-255,7156,75080,1,237593
45429,0.001797,172.31.36.0-255,66,75146,1,237593
45430,0.001841,74.125.130.0-255,5738,80884,1,237593
45431,0.001845,172.31.36.0-255,66,80950,1,237593
45432,0.001852,74.125.130.0-255,7156,88106,1,237593
45433,0.001855,172.31.36.0-255,66,88172,1,237593
45434,0.001874,74.125.130.0-255,3602,91774,1,237593
45435,0.001877,172.31.36.0-255,66,91840,1,237593
45436,0.003834,74.125.130.0-255,5738,97578,1,237593
45437,0.003841,172.31.36.0-255,66,97644,1,237593
45438,0.005817,74.125.130.0-255,5738,103382,1,237593
45439,0.005823,172.31.36.0-255,66,103448,1,237593
45440,0.007792,74.125.130.0-255,1484,104932,1,237593
45441,0.007825,74.125.130.0-255,4320,109252,1,237593
45442,0.007829,172.31.36.0-255,66,109318,1,237593
45443,0.009807,74.125.130.0-255,5738,115056,1,237593
45444,0.009813,172.31.36.0-255,66,115122,1,237593
45445,0.011809,74.125.130.0-255,5738,120860,1,237593
45446,0.011818,172.31.36.0-255,66,120926,1,237593
45447,0.013814,74.125.130.0-255,5738,126664,1,237593
45448,0.013824,172.31.36.0-255,66,126730,1,237593
45449,0.015801,74.125.130.0-255,5738,132468,1,237593
45450,0.01581,172.31.36.0-255,66,132534,1,237593
45451,0.017802,74.125.130.0-255,5738,138272,1,237593
45452,0.017809,172.31.36.0-255,66,138338,1,237593
45453,0.019801,74.125.130.0-255,5738,144076,1,237593
45454,0.019811,172.31.36.0-255,66,144142,1,237593
45455,0.021797,74.125.130.0-255,5738,149880,1,237593
45456,0.021808,172.31.36.0-255,66,149946,1,237593
45457,0.023788,74.125.130.0-255,5738,155684,1,237593
45458,0.023797,172.31.36.0-255,66,155750,1,237593
45459,0.02578,74.125.130.0-255,5738,161488,1,237593
45460,0.025789,172.31.36.0-255,66,161554,1,237593
45461,0.027773,74.125.130.0-255,5738,167292,1,237593
45462,0.02778,172.31.36.0-255,66,167358,1,237593
45463,0.029769,74.125.130.0-255,5738,173096,1,237593
45464,0.029777,172.31.36.0-255,66,173162,1,237593
45465,0.031761,74.125.130.0-255,5738,178900,1,237593
45466,0.031768,172.31.36.0-255,66,178966,1,237593
45467,0.032566,172.31.36.0-255,172,179138,1,237593
45468,0.032599,172.31.36.0-255,1114,180252,1,237593
45469,0.032646,172.31.36.0-255,1514,181766,1,237593
45470,0.032648,172.31.36.0-255,1514,183280,1,237593
45471,0.032653,172.31.36.0-255,1514,184794,1,237593
45472,0.032654,172.31.36.0-255,1514,186308,1,237593
45473,0.032683,172.31.36.0-255,1489,187797,1,237593
45474,0.03374,74.125.130.0-255,5738,193535,1,237593
45475,0.033747,172.31.36.0-255,66,193601,1,237593
45476,0.034105,104.244.42.0-255,66,193667,1,237593
45477,0.034165,104.244.42.0-255,66,193733,1,237593
45478,0.034211,104.244.42.0-255,66,193799,1,237593
45479,0.03573,74.125.130.0-255,5738,199537,1,237593
45480,0.035735,172.31.36.0-255,66,199603,1,237593
45481,0.037715,74.125.130.0-255,4320,203923,1,237593
45482,0.03772,172.31.36.0-255,66,203989,1,237593
45483,0.037746,74.125.130.0-255,1484,205473,1,237593
45484,0.039701,74.125.130.0-255,4320,209793,1,237593
45485,0.039706,172.31.36.0-255,66,209859,1,237593
45486,0.041685,74.125.130.0-255,4320,214179,1,237593
45487,0.04169,172.31.36.0-255,66,214245,1,237593
45488,0.041719,74.125.130.0-255,1484,215729,1,237593
45489,0.043676,74.125.130.0-255,4320,220049,1,237593
45490,0.043681,172.31.36.0-255,66,220115,1,237593
45491,0.045669,74.125.130.0-255,5738,225853,1,237593
45492,0.045675,172.31.36.0-255,66,225919,1,237593
45493,0.047647,74.125.130.0-255,5738,231657,1,237593
45494,0.047653,172.31.36.0-255,66,231723,1,237593
45495,0.049632,74.125.130.0-255,4320,236043,1,237593
45496,0.049637,172.31.36.0-255,66,236109,1,237593
45497,0.04967,74.125.130.0-255,1484,237593,1,237593
45498,0.0,172.217.194.0-255,153,153,1,225465
45499,3.2e-05,172.31.36.0-255,66,219,1,225465
45500,3.9e-05,172.217.194.0-255,1484,1703,1,225465
45501,4.3e-05,172.31.36.0-255,66,1769,1,225465
45502,4.7e-05,172.217.194.0-255,2902,4671,1,225465
45503,5e-05,172.31.36.0-255,66,4737,1,225465
45504,5.7e-05,172.217.194.0-255,7156,11893,1,225465
45505,5.9e-05,172.31.36.0-255,66,11959,1,225465
45506,6.2e-05,172.217.194.0-255,1484,13443,1,225465
45507,6.5e-05,172.31.36.0-255,66,13509,1,225465
45508,6.8e-05,172.217.194.0-255,584,14093,1,225465
45509,7e-05,172.31.36.0-255,66,14159,1,225465
45510,8.9e-05,172.217.194.0-255,1484,15643,1,225465
45511,9.1e-05,172.31.36.0-255,66,15709,1,225465
45512,0.000114,172.217.194.0-255,4320,20029,1,225465
45513,0.000116,172.31.36.0-255,66,20095,1,225465
45514,0.000121,172.217.194.0-255,2902,22997,1,225465
45515,0.000123,172.31.36.0-255,66,23063,1,225465
45516,0.000139,172.217.194.0-255,7156,30219,1,225465
45517,0.000142,172.31.36.0-255,66,30285,1,225465
45518,0.000145,172.217.194.0-255,1125,31410,1,225465
45519,0.000147,172.31.36.0-255,66,31476,1,225465
45520,0.00019,172.217.194.0-255,1484,32960,1,225465
45521,0.000193,172.31.36.0-255,66,33026,1,225465
45522,0.000198,172.217.194.0-255,2902,35928,1,225465
45523,0.0002,172.31.36.0-255,66,35994,1,225465
45524,0.000215,172.217.194.0-255,5738,41732,1,225465
45525,0.000218,172.31.36.0-255,66,41798,1,225465
45526,0.000231,172.217.194.0-255,2902,44700,1,225465
45527,0.000233,172.31.36.0-255,66,44766,1,225465
45528,0.000249,172.217.194.0-255,3961,48727,1,225465
45529,0.000251,172.31.36.0-255,66,48793,1,225465
45530,0.000296,172.217.194.0-255,5738,54531,1,225465
45531,0.000299,172.31.36.0-255,66,54597,1,225465
45532,0.00032,172.217.194.0-255,1484,56081,1,225465
45533,0.000328,172.217.194.0-255,7156,63237,1,225465
45534,0.000331,172.31.36.0-255,66,63303,1,225465
45535,0.000354,172.217.194.0-255,3156,66459,1,225465
45536,0.000357,172.31.36.0-255,66,66525,1,225465
45537,0.000783,172.217.194.0-255,1484,68009,1,225465
45538,0.000792,172.217.194.0-255,2902,70911,1,225465
45539,0.000796,172.31.36.0-255,66,70977,1,225465
45540,0.0008,172.217.194.0-255,1484,72461,1,225465
45541,0.000821,172.217.194.0-255,4320,76781,1,225465
45542,0.000823,172.31.36.0-255,66,76847,1,225465
45543,0.000828,172.217.194.0-255,2902,79749,1,225465
45544,0.00083,172.31.36.0-255,66,79815,1,225465
45545,0.000869,172.31.36.0-255,66,79881,1,225465
45546,0.000882,172.31.36.0-255,66,79947,1,225465
45547,0.001296,172.217.194.0-255,1484,81431,1,225465
45548,0.001304,172.217.194.0-255,2902,84333,1,225465
45549,0.001309,172.31.36.0-255,66,84399,1,225465
45550,0.001315,172.217.194.0-255,5738,90137,1,225465
45551,0.001318,172.31.36.0-255,66,90203,1,225465
45552,0.001364,172.31.36.0-255,66,90269,1,225465
45553,0.001384,172.217.194.0-255,1484,91753,1,225465
45554,0.001391,172.217.194.0-255,5738,97491,1,225465
45555,0.001393,172.31.36.0-255,66,97557,1,225465
45556,0.001398,172.217.194.0-255,2902,100459,1,225465
45557,0.0014,172.31.36.0-255,66,100525,1,225465
45558,0.001418,172.217.194.0-255,2184,102709,1,225465
45559,0.001422,172.31.36.0-255,66,102775,1,225465
45560,0.001761,172.217.194.0-255,1484,104259,1,225465
45561,0.001766,172.217.194.0-255,2902,107161,1,225465
45562,0.00177,172.31.36.0-255,66,107227,1,225465
45563,0.00179,172.217.194.0-255,5738,112965,1,225465
45564,0.001793,172.31.36.0-255,66,113031,1,225465
45565,0.001814,172.217.194.0-255,2902,115933,1,225465
45566,0.001816,172.31.36.0-255,66,115999,1,225465
45567,0.001845,172.31.36.0-255,66,116065,1,225465
45568,0.001858,172.31.36.0-255,66,116131,1,225465
45569,0.00186,172.217.194.0-255,1484,117615,1,225465
45570,0.001884,172.217.194.0-255,2902,120517,1,225465
45571,0.001887,172.31.36.0-255,66,120583,1,225465
45572,0.001892,172.217.194.0-255,5738,126321,1,225465
45573,0.001894,172.31.36.0-255,66,126387,1,225465
45574,0.001897,172.217.194.0-255,1484,127871,1,225465
45575,0.001925,172.31.36.0-255,66,127937,1,225465
45576,0.001937,172.31.36.0-255,66,128003,1,225465
45577,0.001965,172.217.194.0-255,2902,130905,1,225465
45578,0.001967,172.31.36.0-255,66,130971,1,225465
45579,0.002026,172.217.194.0-255,2902,133873,1,225465
45580,0.002039,172.217.194.0-255,4320,138193,1,225465
45581,0.002049,172.217.194.0-255,2902,141095,1,225465
45582,0.00207,172.217.194.0-255,5738,146833,1,225465
45583,0.002094,172.217.194.0-255,1484,148317,1,225465
45584,0.002125,172.217.194.0-255,2902,151219,1,225465
45585,0.002141,172.217.194.0-255,2184,153403,1,225465
45586,0.002167,172.217.194.0-255,4320,157723,1,225465
45587,0.002186,172.217.194.0-255,1484,159207,1,225465
45588,0.002192,172.217.194.0-255,5738,164945,1,225465
45589,0.002232,172.217.194.0-255,2902,167847,1,225465
45590,0.002279,172.217.194.0-255,2902,170749,1,225465
45591,0.00229,172.217.194.0-255,4320,175069,1,225465
45592,0.002293,172.217.194.0-255,1484,176553,1,225465
45593,0.002307,172.217.194.0-255,7156,183709,1,225465
45594,0.002342,172.217.194.0-255,1484,185193,1,225465
45595,0.002354,172.217.194.0-255,2902,188095,1,225465
45596,0.002364,172.217.194.0-255,2902,190997,1,225465
45597,0.002387,172.217.194.0-255,1484,192481,1,225465
45598,0.002432,172.217.194.0-255,7156,199637,1,225465
45599,0.002503,172.217.194.0-255,4320,203957,1,225465
45600,0.002517,172.217.194.0-255,5738,209695,1,225465
45601,0.002532,172.217.194.0-255,3602,213297,1,225465
45602,0.002535,172.217.194.0-255,2797,216094,1,225465
45603,0.002538,172.217.194.0-255,105,216199,1,225465
45604,0.004192,172.31.36.0-255,66,216265,1,225465
45605,0.006825,172.31.36.0-255,105,216370,1,225465
45606,0.009304,172.217.194.0-255,66,216436,1,225465
45607,0.034163,172.31.36.0-255,172,216608,1,225465
45608,0.034201,172.31.36.0-255,1113,217721,1,225465
45609,0.034248,172.31.36.0-255,1514,219235,1,225465
45610,0.03425,172.31.36.0-255,1514,220749,1,225465
45611,0.034251,172.31.36.0-255,1514,222263,1,225465
45612,0.034257,172.31.36.0-255,1514,223777,1,225465
45613,0.034258,172.31.36.0-255,1490,225267,1,225465
45614,0.035683,104.244.42.0-255,66,225333,1,225465
45615,0.035755,104.244.42.0-255,66,225399,1,225465
45616,0.035842,104.244.42.0-255,66,225465,1,225465
45617,0.0,74.125.24.0-255,148,148,1,191170
45618,3.6e-05,172.31.36.0-255,66,214,1,191170
45619,4.3e-05,74.125.24.0-255,1484,1698,1,191170
45620,4.7e-05,172.31.36.0-255,66,1764,1,191170
45621,5.2e-05,74.125.24.0-255,2902,4666,1,191170
45622,5.5e-05,172.31.36.0-255,66,4732,1,191170
45623,6.2e-05,74.125.24.0-255,7156,11888,1,191170
45624,6.6e-05,172.31.36.0-255,66,11954,1,191170
45625,0.00011,74.125.24.0-255,1484,13438,1,191170
45626,0.000114,172.31.36.0-255,66,13504,1,191170
45627,0.000148,172.31.36.0-255,66,13570,1,191170
45628,0.00016,172.31.36.0-255,66,13636,1,191170
45629,0.000163,74.125.24.0-255,1484,15120,1,191170
45630,0.000165,172.31.36.0-255,66,15186,1,191170
45631,0.000169,74.125.24.0-255,2902,18088,1,191170
45632,0.000171,172.31.36.0-255,66,18154,1,191170
45633,0.000205,74.125.24.0-255,5738,23892,1,191170
45634,0.000209,172.31.36.0-255,66,23958,1,191170
45635,0.000222,172.31.36.0-255,66,24024,1,191170
45636,0.000274,74.125.24.0-255,4320,28344,1,191170
45637,0.000278,172.31.36.0-255,66,28410,1,191170
45638,0.000316,172.31.36.0-255,66,28476,1,191170
45639,0.000421,74.125.24.0-255,383,28859,1,191170
45640,0.000427,172.31.36.0-255,66,28925,1,191170
45641,0.000677,74.125.24.0-255,1484,30409,1,191170
45642,0.000682,172.31.36.0-255,66,30475,1,191170
45643,0.000689,74.125.24.0-255,2902,33377,1,191170
45644,0.000692,172.31.36.0-255,66,33443,1,191170
45645,0.000697,74.125.24.0-255,2902,36345,1,191170
45646,0.000699,172.31.36.0-255,66,36411,1,191170
45647,0.000724,74.125.24.0-255,2902,39313,1,191170
45648,0.000728,172.31.36.0-255,66,39379,1,191170
45649,0.000761,172.31.36.0-255,66,39445,1,191170
45650,0.000788,74.125.24.0-255,1484,40929,1,191170
45651,0.000819,172.31.36.0-255,66,40995,1,191170
45652,0.000823,74.125.24.0-255,766,41761,1,191170
45653,0.001117,172.31.36.0-255,66,41827,1,191170
45654,0.001412,74.125.24.0-255,1484,43311,1,191170
45655,0.001421,74.125.24.0-255,2902,46213,1,191170
45656,0.001425,172.31.36.0-255,66,46279,1,191170
45657,0.001432,74.125.24.0-255,5738,52017,1,191170
45658,0.001435,172.31.36.0-255,66,52083,1,191170
45659,0.001456,74.125.24.0-255,1484,53567,1,191170
45660,0.001499,172.31.36.0-255,66,53633,1,191170
45661,0.001541,74.125.24.0-255,2902,56535,1,191170
45662,0.001545,172.31.36.0-255,66,56601,1,191170
45663,0.001572,172.31.36.0-255,66,56667,1,191170
45664,0.00163,74.125.24.0-255,1484,58151,1,191170
45665,0.001636,74.125.24.0-255,2902,61053,1,191170
45666,0.001639,172.31.36.0-255,66,61119,1,191170
45667,0.001646,74.125.24.0-255,4320,65439,1,191170
45668,0.001648,172.31.36.0-255,66,65505,1,191170
45669,0.001668,74.125.24.0-255,1484,66989,1,191170
45670,0.001681,172.31.36.0-255,66,67055,1,191170
45671,0.001716,74.125.24.0-255,2902,69957,1,191170
45672,0.001793,172.31.36.0-255,66,70023,1,191170
45673,0.001798,172.31.36.0-255,66,70089,1,191170
45674,0.0018,172.31.36.0-255,66,70155,1,191170
45675,0.001804,74.125.24.0-255,1484,71639,1,191170
45676,0.001809,74.125.24.0-255,5020,76659,1,191170
45677,0.001813,172.31.36.0-255,66,76725,1,191170
45678,0.001816,74.125.24.0-255,1484,78209,1,191170
45679,0.00182,74.125.24.0-255,2902,81111,1,191170
45680,0.001823,172.31.36.0-255,66,81177,1,191170
45681,0.001854,74.125.24.0-255,5738,86915,1,191170
45682,0.001858,172.31.36.0-255,66,86981,1,191170
45683,0.001862,74.125.24.0-255,2902,89883,1,191170
45684,0.001865,172.31.36.0-255,66,89949,1,191170
45685,0.001891,172.31.36.0-255,66,90015,1,191170
45686,0.001939,172.31.36.0-255,66,90081,1,191170
45687,0.001957,74.125.24.0-255,5738,95819,1,191170
45688,0.001959,172.31.36.0-255,66,95885,1,191170
45689,0.001983,74.125.24.0-255,2902,98787,1,191170
45690,0.001986,172.31.36.0-255,66,98853,1,191170
45691,0.002002,172.31.36.0-255,66,98919,1,191170
45692,0.002017,172.31.36.0-255,66,98985,1,191170
45693,0.002028,172.31.36.0-255,66,99051,1,191170
45694,0.002061,172.31.36.0-255,66,99117,1,191170
45695,0.002072,172.31.36.0-255,66,99183,1,191170
45696,0.002091,74.125.24.0-255,1484,100667,1,191170
45697,0.002128,172.31.36.0-255,66,100733,1,191170
45698,0.002148,172.31.36.0-255,66,100799,1,191170
45699,0.002151,74.125.24.0-255,766,101565,1,191170
45700,0.00421,172.31.36.0-255,66,101631,1,191170
45701,0.004504,74.125.24.0-255,4320,105951,1,191170
45702,0.00451,172.31.36.0-255,66,106017,1,191170
45703,0.006561,74.125.24.0-255,1484,107501,1,191170
45704,0.006844,74.125.24.0-255,4320,111821,1,191170
45705,0.006853,172.31.36.0-255,66,111887,1,191170
45706,0.009212,74.125.24.0-255,5738,117625,1,191170
45707,0.009219,172.31.36.0-255,66,117691,1,191170
45708,0.01158,74.125.24.0-255,5738,123429,1,191170
45709,0.011587,172.31.36.0-255,66,123495,1,191170
45710,0.013951,74.125.24.0-255,5738,129233,1,191170
45711,0.013962,172.31.36.0-255,66,129299,1,191170
45712,0.016316,74.125.24.0-255,5738,135037,1,191170
45713,0.016325,172.31.36.0-255,66,135103,1,191170
45714,0.018663,74.125.24.0-255,5738,140841,1,191170
45715,0.018671,172.31.36.0-255,66,140907,1,191170
45716,0.021074,74.125.24.0-255,5738,146645,1,191170
45717,0.021081,172.31.36.0-255,66,146711,1,191170
45718,0.023426,74.125.24.0-255,5738,152449,1,191170
45719,0.023437,172.31.36.0-255,66,152515,1,191170
45720,0.025817,74.125.24.0-255,5738,158253,1,191170
45721,0.025826,172.31.36.0-255,66,158319,1,191170
45722,0.028163,74.125.24.0-255,5738,164057,1,191170
45723,0.028171,172.31.36.0-255,66,164123,1,191170
45724,0.03052,74.125.24.0-255,5738,169861,1,191170
45725,0.030533,172.31.36.0-255,66,169927,1,191170
45726,0.03289,74.125.24.0-255,5738,175665,1,191170
45727,0.032901,172.31.36.0-255,66,175731,1,191170
45728,0.0347,172.31.36.0-255,172,175903,1,191170
45729,0.034735,172.31.36.0-255,1115,177018,1,191170
45730,0.034791,172.31.36.0-255,1514,178532,1,191170
45731,0.034793,172.31.36.0-255,1514,180046,1,191170
45732,0.034794,172.31.36.0-255,1514,181560,1,191170
45733,0.034795,172.31.36.0-255,1514,183074,1,191170
45734,0.034823,172.31.36.0-255,1489,184563,1,191170
45735,0.035254,74.125.24.0-255,4320,188883,1,191170
45736,0.03526,172.31.36.0-255,66,188949,1,191170
45737,0.035283,74.125.24.0-255,1484,190433,1,191170
45738,0.03628,104.244.42.0-255,66,190499,1,191170
45739,0.0363,104.244.42.0-255,66,190565,1,191170
45740,0.036374,104.244.42.0-255,66,190631,1,191170
45741,0.037584,74.125.24.0-255,302,190933,1,191170
45742,0.037591,172.31.36.0-255,66,190999,1,191170
45743,0.037742,172.31.36.0-255,105,191104,1,191170
45744,0.040066,74.125.24.0-255,66,191170,1,191170
45745,0.0,74.125.24.0-255,147,147,1,243645
45746,2.3e-05,172.31.36.0-255,66,213,1,243645
45747,3.1e-05,74.125.24.0-255,1484,1697,1,243645
45748,3.5e-05,172.31.36.0-255,66,1763,1,243645
45749,4e-05,74.125.24.0-255,2902,4665,1,243645
45750,4.3e-05,172.31.36.0-255,66,4731,1,243645
45751,5.9e-05,74.125.24.0-255,7156,11887,1,243645
45752,6.2e-05,172.31.36.0-255,66,11953,1,243645
45753,6.6e-05,74.125.24.0-255,2036,13989,1,243645
45754,6.9e-05,172.31.36.0-255,66,14055,1,243645
45755,0.000367,74.125.24.0-255,1484,15539,1,243645
45756,0.000372,172.31.36.0-255,66,15605,1,243645
45757,0.000379,74.125.24.0-255,2902,18507,1,243645
45758,0.000383,172.31.36.0-255,66,18573,1,243645
45759,0.000387,74.125.24.0-255,2902,21475,1,243645
45760,0.000389,172.31.36.0-255,66,21541,1,243645
45761,0.000421,74.125.24.0-255,2902,24443,1,243645
45762,0.000424,172.31.36.0-255,66,24509,1,243645
45763,0.000436,172.31.36.0-255,66,24575,1,243645
45764,0.000461,74.125.24.0-255,2543,27118,1,243645
45765,0.000463,172.31.36.0-255,66,27184,1,243645
45766,0.000476,172.31.36.0-255,66,27250,1,243645
45767,0.000516,172.31.36.0-255,66,27316,1,243645
45768,0.000551,74.125.24.0-255,415,27731,1,243645
45769,0.000553,172.31.36.0-255,66,27797,1,243645
45770,0.000613,74.125.24.0-255,329,28126,1,243645
45771,0.000616,172.31.36.0-255,66,28192,1,243645
45772,0.000678,74.125.24.0-255,1484,29676,1,243645
45773,0.000681,172.31.36.0-255,66,29742,1,243645
45774,0.000686,74.125.24.0-255,2902,32644,1,243645
45775,0.00071,74.125.24.0-255,5738,38382,1,243645
45776,0.000713,74.125.24.0-255,1484,39866,1,243645
45777,0.000716,172.31.36.0-255,66,39932,1,243645
45778,0.000721,172.31.36.0-255,66,39998,1,243645
45779,0.000784,172.31.36.0-255,66,40064,1,243645
45780,0.000951,74.125.24.0-255,1484,41548,1,243645
45781,0.000956,74.125.24.0-255,2902,44450,1,243645
45782,0.000959,74.125.24.0-255,1484,45934,1,243645
45783,0.00097,74.125.24.0-255,1484,47418,1,243645
45784,0.000973,172.31.36.0-255,66,47484,1,243645
45785,0.000985,74.125.24.0-255,2902,50386,1,243645
45786,0.001005,74.125.24.0-255,4320,54706,1,243645
45787,0.00101,172.31.36.0-255,66,54772,1,243645
45788,0.001076,74.125.24.0-255,4320,59092,1,243645
45789,0.00108,74.125.24.0-255,3602,62694,1,243645
45790,0.001094,172.31.36.0-255,66,62760,1,243645
45791,0.001527,74.125.24.0-255,1484,64244,1,243645
45792,0.001546,74.125.24.0-255,2902,67146,1,243645
45793,0.001549,172.31.36.0-255,66,67212,1,243645
45794,0.001553,74.125.24.0-255,1484,68696,1,243645
45795,0.001577,74.125.24.0-255,1484,70180,1,243645
45796,0.001583,74.125.24.0-255,7156,77336,1,243645
45797,0.0016,172.31.36.0-255,66,77402,1,243645
45798,0.001606,74.125.24.0-255,5738,83140,1,243645
45799,0.00161,172.31.36.0-255,66,83206,1,243645
45800,0.001629,74.125.24.0-255,1484,84690,1,243645
45801,0.001655,74.125.24.0-255,2184,86874,1,243645
45802,0.001661,172.31.36.0-255,66,86940,1,243645
45803,0.001937,74.125.24.0-255,1484,88424,1,243645
45804,0.001942,74.125.24.0-255,2902,91326,1,243645
45805,0.001945,172.31.36.0-255,66,91392,1,243645
45806,0.001948,74.125.24.0-255,1484,92876,1,243645
45807,0.001966,74.125.24.0-255,4320,97196,1,243645
45808,0.001971,74.125.24.0-255,4320,101516,1,243645
45809,0.001976,172.31.36.0-255,66,101582,1,243645
45810,0.002022,74.125.24.0-255,5738,107320,1,243645
45811,0.002035,74.125.24.0-255,2184,109504,1,243645
45812,0.002042,172.31.36.0-255,66,109570,1,243645
45813,0.002151,74.125.24.0-255,1484,111054,1,243645
45814,0.002156,74.125.24.0-255,2902,113956,1,243645
45815,0.002169,172.31.36.0-255,66,114022,1,243645
45816,0.002174,74.125.24.0-255,2902,116924,1,243645
45817,0.002183,172.31.36.0-255,66,116990,1,243645
45818,0.002211,74.125.24.0-255,2902,119892,1,243645
45819,0.002214,74.125.24.0-255,1484,121376,1,243645
45820,0.002229,74.125.24.0-255,5738,127114,1,243645
45821,0.002243,74.125.24.0-255,6438,133552,1,243645
45822,0.002269,74.125.24.0-255,4320,137872,1,243645
45823,0.002272,172.31.36.0-255,66,137938,1,243645
45824,0.002277,172.31.36.0-255,66,138004,1,243645
45825,0.002382,74.125.24.0-255,1484,139488,1,243645
45826,0.002388,74.125.24.0-255,6438,145926,1,243645
45827,0.011656,74.125.24.0-255,1484,147410,1,243645
45828,0.011837,172.31.36.0-255,66,147476,1,243645
45829,0.014232,74.125.24.0-255,5738,153214,1,243645
45830,0.014239,172.31.36.0-255,66,153280,1,243645
45831,0.016591,74.125.24.0-255,5738,159018,1,243645
45832,0.016598,172.31.36.0-255,66,159084,1,243645
45833,0.019017,74.125.24.0-255,5738,164822,1,243645
45834,0.020333,172.31.36.0-255,66,164888,1,243645
45835,0.022706,74.125.24.0-255,5738,170626,1,243645
45836,0.022717,172.31.36.0-255,66,170692,1,243645
45837,0.025177,74.125.24.0-255,5738,176430,1,243645
45838,0.025185,172.31.36.0-255,66,176496,1,243645
45839,0.027593,74.125.24.0-255,5738,182234,1,243645
45840,0.027601,172.31.36.0-255,66,182300,1,243645
45841,0.030012,74.125.24.0-255,5738,188038,1,243645
45842,0.030021,172.31.36.0-255,66,188104,1,243645
45843,0.032435,74.125.24.0-255,5738,193842,1,243645
45844,0.032443,172.31.36.0-255,66,193908,1,243645
45845,0.034879,74.125.24.0-255,5738,199646,1,243645
45846,0.034889,172.31.36.0-255,66,199712,1,243645
45847,0.037255,74.125.24.0-255,5738,205450,1,243645
45848,0.037264,172.31.36.0-255,66,205516,1,243645
45849,0.039538,172.31.36.0-255,172,205688,1,243645
45850,0.039569,172.31.36.0-255,1114,206802,1,243645
45851,0.039635,172.31.36.0-255,1514,208316,1,243645
45852,0.039637,172.31.36.0-255,1514,209830,1,243645
45853,0.039642,172.31.36.0-255,1514,211344,1,243645
45854,0.039643,172.31.36.0-255,1514,212858,1,243645
45855,0.039682,74.125.24.0-255,5738,218596,1,243645
45856,0.039686,172.31.36.0-255,66,218662,1,243645
45857,0.03969,172.31.36.0-255,1503,220165,1,243645
45858,0.041069,104.244.42.0-255,66,220231,1,243645
45859,0.041116,104.244.42.0-255,66,220297,1,243645
45860,0.041223,104.244.42.0-255,66,220363,1,243645
45861,0.041276,104.244.42.0-255,66,220429,1,243645
45862,0.042097,74.125.24.0-255,5738,226167,1,243645
45863,0.042103,172.31.36.0-255,66,226233,1,243645
45864,0.044473,74.125.24.0-255,5738,231971,1,243645
45865,0.04448,172.31.36.0-255,66,232037,1,243645
45866,0.046886,74.125.24.0-255,5738,237775,1,243645
45867,0.046894,172.31.36.0-255,66,237841,1,243645
45868,0.049271,74.125.24.0-255,5738,243579,1,243645
45869,0.049278,172.31.36.0-255,66,243645,1,243645
